hour,ADCB Bikeshare | ADIA HQ,ADCB Bikeshare | ARG Gate 13,ADCB Bikeshare | ARG Gate 18,ADCB Bikeshare | Al Ain Tower,ADCB Bikeshare | Al Amanah Khalidiya,ADCB Bikeshare | Al Aryam Tower,ADCB Bikeshare | Al Bandar,ADCB Bikeshare | Al Muneera North,ADCB Bikeshare | Al Muneera South,ADCB Bikeshare | Al Yousuf Center,ADCB Bikeshare | Al Zeina,ADCB Bikeshare | Arc Tower,ADCB Bikeshare | Capital Plaza,ADCB Bikeshare | City of Lights,ADCB Bikeshare | Corniche East,ADCB Bikeshare | Corniche Plaza,ADCB Bikeshare | Ferrari World,ADCB Bikeshare | Gardens Plaza,ADCB Bikeshare | Gate Tower,ADCB Bikeshare | Golf Gardens,ADCB Bikeshare | Hamdan - Salam,ADCB Bikeshare | Irena HQ,ADCB Bikeshare | Louvre,ADCB Bikeshare | Louvre Boulevard,ADCB Bikeshare | Marasy,ADCB Bikeshare | Marina Mall Signal,ADCB Bikeshare | Masdar City,ADCB Bikeshare | NYU East,ADCB Bikeshare | NYU West,ADCB Bikeshare | Nation Towers,ADCB Bikeshare | Paragon Bay Mall,ADCB Bikeshare | Rayhaan Rotana,ADCB Bikeshare | Rosewood Hotel,ADCB Bikeshare | SBV 14,ADCB Bikeshare | Saadiyat Beach,ADCB Bikeshare | Saadiyat Beach Club,ADCB Bikeshare | Saadiyat Beach Golf Club,ADCB Bikeshare | Saadiyat Beach Residences,ADCB Bikeshare | Siemens Building,ADCB Bikeshare | Sky Tower,ADCB Bikeshare | St. Regis,ADCB Bikeshare | United Square,ADCB Bikeshare | WTC,ADCB Bikeshare | Yas Beach Station,ADCB Bikeshare | Yas Links,ADCB Bikeshare | Yas Marina,ADCB Bikeshare | Yas Plaza,ADCB Bikeshare | Yas Viceroy,ADCB Bikeshare | Yas Waterworld,ARbike | Baldaccio,ARbike | Bucciarelli,ARbike | Giotto,ARbike | Mecenate,ARbike | Ospedale,ARbike | Sant'Agostino,ARbike | Stazione Bus,ARbike | Stazione Ferroviaria,ARbike | Tribunale,Alba | 01. Stazione FF.SS.,Alba | 02. Savona,Alba | 03. Savona 2,Alba | 04. Municipio,Alba | 05. Medford,Alba | 06. Piave,Alba | 07. Langhe,Alba | 08. S. Barbara,Alba | 09. Ferrero,Andria in Bici | Caduti sul lavoro,Andria in Bici | Cimitero,Andria in Bici | Garibaldi,Andria in Bici | Ipercoop,Andria in Bici | Marconi,Andria in Bici | Municipio,Andria in Bici | Roma,Andria in Bici | Santa Maria Vetere,Andria in Bici | Stadio,Andria in Bici | Stazione Ferroviaria,Andria in Bici | Verdi,Andria in Bici | Vittor Pisani,ArborBike | Murfin & Hubbard,Arriva | Autobusová stanica,Arriva | Chrenovský most,Arriva | Mestský Park,Arriva | SPÚ ŠD Mladosť,Arriva | Svätoplukovo námestie,Arriva | Tr. Andreja Hlinku - Centro Nitra,Arriva | Župné námestie,Ascoli Piceno | De Gasperi,Ascoli Piceno | Federici,Ascoli Piceno | Roma,Ascoli Piceno | Romana,Ascoli Piceno | Stazione,AthensBikes | Athens - Technopolis,Atrakcje turystyczne Tychowo | Dworek w Bukówku,Atrakcje turystyczne Tychowo | Głaz narzutowy „Trygław”,Atrakcje turystyczne Tychowo | Kościół Matki Bożej Wspomożenia Wiernych,Atrakcje turystyczne Tychowo | Kościół Niepokalanego poczęcia Najświętszej Maryi Panny,Atrakcje turystyczne Tychowo | Kościół Podwyższenia Krzyża,Atrakcje turystyczne Tychowo | Kościół matki Bożej Szkaplerznej,Atrakcje turystyczne Tychowo | Kościół św. Antoniego,Atrakcje turystyczne Tychowo | Kościół św. Jana Chrzciciela,Atrakcje turystyczne Tychowo | Kościół św. Jana Kantego,Atrakcje turystyczne Tychowo | Kościół św. Stanisława Kostki,Atrakcje turystyczne Tychowo | Kościół św. Szczepana,Atrakcje turystyczne Tychowo | Muzeum Zimnej Wojny,Atrakcje turystyczne Tychowo | Pałac vol Kleist,Atrakcje turystyczne Tychowo | Pałac w Bukówku,Atrakcje turystyczne Tychowo | Pałac w Dobrowie,Atrakcje turystyczne Tychowo | Pałac w Kikowie,Atrakcje turystyczne Tychowo | Pomnik Jeńców Alianckich,Atrakcje turystyczne Tychowo | Rezerwat Cisy Tychowskie,Atrakcje turystyczne Tychowo | Stawy Paciorkowe,Atrakcje turystyczne Tychowo | Tulipanowiec Amerykański,Austin B-cycle | 10th/Red River,Austin B-cycle | 11th/Congress @ The Texas Capitol,Austin B-cycle | 11th/Salina,Austin B-cycle | 11th/San Jacinto,Austin B-cycle | 12th/San Jacinto @ State Capitol Visitors Garage,Austin B-cycle | 13th/San Antonio,Austin B-cycle | 17th/Guadalupe,Austin B-cycle | 21st/Guadalupe,Austin B-cycle | 21st/Speedway @ PCL,Austin B-cycle | 21st/University,Austin B-cycle | 22nd/Pearl,Austin B-cycle | 23rd/Rio Grande,Austin B-cycle | 23rd/San Jacinto @ DKR Stadium,Austin B-cycle | 26th/Nueces,Austin B-cycle | 28th/Rio Grande,Austin B-cycle | 2nd/Congress,Austin B-cycle | 2nd/Lavaca @ City Hall,Austin B-cycle | 3rd/Nueces,Austin B-cycle | 3rd/Trinity @ The Convention Center,Austin B-cycle | 3rd/West,Austin B-cycle | 4th/Congress,Austin B-cycle | 5th/Campbell,Austin B-cycle | 5th/Guadalupe @ Republic Square,Austin B-cycle | 6th/Brazos,Austin B-cycle | 6th/Chalmers,Austin B-cycle | 6th/Congress,Austin B-cycle | 6th/Lavaca,Austin B-cycle | 6th/Trinity,Austin B-cycle | 6th/West,Austin B-cycle | 8th/Congress,Austin B-cycle | 8th/Lavaca,Austin B-cycle | 8th/Red River,Austin B-cycle | 8th/San Jacinto,Austin B-cycle | 9th/Henderson,Austin B-cycle | Barton Springs Pool,Austin B-cycle | Barton Springs/Bouldin @ Palmer Auditorium,Austin B-cycle | Barton Springs/Kinney,Austin B-cycle | Boardwalk West,Austin B-cycle | Cesar Chavez/Congress,Austin B-cycle | Dean Keeton/Speedway,Austin B-cycle | Dean Keeton/Whitis,Austin B-cycle | East 11th/San Marcos,Austin B-cycle | East 11th/Victory Grill,Austin B-cycle | East 2nd/Pedernales,Austin B-cycle | East 4th/Chicon,Austin B-cycle | East 5th/Broadway @ Capital Metro HQ,Austin B-cycle | East 6th/Medina,Austin B-cycle | East 6th/Pedernales,Austin B-cycle | East 6th/Robert T. Martinez,Austin B-cycle | Electric Drive/Sandra Muraida Way @ Pfluger Ped Bridge,Austin B-cycle | Guadalupe/West Mall @ University Co-op,Austin B-cycle | Hollow Creek/Barton Hills,Austin B-cycle | Lake Austin Blvd/Deep Eddy,Austin B-cycle | Lake Austin/Enfield,Austin B-cycle | Lakeshore/Austin Hostel,Austin B-cycle | Lakeshore/Pleasant Valley,Austin B-cycle | Nash Hernandez/East @ RBJ South,Austin B-cycle | Plaza Saltillo,Austin B-cycle | Rainey/Cummings,Austin B-cycle | Rainey/Davis,Austin B-cycle | Red River/Cesar Chavez @ The Fairmont,Austin B-cycle | Riverside/South Lamar,Austin B-cycle | Rosewood/Angelina,Austin B-cycle | Rosewood/Chicon,Austin B-cycle | South 1st/Riverside @ Long Center,Austin B-cycle | South Congress @ Bouldin Creek,Austin B-cycle | South Congress/Academy,Austin B-cycle | South Congress/Barton Springs @ The Austin American-Statesman,Austin B-cycle | South Congress/James,Austin B-cycle | Sterzing/Barton Springs,Austin B-cycle | Veterans/Atlanta @ MoPac Ped Bridge,Austin B-cycle | Zilker Park,B-cycle | 10th & Main,B-cycle | 10th & Washington,B-cycle | 12th & Wyandotte,B-cycle | 12th and Oak,B-cycle | 13th & Grand,B-cycle | 13th & Locust,B-cycle | 18th & Oak,B-cycle | 18th & Swift,B-cycle | 19th & Wyandotte,B-cycle | 20th & Grand,B-cycle | 29th & Swift,B-cycle | 39th & Roanoke,B-cycle | 39th & State Line,B-cycle | 3rd & Grand,B-cycle | 40th & Broadway,B-cycle | 47th & JC Nichols Pkwy.,B-cycle | 4th & Delaware,B-cycle | 4th & Wyandotte,B-cycle | 51st & Holmes (UMKC),B-cycle | 8th & Broadway,B-cycle | Armour & Main,B-cycle | Armour and Iron,B-cycle | Boulevard Brewing Co.,B-cycle | Brookside Shops,B-cycle | Brookside51,B-cycle | Buttonwood at Union Hill,B-cycle | Crown Center,B-cycle | E. Gorham & N. Brearly,B-cycle | E. Gorham @ James Madison Park,B-cycle | E. Washington & N. Webster,B-cycle | Eastwood & Division,B-cycle | Goodman Community Center,B-cycle | Gregory and Wornall,B-cycle | Hawthorne Ct & State Street,B-cycle | Ian's Pizza on State,B-cycle | Jazz District,B-cycle | John Nolen & Law Park,B-cycle | Kansas City Art Institute,B-cycle | Kauffman Foundation,B-cycle | Langdon St. & N. Lake St.,B-cycle | Library Mall,B-cycle | Longview Lake,B-cycle | MLK & Main St.,B-cycle | Madison College - Truax Campus,B-cycle | Mansion Hill Inn,B-cycle | Martini Corner,B-cycle | Memorial Union,B-cycle | Monroe & Harrison,B-cycle | N. Lake St. @ University Ave.,B-cycle | N. Park & Spring St.,B-cycle | N. Shore @ Brittingham Park,B-cycle | N. Thornton @ Tenney Park,B-cycle | N. Webster & E. Mifflin,B-cycle | Observatory Dr. @ Natatorium Gym,B-cycle | Observatory Dr. @ UW Hospital,B-cycle | Olbrich Biergarten,B-cycle | Olbrich Gardens,B-cycle | Philosopher's Grove,B-cycle | Plaza 209,B-cycle | S. Breese @ Camp Randall,B-cycle | S. Few & Williamson,B-cycle | S. Hamilton & S. Carroll St.,B-cycle | Sheraton Hotel,B-cycle | State St. & N. Frances,B-cycle | The Nelson-Atkins Museum of Art,B-cycle | UW Children's Hospital,B-cycle | UW Credit Union,B-cycle | UW Digestive Health Center,B-cycle | Union South,B-cycle | Union Station,B-cycle | University & Bassett,B-cycle | University St. & Charter St.,B-cycle | University Station Clinic,B-cycle | Vilas Park @ Arboretum,B-cycle | W. Gilman @ Peace Park,B-cycle | W. Mifflin @ Central Library,B-cycle | W. Washington & Regent St.,B-cycle | W. Wilson & MLK,B-cycle | Waldo,B-cycle | Ward Parkway & Broadway,B-cycle | Westport & Main,B-cycle | Westport Sunfresh,B-cycle | Williamson St @ Jenifer St.,B-cycle | Wisconsin & E. Mifflin,B-cycle | Wonder Building,BBBike | 1. Plac Ratuszowy,BBBike | 10. Spółdzielców,BBBike | 11. Łagodna - Złote Łany,BBBike | 12. Sosnkowskiego - Basen,BBBike | 13. Św. J. Chrzciciela,BBBike | 14. Grażyńskiego/Kwiatkowskiego,BBBike | 15. Mostowa (SFERA),BBBike | 16. Lenartowicza/Jutrzenki,BBBike | 17. Bora-Komorowskiego (Gemini),BBBike | 18. Górska - Bulwary Straceńskie,BBBike | 19. Boboli - Szpital Wojewódzki,BBBike | 2. Dworzec PKS,BBBike | 20. Lotnicza/Szarotki,BBBike | 21. Gościnna/Kolista,BBBike | 22. Karbowa/Armii Krajowej,BBBike | 23. Zwardońska - Lotnisko,BBBike | 24. Jaworzańska - Stadion,BBBike | 3. Plac Mikołaja,BBBike | 4. Piastowska (Starostwo Powiatowe),BBBike | 5. Cygański Las,BBBike | 6. ATH,BBBike | 7. Konopnickiej - Basen,BBBike | 8. Partyzantów - Plac Mickiewicza,BBBike | 9. Babiogórska - Pętla,BICI&CO | Cacciatori delle Alpi,BICI&CO | Caserme,BICI&CO | Cavour,BICI&CO | Como Nord Lago,BICI&CO | FN Borghi,BICI&CO | Funicolare,BICI&CO | Municipio,BICI&CO | Pirellino,BICI&CO | RFI San Giovanni,BICI&CO | Sant'Abbondio,BICI&CO | Santa Chiara,BICI&CO | Stadio,BICI&CO | Tavernola,BICI&CO | Universita`,BICI&CO | Villa Olmo,BICI&CO | Vittoria,BIKER Białystok - Orlen | PKN Orlen - 1000-Lecia PP,BIKER Białystok - Orlen | PKN Orlen - Baranowicka,BIKER Białystok - Orlen | PKN Orlen - Gen. Maczka,BIKER Białystok - Orlen | PKN Orlen - Kawaleryjska,BIKER Białystok - Orlen | PKN Orlen - Ks.Suchowolca,BIKER Białystok - Orlen | PKN Orlen - Sikorskiego,BIKER Białystok | 42 Pułku Piechoty / Zacisze Dolistówka,BIKER Białystok | Al. Konstytucji 3 Maja / Studzienna,BIKER Białystok | Antoniukowska / Świętokrzyska,BIKER Białystok | Armii Krajowej,BIKER Białystok | Baranowicka / Zaścianki,BIKER Białystok | Boh. Monte Cassino / Wyszyńskiego,BIKER Białystok | Bohaterów Getta / Piłsudskiego,BIKER Białystok | Branickiego / Miłosza,BIKER Białystok | Branickiego / Świętojańska,BIKER Białystok | Chełmońskiego / Wańkowicza,BIKER Białystok | Choroszcz / Plac dr. Zygmunta Brodowicza,BIKER Białystok | Chrobrego / Piastowska,BIKER Białystok | Dojlidy Górne / Edukacyjna,BIKER Białystok | Dolistowska,BIKER Białystok | Hallera / Gajowa,BIKER Białystok | Ignatki Osiedle / Jodłowa,BIKER Białystok | Kaczorowskiego / Wyszyńskiego,BIKER Białystok | Kampus Uniwesytecki,BIKER Białystok | Kleosin / Tarasiuka,BIKER Białystok | Kolejowa / PKP,BIKER Białystok | Komisji Edukacji Narodowej,BIKER Białystok | Lipowa / Nowy Świat,BIKER Białystok | Lodowa / Chłodna,BIKER Białystok | Mickiewicza - Podleśna,BIKER Białystok | Mickiewicza / Świętojańska,BIKER Białystok | Mieszka I / Piastowska,BIKER Białystok | Nowosielska / Francuska,BIKER Białystok | Piłsudskiego / Pałacowa,BIKER Białystok | Piłsudskiego / Sienkiewicza,BIKER Białystok | Pl.Niepodległości,BIKER Białystok | Plac Niezależnego Zrzeszenia Studentów,BIKER Białystok | Plażowa,BIKER Białystok | Podleśna / Filharmonia,BIKER Białystok | Popiełuszki / Słonecznikowa,BIKER Białystok | Popiełuszki/ Sikorskiego,BIKER Białystok | Produkcyjna / Strażacka,BIKER Białystok | Radzymińska / Zagumienna,BIKER Białystok | Raginisa / Rycerska,BIKER Białystok | Rynek 11 Listopada,BIKER Białystok | Rynek Kościuszki,BIKER Białystok | Sienkiewicza / Ryska,BIKER Białystok | Sikorskiego / Jana Pawła II,BIKER Białystok | Sikorskiego / Witosa,BIKER Białystok | Składowa / Pogodna,BIKER Białystok | Skłodowskiej / Hortex,BIKER Białystok | Sokólska,BIKER Białystok | Stadion Miejski,BIKER Białystok | Swobodna,BIKER Białystok | Słonimska / Urząd Miejski,BIKER Białystok | TEST BKM (SMT KE),BIKER Białystok | Wasilkowska / rondo,BIKER Białystok | Wiejska / Kręta,BIKER Białystok | Wiejska / Pogodna,BIKER Białystok | Zielonogórska / Słonecznikowa,BIKER Białystok | Zwierzyniecka / Świerkowa,BIKER Białystok | Zwycięstwa / Hetmańska,BIKER Białystok | Świętego Jerzego / Dubois,BIKER Białystok | Żurawia / Wiewiórcza,BIKETOWN | Metro Campus - Community Corral,BIKETOWN | N Burrage at Killingsworth Community Corral,BIKETOWN | N Concord at Killingsworth - Community Corral,BIKETOWN | N Failing at Williams,BIKETOWN | N Interstate at Willamette - Community Corral,BIKETOWN | N Killingsworth at Albina,BIKETOWN | N Killingsworth at Gay - Community Corral,BIKETOWN | N Mason at Williams,BIKETOWN | N Michigan at Killingsworth - Community Corral,BIKETOWN | N Mississippi at Beech,BIKETOWN | N Mississippi at N Skidmore,BIKETOWN | N Morris at Williams,BIKETOWN | N Prescott at Interstate,BIKETOWN | N Russell at Interstate Community Corral,BIKETOWN | N Vancouver at Alberta,BIKETOWN | N Williams at Fremont,BIKETOWN | NE 10th at Halsey -- Community Corral,BIKETOWN | NE 11th at Holladay Park,BIKETOWN | NE 14th Pl at Prescott - Community Corral,BIKETOWN | NE 15th at Broadway,BIKETOWN | NE 17th at Killingsworth - Community Corral,BIKETOWN | NE 22nd at Burnside,BIKETOWN | NE 22nd at Thompson - Community Corral (Irvington Tennis Club),BIKETOWN | NE 28th at Couch - Community Corral,BIKETOWN | NE 28th at Glisan- Community Corral,BIKETOWN | NE 2nd at NE Schuyler,BIKETOWN | NE 30th at Glisan - Community Corral,BIKETOWN | NE 33rd at Emerson - Community Corral,BIKETOWN | NE 33rd at Jarrett (Kennedy School) - Community Corral,BIKETOWN | NE 41st at Sandy Blvd (Hollywood Theatre) Community Corral,BIKETOWN | NE 42nd at Hancock - Community Corral,BIKETOWN | NE 42nd at NE Alberta Court,BIKETOWN | NE 43rd at Sandy,BIKETOWN | NE 48th at Fremont - Community Corral,BIKETOWN | NE 50th at Fremont - Community Corral,BIKETOWN | NE 50th at Sandy,BIKETOWN | NE 60th at Cully,BIKETOWN | NE Alberta at 10th - Community Corral,BIKETOWN | NE Alberta at 14th - Community Corral,BIKETOWN | NE Alberta at 17th - Community Corral,BIKETOWN | NE Alberta at 22nd - Community Corral,BIKETOWN | NE Alberta at 24th - Community Corral,BIKETOWN | NE Alberta at NE 29th/30th - Community Corral,BIKETOWN | NE Broadway at 12th,BIKETOWN | NE Couch at MLK,BIKETOWN | NE Cully at Killingsworth - Community Corral,BIKETOWN | NE Cully at Skidmore - Community Corral,BIKETOWN | NE Fremont at 15th - Community Corral,BIKETOWN | NE Glisan at 24th,BIKETOWN | NE Glisan at 53rd,BIKETOWN | NE Going at Grand,BIKETOWN | NE Holladay at MLK - Community Corral,BIKETOWN | NE Killingsworth at 30th - Community Corral,BIKETOWN | NE MLK at Knott,BIKETOWN | NE Multnomah at 9th,BIKETOWN | NE Multnomah at Grand,BIKETOWN | NE Sandy at 16th,BIKETOWN | NE Wheeler at Multnomah,BIKETOWN | NW 10th at Everett,BIKETOWN | NW 11th at The Fields,BIKETOWN | NW 13th at Marshall,BIKETOWN | NW 18th at Flanders,BIKETOWN | NW 18th at Northrup,BIKETOWN | NW 19th at Johnson,BIKETOWN | NW 20th at Burnside,BIKETOWN | NW 21st at Johnson,BIKETOWN | NW 22nd at Lovejoy,BIKETOWN | NW 23rd at Overton,BIKETOWN | NW 2nd at Everett,BIKETOWN | NW 4th at Couch,BIKETOWN | NW Broadway at Everett,BIKETOWN | NW Couch at 11th,BIKETOWN | NW Everett at 22nd,BIKETOWN | NW Flanders at 14th,BIKETOWN | NW Front at 17th,BIKETOWN | NW Glisan at 21st,BIKETOWN | NW Johnson at Jamison Square,BIKETOWN | NW Kearney at 23rd,BIKETOWN | NW Marshall at Tanner Springs Park,BIKETOWN | NW Naito at Ironside,BIKETOWN | NW Nicolai at Sherlock Community Corral,BIKETOWN | NW Pettygrove at 15th,BIKETOWN | NW Raleigh at 21st,BIKETOWN | NW Station at Irving,BIKETOWN | NW Thurman at 24th,BIKETOWN | SE 14th at Stark,BIKETOWN | SE 28th at Pine - Community Corral,BIKETOWN | SE 29th and Gladstone - Community Corral,BIKETOWN | SE 29th at Belmont,BIKETOWN | SE 29th at Hawthorne,BIKETOWN | SE 29th at Stark,BIKETOWN | SE 2nd Pl at Tilikum Way,BIKETOWN | SE 30th at Division,BIKETOWN | SE 34th at Division,BIKETOWN | SE 34th at Hawthorne,BIKETOWN | SE 37th at Division - Community Corral,BIKETOWN | SE 37th at Gladstone - Community Corral,BIKETOWN | SE 40th at Hawthorne,BIKETOWN | SE 47th at Hawthorne- Community Corral,BIKETOWN | SE 49th at Division - Community Corral,BIKETOWN | SE 50th at Division - Community Corral,BIKETOWN | SE 50th at Hawthorne- Community Corral,BIKETOWN | SE 9th at Belmont,BIKETOWN | SE 9th at Burnside,BIKETOWN | SE 9th at Madison,BIKETOWN | SE Alder at 6th,BIKETOWN | SE Belmont at 20th,BIKETOWN | SE Belmont at 33rd,BIKETOWN | SE Belmont at 42nd,BIKETOWN | SE Belmont at 45th - Community Corral,BIKETOWN | SE Clay at Water,BIKETOWN | SE Clinton at 21st,BIKETOWN | SE Clinton at 26th,BIKETOWN | SE Elliott at Division,BIKETOWN | SE Gideon at 12th Ave MAX station,BIKETOWN | SE Hawthorne at 20th,BIKETOWN | SE Ladd at Hawthorne,BIKETOWN | SE Powell Blvd at 29th Ave - Community Corral,BIKETOWN | SE Taylor at Chavez Community Corral,BIKETOWN | SE Water at Taylor,BIKETOWN | SW 10th at Columbia,BIKETOWN | SW 10th at Harvey Milk,BIKETOWN | SW 12th at Clay,BIKETOWN | SW 18th at Jefferson,BIKETOWN | SW 2nd at Pine,BIKETOWN | SW 3rd at Ankeny,BIKETOWN | SW 3rd at Morrison,BIKETOWN | SW 4th at College,BIKETOWN | SW 4th at Jefferson (City Hall) - Community Corral,BIKETOWN | SW 5th at Main,BIKETOWN | SW 5th at Morrison,BIKETOWN | SW 5th at Oak,BIKETOWN | SW Broadway at Smith Memorial Student Union,BIKETOWN | SW Harrison at 1st,BIKETOWN | SW Harvey Milk at Burnside,BIKETOWN | SW Market at Keller Fountain Park,BIKETOWN | SW Moody at Aerial Tram Terminal,BIKETOWN | SW Moody at Thomas,BIKETOWN | SW Morrison at 18th,BIKETOWN | SW Morrison at Pioneer Courthouse Sq.,BIKETOWN | SW Naito at Ankeny Plaza,BIKETOWN | SW Naito at Morrison,BIKETOWN | SW Park at Portland Art Museum,BIKETOWN | SW Park at SW Wright (Oregon Holocaust Memorial) Community Corral,BIKETOWN | SW Park at W Burnside - Community Corral,BIKETOWN | SW River at Montgomery,BIKETOWN | SW Salmon at Waterfront Park,BIKETOWN | SW Yamhill at Director Park,BIKETOWN | Tilikum West at SW Moody,BIKETOWN | Urban Center Plaza at SW 6th St,BL bike | Aquana,BL bike | Centar - Gradska uprava,BL bike | Oblićevo,BL bike | Park Mladen Stojanović,BL bike | Studenski dom - Venecija most,BRiteBikes | 3001 Bishop Drive,BRiteBikes | BR 11,BRiteBikes | BR 12 North,BRiteBikes | BR 15 North,BRiteBikes | BR 15 South,BRiteBikes | BR 2600 Visitor Lot,BRiteBikes | BR 3 North,BRiteBikes | BR 3 South,BRiteBikes | BR 6,BRiteBikes | BR 7,BRiteBikes | BR 8,BRiteBikes | BR 9,BRiteBikes | BR1,BRiteBikes | San Ramon City Hall,BRiteBikes | San Ramon Marriot,BRiteBikes | San Ramon Permit Center / Police Station,BRiteBikes | Transit Hub,Baksi | 1.Yahya Kaptan Bisiklet Egitim,Baksi | 10. Marina,Baksi | 11. Tren Gari,Baksi | 1118-Ertugrul Gazi Meydani,Baksi | 1161-Hereke Sahil,Baksi | 12. Seka Park Palmiye,Baksi | 13. Seka Park Uçurtma Tepesi,Baksi | 14. Seka Park 2. Etap,Baksi | 15. Plaj Yolu,Baksi | 16. Yildiz Konutlari,Baksi | 17. Alikahya Merkez,Baksi | 19. Naila 1,Baksi | 2. Yahya Kaptan D-100,Baksi | 20. Naila 2 Karsiyaka Sahil,Baksi | 21.Outlet Center,Baksi | 23. Kongre Sarayi Parki Gölcük,Baksi | 24. Degirmendere Sahil,Baksi | 25. Karamürsel Sahil,Baksi | 26. Bekirdere Üçyol Zincirliku,Baksi | 27. Muhsin Yazicioglu Parki,Baksi | 28. Eskihisar Sahil,Baksi | 29. Darica Sahil,Baksi | 3. Kinali Asker Parki,Baksi | 30. 60 Evler Sahil,Baksi | 31. Tütünçiftlik Sahil,Baksi | 32. Tramvay Terminal,Baksi | 33. Köseköy MYO.,Baksi | 4. Demokrasi Kavsagi,Baksi | 5. Dogu Kisla Parki,Baksi | 6. Anit Park,Baksi | 7. Izmit Belediyesi,Baksi | 8. Kocaeli Fuari,Baksi | 9. Mimar Sinan Köprüsü,Baksi | A.A Saygun,Baksi | Alaybey Tersane Cafe,Baksi | Ali Çetinkaya Bulvarı,Baksi | Alsancak Garı,Baksi | Alsancak İskele,Baksi | Altinkemer Sahil,Baksi | Atatürk Parkı,Baksi | Bayraklı Nikah Salonu,Baksi | Bayraklı İskele,Baksi | Bostanlı Odağı,Baksi | Bostanlı Spor Tesisleri,Baksi | Bostanlı iskele,Baksi | Buz Pisti,Baksi | Cebeci Sahil,Baksi | Cumhuriyet Parki,Baksi | Dereköy Sahil,Baksi | Doğal Yaşam Parkı,Baksi | Düden Park,Baksi | Eregli Sahil,Baksi | Fatma Hanim Parki,Baksi | Gebze Kent Meydani,Baksi | Gençlik Merkezi,Baksi | Gölcük Denizevler Sahil,Baksi | Gölcük Kent Meydani,Baksi | Gölkay Park,Baksi | Göztepe Köprü,Baksi | Işıklar,Baksi | KOÜ A Kapi,Baksi | KOÜ B Kapi,Baksi | KOÜ Sosyal Tesis,Baksi | Kandira Kent Meydani,Baksi | Kandira Otogar,Baksi | Kapalı Yol,Baksi | Karantina,Baksi | Karataş,Baksi | Karsiyaka Sahil,Baksi | Kartepe Belediyesi,Baksi | Karşıyaka Evlendirme Dairesi,Baksi | Karşıyaka iskele,Baksi | Konak Metro (1130),Baksi | Konak İskele,Baksi | Konyaaltı Meydan,Baksi | Kuş Cenneti,Baksi | Köprü,Baksi | Körfez Yarimca Sahil,Baksi | Liman,Baksi | MaviŞehir,Baksi | Mavişehir Balıkçı Barınağı,Baksi | Mehmed Ali Pasa,Baksi | Meles Rekreasyon Alanı,Baksi | Olbia Meydan,Baksi | Osman Hamdi Bey Kültür Merkezi,Baksi | Pasaport İskele,Baksi | Sahilevleri 1,Baksi | Sahilevleri 2,Baksi | Sampi Kavşağı,Baksi | Seka Park Otel,Baksi | Susuzdede,Baksi | Varyant,Baksi | Vasıf Çınar,Baksi | Yunuslar,Baksi | Üçkuyular İskelesi,Baksi | İnciraltı Kent Ormanı,Baksi | İnciraltı Rekreasyon Alanı,Baksi | İzban Turan İstasyonu,Baksi | İzmirim Kart Yükleme Noktası,Batumvelo | 01 Porti,Batumvelo | 02 Rusuli Skola,Batumvelo | 03 Centraluri,Batumvelo | 04 Shaumiani,Batumvelo | 05 b27,Batumvelo | 06 Universiteti,Batumvelo | 07 Akademia,Batumvelo | 08 b28,Batumvelo | 09 b23,Batumvelo | 10 Axali Bulvari 2,Batumvelo | 11 Aeroporti,Batumvelo | 12 Iusticia,Batumvelo | 13 Mwvane Koncxi,Batumvelo | 14 Geocell,Batumvelo | 15 Anbani,Batumvelo | 16 Parki,Batumvelo | 17 Meria,Batumvelo | 18 1 Mcdonalds,Batumvelo | 19 b14,Batumvelo | 20 Biria,Batumvelo | 21 Piaca,Batumvelo | 22 Benze,BelfastBikes | Alfred Street / St Malachy's Church,BelfastBikes | Allstate,BelfastBikes | Antrim Road / Duncairn Centre,BelfastBikes | Arthur Street / Chichester Street,BelfastBikes | Bankmore Square / Dublin Road,BelfastBikes | Belfast City Hospital,BelfastBikes | Botanic Avenue / Shaftesbury Square,BelfastBikes | Bradbury Place,BelfastBikes | CS Lewis Square,BelfastBikes | Carlisle Circus,BelfastBikes | Carrick Hill/St Patricks Church,BelfastBikes | Castle Place/Royal Avenue,BelfastBikes | Cathedral Gardens / York Street,BelfastBikes | Central Station / Mays Meadow,BelfastBikes | City Hall,BelfastBikes | College Square East,BelfastBikes | Connswater Shopping Centre,BelfastBikes | Corporation Square,BelfastBikes | Cotton Court / Waring Street,BelfastBikes | Donegall Quay,BelfastBikes | Europa Bus Station / Blackstaff Square,BelfastBikes | Falls Road/Twin Spire,BelfastBikes | Gasworks ( Lagan Towpath ),BelfastBikes | Gasworks (Cromac Street),BelfastBikes | Girdwood Community Hub/ Cliftonville Park Avenue,BelfastBikes | Great Victoria Street / Hope Street,BelfastBikes | Grosvenor Road/Servia Street,BelfastBikes | Linenhall Street / Donegall Square South,BelfastBikes | Mater Hospital/Crumlin Road,BelfastBikes | Millfield,BelfastBikes | Odyssey / Sydenham Road,BelfastBikes | Ormeau Park,BelfastBikes | Ormeau Road / Rosetta Roundabout,BelfastBikes | Ormeau Road/Somerset Street,BelfastBikes | Queens University / Botanic Gardens,BelfastBikes | Queens University / University Road,BelfastBikes | Royal Avenue / Castlecourt,BelfastBikes | Royal Victoria Hospital,BelfastBikes | Shankill Leisure Centre/ Shankill Road,BelfastBikes | Skainos,BelfastBikes | St George's Market / Cromac Square,BelfastBikes | Stranmillis Roundabout,BelfastBikes | Titanic Belfast Met,BelfastBikes | Titanic Walkway/Queens Road,BelfastBikes | Victoria Square / Victoria Street,BelfastBikes | Waterfront,"Berlin-Buch Campus | Campus Berlin-Buch, D24","Berlin-Buch Campus | Campus Berlin-Buch, D79",Berlin-Buch Campus | Helios Klinikum Berlin-Buch,Berlin-Buch Campus | S-Bahnhof Berlin-Buch,BiGi | Alpini,BiGi | Auchan - Carducci,BiGi | Battisti,BiGi | Bianzana,BiGi | Borgo Palazzo,BiGi | Cavour,BiGi | Coghetti,BiGi | Don Bosco,BiGi | Maj,BiGi | Matteotti,BiGi | Mazzini,BiGi | Oberdan,BiGi | Ospedale Papa Giovanni XXIII,BiGi | Paleocapa,BiGi | Palma il Vecchio,BiGi | Pirovano,BiGi | Rezzara,BiGi | San Fermo,BiGi | Sant'Anna,BiGi | Sant'Orsola,BiGi | Santo Spirito,BiGi | Tironi,BiGi | Viale Emanuele,Bianzone in Bici | Stazione F.S.,Bici Perugia | 01. Minimetro,Bici Perugia | 02. Duranti,Bici Perugia | 03. Trasimeno,Bici Perugia | 04. Centova,Bici Perugia | 05. Borgonovo,Bici Perugia | 06. Nuvolari,Bici Perugia | 07. Piazza Italia,Bici in Busto | Beata Giuliana,Bici in Busto | Municipio,Bici in Busto | Ospedale,Bici in Busto | Piazza San Michele,Bici in Busto | Piazza Santa Maria,Bici in Busto | Piscina Manara Mercato,Bici in Busto | Stazione FF SS,Bici in Busto | Stazione FNM,Bici in Busto | Tribunale,Bici las Condes | 001 VITACURA / SAN PATRICIO,Bici las Condes | 002 I. GOYENECHEA / EL BOSQUE NORTE,Bici las Condes | 003 EL GOLF / ISIDORA GOYENECHEA,Bici las Condes | 004 ZURICH / VITACURA,Bici las Condes | 005 ROGER DE FLOR / ENCOMENDEROS,Bici las Condes | 006 REYES LAVALLE (CENTRO CIVICO),Bici las Condes | 007 ALSACIA / APOQUINDO,Bici las Condes | 008 APOQUINDO / HANS C. ANDERSEN,Bici las Condes | 009 SAN CRESCENTE / NAPOLEÓN,Bici las Condes | 010 BURGOS / APOQUINDO,Bici las Condes | 011 GERTRUDIS ECHEÑIQUE / CALLAO,Bici las Condes | 012 PDTE. ERRAZURIZ / ENRIQUE FOSTER SUR,Bici las Condes | 013 PDTE. ERRAZURIZ / ALCANTARA,Bici las Condes | 014 MALAGA / RAPALLO,Bici las Condes | 015 SANCHEZ FONTECILLA / MARTIN DE ZAMORA,Bici las Condes | 016 HENDAYA / APOQUINDO,Bici las Condes | 017 PLAZA DON RAUL SIMON BERNARD,Bici las Condes | 018 SANCHEZ FONTECILLA / CRISTOBAL COLON,Bici las Condes | 019 ALCANTARA / VATICANO,Bici las Condes | 020 SANCHEZ FONTECILLA / I. LA CATOLICA,Bici las Condes | 021 I. LA CATOLICA / CARLOS V,Bici las Condes | 022 ALCANTARA / APOQUINDO,Bici las Condes | 023 A. VESPUCIO / PDTE. KENNEDY,Bici las Condes | 024 MALAGA / CRISTOBAL COLÓN,Bici las Condes | 025 CERRO COLORADO / ROSARIO NORTE,Bici las Condes | 051 PADRE HURTADO ORIENTE / KENNEDY,Bici las Condes | 052 LAS TRANQUERAS / PINARES,Bici las Condes | 053 PADRE HURTADO / LAS CONDES,Bici las Condes | 054 CALETERA AV LAS CONDES / ESTADIO ISRAELITA,Bici las Condes | 055 GERONIMO DE ALDERETE / MAR DE CORAL,Bici las Condes | 056 CHESTERTON / BOCACCIO,Bici las Condes | 057 PADRE HURTADO / BOCACCIO,Bici las Condes | 058 LAS TRANQUERAS / PLAZA VALENZUELA LLANOS,Bici las Condes | 059 LA ORACION / GERONIMO DE ALDERETE,Bici las Condes | 060 PRESIDENTE RIESCO / MANQUEHUE,Bici las Condes | 061 ESTOCOLMO / LOS MILITARES,Bici las Condes | 062 PADRE HURTADO / CAMINO EL ALBA,Bici las Condes | 063 APOQUINDO / NUESTRA SEÑORA DEL ROSARIO,Bici las Condes | 064 PEHUEN / APOQUINDO,Bici las Condes | 065 TOMAS MORO / APOQUINDO,Bici las Condes | 066 APOQUINDO / VILANOVA,Bici las Condes | 067 IV CENTENARIO / APOQUINDO,Bici las Condes | 068 IV CENTENARIO/EL GALEON,Bici las Condes | 069 LOS DOMINICOS / IMPERIAL,Bici las Condes | 070 COLON / PADRE HURTADO,Bici las Condes | 071 CRISTOBAL COLON / FUENTE OVEJUNA,Bici las Condes | 072 CRISTOBAL COLON (ROTONDA ATENAS ORIENTE),Bici las Condes | 073 VISVIRI / ALONSO DE CAMARGO,Bici las Condes | 074 PADRE HURTADO / ALEJANDRO FLEMING,Bici las Condes | 075 IV CENTENARIO / ALEJANDRO FLEMING,Bici las Condes | 076 ISABEL LA CATOLICA / EL PILLAN,Bici las Condes | 077 TOMAS MORO / ALEJANDRO FLEMING,Bici las Condes | 078 PADRE HURTADO / NVA BILBAO,Bici las Condes | 079 MANUEL CLARO VIAL / IV CENTENARIO,Bici las Condes | 080 MALLALIL / TOMAS MORO,Bici las Condes | 081 PDTE. KENNEDY / ROSARIO NORTE,Bici las Condes | 082 APOQUINDO / TOBALABA,Bici las Condes | 083 COSTANERA SUR / ANDRES BELLO,Bici las Condes | 084 ISIDORA GOYENECHEA / CARMENCITA,Bici las Condes | 085 LOS MILITARES / ALONSO DE CORDOVA,Bici las Condes | 086 LATERAL KENNEDY / GERONIMO DE ALDERETE,Bici las Condes | 087 MANQUEHUE SUR / EL DIRECTOR,Bici las Condes | 088 MANQUEHUE SUR / CRISTOBAL COLON,Bici las Condes | 089 PADRE HURTADO / GENERAL BLANCHE,Bici las Condes | 090 PADRE HURTADO SUR (MALL LOS DOMINICOS),Bici las Condes | 091 LIBIA / LAS CONDES,Bici las Condes | 093 AV. LAS CONDES / ESTORIL,Bici las Condes | 094 LAS CONDES / VALLE ALEGRE,Bici las Condes | 095 LAS CONDES / FERNANDEZ CONCHA,Bici las Condes | 096 LA POSADA / FERNANDEZ CONCHA,Bici las Condes | 097 LA POSADA / SAN ANTONIO,Bici las Condes | 098 CRISTOBAL COLON / PAUL HARRIS,Bici las Condes | 099 VITAL APOQUINDO / LA QUEBRADA,Bici las Condes | 100 PDTE. RIESCO / AMERICO VESPUCIO,"Bici las Condes | 26 CERRO COLORADO/MANQUEHUE""",Bici las Condes | 27 PDTE. RIESCO/LOS ESTANDARTES,Bici las Condes | 28 PDTE. RIESCO/ALONSO DE CORDOVA,Bici las Condes | 29 PDTE. RIESCO/ROSARIO NORTE,Bici las Condes | 30 LOS MILITARES/A. VESPUCIO,Bici las Condes | 31 ALONSO DE CORDOVA INTERIOR,Bici las Condes | 32 APOQUINDO - LA CASTELLANA NORTE,Bici las Condes | 33 MANQUEHUE - APOQUINDO,Bici las Condes | 34 LUIS RODRIGUEZ VELASCO - CORONEL PEREIRA,Bici las Condes | 35 APOQUINDO / LUIS ZEGERS,Bici las Condes | 36 MANQUEHUE - ALONSO DE CORDOVA,Bici las Condes | 37 DEL INCA - CRUZ DEL SUR,Bici las Condes | 38 DEL INCA - ANTONIA SALAS,Bici las Condes | 39 MARTIN DE ZAMORA - ALGECIRAS,Bici las Condes | 40 SEBASTIAN EL CANO - VICTOR RAE,Bici las Condes | 41 ALONSO DE CAMARGO - SEBASTIAN EL CANO,Bici las Condes | 42 MARTIN ALONSO PINZON - DIEGO DE DEZA,Bici las Condes | 43 MANQUEHUE - ALONSO DE CAMARGO,Bici las Condes | 44 MANQUEHUE - I. LA CATOLICA,Bici las Condes | 45 LATADIA - A. VESPUCIO,Bici las Condes | 46 ROTONDA LATADIA - SEBASTIAN EL CANO,Bici las Condes | 47 MANQUEHUE - CARLOS ALVARADO,Bici las Condes | 48 PLAZA BRASILIA,Bici las Condes | 49 NORUEGA - LOS MILITARES,Bici las Condes | 50 ROTONDA LA CAPITANIA,BiciMAD | Agustín de Betancourt,BiciMAD | Alberto Alcocer,BiciMAD | Alcalá,BiciMAD | Alcalá-Ventas,BiciMAD | Alcántara,BiciMAD | Almadén,BiciMAD | Alonso Martínez,BiciMAD | Altamirano,BiciMAD | Antonio Maura,BiciMAD | Antón Martín,BiciMAD | Arcipreste de Hita A,BiciMAD | Arcipreste de Hita B,BiciMAD | Atocha A,BiciMAD | Atocha B,BiciMAD | Augusto Figueroa,BiciMAD | Avenida de los Toreros,BiciMAD | Ayala,BiciMAD | Banco de España A,BiciMAD | Barceló,BiciMAD | Beata,BiciMAD | Biblioteca Nacional,BiciMAD | Bravo Murillo 44,BiciMAD | Calle Mayor,BiciMAD | Carlos Cambronero,BiciMAD | Carretas,BiciMAD | Casa Encendida,BiciMAD | Castellana,BiciMAD | Castellana 106,BiciMAD | Castellana 164,BiciMAD | Castellana 42,BiciMAD | Castellana frente a Hermanos Pinzón,BiciMAD | Castelló,BiciMAD | Cea Bermúdez,BiciMAD | Cibeles,BiciMAD | Claudio Coello,BiciMAD | Colegio Arquitectos,BiciMAD | Colombia,BiciMAD | Columela,BiciMAD | Colón A,BiciMAD | Colón B,BiciMAD | Conde Duque,BiciMAD | Conde Peñalver,BiciMAD | Conde de Casal,BiciMAD | Conde de Romanones,BiciMAD | Cuatro Caminos 2,BiciMAD | Cuesta de Moyano,BiciMAD | Diego de León 52,BiciMAD | Diego de león,BiciMAD | Doce de Octubre,BiciMAD | Doctor Arce 45,BiciMAD | Doctor Esquerdo-Hermosilla,BiciMAD | Embajada de Italia,BiciMAD | Embajadores 1,BiciMAD | Embajadores 2,BiciMAD | Embajadores-Cáceres,BiciMAD | Entrada Matadero,BiciMAD | Espalter,BiciMAD | Estrecho,BiciMAD | Fernando el Católico,BiciMAD | Ferraz,BiciMAD | Fuencarral,BiciMAD | General Martínez Campos,BiciMAD | General Pardiñas,BiciMAD | General Perón 1,BiciMAD | General Perón con Poeta Joan Maragall,BiciMAD | General Álvarez de Castro,BiciMAD | Glorieta de los Cuatro Caminos,BiciMAD | Guzmán el Bueno,BiciMAD | Hortaleza,BiciMAD | Huertas,BiciMAD | Ibiza,BiciMAD | Jacinto Benavente,BiciMAD | Jacometrezo,BiciMAD | Jaime el Conquistador,BiciMAD | Jesús y María,BiciMAD | Jorge Juan,BiciMAD | José Abascal,BiciMAD | José Gutiérrez Abascal,BiciMAD | Juan Bravo 50,BiciMAD | Juan Martín,BiciMAD | Legazpi,BiciMAD | Malasaña,BiciMAD | Manuel Silvela,BiciMAD | Marqués de Cubas,BiciMAD | Marqués de Salamanca,BiciMAD | Marqués de Zafra,BiciMAD | Marqués de la Ensenada,BiciMAD | María Francisca 1,BiciMAD | Menéndez Pelayo,BiciMAD | Metro Pirámides,BiciMAD | Miguel Moya,BiciMAD | Moncloa,BiciMAD | Museo Reina Sofía,BiciMAD | Mártires Concepcionistas,BiciMAD | Méndez Álvaro,BiciMAD | Narváez,BiciMAD | Niño Jesús,BiciMAD | O'Donnell,BiciMAD | Orense 12,BiciMAD | Orense 36,BiciMAD | Ortega y Gasset,BiciMAD | Ortega y Gasset 87,BiciMAD | Palacio de Deportes,BiciMAD | Palacio de Oriente,BiciMAD | Palos de la Frontera,BiciMAD | Parque Berlín,BiciMAD | Parque Roma,BiciMAD | Paseo de Moret,BiciMAD | Paseo de la Castellana con Raimundo Fernández,BiciMAD | Paseo de la Esperanza,BiciMAD | Paseo de la Florida,BiciMAD | Paseo de la Habana 42,BiciMAD | Paseo de la Habana 63,BiciMAD | Paseo de las Delicias,BiciMAD | Pedro Bosch,BiciMAD | Pintor Rosales,BiciMAD | Plaza Conde Suchil,BiciMAD | Plaza San Francisco,BiciMAD | Plaza de Celenque A,BiciMAD | Plaza de Celenque B,BiciMAD | Plaza de Colón,BiciMAD | Plaza de España A,BiciMAD | Plaza de España B,BiciMAD | Plaza de Felipe II,BiciMAD | Plaza de Juan Pujol,BiciMAD | Plaza de Lavapiés,BiciMAD | Plaza de Nelson Mandela,BiciMAD | Plaza de Pedro Zerolo,BiciMAD | Plaza de Ramales,BiciMAD | Plaza de San Ildefonso,BiciMAD | Plaza de San Juan de la Cruz,BiciMAD | Plaza de San Miguel,BiciMAD | Plaza de Santa Ana,BiciMAD | Plaza de la Cebada,BiciMAD | Plaza de la Independencia,BiciMAD | Plaza de la Provincia,BiciMAD | Plaza de la República Argentina,BiciMAD | Plaza de las Salesas,BiciMAD | Plaza de los Astros,BiciMAD | Plaza de los Carros,BiciMAD | Plaza del Carmen,BiciMAD | Plaza del Cordón,BiciMAD | Prim,BiciMAD | Príncipe de Vergara,BiciMAD | Puerta de Granada,BiciMAD | Puerta de Madrid,BiciMAD | Puerta de Mariano de Cavia,BiciMAD | Puerta de Toledo,BiciMAD | Puerta del Doce de Octubre,BiciMAD | Puerta del Pacífico,BiciMAD | Puerta del Sol A,BiciMAD | Puerta del Sol B,BiciMAD | Puerta del Ángel Caído,BiciMAD | Pº Castellana - Glorieta de Emilio Castelar,BiciMAD | Pío Baroja,BiciMAD | Quinta Fuente del Berro,BiciMAD | Quintana,BiciMAD | Raimundo Fernández,BiciMAD | Red de San Luis A,BiciMAD | Remonta,BiciMAD | Retiro-Ibiza,BiciMAD | Ribera de Curtidores,BiciMAD | Ronda de Atocha,BiciMAD | Sainz de Baranda,BiciMAD | San Andrés,BiciMAD | San Bernardo,BiciMAD | San Francisco de Sales,BiciMAD | San Germán,BiciMAD | San Hermenegildo,BiciMAD | San Quintín,BiciMAD | San Vicente Ferrer,BiciMAD | Santa Cruz del Marcenado,BiciMAD | Santa Engracia 127,BiciMAD | Santa Engracia 14,BiciMAD | Santa Isabel,BiciMAD | Santa María de la Cabeza,BiciMAD | Santo Domingo,BiciMAD | Segovia 26,BiciMAD | Segovia 45,BiciMAD | Serrano,BiciMAD | Serrano 210,BiciMAD | Sevilla,BiciMAD | Sor Ángela de la Cruz,BiciMAD | Tres Cruces,BiciMAD | Valderribas,BiciMAD | Velázquez,BiciMAD | Velázquez 130,BiciMAD | Velázquez-Diego de León,BiciMAD | Ventas,BiciMAD | Ventura Rodríguez,BiciMAD | Villanueva,BiciMia | 1Â° Maggio,BiciMia | ALFA ACCIAI,BiciMia | Arnaldo,BiciMia | Autosilo,BiciMia | Badia,BiciMia | Borgo Trento,BiciMia | Branze,BiciMia | Brescia 2,BiciMia | Buffalora,BiciMia | Caduti del Lavoro,BiciMia | Cairoli,BiciMia | Casazza,BiciMia | Castellini,BiciMia | Cavour,BiciMia | Chiusure,BiciMia | Corsica,BiciMia | Corso Martiri,BiciMia | Cremona,BiciMia | Da Vinci,BiciMia | Dalmazia,BiciMia | Don Bosco,BiciMia | Duca Abruzzi,BiciMia | Duomo,BiciMia | Europa,BiciMia | Fiumicello,BiciMia | Folzano,BiciMia | Fornaci,BiciMia | Fossa Bagni,BiciMia | Galilei,BiciMia | Garibaldi,BiciMia | Golgi,BiciMia | Gramsci,BiciMia | Iveco,BiciMia | Kennedy,BiciMia | Lamarmora - Metro,BiciMia | Magenta,BiciMia | Marconi,BiciMia | Milano,BiciMia | Mompiano Ambaraga,BiciMia | Mompiano Metro,BiciMia | Nino Bixio,BiciMia | Ospedali Civili,BiciMia | Ospedali Civili Metro,BiciMia | Palagiustizia,BiciMia | Pallata,BiciMia | Parco Castelli,BiciMia | Parco Ducos 2,BiciMia | Piave,BiciMia | Poliambulanza,BiciMia | Polivalente (Via Collebeato),BiciMia | Prealpino,BiciMia | Prealpino Tovini,BiciMia | Questura,BiciMia | Randaccio,BiciMia | Repubblica,BiciMia | Rovetta,BiciMia | San Bartolomeo,BiciMia | San Domenico,BiciMia | San Donino,BiciMia | San Faustino,BiciMia | San Polino,BiciMia | San Polo Cimabue,BiciMia | San Polo Parco 1,BiciMia | San Polo Parco 2,BiciMia | Sant Anna,BiciMia | Sant Eufemia,BiciMia | Sant Eufemia Buffalora,BiciMia | Satellite,BiciMia | Sostegno,BiciMia | Spalto San Marco,BiciMia | Stazione FS,BiciMia | Stazione FS Metro,BiciMia | Tebaldo Brusato,BiciMia | Vallecamonica,BiciMia | Veneto,BiciMia | Via Scuole,BiciMia | Villaggio Sereno,BiciMia | Violino,BiciMia | Vittoria,BiciMia | Volta,BiciMia | Wuhrer,BiciMia | Zanardelli,BiciMia | Zooprofilattico,BiciSchio | Duomo,BiciSchio | Stazione Bus,BiciSchio | Stazione FS,Bicicletar | Ana Bilhar,Bicicletar | Anfiteatro Parque do Cocó,Bicicletar | Assembléia Legislativa,Bicicletar | Aterrinho Praia de Iracema - Minibicicletar,Bicicletar | Aterrinho da Praia de Iracema,Bicicletar | Aterro Praia de Iracema,Bicicletar | BNB Clube,Bicicletar | BNB Cultural / Catedral,Bicicletar | Banco do Brasil - 13 de Maio,Bicicletar | Calçadão Crasa,Bicicletar | Campo do América,Bicicletar | Campus Porangabuçu - UFC,Bicicletar | Campus do Pici - UFC,Bicicletar | Carrefour,Bicicletar | Casa Freitas Montese,Bicicletar | Centro de Humanidades - UECE,Bicicletar | Cidade 2000,Bicicletar | Contax Borges de Melo,Bicicletar | Coronel Linhares,Bicicletar | Costa Mendes,Bicicletar | Círculo Militar,Bicicletar | Dragão do Mar,Bicicletar | Esplanada Montese,Bicicletar | Extra Aguanambi,Bicicletar | FIC Aldeota,Bicicletar | FIC Guararapes,Bicicletar | Faculdade Cearense,Bicicletar | Faculdade Lourenço Filho,Bicicletar | Floriano Peixoto,Bicicletar | Francisco Matos,Bicicletar | Frangolândia Sgt. Hermínio,Bicicletar | Frei Mansueto,Bicicletar | Fórum,Bicicletar | Hospital Geral de Fortaleza,Bicicletar | Hospital Walter Cantídio,Bicicletar | Igreja Redonda,Bicicletar | Igreja de Fátima,Bicicletar | Igreja de Nazaré,Bicicletar | Instituto dos Cegos,Bicicletar | Joaquim Nabuco,Bicicletar | Jornal O Povo,Bicicletar | José Sombra,Bicicletar | José Vilar,Bicicletar | João Cordeiro,Bicicletar | Júlio Azevedo,Bicicletar | Lago Jacarey - Minibicicletar,Bicicletar | Liceu do Ceará,Bicicletar | Livraria Cultura,Bicicletar | Monsenhor Tabosa,Bicicletar | Moreira da Rocha,Bicicletar | North Shopping,Bicicletar | Náutico,Bicicletar | Otávio Lobo,Bicicletar | Polo de Lazer Sargento Hermínio - Minibicicletar,Bicicletar | Portugália,Bicicletar | Praça Coração de Jesus,Bicicletar | Praça Luíza Távora,Bicicletar | Praça Luíza Távora - Minibicicletar,Bicicletar | Praça Martins Dourado,Bicicletar | Praça Monte Castelo,Bicicletar | Praça Otávio Bonfim,Bicicletar | Praça Portugal,Bicicletar | Praça da Bandeira,Bicicletar | Praça da Gentilândia,Bicicletar | Praça da Imprensa,Bicicletar | Praça das Flores,Bicicletar | Praça das Flores - Minibicicletar,Bicicletar | Praça do Ferreira,Bicicletar | Regional 3,Bicicletar | Reitoria UFC,Bicicletar | Rodoviária,Bicicletar | Rui Barbosa,Bicicletar | SENAI Jacarecanga,Bicicletar | Salesiano Dom Bosco,Bicicletar | Salinas,Bicicletar | Santa Cecília,Bicicletar | Shopping Benfica,Bicicletar | Shopping Del Paseo,Bicicletar | Shopping Iguatemi,Bicicletar | Shopping RioMar,Bicicletar | Terminal do Papicu,Bicicletar | Torres Câmara,Bicicletar | UNIMED,Bicicletar | Unifor,Bicicletar | Érico Mota,Bicikelj | ANTONOV TRG,Bicikelj | BARJANSKA C.-CENTER STAREJŠIH TRNOVO,Bicikelj | BAVARSKI DVOR,Bicikelj | BONIFACIJA,Bicikelj | BRATOVŠEVA PLOŠČAD,Bicikelj | BREG,Bicikelj | BRODARJEV TRG,Bicikelj | BS4-STOŽICE,Bicikelj | BTC CITY ATLANTIS,Bicikelj | BTC CITY/DVORANA A,Bicikelj | CANKARJEVA UL.-NAMA,Bicikelj | CESTA NA ROŽNIK,Bicikelj | CITYPARK,Bicikelj | DUNAJSKA C.-PS MERCATOR,Bicikelj | DUNAJSKA C.-PS PETROL,Bicikelj | GH ŠENTPETER-NJEGOŠEVA C.,Bicikelj | GRUDNOVO NABREŽJE-KARLOVŠKA C.,Bicikelj | HOFER-KAJUHOVA,Bicikelj | ILIRSKA ULICA,Bicikelj | KINO ŠIŠKA,Bicikelj | KONGRESNI TRG-ŠUBIČEVA ULICA,Bicikelj | KOPRSKA ULICA,Bicikelj | LIDL BEŽIGRAD,Bicikelj | LIDL-LITIJSKA CESTA,Bicikelj | MASARYKOVA DDC,Bicikelj | MERCATOR CENTER ŠIŠKA,Bicikelj | MERCATOR MARKET - CELOVŠKA C. 163,Bicikelj | MIKLOŠIČEV PARK,Bicikelj | P + R DOLGI MOST,Bicikelj | P+R BARJE,Bicikelj | PARK NAVJE-ŽELEZNA CESTA,Bicikelj | PARKIRIŠČE NUK 2-FF,Bicikelj | PLEČNIKOV STADION,Bicikelj | POGAČARJEV TRG-TRŽNICA,Bicikelj | POLJANSKA-POTOČNIKOVA,Bicikelj | POVŠETOVA-GRABLOVIČEVA,Bicikelj | PREGLOV TRG,Bicikelj | PREŠERNOV TRG-PETKOVŠKOVO NABREŽJE,Bicikelj | ROŽNA DOLINA-ŠKRABČEVA UL.,Bicikelj | SAVSKO NASELJE 1-ŠMARTINSKA CESTA,Bicikelj | SAVSKO NASELJE 2-LINHARTOVA CESTA,Bicikelj | SITULA,Bicikelj | SREDNJA FRIZERSKA ŠOLA,Bicikelj | STARA CERKEV,Bicikelj | TIVOLI,Bicikelj | TRG MDB,Bicikelj | TRG OF-KOLODVORSKA UL.,Bicikelj | TRNOVO,Bicikelj | TRŽAŠKA C.-ILIRIJA,Bicikelj | TRŽNICA KOSEZE,Bicikelj | TRŽNICA MOSTE,Bicikelj | VILHARJEVA CESTA,Bicikelj | ZALOŠKA C.-GRABLOVIČEVA C.,Bicikelj | ŠMARTINSKI PARK,Bicikelj | ŠPICA,Bicikelj | ŠPORTNI CENTER STOŽICE,Bicikelj | ŠTEPANJSKO NASELJE 1-JAKČEVA ULICA,Bicikelj | ŽIVALSKI VRT,Bicileon | Albeitar,Bicileon | CC Crucero,Bicileon | Espacio Vias,Bicileon | LEON PLAZA. MUSAC,Bicileon | Navatejera Polideportivo,Bicileon | Plaza San Marcelo,Bicileon | Polígono X,Bicileon | Renfe,Bicileon | San Pedro,Bicileon | Universidad Industriales,Bicileon | Villaquilambre - Ayuntamiento,BicinQuartucciu | Rosselli,BicinQuartucciu | Sunda,Bicincittà | 01. Curtatone,Bicincittà | 01. Stadio,Bicincittà | 01. Stazione,Bicincittà | 02. Monti Lepini,Bicincittà | 02. S. Agostino,Bicincittà | 02. Vinci,Bicincittà | 03. 19 Marzo,Bicincittà | 03. Murialdo,Bicincittà | 03. S. Girolamo,Bicincittà | 04. Cimitero,Bicincittà | 04. Fortezza,Bicincittà | 04. Piscina Comunale,Bicincittà | 05. Antiporto,Bicincittà | 05. Centro Sociale,Bicincittà | 05. Stazione P.za Italia,Bicincittà | 06. Due Ponti,Bicincittà | 06. Staz. Montecatini Centro,Bicincittà | 07. Napoli,Bicincittà | 07. Simoncini,Bicincittà | 08. Ospedale,Bicincittà | 08. Redi,Bicincittà | 09. Acquacalda,Bicincittà | 09. Excelsior,Bicincittà | 10. Ravacciano,Bicincittà | 10. Torretta,Bicincittà | 11. Leopoldine,Bicincittà | 11. S. Miniato,Bicincittà | 12. Terminal Bus,Bicincittà | 13. Taverne D'Arbia,Bicincittà | 14. Vico Alto,Bicincittà | 15. Casa dell'Ambiente,Bicincittà | 16. Frajese,Bicincittà | 17. Mercato,Bicincittà | 18. Tufi,Bicincittà | 2 Giugno,Bicincittà | 3° Palazzo Uffici,Bicincittà | Acquarica del capo,Bicincittà | Africo Nuovo,Bicincittà | Ancien-Stand,Bicincittà | Anconetta,Bicincittà | Antica Stazione,Bicincittà | Area Archeologica Luni,Bicincittà | Area Parco,Bicincittà | Avenue Piccard,Bicincittà | Avenue de Lonay,Bicincittà | Avenue de l´Europe - Monthey,Bicincittà | Avenza,Bicincittà | Bahnhof Murten - Gare de Morat,Bicincittà | Battaglia,Bicincittà | Bianco,Bicincittà | Bietschhorn,Bicincittà | Bocca di Magra,Bicincittà | Borgarello,Bicincittà | Borgata,Bicincittà | Bourg,Bicincittà | Brancaleone,Bicincittà | Bruzzano,Bicincittà | Burtigniere,Bicincittà | Business Park Terre Bonne,Bicincittà | CPNV,Bicincittà | Caboto,Bicincittà | Cagliari,Bicincittà | Calcutta,Bicincittà | Calolziocorte,Bicincittà | Campo Canoa,Bicincittà | Campo Marzio,Bicincittà | Caracalla,Bicincittà | Carisia,Bicincittà | Castel Guelfo The Style Outlets,Bicincittà | Castello S. Giorgio,Bicincittà | Castiglioni,Bicincittà | Cavalleggeri,Bicincittà | Cavour,Bicincittà | Cellarium,Bicincittà | Centre Manor - Monthey,Bicincittà | Centre Sportif UNIL EPFL,Bicincittà | Centre Thermal,Bicincittà | Centro Culturale,Bicincittà | Certosa,Bicincittà | Changins - EIC,Bicincittà | Chateau,Bicincittà | Chateauneuf - Furet,Bicincittà | Cheyres - Place du Port,Bicincittà | Cible,Bicincittà | Cimitero,Bicincittà | Citterio,Bicincittà | Collines,Bicincittà | Comune,Bicincittà | Contrada di Verla,Bicincittà | Cormanon,Bicincittà | Debarcadere de Nyon,Bicincittà | Delay,Bicincittà | Divonne centre,Bicincittà | Donja lastva - Crkva sv. Roka,Bicincittà | Donja lastva - Stara kula,Bicincittà | Dorigny,Bicincittà | ENI Corporate University,Bicincittà | Ex Mattatoio,Bicincittà | Ferruzzano,Bicincittà | Fiera,Bicincittà | Fiumaretta,Bicincittà | Formigara,Bicincittà | Fornaci,Bicincittà | Fra Locci,Bicincittà | Gare Avenches,Bicincittà | Gare Estavayer-le-Lac,Bicincittà | Gare Yverdon-les-Bains,Bicincittà | Gare de Fribourg - BCF,Bicincittà | Gare de Gland Nord - Swissquote,Bicincittà | Gare de Gland Sud - SEIC,Bicincittà | Gare de Nyon,Bicincittà | Gare de Payerne,Bicincittà | Gare de Renens,Bicincittà | Gare de Sion,Bicincittà | Gare de Vevey,Bicincittà | Gare d´Aigle,Bicincittà | Garibaldi,Bicincittà | Garlate,Bicincittà | Gemini,Bicincittà | Giussago,Bicincittà | Gradska Riva,Bicincittà | Gradski Stadion,Bicincittà | Gramsci,Bicincittà | Grand-Rive,Bicincittà | Grazioli,Bicincittà | Groupe E - Granges-Paccot,Bicincittà | HEIG-VD Cheseaux,Bicincittà | HEIG-VD St-Roch,Bicincittà | Halte de Malley,Bicincittà | Hopital de zone de Nyon,Bicincittà | Hotel de Ville - Aigle,Bicincittà | Hotel de Ville - Monthey,Bicincittà | IDHEAP,Bicincittà | Istituto Carlo Porta - INPS,Bicincittà | Istituto Mapelli,Bicincittà | La Jonction - Marly,Bicincittà | La Ligniere,Bicincittà | La Palma,Bicincittà | La Tour-de-Trême Centre,Bicincittà | Laboratorio ENI,Bicincittà | Lago di Paola,Bicincittà | Lecco - Bione,Bicincittà | Lecco - Diaz,Bicincittà | Lecco - La Meridiana,Bicincittà | Lecco - La Piccola,Bicincittà | Lecco - Ospedale,Bicincittà | Lecco - XX Settembre,Bicincittà | Lerici Centro,Bicincittà | Les Tuillieres,Bicincittà | Liberta`,Bicincittà | Longemalle,Bicincittà | Lučica Kalimanj,Bicincittà | Mach,Bicincittà | Malgrate 1,Bicincittà | Malgrate 2,Bicincittà | Marconi,Bicincittà | Marina,Bicincittà | Massarosa - La Brilla,Bicincittà | Mazzini,Bicincittà | Medtronic,Bicincittà | Metropolitana,Bicincittà | Morigerati,Bicincittà | Municipio,Bicincittà | Museo,Bicincittà | Nespresso Avenches,Bicincittà | Nestle Bergere,Bicincittà | Nestle Plan-Dessus,Bicincittà | Nestle entre-deux-Villes,Bicincittà | Nova Friburgo,Bicincittà | Olginate,Bicincittà | Ospedale,Bicincittà | Ospedale San Giovanni,Bicincittà | Ospedale Vecchio,Bicincittà | Ouchy,Bicincittà | Palazzo Te,Bicincittà | Paradiso Centro,Bicincittà | Parcheggio S. Francesco,Bicincittà | Parco,Bicincittà | Parco Martin Luther King,Bicincittà | Piazza Oberdan,Bicincittà | Piazza Sulis,Bicincittà | Piazza Venezia Giulia,Bicincittà | Pisa - Cascine Vecchie,Bicincittà | Piscine - Aigle,Bicincittà | Pizzighettone,Bicincittà | Place Alan Turing,Bicincittà | Place de la Gare,Bicincittà | Place de la Gare - Bulle,Bicincittà | Place de la Gare - Monthey,Bicincittà | Place de l’Europe,Bicincittà | Place des Bastians,Bicincittà | Place du Cotterg,Bicincittà | Place du Marche`,Bicincittà | Poetto - Cagliari,Bicincittà | Poetto - Quartu Sant'Elena,Bicincittà | Porta Cerese,Bicincittà | Porto,Bicincittà | Porto Frailis,Bicincittà | Poste Via Di Vittorio,Bicincittà | Prangins - La Place,Bicincittà | Presicce,Bicincittà | Pressano,Bicincittà | Preverenges,Bicincittà | Quartier de l’Innovation,Bicincittà | Renaredda,Bicincittà | Repubblica,Bicincittà | Rive-Reine,Bicincittà | Rives du Lac,Bicincittà | Rivier,Bicincittà | Romont,Bicincittà | Rue Louis de Savoie,Bicincittà | SSC,Bicincittà | San Biagio,Bicincittà | San Fruttuoso,Bicincittà | San Giuliano Terme - La Sterpaia,Bicincittà | San Lorenzo,Bicincittà | San Lussorio,Bicincittà | San Rocco,Bicincittà | San Terenzo,Bicincittà | SanPiero a Grado - Sentiero 3 pini,Bicincittà | Sant'Jacopo,Bicincittà | Santa Lucia,Bicincittà | Sarzana - Porta Romana,Bicincittà | Sarzana - Stazione F.S.,Bicincittà | Sarzana - Viale XXI Luglio,Bicincittà | Sarzana - piazza San Giorgio,Bicincittà | Scex,Bicincittà | Schönberg,"Bicincittà | Scuola ""De Gasperi""",Bicincittà | Sede Parco dei Colli,Bicincittà | Sempione,Bicincittà | Sicili`,Bicincittà | Site Chimique - Monthey,Bicincittà | Sjeverni ulaz u marinu,Bicincittà | Sorge,Bicincittà | St-Le`onard - Groupe E,Bicincittà | Stadio,Bicincittà | Stazione,Bicincittà | Stazione Assemini,Bicincittà | Stazione Centrale,Bicincittà | Stazione FF.SS,Bicincittà | Stazione FF.SS.,Bicincittà | Stazione FFSS,Bicincittà | Stazione Ferroviaria,Bicincittà | Stazione Mobile,Bicincittà | Stazione RFI,Bicincittà | Stazione TN-MALE',Bicincittà | Supercortemaggiore,Bicincittà | Taurisano,Bicincittà | Torrecostiera,Bicincittà | Triangle de l Etraz,Bicincittà | UICN,Bicincittà | USI Universita` della Svizzera Italiana,Bicincittà | Umberto I,Bicincittà | Uni Pe`rolles,Bicincittà | Unil Centre,Bicincittà | Unipol,Bicincittà | Urban Center,Bicincittà | Venere Azzurra,Bicincittà | Vercurago,Bicincittà | Via Garibaldi,Bicincittà | Via Giovanni Ventitreesimo,Bicincittà | Viareggio - Marina di Levante,Bicincittà | Vicolungo The Style Outlets,Bicincittà | Villa Comunale,Bicincittà | Villa Fabbricotti,Bicincittà | Villars sur Glane - Gare,Bicincittà | Villetta di Serapo,Bicincittà | XXV Aprile,Bicincittà | Y-Parc,Bicincittà | Zone industrielle,"Bicing | 01 - C/ GRAN VIA CORTS CATALANES, 760","Bicing | 02 - C/ ROGER DE FLOR, 126","Bicing | 03 - C/ NÀPOLS, 82","Bicing | 04 - C/ RIBES, 13","Bicing | 05 - PG. LLUIS COMPANYS, 11 (ARC TRIOMF)","Bicing | 06 - PG. LLUIS COMPANYS, 18  (ARC TRIOMF)","Bicing | 07 - PG. PUJADES,  1 (JUTJATS)","Bicing | 08 - PG. PUJADES, 2","Bicing | 09 - AV. MARQUÉS DE L'ARGENTERA,13","Bicing | 100 - C/ TARRAGONA,  159-173","Bicing | 101 - AV. DIAGONAL,  602","Bicing | 102 - AV. DIAGONAL,  612","Bicing | 103 - C/ ARAGÓ, 629","Bicing | 104 - C/ VALÈNCIA, 621","Bicing | 105 - PL. URQUINAONA, 9-10","Bicing | 106 - PL  JOANIC - C / BRUNIQUER, 59","Bicing | 107 - TRAV. DE GRÀCIA, 92 / VIA AUGUSTA","Bicing | 108 - C / INDÚSTRIA, 10","Bicing | 109 - C/ LONDRES,  53","Bicing | 11 - PG. MARITIM, 11 (DAVANT PL. BRUGADA)","Bicing | 110 - AV. ROMA,  136","Bicing | 111 - C/ CALÀBRIA, 137","Bicing | 112 - C/ FLORIDABLANCA, 49","Bicing | 113 - RONDA DE SANT PAU, 51","Bicing | 114 - PL. JEAN GENET,  1","Bicing | 115 - AV. MARQUÉS DE L'ARGENTERA,  3","Bicing | 116 - C/ DEL DR. AIGUADER, 72 / PG. SALVAT PAPASSEIT","Bicing | 117 - C/ ROSA SENSAT, 12","Bicing | 118 - C/ PUJADES,  3","Bicing | 119 - C/ SARDENYA,  178","Bicing | 12 - PG. MARITIM, 23 (HOSPITAL DEL MAR)","Bicing | 120 - C/ LEPANT,  278","Bicing | 121 - C/ CASTILLEJOS, 258","Bicing | 122 - C/ NÀPOLS, 344","Bicing | 123 - C/ GIRONA, 142",Bicing | 124 - C/ NOVA  BOCANA,"Bicing | 125 - PG. MARíTIM, 31 B (ANNEXA A LA  12)",Bicing | 126 - PG. DE COLOM /VIA LAIETANA,"Bicing | 127 - C/ ARAGÓ, 659 /NAVAS DE TOLOSA","Bicing | 128 - RAMBLA DE GUIPÚSCOA, 43/FLUVIÀ","Bicing | 129 - C/ MANSO, 46","Bicing | 13 - CARRER DE LA MARINA, 25-33","Bicing | 130 - RAMBLA DE GUIPÚSCOA, 103 /CANTÀBRIA","Bicing | 131 - RAMBLA  DE GUIPÚSCOA, 158/ CA N'OLIVA",Bicing | 132 - PL.VALENTÍ ALMIRALL,"Bicing | 133 - GRAN VIA DE LES CORTS CATALANES, 902","Bicing | 134 - C/ BAC DE RODA, 157","Bicing | 135 - GRAN VIA DE LES CORTS CATALANES,  981","Bicing | 136 - GRAN VIA DE LES CORTS CATALANES,  1062","Bicing | 137 - GRAN VIA DE LES CORTS CATALANES, 1041","Bicing | 138 - GRAN VIA DE LES CORTS CATALANES, 1118","Bicing | 139 - GRAN VIA DE LES CORTS CATALANES,  1131","Bicing | 14 - AV. MARQUÉS DE  L'ARGENTERA, 15","Bicing | 140 - C/ VILADOMAT, 122","Bicing | 141 - GRAN VIA DE LES CORTS CATALANES ,  940","Bicing | 142 - C/ SANCHO DE ÁVILA,  104 - C/ BADAJOZ","Bicing | 143 -C/ SANCHO DE ÁVILA, 170 / LLACUNA","Bicing | 144 - C/ CASTELLA,  28 / DIAGONAL","Bicing | 145 - C/ PERE IV,  301 / FLUVIÀ","Bicing | 147 - RAMBLA PRIM, 79","Bicing | 148 - RONDA SANT PAU, 79","Bicing | 149 - C/ PUJADES, 57B","Bicing | 15 - C/ GIRONA, 68","Bicing | 150 - C/ ESPRONCEDA, 124","Bicing | 151 - C/ PALLARS, 182","Bicing | 152 - C/ PUJADES, 121","Bicing | 153 - C/ PUJADES, 173/RAMBLA DEL POBLE NOU","Bicing | 154 - C/ PUJADES, 191","Bicing | 155 - C/ PUJADES, 311/ FLUVIÀ","Bicing | 156 - C/ SELVA DE MAR, 46","Bicing | 157 - C/ LLULL, 465","Bicing | 158 - RAMBLA DE PRIM, 19","Bicing | 159 - AV. DIAGONAL, 26","Bicing | 160 - AV. D'EDUARD MARISTANY, 1 /FORUM","Bicing | 161 - C/ RAMON TURRÓ, 91","Bicing | 162 - C/ RAMON TURRÓ, 292","Bicing | 163 - AV. ICÀRIA, 202","Bicing | 164 - C/ INDEPENDÈNCIA, 379","Bicing | 165 - C/ DEL DOCTOR TRUETA, 222","Bicing | 166 - C/ BILBAO, 2","Bicing | 167 - C/ BAC DE RODA, 11",Bicing | 168 - SELVA DE MAR / PG. DEL TAULAT,"Bicing | 17 - AV. MERIDIANA, 47 (ANNEXA A LA 16)","Bicing | 170 - AV.LITORAL, 40 (ANNEXA A LA 169)","Bicing | 171 - PG. MARÍTIM DE LA NOVA ICÀRIA, 83","Bicing | 173 - AV.LITORAL, 84","Bicing | 174 - PG. DE GARCIA FÀRIA, 21/ESPRONCEDA","Bicing | 175 - C/ LLULL, 309","Bicing | 176 - PG. DE GARCIA FÀRIA, 37/JOSEP FERRATER","Bicing | 177 - C/ ROSSELLÓ, 557","Bicing | 178 - PG. DE GARCIA FÀRIA, 85","Bicing | 179 - PG. ZONA FRANCA, 244","Bicing | 18 - C/ ROSSELLÓ, 453",Bicing | 180 - GRAN VIA DE LES CORTS CATALANES/MOSSÈN AMADEU OLLER,"Bicing | 182 - GRAN VIA DE LES CORTS CATALANES, 273","Bicing | 183 - C/ GAVÀ, 1","Bicing | 184 - C/ QUETZAL, 22-24","Bicing | 185 - C/GAVÀ, 81","Bicing | 186 - C/CONSELL DE CENT, 6","Bicing | 187 - C/ DE SANT PAU, 89 - 97",Bicing | 188 - PG. SANT ANTONI /PL. SANTS,"Bicing | 189 - C/ BRUC, 130","Bicing | 19 - C/ ROSSELLÓ, 354","Bicing | 190 - AV. LITORAL, 72","Bicing | 191 - C/ ROCAFORT, 167","Bicing | 192 - C/ JOAN GÜELL, 50","Bicing | 193 - C/ FÍGOLS, 1","Bicing | 194 - C/ JOAN GÜELL, 98","Bicing | 195 - C/ VALLESPIR, 130","Bicing | 196 - C/ BERLÍN, 38","Bicing | 197 - C/ GELABERT, 1","Bicing | 198 - C/ VALLESPIR, 194","Bicing | 199 - C/ MEJÍA LEQUERICA, 2","Bicing | 20 - C/ CARTAGENA, 308","Bicing | 200 - C/ CAN BRUIXA, 1","Bicing | 201 - C/ NUMÀNCIA, 136","Bicing | 202 - C/ DE LES CORTS, 20","Bicing | 203 - AV. DIAGONAL, 668","Bicing | 204 - AV. DIAGONAL, 664","Bicing | 205 - C/ EUROPA, 25","Bicing | 206 - AV. DIAGONAL, 650","Bicing | 207 - AV. DIAGONAL, 634","Bicing | 208 - AV. DIAGONAL, 630","Bicing | 209 - C/ DIPUTACIÓ, 200","Bicing | 21 - C/ SANT ANTONI MARIA CLARET, 214","Bicing | 210 - C/ VILARDELL, 18","Bicing | 211 - C/ SANCHO DE ÁVILA, 60-64","Bicing | 212 - AV. SARRIÀ, 163","Bicing | 213 - C/ SANTA FE DE NOU MÈXIC, 2","Bicing | 214 - C/ JOSÉ DE  AGULLÓ, 9","Bicing | 215 - C/ GANDUXER, 29","Bicing | 216 - C/ MADRAZO, 131","Bicing | 217 - C/ RECTOR UBACH, 24","Bicing | 218 - C/ CONSELL DE CENT, 566","Bicing | 219 - C/ LAFORJA, 74-76","Bicing | 22 - C/ SARDENYA, 292","Bicing | 220 - C/ TUSET, 19","Bicing | 221 - GRAN DE GRÀCIA, 155 (METRO FONTANA)","Bicing | 222 - C/ DEL CANÓ, 1","Bicing | 223 - C/ DE BONAVISTA, 14","Bicing | 224 - C / GIRONA, 176","Bicing | 225 - C/ MALLORCA, 84","Bicing | 226 - C/ MONTMANY, 1","Bicing | 227 - C/ DEL TORRENT DE LES FLORS, 102","Bicing | 228 - PL. DEL NORD, 5","Bicing | 229 - C/ DE LA SANTACREU, 2 (PL.DE LA VIRREINA)","Bicing | 23 - C/ BRUC, 45","Bicing | 230 - C/ DE NIL FABRA, 16-20","Bicing | 231 - C/ PI I MARGALL, 38","Bicing | 232 - C/ VILÀ I VILÀ, 45","Bicing | 233 - C/ NOU DE LA RAMBLA, 164","Bicing | 234 - PG. DE L´EXPOSICIÓ, 30 /BLASCO GARAY","Bicing | 235 - AV. PARAL.LEL, 98","Bicing | 236 - AV. PARAL.LEL, 194","Bicing | 237 - C/ RIUS I TAULET, 4","Bicing | 238 - C/ ESPRONCEDA, 298","Bicing | 239 - C/ INDÚSTRIA, 329","Bicing | 24 - C/ MARINA, 199","Bicing | 240 - C/ JOSEP ESTIVILL, 32","Bicing | 241 - C/ TEODOR LLORENTE, 2","Bicing | 242 - C/ RAMON ALBÓ, 1","Bicing | 243 - C/ ALEXANDRE GALÍ, 1-5","Bicing | 244 - C/ FELIP II, 214","Bicing | 246 - C/ GARCILASO, 77","Bicing | 247 - C/ FELIPE II, 112","Bicing | 248 - C/ PALÈNCIA, 31","Bicing | 249 - C/ AÇORES,1-3","Bicing | 25 - C/ BRUC, 102","Bicing | 250 - C/ PORTUGAL, 3","Bicing | 251 - C/ CARDENAL TEDESCHINI, 13","Bicing | 252 - RAMBLA DE L'ONZE DE SETEMBRE, 31","Bicing | 253 - C/ ONZE DE SETEMBRE, 37-39","Bicing | 254 - RAMBLA DE L'ONZE DE SETEMBRE, 69","Bicing | 255 - C/ IRLANDA, 11-21","Bicing | 256 - C/ MALATS, 28-30","Bicing | 257 - C/ SANT ADRIÀ, 2-8","Bicing | 258 - C/ FERNANDO PESSOA, 41","Bicing | 259 - C/ DE BARTRINA, 14","Bicing | 26 - C/ DOS DE MAIG, 230-232","Bicing | 260 - CARRER DEL CINCA, 7","Bicing | 261 - C/ VILLARROEL, 39","Bicing | 262 - C/ ROCAFORT, 103","Bicing | 263 - PG. TORRAS I BAGES, 29","Bicing | 264 - C/REPÚBLICA DOMINICANA,25(CENTRE COMERCIAL)","Bicing | 265 - C/ CASANOVAS, 67","Bicing | 266 - C/ CONCEPCIÓ ARENAL, 176","Bicing | 267 - PG. TORRAS I BAGES, 129","Bicing | 268 - C/ FERNANDO PESSOA, 72","Bicing | 269 - VIA BARCINO, 121","Bicing | 27 - C/ PROVENÇA, 322","Bicing | 270 - CRTA. DE RIBES, 77 (TRINITAT VELLA)","Bicing | 271 - VIA BARCINO, 69","Bicing | 272 - C/ CONCEPCIÓ ARENAL, 281",Bicing | 273 - AV. MERIDIANA/PG. FABRA I PUIG (SANT ANDREU),"Bicing | 274 - RAMBLA FABRA I PUIG, 67","Bicing | 275 - AV. RIO DE JANEIRO, 3",Bicing | 276 - PLAÇA ALFONS X EL SAVI / RONDA DEL GUINARDO,"Bicing | 277 - TRAVESSERA DE GRÀCIA, 328","Bicing | 278 - TRAVESSERA DE GRÀCIA, 368","Bicing | 279 - C/ MAS CASANOVAS, 137","Bicing | 28 - C/ SARDENYA, 362","Bicing | 280 - C/ SANT ANTONI Mª CLARET, 290-296","Bicing | 281 - C/ D'ESCORNALBOU, 51","Bicing | 282 - PG. FONT D´EN- FARGAS, 1","Bicing | 283 - C/ FULTON, 1","Bicing | 284 - AV. DIAGONAL, 652","Bicing | 285 - C/ MALATS, 98-100","Bicing | 286 - C/ BOLÍVIA, 76","Bicing | 287 - GRAN VIA DE LES CORTS CATALANES, 632",Bicing | 288 - PL. VIRREI AMAT,"Bicing | 289 - C/ MÚRCIA, 64","Bicing | 29 - C/ PROVENÇA, 388-390","Bicing | 290 - PL. DELS JARDINS D'ALFÀBIA, 1","Bicing | 291 - C/ CUBELLES, 2","Bicing | 292 - C/ AMILCAR, 1","Bicing | 293 - C/ GRANOLLERS, 1",Bicing | 294 - SEU DEL DISTRICTE (NOU BARRIS),"Bicing | 295 - C/ SANT ISCLE, 60","Bicing | 296 - C/ DE ROSSELLÓ I PORCEL, 1/AV.MERIDIANA","Bicing | 297 -  C/ TURÓ BLAU, 1-3","Bicing | 298 - C/ ANDREU NIN, 22","Bicing | 299 - C/ DE L'ESCULTOR ORDÓÑEZ, 55","Bicing | 30 - AV. DIAGONAL, 231 AMB PADILLA","Bicing | 300 - C/ DE MALADETA, 1","Bicing | 301 - C/ MARIE CURIE, 8-14","Bicing | 302 - C/ CAVALLERS, 41","Bicing | 303 - C/ CAVALLERS, 67","Bicing | 304 - PG. MANUEL GIRONA, 7","Bicing | 305 - AV. DIAGONAL, 680","Bicing | 306 - C/ DOCTOR SALVADOR CARDENAL, 1-5",Bicing | 307 - C/ PINTOR RIBALTA / AV. XILE,"Bicing | 308 - C/ CARDENAL REIG, 11","Bicing | 309 - C/ SANT RAMON NONAT,  26",Bicing | 31 - PL. DEL MAR,Bicing | 310 - C/ JOSEP SAMITIER / JOAN XXIII,"Bicing | 311 - C/ GALLEGO, 2","Bicing | 312 - C/ ARIZALA, 77","Bicing | 313 - C/ FELIU DE CASANOVA, 1","Bicing | 314 - RAMBLA DEL BRASIL, 44","Bicing | 315 - C/ DEL GUINARDÓ, 32-38","Bicing | 316 - C/ CANTÀBRIA, 55","Bicing | 317 - RAMBLA DE PRIM, 256","Bicing | 318 - C/ CARTAGENA, 368","Bicing | 319 - C/ SAGUÉS, 1",Bicing | 32 - LA BARCELONETA (CN BARCELONETA),"Bicing | 320 - VÍA AUGUSTA, 109","Bicing | 321 - C/ SANT HERMENEGILD, 30","Bicing | 322 - C/ SANTALÓ, 165","Bicing | 323 - C/ VALLMAJOR, 13","Bicing | 324 - C/ REINA VICTORIA, 31","Bicing | 325 - C/ ALT DE GIRONELLA, 13","Bicing | 326 - C/ BALMES, 409","Bicing | 327 - C/ REUS, 23","Bicing | 328 - C/ ARTESA DE SEGRE, 2","Bicing | 329 - C/ DE LES ESCOLES PIES, 99",Bicing | 33 - C/ PONTEVEDRA / JUDICI,"Bicing | 331 - C/ CASTELLNOU, 65","Bicing | 332 - C/ DOCTOR ROUX, 86","Bicing | 333 - PASSATGE DE SENILLOSA, 3-5","Bicing | 334 - VIA AUGUSTA, 348","Bicing | 335 - C/ SANTA AMÈLIA, 2","Bicing | 336 - C/ CAPONATA, 10","Bicing | 337 - C/ CARME KARR, 12-14","Bicing | 338 - AV. J. V. FOIX,  63","Bicing | 339 - C/ RAMON TURRÓ, 246","Bicing | 34 - C/ SANT PERE MÉS ALT, 4","Bicing | 340 - C/ SANT ADRIÀ, 113","Bicing | 341 - PG. D'ENRIC SANCHIS, 33","Bicing | 342 - C/ ROC BORONAT, 134",Bicing | 343 - CAMPANA DE LA MAQUINISTA (SAO PAULO I PL. DE,"Bicing | 344 - C/ CIUTAT D'ASUNCIÓN, 73 / POTOSÍ",Bicing | 345 - PL. TERESA DE CLARAMUNT/C/ DELS FERROCARILS,"Bicing | 346 - C/ DE LA FONERIA, 33","Bicing | 347 - C/ ALTS FORNS, 77",Bicing | 348 - JARDINS DE CAN FERRERO/PG.DE LA ZONA FRANCA,"Bicing | 349 - C/ DE L'ENERGIA, 2 / ALTS FORNS","Bicing | 35 - C/ SANT RAMON DE PENYAFORT, 1","Bicing | 350 - C/ VILLARROEL, 208","Bicing | 351 - C/ JANE ADDAMS, 26/ CRTA. DEL PRAT","Bicing | 352 - C/RADI,10/GRAN VIA DE LES CORTS CATALANES",Bicing | 353 - C/ MUNNÉ  2-6,"Bicing | 354 - RAMBLA DEL BRASIL, 5","Bicing | 356 - C/ CAMÈLIES, 73","Bicing | 357 - C/ CARDENER, 59","Bicing | 358 - C/ GOMBAU, 24","Bicing | 359 - C/ MÉNDEZ NÚÑEZ, 16","Bicing | 36 - AV. DE LA CATEDRAL, 6","Bicing | 360 - C/ BAILÉN, 62",Bicing | 361 - PG. DE COLOM (LES RAMBLES),"Bicing | 362 - C/ BAILÉN, 100","Bicing | 363 - C/ BRUC, 20","Bicing | 364 - PG. DE GRÀCIA, 61","Bicing | 365 - C/ VILADOMAT, 244","Bicing | 367 - C/ MARQUÈS DE SENTMENAT, 46","Bicing | 368 - C/ DIPUTACIÓ, 350","Bicing | 369 - C/ CONSELL DE CENT, 482","Bicing | 37 - PL. ANTONIO LÓPEZ (CORREUS, VIA LAIETANA)","Bicing | 370 - C/ SARDENYA, 326","Bicing | 371 - C/ DELS ENAMORATS, 49","Bicing | 372 - C/ RIBES, 77","Bicing | 373 - AV. PARAL.LEL, 132","Bicing | 374 - PG. DE GRÀCIA, 89",Bicing | 375 - WORLD TRADE CENTER,Bicing | 376 - WORLD TRADE CENTER,Bicing | 377 - PL. ICTÍNEO,"Bicing | 378 - PL. JOAQUIM XIRAU I PALAU, 1","Bicing | 380 - C/ DURAN I BAS, 2","Bicing | 381 - C/ AGUSTÍ DURAN I SANPERE, 10","Bicing | 382 - C/ LOPE DE VEGA, 79","Bicing | 384 - C/ VILAMARÍ, 85","Bicing | 385 - C/ CASANOVA, 119",Bicing | 386 - AV. PARAL.LEL 164,"Bicing | 387 - C/ NÀPOLS, 125","Bicing | 388 - C/ RIERA ALTA, 6",Bicing | 389 - RECINTE PARC DE LA CIUTADELLA,Bicing | 39 - PL. PAU VILA,"Bicing | 390 - C/ COMERÇ, 36","Bicing | 391 - C/ SAGRERA, 74","Bicing | 392 - C/ RAMON TURRÓ, 4","Bicing | 393 - C/ LLACUNA, 86","Bicing | 394 - C/ DIPUTACIÓ, 226","Bicing | 395 - PL. CATALUNYA, 22","Bicing | 396 - C/ JOAN MIRÓ, 2-12",Bicing | 397 - AV. LITORAL (PG MARÍTIM DEL PORT OLÍMPIC),Bicing | 398 - PG. MARÍTIM DE LA BARCELONETA/ANDREA DÒRIA,"Bicing | 40 - C/ DOCTOR AIGUADER, 2",Bicing | 400 - MOLL ORIENTAL,Bicing | 401 - PL. ANTONIO LÓPEZ ( VIA LAIETANA),Bicing | 402 - PG. DE COLOM (VIA LAIETANA),"Bicing | 404 - C/ JUAN GRIS, 28","Bicing | 405 - C/ COMTE BORRELL, 198","Bicing | 406 - GRAN VIA DE LES CORTS CATALANES, 592","Bicing | 408 - C/ RAMON TRIAS FARGAS, 23","Bicing | 409 - C/ JOAN D'ÀUSTRIA, 31B",Bicing | 41 - PL. POETA BOSCÀ/ATLÀNTIDA,Bicing | 410 - PG. DE COLOM (LES RAMBLES),"Bicing | 412 - PL. URQUINAONA, 3","Bicing | 413 - C/ BRUC, 66","Bicing | 414 - C/ CASP, 67","Bicing | 415 - RAMBLA DEL RAVAL, 13","Bicing | 416 - RAMBLA DEL RAVAL, 20",Bicing | 418 - PG. DE LLUíS COMPANYS (ARC DE TRIOMF),Bicing | 419 - PG. DE LLUíS COMPANYS (ARC DE TRIOMF),"Bicing | 42 - C/ CIUTAT DE GRANADA, 168 / AV. DIAGONAL","Bicing | 420 - GRAN VIA DE LES CORTS CATALANES, 361",Bicing | 421 - PL. DE JOAN PEIRÓ,"Bicing | 423 - C/ HONDURAS, 32-34",Bicing | 424 - PG. MARÍTIM DE LA BARCELONETA,"Bicing | 425 - C/ DE CERVELLÓ, 5","Bicing | 426 - C/ DE RIBES, 59 B","Bicing | 427 - C/ DE SANT PAU, 119/ RONDA SANT PAU","Bicing | 428 - C/ PUJADES, 103","Bicing | 44 - AV. MERIDIANA, 66 ( COSTAT METRO GLORIES)","Bicing | 45 - C/ SARDENYA, 66","Bicing | 46 - C/ RAMON TRIAS FARGAS, 19","Bicing | 47 - C/ RAMON TRIAS FARGAS, 21","Bicing | 48 - AV. MERIDIANA, 40","Bicing | 49 - C/ ROSA SENSAT, 20",Bicing | 492 - PL. TETUAN,Bicing | 494 - RAMBLA CATALUNYA/DIPUTACIO,Bicing | 495 - C/ DIPUTACIÓ - TARRAGONA,"Bicing | 496 - C/ PROVENÇA, 445","Bicing | 50 - AV. PARAL.LEL, 54",Bicing | 51 - PL. VICENÇ MARTORELL,Bicing | 53 - PL. CARLES PI I SUNYER,"Bicing | 54 - C/ SANT OLEGUER, 2","Bicing | 55 - LA RAMBLA, 80","Bicing | 56 - PORTAL DE SANTA MADRONA, 2-4","Bicing | 57 - RAMBLA, 2",Bicing | 58 - PLAÇA DELS ÀNGELS ( MACBA ),Bicing | 59 - PLAÇA DELS ÀNGELS ( MACBA ),"Bicing | 60 - RAMBLA CATALUNYA, 47","Bicing | 61 - RAMBLA CATALUNYA, 42","Bicing | 62 - PL. CATALUNYA, 5","Bicing | 63 - PL. CATALUNYA, 7","Bicing | 64 - PL. CATALUNYA, 10-11 (RAMBLA)","Bicing | 65 - PL. CATALUNYA, 10-11 (PG. DE GRACIA)","Bicing | 66 - GRAN VIA DE LES CORTS CATALANES, 609","Bicing | 67 - C/ ROCAFORT, 214 / ROSSELLÓ","Bicing | 68 - RAMBLA CATALUNYA, 133 /  CÒRSEGA","Bicing | 69 - CARRER DE LA MARINA, 25-33","Bicing | 70 - C/ COMTE URGELL, 23","Bicing | 71 - C/ FLORIDABLANCA, 145","Bicing | 72 - C/ PROVENÇA, 215","Bicing | 73 - C/ ENRIC GRANADOS, 93","Bicing | 74 - AV. JOSEP TARRADELLAS, 133","Bicing | 75 - AV. JOSEP TARRADELLAS, 58","Bicing | 76 - CÒRSEGA, 216",Bicing | 78 - PL. UNIVERSITAT /  ARIBAU,Bicing | 79 - PL. UNIVERSITAT,"Bicing | 80 - C/ ENRIC  GRANADOS, 35","Bicing | 81 - C/ VILAMARÍ,  61","Bicing | 82 - C/ ROCAFORT, 72-74","Bicing | 83 - C/ COMTE BORRELL, 177","Bicing | 84 - C/ DEL COMTE D'URGELL, 75 B","Bicing | 85 - AV. PARAL·LEL, 146 BIS","Bicing | 86 - C/ VILADOMAT,  2","Bicing | 87 - C/ MALLORCA, 41-43","Bicing | 88 - C/ LONDRES, 101-103","Bicing | 89 - C/ ROSSELLÓ,  101","Bicing | 90 - C/ ROSSELLÓ, 108-110","Bicing | 92 - C / PROVENÇA, 241","Bicing | 93 - GRAN VIA DE LES CORTS CATALANES, 375-385","Bicing | 94 - GRAN  VIA DE LES CORTS CATALANES, 375-385","Bicing | 95 - C/ TARRAGONA, 103-115","Bicing | 96 - GRAN VIA DE LES CORTS CATALANES, 361","Bicing | 97 - C/ TARRAGONA, 141","Bicing | 98 - C/ VIRIAT, 43","Bicing | 99 - C/ VIRIAT,  53",Bicing | Av Meridiana,Bicing | Cardener,Bicing | Carrer Comerç,Bicing | Carreras i Candi,Bicing | Casanova,Bicing | Comte Borrell,Bicing | Doctor Carulla,Bicing | Font d'en Fargas 1,Bicing | Gran Via,Bicing | Josep Tarradellas 133,Bicing | Paral·lel 146,Bicing | Pau Casals,Bicing | Pere IV 449,Bicing | Pl. Sant Miquel,Bicing | Plaça de Sant Miquel,Bicing | Rambla Catalunya (Diputació),Bicipalma | ARAGÓ-JAUME BALMES,Bicipalma | ARAGÓ-NUREDDUNA,Bicipalma | ARXIDUC LLUIS SALVADOR,Bicipalma | AVD ARGENTINA,Bicipalma | BLANQUERNA BARTOLOMÉ,Bicipalma | BLANQUERNA-SALLENT,Bicipalma | CECILI METEL,Bicipalma | CTRA. VALLDEMOSSA,Bicipalma | F. MANUEL HERREROS,Bicipalma | FÁBRICA,Bicipalma | INSTITUT BALEAR,Bicipalma | J VERDAGUER-J BALMES,Bicipalma | JAUME III,Bicipalma | MANACORMANUEL AZAÑA,Bicipalma | MANUEL AZAÑA,Bicipalma | MATEU ENRIC LLADÓ,Bicipalma | METGE DARDER,Bicipalma | P. BARTOMEU BARCELÓ I MIR,Bicipalma | PALEXANDER FLEMING,Bicipalma | PARC DE ESTACIONS,Bicipalma | PARC DE SA RIERA,Bicipalma | PARC DE SES VELES,Bicipalma | PL ALEXANDRE JAUME,Bicipalma | PL DE LA REINA,Bicipalma | PL PORTA S CATALINA,Bicipalma | PL REI JOAN CARLES I,Bicipalma | PL. DESPANYA,Bicipalma | PL. MADRID,Bicipalma | PL. PARIS,Bicipalma | PL. SANTA EULALIA,Bicipalma | PLAÇA BARCELONA,Bicipalma | PLAÇA PONT,Bicipalma | SAN VICENTE DE PAUL,Bicipalma | SANT-FERRAN,Bicipalma | SON COSTA - SON FORTEZA,Bicipalma | TRAVESSA BALLESTER,Bicipalma | VIA ROMA,Bicloo | #00001-PREFECTURE,Bicloo | #00002-HÔTEL DE VILLE,Bicloo | #00003-STRASBOURG,Bicloo | #00004-MOULIN,Bicloo | #00005-BROSSARD,Bicloo | #00006-PLACE DU CIRQUE,Bicloo | #00007- BARILLERIE,Bicloo | #00008-BOUCHERIE,Bicloo | #00009-GUEPIN,Bicloo | #00010- PICASSO,Bicloo | #00011-CALVAIRE,Bicloo | #00012-DELORME,Bicloo | #00013-BRETAGNE SUD,Bicloo | #00014-SAINT FÉLIX,Bicloo | #00015-ARISTIDE BRIAND,Bicloo | #00016-EDOUARD NORMAND,Bicloo | #00017-SAINTE ELISABETH,Bicloo | #00018-VIARME,Bicloo | #00019-SAINT SIMILIEN,Bicloo | #00020-BOUFFAY,Bicloo | #00021-TALENSAC SUD,Bicloo | #00022-MOQUECHIEN,Bicloo | #00023-BUAT,Bicloo | #00024-VERSAILLES,Bicloo | #00025-DALBY,Bicloo | #00026-GUIST'HAU SUD,Bicloo | #00027-GUIST'HAU NORD,Bicloo | #00028- EDIT DE NANTES,Bicloo | #00030-COMMERCE,Bicloo | #00031-BOURSE,Bicloo | #00033-RACINE,Bicloo | #00034-MEDIATHEQUE,Bicloo | #00035-JEAN V,Bicloo | #00036-ALGER,Bicloo | #00037-FELIX EBOUE,Bicloo | #00038-RICORDEAU,Bicloo | #00039-QUAI MONCOUSU,Bicloo | #00040-MADELEINE,Bicloo | #00041-BRUNELIERE,Bicloo | #00042-GARE MARITIME,Bicloo | #00043 - MACHINE DE L'ÎLE,Bicloo | #00044-PALAIS DE JUSTICE,Bicloo | #00045-PRAIRIE AU DUC,Bicloo | #00046-REPUBLIQUE,Bicloo | #00047- MARTYRS NANTAIS,Bicloo | #00048-VERDUN,Bicloo | #00049-DUCHESSE ANNE,Bicloo | #00050-CHATEAU,Bicloo | #00051-TABARLY,Bicloo | #00052-BACO,Bicloo | #00053-OLIVETTES,Bicloo | #00054- CITE INTERNATIONALE DES CONGRES,Bicloo | #00055-MAGELLAN,Bicloo | #00056-VINCENT GACHE,Bicloo | #00057-GAETAN RONDEAU,Bicloo | #00058-PALAIS DES SPORTS,Bicloo | #00059-STADE SAUPIN,Bicloo | #00060-GARE DE NANTES NORD,Bicloo | #00061-LIEU UNIQUE,Bicloo | #00063-JARDIN DES PLANTES,Bicloo | #00064-SAINT CLEMENT,Bicloo | #00065-COURS SULLY,Bicloo | #00066-CHANZY,Bicloo | #00067-WALDECK ROUSSEAU,Bicloo | #00068-LIVET,Bicloo | #00069 - MANUFACTURE,Bicloo | #00070-GARE DE NANTES SUD,Bicloo | #00071-TALENSAC NORD,Bicloo | #00072-BELLAMY-GUÉ MOREAU,Bicloo | #00073-SARRADIN,Bicloo | #00074-CANCLAUX,Bicloo | #00075-LAMORICIERE,Bicloo | #00076-RENÉ BOUHIER,Bicloo | #00077-ECOLE D'ARCHITECTURE,Bicloo | #00078-DE GAULLE,Bicloo | #00079-MALAKOFF,Bicloo | #00080 - VICTOR HUGO,Bicloo | #00081 - MANGIN,Bicloo | #00082-SEBILLEAU,Bicloo | #00083-MILLERAND,Bicloo | #00084-RÉGION,Bicloo | #00085-BEL AIR,Bicloo | #00086-HAUTS PAVÉS,Bicloo | #00087-ANATOLE FRANCE,Bicloo | #00088-MELLINET,Bicloo | #00089-SAINT-AIGNAN,Bicloo | #00090-PROCE,Bicloo | #00091-ROND POINT DE VANNES,Bicloo | #00092-ROND POINT DE RENNES,Bicloo | #00093-FACULTES,Bicloo | #00094-PETIT PORT,Bicloo | #00095-MICHELET,Bicloo | #00096-TORTIERE,Bicloo | #00097-SAINT DONATIEN,Bicloo | #00098-HUIT MAI,Bicloo | #00099-ST JACQUES,Bicloo | #00100 - GRENERAIE,Bicloo | #00101 - PIRMIL,Bicloo | #00102-GARE PT ROUSSEAU,Bicloo | #00103-GRUE JAUNE,Bicloo | #00104 - ANTILLES,Bicloo | #00105 - HANGAR A BANANES,Bicloo | #00106-GARENNES,Bicloo | #00108 - BONNE GARDE,Bicloo | #00109 - CLOS TOREAU,Bicloo | #00110 - AUDITORIUM,Bicloo | #00111-DIDEROT,Bicloo | #00112 - POLE SOCIAL MARION CAHOUR,Bicloo | #00113 - MAIRIE DE REZE,Bicloo | #00114 - ATOUTSUD,Bicloo | #00115 - TRENTEMOULT,Bicloo | #00116 - LIBERTE,Bicloo | #00117 - MAIRIE DE CHANTENAY,Bicloo | #00119 - ZOLA,Bicloo | #00120-ROND-POINT DE PARIS,Bicloo | #00121-VICTOR RICHARD,Bicloo | #00122 - MITRIE,Bicloo | #00123 - TRARIEUX,Bicykle za dobré skutky | BARLIČKA,Bicykle za dobré skutky | EPERIA,Bicykle za dobré skutky | STANICA,Bicykle za dobré skutky | STARBIKE,Bicykle za dobré skutky | TROJICA,Bicykle za dobré skutky | UNIPO,Biella | Centro,Biella | Citta` Studi,Biella | Funicolare,Biella | Gromo Cridis,Biella | San Sebastiano,Biella | Stazione Ferroviaria,Bike Belém | Almirante Tamandaré,Bike Belém | Basílica Santuário Nsa. Senhora de Nazare,Bike Belém | Estação Doca ( FUNASA ),Bike Belém | Estação Hangar,Bike Belém | Estação das Docas ( Pça Pedro Teixeira),Bike Belém | Forte Castelo,Bike Belém | Mangal das Garças,Bike Belém | Mercado Nazaré,Bike Belém | Parque do Utinga,Bike Belém | Polo Joalheiro,Bike Belém | Portal da Amazônia,Bike Belém | Praça Batista Campos,Bike Belém | Santuário de Ns. de Fátima,Bike Belém | São Brás,Bike Belém | Teatro da Paz,Bike Share Toronto | 111 Bond St (North of Dundas St E)  - SMART,Bike Share Toronto | 12 Harbour St,Bike Share Toronto | 128 Sterling Ave - SMART,Bike Share Toronto | 161 Bleecker St (South of Wellesley),Bike Share Toronto | 20 Charles St E,Bike Share Toronto | 20 Polson St,Bike Share Toronto | 20 Polson St (Polson Pier),Bike Share Toronto | 200 Bloor St. E.,Bike Share Toronto | 25 York St – Union Station South,Bike Share Toronto | 424 Wellington St W,Bike Share Toronto | 457 King St. W. at Spadina,Bike Share Toronto | 51 Parliament St,Bike Share Toronto | 519 Church St - SMART,Bike Share Toronto | 80 Clinton St (North of College),Bike Share Toronto | Adelaide St W / Bay St - SMART,Bike Share Toronto | Adelaide St W / Brant St,Bike Share Toronto | Adelaide St W / Strachan Ave,Bike Share Toronto | Alma Ave / Gladstone Ave SMART,Bike Share Toronto | Alton Ave / Dundas St E (Greenwood Park),Bike Share Toronto | Amelia St. / Sumach St.,Bike Share Toronto | Annette St / Keele St - SMART,Bike Share Toronto | Antler St / Campbell Ave - SMART,Bike Share Toronto | Augusta Ave / Denison Sq,Bike Share Toronto | Augusta Ave / Dundas St W,Bike Share Toronto | Baldwin Ave / Spadina Ave - SMART,Bike Share Toronto | Balliol St / Yonge St  SMART,Bike Share Toronto | Barton St / Howland St - SMART,Bike Share Toronto | Bathurst St / Adelaide St W,Bike Share Toronto | Bathurst St / Dundas St W,Bike Share Toronto | Bathurst St / Fort York Blvd,Bike Share Toronto | Bathurst St / Lennox St,Bike Share Toronto | Bathurst St/Queens Quay(Billy Bishop Airport),Bike Share Toronto | Bathurst Subway Station,Bike Share Toronto | Bay St / Albert St,Bike Share Toronto | Bay St / Charles St - SMART,Bike Share Toronto | Bay St / College St (East Side),Bike Share Toronto | Bay St / College St (West Side) - SMART,Bike Share Toronto | Bay St / Davenport Rd,Bike Share Toronto | Bay St / Queens Quay W (Ferry Terminal),Bike Share Toronto | Bay St / St. Joseph St,Bike Share Toronto | Bay St / Wellesley St W,Bike Share Toronto | Belmont St / Davenport Rd - SMART,Bike Share Toronto | Beltline Trail / Chaplin Cres.,Bike Share Toronto | Berkeley St / Adelaide St E - SMART,Bike Share Toronto | Berkeley St / Dundas St E - SMART,Bike Share Toronto | Beverley  St / Dundas St W,Bike Share Toronto | Beverley St / College St,Bike Share Toronto | Blake St / Boultbee Ave,Bike Share Toronto | Bleecker St / St James Ave,Bike Share Toronto | Bloor GO / UP Station (West Toronto Railpath),Bike Share Toronto | Bloor St / Brunswick Ave,Bike Share Toronto | Bloor St E / Huntley St - SMART,Bike Share Toronto | Bloor St W / Balmuto St,Bike Share Toronto | Bloor St W / Christie St,Bike Share Toronto | Bloor St W / Dundas St W,Bike Share Toronto | Bloor St W / High Park Ave (High Park),Bike Share Toronto | Bloor St W / Huron St,Bike Share Toronto | Bloor St W / Manning Ave - SMART,Bike Share Toronto | Bloor St W / Shaw Ave - SMART,Bike Share Toronto | Blue Jays Way / Navy Wharf Ct,Bike Share Toronto | Blue Jays Way / Spadina Ave,Bike Share Toronto | Blythwood Rd / Yonge St - SMART,Bike Share Toronto | Bond St / Queen St E,Bike Share Toronto | Borden St / Bloor St W - SMART,Bike Share Toronto | Boston Ave / Queen St E,Bike Share Toronto | Bremner Blvd / Rees St,Bike Share Toronto | Briar Hill Ave / Yonge St - SMART,Bike Share Toronto | Bridgeman Ave / Bathurst St,Bike Share Toronto | Bridgeman Ave / Kendal Ave,Bike Share Toronto | Broadview Ave / Danforth Ave,Bike Share Toronto | Broadview Ave / Westwood Ave,Bike Share Toronto | Canniff St / Crawford St - SMART,Bike Share Toronto | Cariboo St / Rail Path,Bike Share Toronto | Carlaw Ave / Danforth Ave - SMART,Bike Share Toronto | Carlaw Ave / Strathcona Ave,Bike Share Toronto | Carlton St / Parliament St,Bike Share Toronto | Castle Frank Station,Bike Share Toronto | Central Tech  (Harbord St),Bike Share Toronto | Charles St E / Jarvis St - SMART,Bike Share Toronto | Charles St W / Balmuto St - SMART,Bike Share Toronto | Cherry Beach,Bike Share Toronto | Cherry Beach Sports Field (55 Unwin Ave),Bike Share Toronto | Cherry St / Distillery Ln,Bike Share Toronto | Cherry St / Mill St,Bike Share Toronto | Chester Station,Bike Share Toronto | Chorley Park - SMART,Bike Share Toronto | Christie St / Benson Ave (Wychwood Barns),Bike Share Toronto | Church St  / Wood St,Bike Share Toronto | Church St / Alexander St,Bike Share Toronto | Church St / Bloor St E,Bike Share Toronto | Church St / Dundas St E - SMART,Bike Share Toronto | Church St / Lombard St,Bike Share Toronto | Claremont St / Dundas St W,Bike Share Toronto | Clarence Square,Bike Share Toronto | Clendenan Ave / Rowland St - SMART,Bike Share Toronto | College Park - Yonge Entrance,Bike Share Toronto | College Park - Yonge St Entrance,Bike Share Toronto | College Park South,Bike Share Toronto | College Park- Gerrard Entrance,Bike Share Toronto | College St / Borden St,Bike Share Toronto | College St / Crawford St,Bike Share Toronto | College St / Huron St,Bike Share Toronto | College St / Major St,Bike Share Toronto | College St / Markham St,Bike Share Toronto | College St / McCaul St,Bike Share Toronto | College St / University Ave,Bike Share Toronto | Concord Av / Dewson St,Bike Share Toronto | Concord Ave / Bloor St W - SMART,Bike Share Toronto | Cosburn Ave / Cedarvale Ave - SMART,Bike Share Toronto | Cosburn Ave / Donlands Ave,Bike Share Toronto | Coxwell Ave / Plains Rd,Bike Share Toronto | Coxwell Ave/  Lakeshore Blvd E,Bike Share Toronto | Crawford St / Queen St W,Bike Share Toronto | Cumberland Ave / Bay St SMART,Bike Share Toronto | D'Arcy St / Spadina Ave - SMART,Bike Share Toronto | D'Arcy St. /McCaul St. SMART,Bike Share Toronto | Danforth Ave / Aldridge Ave,Bike Share Toronto | Danforth Ave / Barrington Ave,Bike Share Toronto | Danforth Ave / Coxwell Ave,Bike Share Toronto | Danforth Ave / Ellerbeck St,Bike Share Toronto | Danforth Ave / Gough Ave,Bike Share Toronto | Danforth Ave / Lamb Ave,Bike Share Toronto | Danforth Ave / Sibley Ave - SMART,Bike Share Toronto | Danforth Ave / Westlake Ave,Bike Share Toronto | Davenport Rd / Avenue Rd,Bike Share Toronto | Davenport Rd / Bathurst St,Bike Share Toronto | Davenport Rd / Christie St,Bike Share Toronto | Davenport Rd / Lansdowne Ave.,Bike Share Toronto | Davenport Rd / McAlpine St - SMART,Bike Share Toronto | Davenport Rd / Oakwood Rd - SMART,Bike Share Toronto | Dentonia Park,Bike Share Toronto | Dentonia Park Station,Bike Share Toronto | Dockside Dr / Queens Quay E (Sugar Beach),Bike Share Toronto | Donlands Station,Bike Share Toronto | Dovercourt Rd / Harrison St (Green P) - SMART,Bike Share Toronto | Dufferin Gate - SMART,Bike Share Toronto | Dufferin St / Bloor St,Bike Share Toronto | Dufferin St / Sylvan Av (Dufferin Grove Park),Bike Share Toronto | Dundas St E / Boulton Ave - SMART,Bike Share Toronto | Dundas St E / Broadview Ave,Bike Share Toronto | Dundas St E / Parliament St,Bike Share Toronto | Dundas St E / Pembroke St - SMART,Bike Share Toronto | Dundas St E / Regent Park Blvd,Bike Share Toronto | Dundas St E / Victoria St,Bike Share Toronto | Dundas St W / Crawford St,Bike Share Toronto | Dundas St W / Edna Ave,Bike Share Toronto | Dundas St W / Roncesvalles Green P - SMART,Bike Share Toronto | Dundas St W / St. Patrick St,Bike Share Toronto | Dundas St W / Yonge St,Bike Share Toronto | Dundonald St / Church St,Bike Share Toronto | Dupont St / Emerson Ave SMART,Bike Share Toronto | E.T. Seaton Park (Eglinton Ave E / Leslie St),Bike Share Toronto | East Liberty St / Pirandello St,Bike Share Toronto | Eastern Ave / Winnifred Ave,Bike Share Toronto | Eastwood Rd / Coxwell Ave - SMART,Bike Share Toronto | Eastwood Rd / Woodbine Ave - SMART,Bike Share Toronto | Edward St / Yonge St,Bike Share Toronto | Eglinton Ave W / Henning Ave SMART,Bike Share Toronto | Elizabeth St / Edward St (Bus Terminal),Bike Share Toronto | Ellis Ave / The Queensway,Bike Share Toronto | Erskine Ave / Yonge St SMART,Bike Share Toronto | Essex St / Christie St,Bike Share Toronto | Euclid Ave / Bloor St W,Bike Share Toronto | Exhibition GO (Atlantic Ave),Bike Share Toronto | Exhibition GO Station,Bike Share Toronto | Fleet St / Garrison Rd (Fort York),Bike Share Toronto | Fort York  Blvd / Capreol Ct,Bike Share Toronto | Fort York Blvd / Bathurst St SMART,Bike Share Toronto | Fort York Blvd / Garrison Rd,Bike Share Toronto | Frederick St / King St E,Bike Share Toronto | Frederick St / The Esplanade,Bike Share Toronto | Frobisher Ave / Lascelles Blvd,Bike Share Toronto | Front St / Simcoe St,Bike Share Toronto | Front St E / Cherry St,Bike Share Toronto | Front St E / Scott St,Bike Share Toronto | Front St W / Bay St (North Side),Bike Share Toronto | Front St W / Bay St (South Side),Bike Share Toronto | Front St W / Blue Jays Way,Bike Share Toronto | Front St W / University Ave (1),Bike Share Toronto | Front St W / University Ave (2),Bike Share Toronto | Front St W / Yonge St (Hockey Hall of Fame),Bike Share Toronto | Fulton Ave / Pape Ave,Bike Share Toronto | Gailbraith Rd / King’s College Cr. (U of T),Bike Share Toronto | Gamble Ave / Broadview Ave,Bike Share Toronto | Garden Ave / Roncesvalles Ave,Bike Share Toronto | George St / King St E,Bike Share Toronto | Gerrard Square Mall (1010 Gerrard St E),Bike Share Toronto | Gerrard St E / Broadview - SMART,Bike Share Toronto | Gerrard St E / Leslie St - SMART,Bike Share Toronto | Gerrard St E / Malvern Ave - SMART,Bike Share Toronto | Gerrard St E / River St,Bike Share Toronto | Gerrard St E / Ted Reeve Dr,Bike Share Toronto | Gerrard St E / Victoria Park Ave - SMART,Bike Share Toronto | Glen Edyth Dr / Davenport Rd,Bike Share Toronto | Glendonwynne Ave / Bloor St W - SMART,Bike Share Toronto | Goodwood Park Ct / Dentonia Park - SMART,Bike Share Toronto | Gould St / Mutual St,Bike Share Toronto | Gould St / Yonge St (Ryerson University)f,Bike Share Toronto | Granby St / Church St - SMART,Bike Share Toronto | HTO Park (Queens Quay W),Bike Share Toronto | Hanna Ave / Liberty St,Bike Share Toronto | Harbord St / Clinton St,Bike Share Toronto | Havelock St / Dufferin Park,Bike Share Toronto | Hayter St / Laplante Ave,Bike Share Toronto | High Park - Grenadier Cafe,Bike Share Toronto | High Park - West Rd,Bike Share Toronto | High Park Amphitheatre,Bike Share Toronto | High Park Outdoor Pool,Bike Share Toronto | High Park Subway - SMART,Bike Share Toronto | High Park Subway Station,Bike Share Toronto | Hocken Ave./Vaughan Rd.,Bike Share Toronto | Howard Park Ave / Dundas St W - SMART,Bike Share Toronto | Howard St / Ontario St - SMART,Bike Share Toronto | Howard St / Sherbourne St,Bike Share Toronto | Hubbard Blvd / Balsam Av,Bike Share Toronto | Hubbard Blvd. / Glen Manor Dr.,Bike Share Toronto | Humber Bay Shores Park East,Bike Share Toronto | Humber Bay Shores Park West,Bike Share Toronto | Humberside Grounds - SMART,Bike Share Toronto | Huron/ Harbord St,Bike Share Toronto | Isabella St / Church St - SMART,Bike Share Toronto | Jane St / Bloor St W (Jane Subway Station),Bike Share Toronto | Jarvis St / Carlton St,Bike Share Toronto | Jarvis St / Dundas St E,Bike Share Toronto | Jarvis St / Isabella St,Bike Share Toronto | Jarvis St / Maitland Pl,Bike Share Toronto | Jarvis St / Richmond St E,Bike Share Toronto | Jimmie Simpson Park (Queen St E),Bike Share Toronto | John St  / Mercer St - SMART,Bike Share Toronto | Keele St / Annette St - SMART,Bike Share Toronto | Keele St / Vine Ave - SMART,Bike Share Toronto | Kendal Ave / Bernard Ave,Bike Share Toronto | Kendal Ave / Spadina Rd,Bike Share Toronto | Kew Beach Ave / Kenilworth Ave,Bike Share Toronto | King / Cowan Ave - SMART,Bike Share Toronto | King St / Jordan St,Bike Share Toronto | King St E / Jarvis St,Bike Share Toronto | King St E / Ontario St.,Bike Share Toronto | King St E / River St,Bike Share Toronto | King St E / Victoria St,Bike Share Toronto | King St W / Bay St (East Side),Bike Share Toronto | King St W / Bay St (West Side),Bike Share Toronto | King St W / Brant St,Bike Share Toronto | King St W / Charlotte St,Bike Share Toronto | King St W / Douro St,Bike Share Toronto | King St W / Fraser Ave,Bike Share Toronto | King St W / Joe Shuster Way,Bike Share Toronto | King St W / Jordan St,Bike Share Toronto | King St W / Portland St,Bike Share Toronto | King St W / Spadina Ave,Bike Share Toronto | King St W / Stafford St,Bike Share Toronto | King St W / Tecumseth St,Bike Share Toronto | King St W / Widmer St,Bike Share Toronto | King St W / York St,Bike Share Toronto | Lakeshore Blvd E / Bonnycastle St - SMART,Bike Share Toronto | Lakeshore Blvd E / Knox Ave,Bike Share Toronto | Lakeshore Blvd E / Parliament St,Bike Share Toronto | Lakeshore Blvd E /Leslie St,Bike Share Toronto | Lakeshore Blvd W / Ellis Ave,Bike Share Toronto | Lakeshore Blvd W / Louisa St - SMART,Bike Share Toronto | Lakeshore Blvd W / Ontario Dr,Bike Share Toronto | Lakeshore Blvd W / The Boulevard Club,Bike Share Toronto | Lakeshore Blvd W / Windermere Ave,Bike Share Toronto | Lansdowne Ave / Whytock Ave,Bike Share Toronto | Lansdowne Subway Station,Bike Share Toronto | Lascelles Blvd / Eglinton Ave W - SMART,Bike Share Toronto | Lawton Blvd / Yonge St,Bike Share Toronto | Lee Ave / Queen St E,Bike Share Toronto | Liberty St / Fraser Ave Green P,Bike Share Toronto | Lisgar St / Dundas St SMART,Bike Share Toronto | Little Norway Park,Bike Share Toronto | Logan Av / Gerrard St E,Bike Share Toronto | Logan Ave / Bain Ave,Bike Share Toronto | Lonsdale Rd / Spadina Rd,Bike Share Toronto | Lower Jarvis / Queens Quay,Bike Share Toronto | Lower Jarvis / Queens Quay E,Bike Share Toronto | Lower Jarvis St / The Esplanade,Bike Share Toronto | Lower Sherbourne St / The Esplanade,Bike Share Toronto | Lower Simcoe St / Bremner Blvd,Bike Share Toronto | Lower Spadina Ave / Lakeshore Blvd,Bike Share Toronto | Macpherson Ave / Spadina Rd,Bike Share Toronto | Madison Ave / Bloor St W,Bike Share Toronto | Mallon Ave / Jones Ave - SMART,Bike Share Toronto | Mallon Ave / Jones Ave -SMART,Bike Share Toronto | Marilyn Bell Park Tennis Court,Bike Share Toronto | Marlborough Ave / Yonge St,Bike Share Toronto | Martin Goodman Trail (Marilyn Bell Park),Bike Share Toronto | Martin Goodman Trail / Ontario Dr,Bike Share Toronto | Mary McCormick Rec Centre (Sheridan Ave),Bike Share Toronto | McGill St / Church St,Bike Share Toronto | Merton St / Al Green Ln - SMART,Bike Share Toronto | Merton St / Mount Pleasant Rd - SMART,Bike Share Toronto | Metro Hall Plaza,Bike Share Toronto | Mill St / Parliament St,Bike Share Toronto | Mill St / Tannery Rd,Bike Share Toronto | Morse St / Eastern Ave,Bike Share Toronto | Mortimer Ave / Carlaw Ave SMART,Bike Share Toronto | Mortimer Ave / Coxwell Ave,Bike Share Toronto | Navy Wharf Ct. / Bremner Blvd.,Bike Share Toronto | Neil McLellan Park - SMART,Bike Share Toronto | Nelson St / Duncan St,Bike Share Toronto | Niagara St / Richmond St W,Bike Share Toronto | Niagara St / Tecumseth St,Bike Share Toronto | Northern Dancer Blvd / Lakeshore Blvd E,Bike Share Toronto | Ontario Place Blvd / Lakeshore Blvd W,Bike Share Toronto | Ontario St / Adelaide St E -SMART,Bike Share Toronto | Ontario St / King St E,Bike Share Toronto | Orchard Park,Bike Share Toronto | Ossington Ave / Bloor St W,Bike Share Toronto | Ossington Ave / College St,Bike Share Toronto | Ossington Ave / Harrison St,Bike Share Toronto | Pacific Ave / Glenlake Ave - SMART,Bike Share Toronto | Palmerston Ave / Vermont Ave,Bike Share Toronto | Pape Ave / Gamble Ave,Bike Share Toronto | Pape Subway Green P,Bike Share Toronto | Parkside Dr / Bloor St W - SMART,Bike Share Toronto | Parliament St / Aberdeen Ave,Bike Share Toronto | Parliament St / Bloor St E,Bike Share Toronto | Parliament St / Gerrard St,Bike Share Toronto | Pears Av / Avenue Rd,Bike Share Toronto | Phoebe St / Spadina Ave,Bike Share Toronto | Pottery Rd / Lower Don River Trail - SMART,Bike Share Toronto | Pretoria Av / Broadview Av,Bike Share Toronto | Primrose Ave / Davenport Rd,Bike Share Toronto | Princes' Blvd / Nunavut Rd,Bike Share Toronto | Princess St / Adelaide St E,Bike Share Toronto | Queen St E / Alton Av,Bike Share Toronto | Queen St E / Berkeley St,Bike Share Toronto | Queen St E / George St (Moss Park),Bike Share Toronto | Queen St E / Hammersmith Ave,Bike Share Toronto | Queen St E / Larchmount Ave,Bike Share Toronto | Queen St E / Nursewood Rd (Neville Park Loop),Bike Share Toronto | Queen St E / Pape Ave - SMART,Bike Share Toronto | Queen St E / Sackville St,Bike Share Toronto | Queen St E / Victoria St,Bike Share Toronto | Queen St W  /  Fuller Ave - SMART,Bike Share Toronto | Queen St W / Close Ave,Bike Share Toronto | Queen St W / Cowan Ave,Bike Share Toronto | Queen St W / Dovercourt Rd,Bike Share Toronto | Queen St W / Gladstone Ave,Bike Share Toronto | Queen St W / James St,Bike Share Toronto | Queen St W / Ossington Ave,Bike Share Toronto | Queen St W / Portland St,Bike Share Toronto | Queen St W / Roncesvalles Ave,Bike Share Toronto | Queen St W / Shaw St,Bike Share Toronto | Queen St W / Spadina Ave,Bike Share Toronto | Queen St W / York St (City Hall),Bike Share Toronto | Queen St. E / Eastern Ave,Bike Share Toronto | Queen St. E / Rhodes Ave.,Bike Share Toronto | Queen St. E / Spruce Hill Rd.,Bike Share Toronto | Queen St. E / Woodward Av,Bike Share Toronto | Queen's Park / Bloor St W,Bike Share Toronto | Queen's Park Cres E / Grosvenor St - SMART,Bike Share Toronto | Queen's Park Cres W / Hoskin Ave,Bike Share Toronto | Queens Quay / Yonge St,Bike Share Toronto | Queens Quay E / Lower Sherbourne,Bike Share Toronto | Queens Quay E / Lower Sherbourne St,Bike Share Toronto | Queens Quay W / Dan Leckie Way,Bike Share Toronto | Queens Quay W / Lower Simcoe St,Bike Share Toronto | Regal Rd / Dufferin St,Bike Share Toronto | Richmond St E / Jarvis St Green P,Bike Share Toronto | Richmond St E / Yonge St,Bike Share Toronto | Riverdale Park North (Broadview Ave),Bike Share Toronto | Riverdale Park South (Broadview Ave),Bike Share Toronto | Robert St / Bloor St W - SMART,Bike Share Toronto | Roehampton Ave / Mount Pleasant Rd - SMART,Bike Share Toronto | Roehampton Ave / Yonge St,Bike Share Toronto | Roncesvalles Ave / Marmaduke St,Bike Share Toronto | Rose Ave / Ontario St - SMART,Bike Share Toronto | Rosedale Park (20 Schofield Ave),Bike Share Toronto | Rosehill Ave / Avoca Ave - SMART,Bike Share Toronto | Roxborough St W / Yonge St,Bike Share Toronto | Roxton Rd / Harbord St,Bike Share Toronto | Rusholme Park Cres / College St,Bike Share Toronto | Rushton Rd / St Clair Ave W - SMART,Bike Share Toronto | Russell Hill Rd / St Clair Ave W - SMART,Bike Share Toronto | Sackville St / Eastern Ave - SMART,Bike Share Toronto | Salem Ave / Bloor St W,Bike Share Toronto | Scott St / The Esplanade,Bike Share Toronto | Seaton St / Dundas St E,Bike Share Toronto | Shaw St / Dupont St - SMART,Bike Share Toronto | Sherbourne St / Carlton St (Allan Gardens),Bike Share Toronto | Sherbourne St / Isabella St,Bike Share Toronto | Sherbourne St / Wellesley St E,Bike Share Toronto | Simcoe St / Adelaide St W,Bike Share Toronto | Simcoe St / Michael Sweet Ave,Bike Share Toronto | Simcoe St / Queen St W,Bike Share Toronto | Simcoe St / Wellington St North,Bike Share Toronto | Simcoe St / Wellington St South,Bike Share Toronto | Soho St / Queen St W,Bike Share Toronto | Sorauren/Geoffrey (Sorauren Park) - SMART,Bike Share Toronto | Southwood Dr / Kingston Rd - SMART,Bike Share Toronto | Spadina Ave / Adelaide St W,Bike Share Toronto | Spadina Ave / Fort York Blvd,Bike Share Toronto | Spadina Ave / Harbord St - SMART,Bike Share Toronto | Spadina Ave / Sussex Ave,Bike Share Toronto | Spadina Ave / Willcocks St,Bike Share Toronto | St Clair Ave W / Bathurst St.,Bike Share Toronto | St Clair Ave W / Hendrick Ave - SMART,Bike Share Toronto | St Clarens Ave / Bloor St W - SMART,Bike Share Toronto | St Clarens Ave / College St,Bike Share Toronto | St. George St / Bloor St W,Bike Share Toronto | St. George St / Hoskin Ave,Bike Share Toronto | St. George St / Russell St - SMART,Bike Share Toronto | St. James Park (King St. E.),Bike Share Toronto | Sterling Rd / Dundas St W,Bike Share Toronto | Stewart St / Bathurst St  - SMART,Bike Share Toronto | Strachan Ave / Princes' Blvd,Bike Share Toronto | Sumach St  / Queen St E,Bike Share Toronto | Sumach St / Carlton St. (Riverdale Farm),Bike Share Toronto | Summerhill Ave / Maclennan Ave - SMART,Bike Share Toronto | Summerhill Station,Bike Share Toronto | Sunnyside - Gus Ryder Pool,Bike Share Toronto | Sunnyside Ave / The Queensway - SMART,Bike Share Toronto | Symington Ave / Dupont St - SMART,Bike Share Toronto | Taddle Creek Park,Bike Share Toronto | Tecumseth St / Queen St W - SMART,Bike Share Toronto | Ted Rogers Way / Bloor St E,Bike Share Toronto | Temperance St. Station,Bike Share Toronto | The Queensway at South Kingsway - SMART,Bike Share Toronto | The Royal Ontario Museum (Bloor St Entrance),Bike Share Toronto | Thompson St / Broadview Ave - SMART,Bike Share Toronto | Tommy Thompson Park (Leslie Street Spit),Bike Share Toronto | Toronto Eaton Centre (Yonge St),Bike Share Toronto | Trent Ave / Danforth Ave - SMART,Bike Share Toronto | Trinity St /Front St E,Bike Share Toronto | Tyndall Ave / King St W - SMART,Bike Share Toronto | Ulster St / Bathurst St,Bike Share Toronto | Union Station,Bike Share Toronto | University Ave / Armoury St - SMART,Bike Share Toronto | University Ave / College St,Bike Share Toronto | University Ave / Elm St,Bike Share Toronto | University Ave / Gerrard St W,Bike Share Toronto | University Ave / Queen St W,Bike Share Toronto | Vanauley St / Queen St W - SMART,Bike Share Toronto | Via Italia / Mackay Ave - SMART,Bike Share Toronto | Victoria Memorial Square Park - SMART,Bike Share Toronto | Victoria Park Subway Station - SMART,Bike Share Toronto | Victoria St / Queen St E,Bike Share Toronto | Wallace Ave / Symington Ave - SMART,Bike Share Toronto | Walton St / Elizabeth St - SMART,Bike Share Toronto | Ward Ave / Wallace Ave,Bike Share Toronto | Wellesley St / Queen's Park Cres,Bike Share Toronto | Wellesley St E / Yonge St (Green P),Bike Share Toronto | Wellington St W / Bay St,Bike Share Toronto | Wellington St W / Portland St,Bike Share Toronto | Wellington St W / Stafford St,Bike Share Toronto | Wellington St W / York St,Bike Share Toronto | Western Battery Rd / Pirandello St,Bike Share Toronto | Westmoreland Ave / Fernbank Ave,Bike Share Toronto | Westmount Ave / St Clair Ave W - SMART,Bike Share Toronto | Widmer St / Adelaide St W,Bike Share Toronto | Willcocks St / St. George St,Bike Share Toronto | Winona Dr / Davenport Rd,Bike Share Toronto | Woodbine Ave / Lakeshore Blvd E,Bike Share Toronto | Woodbine Subway Green P SMART,Bike Share Toronto | Wright / Sorauren (Sorauren Park) - SMART,Bike Share Toronto | Wychwood Ave / Benson Ave - SMART,Bike Share Toronto | Yarmouth Rd / Christie St,Bike Share Toronto | Yonge St / Alexander St - SMART,Bike Share Toronto | Yonge St / Aylmer Ave,Bike Share Toronto | Yonge St / Bloor St,Bike Share Toronto | Yonge St / Davisville Ave,Bike Share Toronto | Yonge St / Dundas Sq,Bike Share Toronto | Yonge St / Dundonald St - SMART,Bike Share Toronto | Yonge St / Harbour St,Bike Share Toronto | Yonge St / Wood St,Bike Share Toronto | Yonge St / Yorkville Ave,Bike Share Toronto | York St / Harbour St,Bike Share Toronto | York St / King St W - SMART,Bike Share Toronto | York St / Lakeshore Blvd W,Bike Share Toronto | York St / Queens Quay W,BikeBrasilia | 102 Sul,BikeBrasilia | Banco Central,BikeBrasilia | Biblioteca Central,BikeBrasilia | Brasil 21,BikeBrasilia | Brasília Shopping,BikeBrasilia | CLN 204,BikeBrasilia | CLN 403,BikeBrasilia | CLN 406,BikeBrasilia | CNMP - Conselho Nacional do Ministério Público,BikeBrasilia | Catedral Metropolitana,BikeBrasilia | Centro Olímpico,BikeBrasilia | Centro de Convenções,BikeBrasilia | Deck Sul,BikeBrasilia | Deck Sul Kids,BikeBrasilia | EQN 104/105,BikeBrasilia | EQN 408/409,BikeBrasilia | EQN 410/411,BikeBrasilia | EQS 104/304,BikeBrasilia | EQS 202 / 203,BikeBrasilia | EQS 204/205,BikeBrasilia | Galeria,BikeBrasilia | ICC Sul,BikeBrasilia | INMETRO,BikeBrasilia | Instituto de Artes,BikeBrasilia | Liberty Mall,BikeBrasilia | Memorial JK,BikeBrasilia | Ministério da Cultura,BikeBrasilia | Ministério da Defesa,BikeBrasilia | Ministério da Saude,BikeBrasilia | Ministério do Planejamento,BikeBrasilia | Ministério dos Transportes,BikeBrasilia | PAT,BikeBrasilia | Parque Asa Delta,BikeBrasilia | Parque da Asa Delta Kids,BikeBrasilia | Praça Buriti,BikeBrasilia | Praça do Povo,BikeBrasilia | Rodoviária,BikeBrasilia | Rodoviária 2,BikeBrasilia | Rodoviária 3,BikeBrasilia | SAS,BikeBrasilia | SQN 205,BikeBrasilia | SQS 305,BikeBrasilia | SRTVS,BikeBrasilia | STF,BikeBrasilia | Setor Hoteleiro Norte,BikeBrasilia | Shopping Mall,BikeBrasilia | Shopping Pátio Brasil,BikeBrasilia | TSE,BikeBrasilia | Torre de TV,BikeBrasilia | W2/EQN305/306,BikeKia | Aupark,BikeKia | Bulvar,BikeKia | Coop - Polomská,BikeKia | Hlinská,BikeKia | Hurbanová,BikeKia | Internáty Hliny,BikeKia | Internáty Veľký diel,BikeKia | Lesopark,BikeKia | Mestský úrad,BikeKia | NBS,BikeKia | Námestie A. Hlinku,BikeKia | OC Dubeň,BikeKia | OC Max,BikeKia | Plaváreň,BikeKia | Predmestská,BikeKia | Spanyolová nemocnica,BikeKia | UNIZA,BikeKia | Vodné dielo,BikeKia | Štefánikovo námestie,BikeKia | Žilpo,BikeMi | Accursio - Portello,BikeMi | Adamello - Lorenzini,BikeMi | Alserio - Cola Montano,BikeMi | Amendola M1,BikeMi | Angilberto - Comacchio,BikeMi | Aquileia,BikeMi | Arcimboldi - Innovazione,BikeMi | Arcivescovado,BikeMi | Arco della Pace 1 - Bertani,BikeMi | Arco della Pace 2 - Pagano,BikeMi | Arcole - Argelati,BikeMi | Arduino,BikeMi | Ascanio Sforza - Pavia,BikeMi | Aspromonte - Pecchio,BikeMi | Augusto,BikeMi | B.Marcello - Boscovich,BikeMi | Bacone - Monteverdi,BikeMi | Baldinucci - Maffucci,BikeMi | Balilla - Tibaldi,BikeMi | Baracca,BikeMi | Bassini - Grossich,BikeMi | Bastioni di Porta Venezia,BikeMi | Bausan - Brofferio,BikeMi | Beatrice d\u0027Este - Cassolo,BikeMi | Beccaria,BikeMi | Benaco - Brembo,BikeMi | Bergognone - Tortona,BikeMi | Bernini,BikeMi | Bertarelli,BikeMi | Bicocca M5 - Pulci,BikeMi | Bocconi 2 - Bach,BikeMi | Bocconi 3 - I. Aragona,BikeMi | Bologna,BikeMi | Bonomelli,BikeMi | Borgogna,BikeMi | Borsieri - Confalonieri,BikeMi | Bovisa - Lambruschini,BikeMi | Bovisa Passante 1 - Alfieri,BikeMi | Brenta MM,BikeMi | Brera,BikeMi | Brescia,BikeMi | Brianza - Venini,BikeMi | Bronzetti - Archimede,BikeMi | Buenos Aires - Argentina,BikeMi | Buenos Aires - Lima,BikeMi | Buonarroti,BikeMi | Bussero - F. Testi,BikeMi | Ca\u0027 Granda - F. Testi,BikeMi | Cadore - Pinaroli,BikeMi | Cadorna 1,BikeMi | Cadorna 2,BikeMi | Cadorna 3,BikeMi | Caiazzo,BikeMi | Cairoli,BikeMi | Caldara / Curtatone,BikeMi | Caneva - Tolentino,BikeMi | Canova - Sangiorgio,BikeMi | Cantore,BikeMi | Cantù,BikeMi | Cardinal Ferrari,BikeMi | Carlo Magno - Alcuino,BikeMi | Castel Morrone - M. A. Di Savoia,BikeMi | Castelli - Ailanti,BikeMi | Castello,BikeMi | Castello Acquario civico,BikeMi | Cavour,BikeMi | Centrale 1,BikeMi | Centrale 2,BikeMi | Certosa - Monteceneri,BikeMi | Chiesa - E. Filiberto,BikeMi | Chiese - F. Testi,BikeMi | Cinque Giornate,BikeMi | Cirene - Friuli,BikeMi | Col di Lana - Col Moschin,BikeMi | Conciliazione,BikeMi | Coni Zugna Solari,BikeMi | Corvetto - Polesine,BikeMi | Crema - Giulio Romano,BikeMi | Crocetta,BikeMi | Cuoco - Monte Cimone,BikeMi | Cusani,BikeMi | D\u0027Ancona,BikeMi | Dante - San Tomaso,BikeMi | Dateo,BikeMi | De Amicis - Conca Del Naviglio,BikeMi | De Angeli - R. Sanzio,BikeMi | De Angeli - Ripamonti,BikeMi | De Marchi - Bottelli,BikeMi | De Marchi - Lucini,BikeMi | Dell\u0027Umanitaria,BikeMi | Dergano,BikeMi | Dezza - Caravaggio,BikeMi | Diaz,BikeMi | Domodossola FNM - Filelfo,"BikeMi | Donizetti \""Provincia\""",BikeMi | Duomo,BikeMi | Durante - D\u0027aviano,BikeMi | Edison,BikeMi | Elba - Cimarosa,BikeMi | Emilia - Piceno,BikeMi | Erculea,BikeMi | F.Filzi,BikeMi | Farini - Quadrio,BikeMi | Fatebenefratelli,BikeMi | Festa del Perdono,BikeMi | Fiamma,BikeMi | Firenze,BikeMi | Foppa - Caravaggio,BikeMi | Foro Buonaparte,BikeMi | Fratelli Bandiera,BikeMi | Friuli,BikeMi | Gabrio Rosa,BikeMi | Gadio - Paleocapa,BikeMi | Galvani - Restelli - RL,BikeMi | Garibaldi - Sturzo,BikeMi | Garibaldi 2 - Sturzo,BikeMi | Garibaldi Pepe,BikeMi | Gioia - Cagliero,BikeMi | Gioia - Carissimi,BikeMi | Gioia - Cassina De\u0027 Pomm,BikeMi | Gioia - Pirelli,BikeMi | Giovanni XXIII,BikeMi | Gorini - Strambio,BikeMi | Gorizia 1,BikeMi | Gorizia 2,BikeMi | Govone - Borgese,BikeMi | IV Novembre,BikeMi | Imbonati - Dergano M3,BikeMi | Indipendenza-Castel Morrone,BikeMi | Istria M5 - F. Testi,BikeMi | Italia - San Martino,BikeMi | Italia - Santa Sofia,BikeMi | Lagosta,BikeMi | Lancetti Passante - Maloja,BikeMi | Lanza,BikeMi | Lazio - Vasari - Morosini,BikeMi | Legnano Arena civica,BikeMi | Livigno - Monte San Genesio,BikeMi | Lodi - Papi,BikeMi | Lombardia - Vallazze,BikeMi | Loreto 1,BikeMi | Lotto,BikeMi | Lunigiana - Sammartini,"BikeMi | M. Gioia - \""Regione\""",BikeMi | Mac Mahon - Artieri,BikeMi | Mac Mahon - Caracciolo,BikeMi | Maciachini - Marche,BikeMi | Majno - Baretti,BikeMi | Manin - Bastioni,BikeMi | Manzoni,BikeMi | Marche - Zara,BikeMi | Marussig - Castelvetro,BikeMi | Mascagni,BikeMi | Meda,BikeMi | Medaglie D\u0027Oro 1,BikeMi | Medaglie D\u0027Oro 2,BikeMi | Melchiorre Gioia - Galvani,BikeMi | Melzi d Eril - Cagnola,BikeMi | Mentana,BikeMi | Milizie - Tortona,BikeMi | Missori,BikeMi | Modena - Castel Morrone,BikeMi | Molino Dorino M1,BikeMi | Molino delle Armi,BikeMi | Montenero - Spartaco,BikeMi | Morgagni Redi,BikeMi | Morozzo della Rocca,BikeMi | Moscova,BikeMi | Murat - Villani - Milano Sport,BikeMi | Muratori - Umbria,BikeMi | Napo Torriani De Lellis,BikeMi | Napoli - Washington,BikeMi | Naviglio G.Valenza,BikeMi | Naviglio Pavese - Torricelli,BikeMi | Nigra - Castellini,BikeMi | Novelli - Carnaghi,BikeMi | Ortles - Orobia,BikeMi | Ortles - Ripamonti,BikeMi | Ospedale Maggiore,BikeMi | P.zza Luigi di Savoia,BikeMi | Pagano - Guido D\u0027Arezzo,BikeMi | Palazzo Marino,BikeMi | Palestro 1,BikeMi | Palestro 2,BikeMi | Patellani,BikeMi | Piazza Carbonari,BikeMi | Piazza Nizza,BikeMi | Piazzale Lodi,BikeMi | Piazzi - Bernina,BikeMi | Piola,BikeMi | Pirelli - UNI Bicocca,BikeMi | Pola RL,BikeMi | Politecnico,BikeMi | Porta Genova,BikeMi | Porta Nuova,BikeMi | Porta Venezia,BikeMi | Porta Venezia 2,BikeMi | Porta Volta,BikeMi | Procaccini - Gramsci,BikeMi | Procaccini . Cimitero Monumentale,BikeMi | QT8 - Isernia,BikeMi | Rastrelli - Pecorari,BikeMi | Regina Margherita,BikeMi | Reni - Guardi,BikeMi | Repubblica,BikeMi | Restelli - Galvani RL 1,BikeMi | Richini,BikeMi | Rio De Janeiro - Sarto,BikeMi | Ripamonti Bellezza,BikeMi | Risorgimento,BikeMi | Romagna - Pascoli,BikeMi | Romolo M2,BikeMi | Roncaglia - Washington,BikeMi | Rosario,BikeMi | Rotonda della Besana,BikeMi | S. F. Romana,BikeMi | S. Nazaro in Brolo,BikeMi | S. Stefano,BikeMi | S.Gioachimo,BikeMi | S.M. del Carso,BikeMi | San Babila Bis,BikeMi | San Barnaba H Mangiagalli,BikeMi | San Giorgio,BikeMi | San Giovanni sul Muro,BikeMi | San Gottardo - Gentilino,"BikeMi | San Lorenzo - \""Colonne\""",BikeMi | San Marco,BikeMi | San Pietro all\u0027Orto,BikeMi | San Pietro in Gessate,BikeMi | San Vito,BikeMi | Sant\u0027Ambrogio,BikeMi | Sant\u0027Angelo - P.ta Nuova,BikeMi | Sant\u0027Eustorgio- P.ta Ticinese,BikeMi | Santa Maria Beltrade,BikeMi | Santa Maria delle Grazie,BikeMi | Santissima Trinità,BikeMi | Sardegna - Sicilia,BikeMi | Sarpi Albertini,BikeMi | Sarpi Niccolini,BikeMi | Sauli - Battaglia,BikeMi | Savona - Tolstoj,BikeMi | Segantini - Darwin,BikeMi | Sempione - Castelvetro,BikeMi | Sempione - Melzi d Eril,BikeMi | Sempione - RAI,BikeMi | Senato,BikeMi | Settembrini - Vitruvio,BikeMi | Spadolini - Centro Leoni,BikeMi | Sraffa,BikeMi | Staz. Greco - Pirelli - Cozzi,BikeMi | Stefini - Ressi,BikeMi | Stelvio - Farini,BikeMi | Stuparich - Albani,BikeMi | Susa - Sidoli,BikeMi | Suzzani - Arezzo,BikeMi | Taramelli RL,BikeMi | Temolo - Innovazione,BikeMi | Teodorico - Gattamelata,BikeMi | Teodosio - Pacini,BikeMi | Teodosio - Porpora,BikeMi | Tiraboschi - Muratori,BikeMi | Tommaseo,BikeMi | Torino - Carrobbio,BikeMi | Toscana- Leoni,BikeMi | Treves,BikeMi | Tricolore,BikeMi | Triennale,BikeMi | Tunisia - Cozzi,BikeMi | Tunisia Lecco Bellintani,BikeMi | Università Bocconi,BikeMi | Università Cattolica,BikeMi | V Alpini,BikeMi | VI Febbraio,BikeMi | VIII novembre,BikeMi | Valtellina - Aprica,BikeMi | Valtellina - Farini,BikeMi | Velasca,BikeMi | Vercelli - Cherubini,BikeMi | Vercelli - Piemonte,BikeMi | Verrocchio - Juvara,BikeMi | Vesuvio - Lipari,BikeMi | Vigliani - Scarampo,BikeMi | Villapizzone FFSS - Lambruschini,BikeMi | Vittor Pisani,BikeMi | XXII Marzo,BikeMi | XXIV Maggio,BikeMi | XXV Aprile,BikeMi | Zara M3,BikeMi | Zavattari - Tempesta,BikePOA | 1 - Mercado,BikePOA | 10 - UFRGS Administração,BikePOA | 11 - Caminho dos Antiquários,BikePOA | 12 - UFRGS Arq.,BikePOA | 13 - FARSUL,BikePOA | 14 - Lima e Silva,BikePOA | 15 - Rua Alberto Tôrres,BikePOA | 16 - República,BikePOA | 17 - Praça Isabel,BikePOA | 18 - Ministério Público,BikePOA | 19 - Rótula do Gasômetro,BikePOA | 2 - Praça da Alfândega,BikePOA | 20 - Praia de Belas,BikePOA | 21 - Praça Itália,BikePOA | 22 - Av. Bastian,BikePOA | 23 - 17 de junho,BikePOA | 24 - Cascatinha,BikePOA | 25 - Estação Nacional,BikePOA | 26 - Praça Garibaldi,BikePOA | 27 - Estação João Pessoa,BikePOA | 28 - Venâncio Aires,BikePOA | 29 - Praça Maj. Joaquim de Queirós,BikePOA | 3 - Casa de Cultura Mário Quintana,BikePOA | 30 - Vieira de Castro,BikePOA | 31 - UFRGS Campus Saúde,BikePOA | 32 - Hospital de Clínicas,BikePOA | 33 - Redenção Mercadinho,BikePOA | 34 - Barros Cassal,BikePOA | 35 - Irmão José Otao,BikePOA | 36 - Fernandes Vieira,BikePOA | 37 - Rua Miguel Tostes,BikePOA | 38 - R. César Lombroso,BikePOA | 39 - Goethe,BikePOA | 4 - Museu Júlio de Castilhos,BikePOA | 40 - Parcão,BikePOA | 41 - Iberê,BikePOA | 5 - Rua Fernando Machado,BikePOA | 6 - Duque de Caxias,BikePOA | 7 - Usina do Gasômetro,BikePOA | 8 - Câmara dos Vereadores,BikePOA | 9 - SERPRO,BikePetrolina | Catedral,BikePetrolina | Facape,BikePetrolina | Integração,BikePetrolina | Orla 1,BikePetrolina | Orla 2,BikePetrolina | Parque Municipal,BikePetrolina | River Shopping,BikeRecife | 1 - Prefeitura,BikeRecife | 10 - Casa da Cultura,BikeRecife | 11 - Ponte do Limoeiro,BikeRecife | 12 - Camilo Simões,BikeRecife | 13 - Tortura Nunca Mais,BikeRecife | 14 - Parque Treze de Maio,BikeRecife | 15 - Cine São Luiz,BikeRecife | 16 - Matriz da Boa Vista,BikeRecife | 17 - Igreja de Santa Cruz,BikeRecife | 18 - Riachuelo,BikeRecife | 19 - Sossego.,BikeRecife | 2 - Praça Tiradentes,BikeRecife | 20 - Palmares,BikeRecife | 21 - Diário de Pernambuco,BikeRecife | 22 - Frei Cassimiro,BikeRecife | 23 - SESC Santo Amaro,BikeRecife | 24 - Cemitério de Santo Amaro,BikeRecife | 25 - Rua do Lazer,BikeRecife | 26 - Praça Oswaldo Cruz,BikeRecife | 27 - Rua da Soledade,BikeRecife | 28 - Salesiano,BikeRecife | 29 - Praça Miguel de Cervantes,BikeRecife | 3 - Praça do Arsenal,BikeRecife | 30 - SJCC,BikeRecife | 31 - Epaminondas,BikeRecife | 32 - Praça Chora Menino,BikeRecife | 33 - CNBB,BikeRecife | 34 - R. Silva Ramos,BikeRecife | 35 - Praça do Derby,BikeRecife | 36 - Politécnica,BikeRecife | 37 - Praça João Pereira Borges,BikeRecife | 38 - Ponte da Capunga,BikeRecife | 39 - Instituto Capibaribe,BikeRecife | 4 - Boulevard Rio Branco,BikeRecife | 40 - Beira Rio,BikeRecife | 41 - Colégio Agnes Erskine,BikeRecife | 42 - Praça do Entrocamento,BikeRecife | 43 - Rua Samuel Pinto,BikeRecife | 44 - Praça Otília,BikeRecife | 45 - R. Bruno Maia,BikeRecife | 46 - R. Adalberto Camargo,BikeRecife | 47 - Faculdade Damas,BikeRecife | 48 - Parque da Jaqueira,BikeRecife | 49 - R. Gen. Abreu e Lima,BikeRecife | 5 - Paço Alfândega,BikeRecife | 50 - Casa Rosada.,BikeRecife | 51 - Praça da FEB,BikeRecife | 52 - Club do Nautico,BikeRecife | 53 - Rua Dr. Vicente Meira,BikeRecife | 54 - Venezuela.,BikeRecife | 55 - Hospital Oswaldo Cruz.,BikeRecife | 56 -R. Bernardino Soares da Silva,BikeRecife | 57 - R. Alfredo de Medeiros,BikeRecife | 58 - Mercado da Encruzilhada,BikeRecife | 59 - Praça do Rosarinho,BikeRecife | 6 - Cais de Santa Rita,BikeRecife | 60 - Pina,BikeRecife | 61 - Segundo Jardim,BikeRecife | 62 - Prof. José Brandão,BikeRecife | 63 - Padre Carapuceiro,BikeRecife | 64 - R. Verdes Mares,BikeRecife | 65 - Parque Dona Lindú,BikeRecife | 66 - Rua Eng. Antônio Jucá,BikeRecife | 67 - Shopping Guararapes,BikeRecife | 68 - Faculdade Guararapes,BikeRecife | 69 - Praça Massangana,BikeRecife | 7 - Praça da República,BikeRecife | 70 - Metrô Monte dos Guararapes,BikeRecife | 71 - Mercado Eufrásio Barbosa,BikeRecife | 72 - Praça do Carmo,BikeRecife | 73 - Praça Doze de Março,BikeRecife | 74 - R. João Cardoso Aires,BikeRecife | 75 - Alberto Lundgren,BikeRecife | 76 - R. Dr. Manoel de Barros Lima,BikeRecife | 77 - Praia da Casa Caiada,BikeRecife | 78 - CCS UFPE,BikeRecife | 79 - NIATE UFPE,BikeRecife | 8 - Praça da Independência,BikeRecife | 80 -Restaurante Universitário UFPE,BikeRecife | 9 - Praça Joaquim Nabuco,BikeRecife | FLOATING-STATION,BikeRio | 1 - Central do Brasil,BikeRio | 10 - Largo da Glória,BikeRio | 101 - Leopoldo Miguez,BikeRio | 102 - Metrô Cantagalo,BikeRio | 103 - Barão de Ipanema,BikeRio | 104 - Assunção,BikeRio | 105 - Dias da Rocha,BikeRio | 106 - Parque Olimpico,BikeRio | 107 - Figueiredo Magalhães,BikeRio | 108 - Hospital Lourenço Jorge,BikeRio | 109 - Metrô Siqueira Campos,BikeRio | 11 - Praça Luiz de Camões,BikeRio | 111 - Siqueira Campos,BikeRio | 113 - República do Peru,BikeRio | 114 - Cardeal Arcoverde,BikeRio | 115 - Shopping Metropolitano,BikeRio | 116 - Praça do Lido,BikeRio | 117 - Antônio Vieira,BikeRio | 119 - Parque Lage,BikeRio | 12 - Artur Bernardes,BikeRio | 120 -  Rua da Passagem,BikeRio | 121 - Mourisco,BikeRio | 122 - Botafogo Praia Shopping,BikeRio | 123 - Bambina,BikeRio | 124 - Praça Joia Valansi,BikeRio | 126 - Clarice Índio do Brasil,BikeRio | 127 - Honório de Barros,BikeRio | 128 - Palacio da Cidade,BikeRio | 129 - Sorocaba,BikeRio | 13 - Parque Guinle,BikeRio | 131 - Metrô Botafogo,BikeRio | 132 - Escola Eleva,BikeRio | 133 - Pasteur,BikeRio | 134 - Pão de Açúcar,BikeRio | 135 - BRT Salvador Allende,BikeRio | 136 - Metrô Flamengo,BikeRio | 137 - Tucumam,BikeRio | 138 - Praça José de Alencar,BikeRio | 139 - Buarque de Macedo,BikeRio | 14 - Pereira da Silva,BikeRio | 141 - Centro Médico Richet,BikeRio | 142 - Praia do Flamengo,BikeRio | 143 - Fluminense,BikeRio | 145 - Praça David Ben Gurion,BikeRio | 146 - Planetário Gávea,BikeRio | 147 - Alfredo Russell,BikeRio | 148 - Bartolomeu Mitre,BikeRio | 149 - Rainha Guilhermina,BikeRio | 15 - Alegrete,BikeRio | 153 - Epitácio Pessoa,BikeRio | 154 - Curva do Calombo,BikeRio | 155 - Igreja Santa Margarida Maria,BikeRio | 156 - J. Carlos,BikeRio | 157 - Frei Leandro,BikeRio | 158 - Lagoa Vasco da Gama,BikeRio | 159 - Hospital da Lagoa,BikeRio | 16 - Praça São Judas Tadeu,BikeRio | 160 - Lineu de Paula Machado,BikeRio | 161 - Jd. Botânico,BikeRio | 162 - Pacheco Leão,BikeRio | 163 - Viúva Lacerda,BikeRio | 164 - Shopping Tijuca,BikeRio | 165 - Tijuca off shopping,BikeRio | 166 - Tijuca Tênis Clube,BikeRio | 167 - Metrô Saens Pena,BikeRio | 168 - Barão de Mesquita 174,BikeRio | 169 - Conde de Bonfim 526,BikeRio | 17 - Oswaldo Cruz,BikeRio | 170 - Pereira de Siqueira,BikeRio | 171 - Colégio Militar,BikeRio | 172 - Maracananzinho,BikeRio | 173 - SENAI Tijuca,BikeRio | 174 - São Cristóvão,BikeRio | 175 - Félix da Cunha,BikeRio | 176 - Largo Frei Cassiano Villarosa,BikeRio | 177 - Senador Furtado,BikeRio | 178 - Praça da Bandeira,BikeRio | 179 - Haddock Lobo,BikeRio | 18 - Praça Nicarágua,BikeRio | 181 - Júlio do Carmo,BikeRio | 182 - Metrô Praça Onze,BikeRio | 183 - Defensoria Pública,BikeRio | 185 - Rua da Lapa,BikeRio | 186 - Lúcio de Mendonça,BikeRio | 187 - Extra Mariz e Barros,BikeRio | 188 - Metrô São Francisco Xavier,BikeRio | 189 - Mariz e Barros,BikeRio | 19 - Guilhermina Guinle,BikeRio | 190 - Metrô Afonso Pena,BikeRio | 191 - Praça Manoel Coelho Mendes,BikeRio | 192 - Saens Peña Medical Center,BikeRio | 193 - Uruguai,BikeRio | 194 - Batalhão de Policia do Exército,BikeRio | 195 - Senador Muniz Freire,BikeRio | 196 - Ribeiro Guimarães,BikeRio | 197 - Octacílio Negrão de Lima,BikeRio | 198 - Conde de Bonfim,BikeRio | 199 - Metrô Estácio,BikeRio | 2 - Praça da República,BikeRio | 20 - Cobal,BikeRio | 200 - Armazém da Utopia,BikeRio | 201 - Aquário,BikeRio | 202 - Armazém 3,BikeRio | 203 - Praça Mauá,BikeRio | 204 - São Bento,BikeRio | 205 - Praça Barão de Ládario,BikeRio | 206 - Tribunal Marítimo,BikeRio | 207 - Rua da Alfândega,BikeRio | 208 - Av. Passos,BikeRio | 209 - Rua da Quitanda,BikeRio | 21 - Real Grandeza,BikeRio | 210 - Praça XV,BikeRio | 211 - Península 2,BikeRio | 212 - Buraco do Lume,BikeRio | 213 - Praça do Expedicionário,BikeRio | 214 - Poeta Manuel Bandeira,BikeRio | 216 - Clementino Fraga,BikeRio | 217 -Balança Mas Não Cai,BikeRio | 218 - Península 1,BikeRio | 219 - Frei Caneca,BikeRio | 22 - General Polidoro,BikeRio | 221 - Rua do Riachuelo,BikeRio | 223 - Henrique Valadares,BikeRio | 224 - Catedral Metropolitano,BikeRio | 225 - República do Líbano,BikeRio | 226 - Rua do Rezende,BikeRio | 227 - Saara Buenos Aires,BikeRio | 228 -  Praça do Itamaraty,BikeRio | 23 - Teresa Guimarães,BikeRio | 230 -Metrô São Conrado,BikeRio | 231 - Prefeito Mendes de Morais,BikeRio | 232 - Parque de Madureira I,BikeRio | 233 - Parque Madureira II,BikeRio | 234 - Pier Barra da Tijuca,BikeRio | 235 - R. Tenente Airton Pereira,BikeRio | 236 - Jornalista Mário Filho,BikeRio | 237 - Adilson Serôa da Motta,BikeRio | 238 - Port Brise,BikeRio | 239 - Praça São Perpétuo,BikeRio | 24 - Lauro Müller,BikeRio | 240 - Windsor Barra,BikeRio | 241 - Posto 4 Barra,BikeRio | 242 - Posto 5 Barra,BikeRio | 243 - Santorini,BikeRio | 244 - Condomínio Vivendas,BikeRio | 245 -Buena Vista,BikeRio | 246 - Barrabella,BikeRio | 247 - Praça Pimentinha,BikeRio | 248 - Downtown,BikeRio | 249 - Ministro Afrânio Costa,BikeRio | 25 - UFRJ Praia Vermelha,BikeRio | 250 - Praça Professor Souza Araújo,BikeRio | 251- Veiga de Almeida,BikeRio | 252 - Parque das Rosas,BikeRio | 253 - Av. Olegário Maciel,BikeRio | 254 - Vila do PAN,BikeRio | 255 - Praça Euvaldo Lodi,BikeRio | 256 - Humaitá,BikeRio | 257 - Metrô Jardim Oceânico,BikeRio | 258 - Praça do Pomar,BikeRio | 259 - Posto 9 Recreio,BikeRio | 26 - Iate Clube,BikeRio | 260 - Posto 12 Recreio,BikeRio | 261 - Praça Soldado Geraldo da,BikeRio | 262 - Golden Green,BikeRio | 263 - Almare,BikeRio | 264 - Alfa Barra,BikeRio | 267 - Terminal Alvorada Leste,BikeRio | 27 - Pedra do Leme,BikeRio | 271 - Alfa Barra II,BikeRio | 273 - Escola Eleva  Barra,BikeRio | 28 - Praça Demétrio Ribeiro,BikeRio | 284 - Praça Restier Gonçalves,BikeRio | 285 - Gláucio Gil Praia,BikeRio | 286 - BRT Benvindo de Novaes,BikeRio | 287 - Dez e meio,BikeRio | 288 - Murilo Araújo,BikeRio | 29 - Fernandes Mendes,BikeRio | 290 - Barra World,BikeRio | 291 - Praça Miguel Osório,BikeRio | 293 - Praia da Macumba,BikeRio | 3 - Praça Tiradentes,BikeRio | 30 - Santa Clara 98,BikeRio | 309 - AQWA Corporate,BikeRio | 31 - Santa Clara,BikeRio | 32 - Bolivar,BikeRio | 33 - Miguel Lemos,BikeRio | 34 - Conselheiro Lafaiete,BikeRio | 35 - Pedra do Arpoador,BikeRio | 36 - Joaquim Nabuco,BikeRio | 37 - Posto 9,BikeRio | 38 - Garcia DÁvila,BikeRio | 39 - Aníbal de Mendonça,BikeRio | 4 - Largo de São Francisco,BikeRio | 40 - Afrânio,BikeRio | 41 - Maria Quitéria,BikeRio | 42 - Metrô Lagoa,BikeRio | 43 - Parque da Catacumba,BikeRio | 44 - Epitácio Pessoa 4224,BikeRio | 45 - Epitácio Pessoa 4794,BikeRio | 46 - Clube Piraquê,BikeRio | 47 - Parque dos Patins,BikeRio | 48 - Parque das Figueiras,BikeRio | 49 - Shopping da Gávea,BikeRio | 5 - Largo da Carioca,BikeRio | 50 - Praça Sibélius,BikeRio | 51 - Cidade Nova,BikeRio | 52 - Medalha Milagrosa,BikeRio | 53 - Gaffrée e Guinle,BikeRio | 54 - Morais e Silva,BikeRio | 55 - Mata Machado,BikeRio | 56 - Praça Varnhagem,BikeRio | 57 - Praça Niteroi,BikeRio | 58 - Estádio Célio de Barros,BikeRio | 59 - Boulevard 28 de setembro 157,BikeRio | 6 - Praça Marechal Âncora,BikeRio | 60 - Maxwell,BikeRio | 61 - SESC Tijuca,BikeRio | 62 - Oi Futuro,BikeRio | 63 - Praça Xavier de Brito,BikeRio | 64 - Metrô Uruguai,BikeRio | 65 - Metrô Uruguaiana,BikeRio | 66 - Estação de Bondes,BikeRio | 67 - Gomes Freire,BikeRio | 68 - Rua do Catete,BikeRio | 69 - Palácio do Catete,BikeRio | 7 - Bossa Nova Mall,BikeRio | 70 - Praça São Salvador,BikeRio | 71 - Palácio Guanabara,BikeRio | 72 - Santa Marta,BikeRio | 73 - Furnas,BikeRio | 74 - Visconde de Caravelas,BikeRio | 75 - Pinheiro Guimarães,BikeRio | 76 - Baixo Gávea,BikeRio | 77 - Cine Leblon,BikeRio | 78 - Fashion Mall,BikeRio | 79 - São Conrado,BikeRio | 8 - MAM,BikeRio | 80 - Praça São Conrado,BikeRio | 81 - General Venâncio Flores,BikeRio | 82 - Antero de Quental,BikeRio | 83 - Cupertino Durão,BikeRio | 84 - Ataulfo de Paiva,BikeRio | 85 - Jardim de Alah,BikeRio | 86 -  Henrique Dumont,BikeRio | 87 - Barão da Torre 631,BikeRio | 88 - Barão da Torre 577,BikeRio | 89 - Praça Nossa Senhora da Paz,BikeRio | 9 - Sala Cecília Meirelles,BikeRio | 90 -  Joana Angélica,BikeRio | 91 - Visconde de Pirajá,BikeRio | 92 - Alberto de Campos,BikeRio | 93 - Praça Nossa Senhora Auxiliadora,BikeRio | 94 - Farme de Amoedo,BikeRio | 95 - General Osório,BikeRio | 96 - Posto 6,BikeRio | 97 - Júlio de Castilhos,BikeRio | 98 - Bulhões de Carvalho,BikeRio | 99 - Sá Ferreira,BikeSampa | 1 - Largo da Batata,BikeSampa | 10 - Rua Campo Verde,BikeSampa | 100 - Itaú Cultural,BikeSampa | 101 -  Praça Gen. Gentil Falcão,BikeSampa | 102 - Rua James Watt,BikeSampa | 103 - Rua Hans Oerted,BikeSampa | 105 - Praça João Duram Alonso,BikeSampa | 106 - Rua Florida,BikeSampa | 107 - Rua Indiana,BikeSampa | 108 - Praça Prof. José Lannes,BikeSampa | 109 - Praça Oswaldo Varella,BikeSampa | 11 - Praça Faria Lima,BikeSampa | 110 - Flórida 1670,BikeSampa | 111 - Edward Weston,BikeSampa | 112 - R. Lee de Forest,BikeSampa | 113 - Rua Andrade Pertence,BikeSampa | 114 - Rua Alvorada,BikeSampa | 115 - Praça Procopio Ferreira,BikeSampa | 116 - Praça Dr. Francisco Patti,BikeSampa | 117 - Cubo Itaú,BikeSampa | 118 - Rua Júlio Diniz,BikeSampa | 119 - Rua Quatá,BikeSampa | 12 - Largo de Batata II,BikeSampa | 120 - Rua Gomes de Carvalho,BikeSampa | 121 - Insper,BikeSampa | 122 - Rua Baluarte,BikeSampa | 123 - Rua Egito,BikeSampa | 124 - Praça PereIra Coutinho,BikeSampa | 125 - Natividade,BikeSampa | 126 - Graúna,BikeSampa | 127 - Jacutinga,BikeSampa | 128 - R. Sampaio Góis,BikeSampa | 129 - Sabiá,BikeSampa | 13 - Esporte Clube Pinheiros Funcionários,BikeSampa | 131 - Pq. Ibirapuera Portão 06,BikeSampa | 132 - Pq. Ibirapuera Portão 05,BikeSampa | 133 - Avenida Ibirapuera,BikeSampa | 137 - Rua do Rocio,BikeSampa | 138 - Chilon,BikeSampa | 14 - Casa Brasileira,BikeSampa | 140 - JK Iguatemi,BikeSampa | 141 - Praça Luis Carlos Paraná,BikeSampa | 143- Rua João Cachoeira,BikeSampa | 144 - Rua Iguatemi,BikeSampa | 145 - CPTM BERRINI,BikeSampa | 147 - Rua Min Jesuíno Cardoso II,BikeSampa | 148 - R. Maria Figueiredo,BikeSampa | 149 - Rua Afonso de Freitas,BikeSampa | 15 - Rua Prof. Artur Ramos,BikeSampa | 150 - Metrô Paraiso,BikeSampa | 16 - Esporte Clube Pinheiros Boliche,BikeSampa | 17 - Rua José Gonçalves de Oliveira,BikeSampa | 18 - Itaú Faria Lima,BikeSampa | 189 - CEMG FARIA LIMA,BikeSampa | 19 - Av. Dr. Cardoso de Melo,BikeSampa | 20 - CPTM Cidade Jardim,BikeSampa | 201 - Metro Sumaré,BikeSampa | 202 - Arruda Alvim,BikeSampa | 203 - Capote Valente 822,BikeSampa | 204- Consolação,BikeSampa | 205 - Alameda Itú 1579,BikeSampa | 206 - Alameda Tietê,BikeSampa | 207 - Bela Cintra,BikeSampa | 209 - Haddock Lobo,BikeSampa | 21 - Parque do Povo portão 1,BikeSampa | 210 - Capote Valente 429,BikeSampa | 211 - Capote Valente,BikeSampa | 212 - R. Estados Unidos,BikeSampa | 213 - Guadelupe,BikeSampa | 214 - João Moura,BikeSampa | 215 - E.E. Godofredo Furtado,BikeSampa | 216 - João Moura 328,BikeSampa | 217 - Alameda Gabriel,BikeSampa | 218 - Cemitério Cardeal,BikeSampa | 219 - Rua Joaquim Antunes,BikeSampa | 22 - Rua Leopoldo Couto,BikeSampa | 220 - R. dos Pinheiros,BikeSampa | 221 - Sampaio Vidal 27,BikeSampa | 222 - Rua Horácio Lane,BikeSampa | 223 -Fradique Coutinho,BikeSampa | 224 - Metrô Fradique Coutinho,BikeSampa | 225 - Sampaio Vidal 530,BikeSampa | 226 - Fradique Coutinho 941,BikeSampa | 227 - R. Simão Álvares,BikeSampa | 229 - Arthur de Azevedo,BikeSampa | 23 - CPTM Vila Olímpia,BikeSampa | 230 - Rua Mariano Correia,BikeSampa | 231 - Instituto Tomie Ohtake,BikeSampa | 232 - Sumidouro,BikeSampa | 233 - Paraopeba,BikeSampa | 234 - Praça Roquete Pinto,BikeSampa | 235 - CETESB,BikeSampa | 236 - Praça Ernami Braga,BikeSampa | 238 - Avenida dos Semaneiros,BikeSampa | 239 - Avenida Antônio Batuira,BikeSampa | 24 - Rua Funchal,BikeSampa | 240 - Praça Panamericana,BikeSampa | 241 - CPTM Cidade Universitária,BikeSampa | 25 - Rua Helena,BikeSampa | 26 - Praça Pierre Germayel,BikeSampa | 261- Praça Pero Vaz de Caminha,BikeSampa | 262 - Colégio Santa Cruz,BikeSampa | 263 - Praça Beethoven,BikeSampa | 264 - Parque Vila Lobos Portão 2,BikeSampa | 267 - CPTM Vila Lobos Jaguaré,BikeSampa | 268 -Hotel Maksoud Plaza,BikeSampa | 269 - R. Blumenau,BikeSampa | 27 - Rua Min. Jesuíno Cardoso,BikeSampa | 270 - R. Nagel,BikeSampa | 271 - R. Fröben,BikeSampa | 272 -SESI Leopoldina,BikeSampa | 273 - R. Hayden,BikeSampa | 275 - R. Hassib Mofarrej,BikeSampa | 276 - R. Carneiro da Silva,BikeSampa | 277 -Carlos Weber 223,BikeSampa | 278 - R. Tripoli,BikeSampa | 28 - Rua Comendador Miguel Calfat,BikeSampa | 29 - Rua João Franco,BikeSampa | 292 - Rua Domingos de Moraes,BikeSampa | 293 - Metrô Ana Rosa,BikeSampa | 294 - Metrô Ana Rosa II,BikeSampa | 295 -Vergueiro,BikeSampa | 297 -SESC Vila Mariana,BikeSampa | 298 - Av. Conseheiro Rodrigues Alves,BikeSampa | 3 - CPTM Pinheiros,BikeSampa | 30 - Bandeira Paulista,BikeSampa | 300 - Caravelas,BikeSampa | 301 - R. França Pinto,BikeSampa | 303 - Rio Grande,BikeSampa | 304 - Gandavo,BikeSampa | 305 - MUBA,BikeSampa | 306 - R. Madre Cabrini,BikeSampa | 307 - Metrô Vila Mariana,BikeSampa | 308 - R da cunha,BikeSampa | 31 - Jacques Felix,BikeSampa | 310 - R. Cel. Lisboa,"BikeSampa | 311 - R. Diogo de Faria , 650",BikeSampa | 312 - R. DIOGO DE FARIA,BikeSampa | 313 - Metrô AACD Servidor,BikeSampa | 314 - R. José Guimarães,BikeSampa | 315 -Metrô Hospital São Paulo,BikeSampa | 316 - EMBAÚ,BikeSampa | 317 - R. Leonardo Nunes,BikeSampa | 318 - Gabriel Rezende Passos,BikeSampa | 319 - Metrô Moema,BikeSampa | 32 - Pq. Ibirapuera Portão 07,BikeSampa | 321 - Gaivota,BikeSampa | 322 - Metrô Eucaliptos,BikeSampa | 323 - Eucaliptos,BikeSampa | 324 - Canário,BikeSampa | 325 - Pintassilgo,BikeSampa | 326 - Inhambú,BikeSampa | 327 - Arapanés,BikeSampa | 328 - R. Demóstenes,BikeSampa | 329 - Bandeirantes,BikeSampa | 33 - Pq. Ibirapuera Portão 08,BikeSampa | 331 - Rua Nebrasca,BikeSampa | 332 - Rua Nova York,BikeSampa | 333 -R. Flórida 53,BikeSampa | 334 - R. Pe. Antônio,BikeSampa | 335 - R. Ribeiro do Vale,BikeSampa | 336 - Flórida 1020,BikeSampa | 337 - Castilho,BikeSampa | 338 - RUA PITÚ,BikeSampa | 339 - R. Min. Luiz Gallotti,BikeSampa | 34 - Rua Bastos Pereira,BikeSampa | 340 - R. Oscar Gomes Cardim II,BikeSampa | 341 - R. Coronel Conrado Siqueira,BikeSampa | 342 - R. Santo Arcádio,BikeSampa | 343 - Jurubatuba,BikeSampa | 345 - R. Henrique FIsher,BikeSampa | 346 - R. Vieira da Silva,BikeSampa | 347 - Metrô Brooklin,BikeSampa | 348 - R. João Pais,BikeSampa | 349 - Cacioneiro de Évora,BikeSampa | 35 - Rua Benedito Lapin,BikeSampa | 355 - R. Dr. Rafael de Barros,BikeSampa | 358 - SHOPPING VILLA LOBOS,BikeSampa | 359 - CENU,BikeSampa | 36 - E.E. Aristides de Castro,BikeSampa | 37 - Edifício Infinity,BikeSampa | 38 - Viradouro,BikeSampa | 4 - Rua Diogo Moreira,BikeSampa | 40 - Brasília,BikeSampa | 41 - Paróquia São Gabriel,BikeSampa | 42 - Hotel Unique,BikeSampa | 44 - Pq. Ibirapuera Portão 09,BikeSampa | 45 - Marechal Bitencourt,BikeSampa | 46 - Rua General Fonseca Telles,BikeSampa | 47 - Suzano,BikeSampa | 48 - Itacema,BikeSampa | 49 - Tapinás,BikeSampa | 5 - Rua Butantã,BikeSampa | 50 - Rua Professor Carlos de Carvalho,BikeSampa | 51 - Praça Luiz Delben Junior,BikeSampa | 53 -Google São Paulo,BikeSampa | 54 - Colégio Madre Alix,BikeSampa | 55 - Jacupiranga,BikeSampa | 56 - Atlântica,BikeSampa | 57 - Groelândia,BikeSampa | 58 - Mube,BikeSampa | 59 - EBAC,BikeSampa | 6 - Rua Manduri,BikeSampa | 60 - Clube Harmonia,BikeSampa | 61 - Venezuela,BikeSampa | 62 - Equador,BikeSampa | 63 - Club Athletico Paulistano,BikeSampa | 64 - Maestro Elias Lobo,BikeSampa | 65 - Rua Dr. João Pinheiro,BikeSampa | 66 - Praça Domingos Delascio,BikeSampa | 67 - Maestro Chiafarelli,BikeSampa | 68 - Praça Nicolau Scarpa,BikeSampa | 69 - Oscar Freire,BikeSampa | 7 - Praça Joaquim Roberto,BikeSampa | 70 - Alameda Casa Branca,BikeSampa | 71 - Pamplona,BikeSampa | 72 - Queluz,BikeSampa | 73 - Ginásio Ibirapuera,BikeSampa | 75 - Viaduto Tutóia,BikeSampa | 76 - 8° Batalhão,BikeSampa | 77 - Alameda j. Eugênio de Lima,BikeSampa | 78 - Alameda Franca,BikeSampa | 80 - Praça Alexandre de Gusmão,BikeSampa | 81 - Colégio Dante Alighieri,BikeSampa | 82- Alameda Min. Rocha Azevedo,BikeSampa | 83- Augusta,BikeSampa | 9 - R. Grécia,BikeSampa | 94 - Alameda Jaú,BikeSampa | 95 - Metrô Brigadeiro,BikeSampa | 96 - Tutóia,BikeSampa | 98 - Sampaio Viana,BikeSampa | 99 - R. Tomás Carvalhal,BikeSantiago | EC01 - Estacion Central,BikeSantiago | EC02 - Metro Las Rejas,BikeSantiago | EC03 - Rio Quetro,BikeSantiago | EC04 - Metro Ecuador,BikeSantiago | EC05 - Metro San Alberto Hurtado,BikeSantiago | EC06 - 5 de Abril / Las Rejas,BikeSantiago | I01 - Metro Hospitales,BikeSantiago | I02 - Santos Dumont,BikeSantiago | I03 - Mathieu,BikeSantiago | I04 - Molino,BikeSantiago | I05 - Vivaceta / Gamero,BikeSantiago | I06 - Mall Independencia,BikeSantiago | LB01 - Puertas de Valle,BikeSantiago | LB02 - Clinica Alemana La Dehesa,BikeSantiago | LB03 - El Tranque - Los Cataños,BikeSantiago | LB04 - La Dehesa / Pie Andino,BikeSantiago | LB05 - Paseo Los Trapenses,BikeSantiago | LB06 - Jose Alcalde Delano / La Madrugada,BikeSantiago | LB07 - La Dehesa / Luis Bascuñan,BikeSantiago | LB08 - Santa Blanca,BikeSantiago | LB09 - San Jose De La Sierra,BikeSantiago | LB10 - Raul Labbe / La Pasarela,BikeSantiago | LB11 - Portal La Dehesa,BikeSantiago | LB12 - La Dehesa - Los Robles,BikeSantiago | LB13 - La Dehesa / El Rodeo,BikeSantiago | LB14 - Cuatro Vientos - Lo Barnechea,BikeSantiago | LB15 - Municipalidad de Lo Barnechea,BikeSantiago | LB16 - Canta Gallo,BikeSantiago | LB17 - El Huinganal / Pie Andino,BikeSantiago | LB18 - La Laguna,BikeSantiago | LB19 - La Dehesa / Bernardo Larrain,BikeSantiago | LF01 - Vicuna Mackenna Poniente,BikeSantiago | LF02 - Froilan Roa - Americo Vespucio,BikeSantiago | LF03 - Metro Bellavista,BikeSantiago | LF04 - Metro Mirador,BikeSantiago | LF05 - Barcelona,BikeSantiago | LF06 - Colombia - Walker Martinez,BikeSantiago | LP01 - Metro Neptuno,BikeSantiago | LP02 - Metro Pajaritos,BikeSantiago | LP03 - Metro San Pablo,BikeSantiago | LP04 - Las Torres / San Pablo,BikeSantiago | LP05 - Metro Lo Prado,BikeSantiago | MC01 - Gregorio de la Fuente,BikeSantiago | MC02 - Macul / Rodrigo de Araya,BikeSantiago | MC03 - Macul /Quilin,BikeSantiago | MC04 - Domingo Arteaga,BikeSantiago | MC05 - Marathon / Rodrigo de Araya,BikeSantiago | MC06 - Marathon / Quilin,BikeSantiago | MP01 - DUOC Maipú,BikeSantiago | MP02 - Estadio Santiago Bueras,BikeSantiago | MP03 - Metro Santiago Bueras,BikeSantiago | MP04 - Plaza Maipu,BikeSantiago | MP05 - Pajaritos / Maipú,BikeSantiago | MP06 - Hospital El Carmen,BikeSantiago | MP07 - Villa Union y Esfuerzo,BikeSantiago | MP08 - Templo Votivo,BikeSantiago | MP09 - Camino a Rinconada / San Martín,BikeSantiago | MP10 - Pajaritos / Ohiggins,BikeSantiago | N01 - Irarrazaval / Agustin Vigorena,BikeSantiago | N02 - Irarrazaval / Jose Pedro Alessandri,BikeSantiago | N03 - Club Nunoa,BikeSantiago | N04 - Hospital Carabineros,BikeSantiago | N05 - Irarrazaval / Hamburgo,BikeSantiago | N06 - Metro Nunoa,BikeSantiago | N07 - Jose Luis Araneda / Capitan Orella,BikeSantiago | N08 - Manuel Montt / Union Literaria,BikeSantiago | N09 - Metro Irarrazaval,BikeSantiago | N10 - Metro Plaza Egaña,BikeSantiago | N11 - Metro Simon Bolivar,BikeSantiago | N12 - Plaza Nunoa,BikeSantiago | N13 - Ricardo Lyon / Hernan Cortes,BikeSantiago | N32 - Plaza Augusto D'Halmar,BikeSantiago | P01 - Andrés Bello / Gral. Holley,BikeSantiago | P02 - Avenida Italia / Marín,BikeSantiago | P03 - Avenida Suecia / El Vergel,BikeSantiago | P04 - Costanera Center 1,BikeSantiago | P05 - Costanera Center 2,BikeSantiago | P06 - Duoc (Antonio Varas),BikeSantiago | P07 - El Aguilucho,BikeSantiago | P08 - Metro Colón,BikeSantiago | P09 - Metro Francisco Bilbao,BikeSantiago | P10 - Metro Manuel Montt,BikeSantiago | P11 - Metro Parque Bustamante,BikeSantiago | P12 - Puente Pedro de Valdivia,BikeSantiago | P13 - Metro Pedro de Valdivia 2,BikeSantiago | P14 - Metro Baquedano,BikeSantiago | P15 - Manuel Montt - Andres Bello,BikeSantiago | P16 - Metro Salvador,BikeSantiago | P17 - Metro Santa Isabel,BikeSantiago | P18 - Metro Tobalaba,BikeSantiago | P19 - Municipalidad Providencia,BikeSantiago | P20 - Nueva Los Leones,BikeSantiago | P21 - Patio Bellavista,BikeSantiago | P22 - Plaza Loreto Cousiño,BikeSantiago | P23 - Metro Inés de Suarez,BikeSantiago | P24 - Plaza Rio De Janeiro,BikeSantiago | P25 - Bustos / Ricardo Lyon,BikeSantiago | P26 - Mar del Plata,BikeSantiago | P27 - Ricardo Lyon / Lota,BikeSantiago | P28 - Ricardo Lyon / Pocuro,BikeSantiago | P29 - Santa Isabel /Ana Luisa Prats,BikeSantiago | P30 - Lo Contador,BikeSantiago | P32 - Valenzuela Castillo,BikeSantiago | P35 - Campus Oriente PUC,BikeSantiago | P36 - Carlos Antúnez / Barros Errázuriz,BikeSantiago | P37 - Obispo Salas,BikeSantiago | P44 - Padre Mariano,BikeSantiago | P45 - Luis Thayer Ojeda / Carmen Sylva,BikeSantiago | P49 - Bilbao - Miguel Claro,BikeSantiago | P52 - Holanda / Pocuro,BikeSantiago | P53 - Plaza Inés de Suarez,BikeSantiago | P55 - Pérez Valenzuela,BikeSantiago | R01 - Bellavista / Recoleta,BikeSantiago | R02 - Cerro Blanco,BikeSantiago | R03 - Clinica Davila,BikeSantiago | R04 - Bellavista / Loreto,BikeSantiago | R05 - Av. Peru / Maestra Lidia Torres,BikeSantiago | R06 - Metro Cementerios,BikeSantiago | R07 - Olivos,BikeSantiago | R08 - Municipalidad de Recoleta,BikeSantiago | R09 - Parque de la Infancia,BikeSantiago | R10 - Loreto / Santa Filomena,BikeSantiago | S01 - Agustinas / Manuel Rodríguez Norte,BikeSantiago | S02 - Metro República,BikeSantiago | S03 - Teatinos / General Mackenna,BikeSantiago | S04 - Av. Portugal / Porvenir,BikeSantiago | S05 - Metro Bellas Artes,BikeSantiago | S06 - Matta / San Diego,BikeSantiago | S07 - Metro Los Héroes,BikeSantiago | S08 - San Isidro / Marcoleta,BikeSantiago | S09 - Santo Domingo / Morandé,BikeSantiago | S10 - Estación Mapocho,BikeSantiago | S11 - Metro Toesca,BikeSantiago | S12 - Barrio Lastarria,BikeSantiago | S13 - Metro Universidad Católica,BikeSantiago | S14 - Santa Isabel / Carmen,BikeSantiago | S15 - Monjitas / Mac Iver,BikeSantiago | S16 - Teatro Municipal,BikeSantiago | S17 - San Isidro / Santa Isabel,BikeSantiago | S18 - Metro Santa Ana,BikeSantiago | S19 - Palacio de La Moneda,BikeSantiago | S20 - Metro Santa Lucía,BikeSantiago | S21 - Metro Quinta Normal,BikeSantiago | S22 - Metro Franklin,BikeSantiago | S23 - Portugal / Santa Victoria,BikeSantiago | S24 - Plaza Yungay,BikeSantiago | S25 - Plaza de Armas,BikeSantiago | S26 - Plaza Brasil,BikeSantiago | S27 - Teatinos / Huérfanos,BikeSantiago | S28 - Portugal / Diagonal Paraguay,BikeSantiago | S29 -San Martin / General Mackenna,BikeSantiago | S30 - San Pablo,BikeSantiago | S36 - Fantasilandia,BikeSantiago | S39 - Metro Parque Almagro,BikeSantiago | S46 - Metro ULA,BikeSantiago | S53 - Pedro Lagos / San Diego,BikeSantiago | S54 - Metro Rondizzoni,BikeSantiago | S55 - Victor Manuel / Matta,BikeSantiago | S62 - Parque O'Higgins,BikeSantiago | S63 - Santa Isabel / Lira,BikeSantiago | S64 - Plaza Bogotá,BikeSantiago | S65 - Mac Iver,BikeSantiago | SJ01 - Carlos Valdovinos / Sierra Bella,BikeSantiago | SJ02 - Metro Carlos Valdovinos,BikeSantiago | SJ03 - Municipalidad de San Joaquin,BikeSantiago | SJ04 - Metro Rodrigo de Araya,BikeSantiago | SJ05 - Carlos Valdovinos / Las Flores,BikeSantiago | SJ06 - Metro Camino Agricola,BikeSantiago | SM01 - Metro El Llano,BikeSantiago | SM02 - Metro San Miguel,BikeSantiago | SM03 - Municipalidad de San Miguel,BikeSantiago | SM04 - Llano Subercaseaux / Carlos Valdovinos,BikeSantiago | SM05 - Plaza el Llano,BikeSantiago | SM06 - San Francisco - Pedro Alarcón,BikeSantiago | V01 - Alejandro Serani,BikeSantiago | V02 - Alonso de Cordova,BikeSantiago | V03 - Alto Las Condes,BikeSantiago | V04 - Francisco de Aguirre,BikeSantiago | V05 - Americo Vespucio / Las Hualtatas,BikeSantiago | V06 - Vespucio / Vitacura,BikeSantiago | V07 - Bicentenario,BikeSantiago | V08 - Eduardo Acevedo,BikeSantiago | V09 - Carolina Rabat,BikeSantiago | V10 - Casa Costanera,BikeSantiago | V11 - Casas de lo Matta,BikeSantiago | V12 - Centro El dorado,BikeSantiago | V13 - Clinica Alemana,BikeSantiago | V14 - Club de Polo,BikeSantiago | V15 - Corte de Apelaciones,BikeSantiago | V16 - Estoril,BikeSantiago | V17 - Fernando Arguello/Brasilia,BikeSantiago | V18 - Geronimo de Alderete/ Juan de Escaray,BikeSantiago | V19 - Isabel Montt / Nueva Costanera,BikeSantiago | V20 - Juan XIII,BikeSantiago | V21 - Kennedy / Cardenal Belarmino,BikeSantiago | V22 - Kennedy / La Aurora,BikeSantiago | V23 - Las Hualtatas / San Felix,BikeSantiago | V24 - Las Hualtatas / Luis Carrera,BikeSantiago | V25 - Las Nieves,BikeSantiago | V26 - Las Tranqueras / Vitacura,BikeSantiago | V27 - Lo Curro,BikeSantiago | V28 - Los Castaños,BikeSantiago | V29 - Los Cobres,BikeSantiago | V30 - Los Laureles,BikeSantiago | V31 - Luis Carrera /Candelaria Goyonechea,BikeSantiago | V32 - Luis Pasteur / Luis Carrera,BikeSantiago | V33 - Manquehue / Luis Pasteur,BikeSantiago | V34 - Mestizo,BikeSantiago | V35 - Municipalidad de Vitacura,BikeSantiago | V36 - Museo de la moda,BikeSantiago | V37 - Naciones Unidas,BikeSantiago | V38 - Nueva Costanera,BikeSantiago | V39 - Pedro Canisio,BikeSantiago | V40 - Paul Claudel,BikeSantiago | V41 - Paque Lo Gallo,BikeSantiago | V42 - Plaza Colombia,BikeSantiago | V43 - Plaza Lo Castillo,BikeSantiago | V44 - Pio XI,BikeSantiago | V45 - Escrivá de Balaguer / La Llavería,BikeSantiago | V46 - Tabancura / Los Rododendros,BikeSantiago | V47 - Eduardo Marquina,BikeSantiago | V48 - Vitacura / La Aurora,BikeSantiago | V49 - Vitacura / Luis Carrera,BikeSantiago | V50 - Vitacura / Padre Hurtado Norte,BikeSantiago | V51 - Pamplona,BikeSantiago | V52 - San Damián,BikeSantiago | V53 - Parque Antonio Rabat,BikeSantos | Alf�ndega,BikeSantos | Aparecida,BikeSantos | Aqu�rio,BikeSantos | Bruno Barbosa,BikeSantos | Canal 02 /  Praia,BikeSantos | Canal 03 / Praia,BikeSantos | Carvalho / Canal 2,BikeSantos | Cidadania,BikeSantos | Dale Coutinho,BikeSantos | Embar�,BikeSantos | Emiss�rio,BikeSantos | Fernando Prestes,BikeSantos | Ferry Boat,BikeSantos | Fonte do Sapo,BikeSantos | Glic�rio / Canal 2,BikeSantos | Gonzaga,BikeSantos | Jos� Bonif�cio,BikeSantos | J�lio Dantas,BikeSantos | M. Nascimento / Horto,BikeSantos | Mau�,BikeSantos | Mercado Municipal,BikeSantos | Pedro Lessa,BikeSantos | Rebou�as,BikeSantos | Rodovi�ria,BikeSantos | SESC,BikeSantos | SESI,BikeSantos | Sabo�,BikeSantos | UNIMES,BikeSantos | UNIP / Santa Casa,BikeSantos | UNISANTOS / Carvalho,BikeSantos | UNISANTOS Boqueir�o,BikeSantos | UNISANTOS Vila Mathias,BikeSantos | USP / UNIMONTE,BikeSantos | Universidade Santa Cec�lia,BikeSantos | Vila Belmiro,Bike_S SRM | 26 Kwietnia - Osiedle Przyjaźń,Bike_S SRM | Al. Piastów - Sowińskiego,Bike_S SRM | Arkońska Szpital,Bike_S SRM | Batalionów Chłopskich - Gryfińska SST,Bike_S SRM | Brama Główna CC,Bike_S SRM | Brama Portowa,Bike_S SRM | CH Słoneczne,Bike_S SRM | Centrum Edukacji Ogrodniczej,Bike_S SRM | Chopina - Krasińskiego,Bike_S SRM | Chopina - Wszystkich Świętych,Bike_S SRM | Chłopska - Kolorowych Domów,Bike_S SRM | Chłopska – Nad Rudzianką,Bike_S SRM | Deptak Bogusława,Bike_S SRM | Duńska,Bike_S SRM | Dworzec Główny PKP - 3 Maja,Bike_S SRM | Dworzec Główny PKP - Kolumba,Bike_S SRM | Dąbska - Gwarna,Bike_S SRM | Filia UM Prawobrzeże,Bike_S SRM | Floating Arena,Bike_S SRM | Gierczak - Krzywoń,Bike_S SRM | Goleniowska - LO III,Bike_S SRM | Iwaszkiewicza - Andrzejewskiego,Bike_S SRM | Jagiellońska - al. Boh. Warszawy,Bike_S SRM | Jasna - Targowisko,Bike_S SRM | Jasna Osiedle,Bike_S SRM | Jasne Błonia - Piotra Skargi,Bike_S SRM | Jezioro Słoneczne,Bike_S SRM | Kolorowych Domów - Beżowa,Bike_S SRM | Krasińskiego -  Wszystkich Świętych,Bike_S SRM | Krzywoustego - CH Kupiec,Bike_S SRM | Książnica Pomorska,Bike_S SRM | Ku Słońcu - Biblioteka Główna ZUT,Bike_S SRM | Kwiatowa,Bike_S SRM | Medicus,Bike_S SRM | Mickiewicza US,Bike_S SRM | Mieszka I - Milczańska,Bike_S SRM | Muzeum Narodowe - Wały Chrobrego,Bike_S SRM | Nabrzeże Starówka,Bike_S SRM | Narutowicza - Potulicka,Bike_S SRM | Niemierzyńska - Krasińskiego,Bike_S SRM | Niemierzyńska - Technopark,Bike_S SRM | PKP Szczecin Zdroje,Bike_S SRM | Plac Dziecka - Narutowicza,Bike_S SRM | Plac Grunwaldzki,Bike_S SRM | Plac Kościuszki,Bike_S SRM | Plac Orła Białego,Bike_S SRM | Plac Rodła - PZU,Bike_S SRM | Plac Rodła - al. Wyzwolenia,Bike_S SRM | Plac Szarych Szeregów,Bike_S SRM | Plac Zgody,Bike_S SRM | Plac Żołnierza Polskiego,Bike_S SRM | Pomnik Mickiewicza - Szczerbcowa,Bike_S SRM | Pomorska - Potok,Bike_S SRM | Powstańców Wielkopolskich B. PUM,Bike_S SRM | Przyjaciół Żołnierza – CH Wilcza,Bike_S SRM | Pętla Bukowe,Bike_S SRM | Pętla SST Turkusowa Lewa,Bike_S SRM | Pętla SST Turkusowa Prawa,Bike_S SRM | Pętla Słoneczne - Łubinowa,Bike_S SRM | Rondo Giedroycia,Bike_S SRM | Rondo Siwka,Bike_S SRM | Rondo Uniwersyteckie - Kampus US,Bike_S SRM | Rondo Zdroje,Bike_S SRM | Rydla - Szkoły,Bike_S SRM | Santocka - Witkiewicza,Bike_S SRM | Sczanieckiej,Bike_S SRM | Sejmik - al. Boh. Warszawy,Bike_S SRM | Stacyjna - PKP,Bike_S SRM | Stara Cegielnia,Bike_S SRM | Staw Brodowski,Bike_S SRM | Struga - Eko Dom,Bike_S SRM | Struga - Leroy Merlin,Bike_S SRM | Szpital Zdroje,Bike_S SRM | Słowackiego - ZUT,Bike_S SRM | Trzeci US - Heliosy,Bike_S SRM | Turzyn,Bike_S SRM | Urząd Miasta Szczecin,Bike_S SRM | Wielkopolska - Monte Cassino,Bike_S SRM | Wojska Polskiego - Lodogryf,Bike_S SRM | Wrzesińska - Goleniowska,Bike_S SRM | Wyspiańskiego,Bike_S SRM | Wyszyńskiego,Bike_S SRM | Wyzwolenia,Bike_S SRM | ZUT - Pułaskiego,Bike_S SRM | Zamek Książąt Pomorskich,Bike_S SRM | Zwierzyniecka - pętla,Bike_S SRM | Łubinowa - Dąbrowskiej,BilbonBizi | 01-LEVANTE,BilbonBizi | 02-BLAS OTERO,BilbonBizi | 03-AYUNTAMIENTO,BilbonBizi | 04-ARRIAGA,BilbonBizi | 05-ASKATASUNA,BilbonBizi | 06-REKALDE,BilbonBizi | 07-AREILTZA,BilbonBizi | 08-TERMIBUS,BilbonBizi | 09-ASTILLERO,BilbonBizi | 10-EGUILLOR,BilbonBizi | 11-ANSELMO CLAVE,BilbonBizi | 12-INDAUTXU,BilbonBizi | 13-LEIZAOLA,BilbonBizi | 14-IBAIZABAL,BilbonBizi | 15-PLAZA ENCARNACIÓN,BilbonBizi | 16-SAN PEDRO,BilbonBizi | 17-KARMELO,BilbonBizi | 18-BOLUETA,BilbonBizi | 19-OTXARKOAGA,BilbonBizi | 20-OLABEAGA,BilbonBizi | 21-SARRIKO,BilbonBizi | 22-HEROS,BilbonBizi | 23-EGAÑA,BilbonBizi | 24-ETXEBARRIA,BilbonBizi | 25-GABRIEL ARESTI,BilbonBizi | 26-ABANDO,BilbonBizi | 27-ESTRADA CALEROS,BilbonBizi | 28-EPALZA,BilbonBizi | 29-AMETZOLA,BilbonBizi | 30-SABINO ARANA,BilbonBizi | 31-CORAZÓN MARIA,BilbonBizi | 32-ARANGOITI,BilbonBizi | 33-MERCADO RIBERA,BilbonBizi | 34-ESKURTZE,BilbonBizi | 35-POLIDEPORTIVO ZORROZA,BilbonBizi | 36-RAMÓN RUBIAL,BilbonBizi | 37-BASARRATE,BilbonBizi | 38-SAN NICOLAS,BilbonBizi | 39-MOYUA,BilbonBizi | 40-ZORROZAURRE,Bixi | 10e avenue / Masson,Bixi | 13e avenue / St-Zotique,Bixi | 15e avenue / Beaubien,Bixi | 15e avenue / Masson,Bixi | 16e avenue / Jean-Talon,Bixi | 18e avenue / Rosemont,Bixi | 19e avenue / St-Joseph Lachine,Bixi | 19e avenue / St-Zotique,Bixi | 1ère  avenue / St-Zotique,Bixi | 1ère avenue / Masson,Bixi | 1ère avenue / Rosemont,Bixi | 26e avenue / Beaubien,Bixi | 28e avenue / Rosemont,Bixi | 29e avenue / St-Zotique,Bixi | 2e avenue / Jean-Rivard,Bixi | 2e avenue / Wellington,Bixi | 35e avenue / Beaubien,Bixi | 41e avenue / Rosemont,Bixi | 4e avenue / Masson,Bixi | 4e avenue / de Verdun,Bixi | 5e avenue / Bannantyne,Bixi | 5e avenue / Rosemont,Bixi | 7e avenue / St-Joseph Rosemont,Bixi | 8e avenue / Beaubien,Bixi | 8e avenue / Notre-Dame Lachine,Bixi | Ahmerst / du Square Amherst,Bixi | Alexandra / Jean-Talon,Bixi | Alexandra / Waverly,Bixi | Alexandre-DeSève / Ste-Catherine,Bixi | Alexandre-DeSève / la Fontaine,Bixi | Alfred Laliberté / de Poutrincourt,Bixi | Alma / Beaubien,Bixi | Ann / Wellington,Bixi | Argyle / Bannantyne,Bixi | Argyle / Sherbrooke,Bixi | Argyle / de Verdun,Bixi | Atwater / Greene,Bixi | Atwater / Sherbrooke,Bixi | Augustin-Cantin / Shearer,Bixi | Aylmer / Prince-Arthur,Bixi | Aylwin / Ontario,Bixi | BAnQ (Berri / de Maisonneuve),Bixi | Ball / Querbes,Bixi | Basile-Routhier / Chabanel,Bixi | Basin / Richmond,Bixi | Basin / du Séminaire,Bixi | Beatty / de Verdun,Bixi | Beaucourt / de la Côte-Ste-Catherine,Bixi | Beaudry / Sherbrooke,Bixi | Bellerive / Duchesneau,Bixi | Belmont / Robert-Bourassa,Bixi | Bennett / Ste-Catherine,Bixi | Benny / Sherbrooke,Bixi | Benny / de Monkland,Bixi | Bercy / Rachel,Bixi | Berlioz / de l'Île des Soeurs,Bixi | Bernard / Jeanne-Mance,Bixi | Berri / Cherrier,Bixi | Berri / Rachel,Bixi | Berri / St-Grégoire,Bixi | Berri / St-Joseph,Bixi | Bibliothèque de Rosemont (9e avenue / Rosemont),Bixi | Bibliothèque de Verdun (Brown / Bannantyne),Bixi | Bibliothèque du Boisé (Thimens / Todd),Bixi | Bishop / Ste-Catherine,Bixi | Bloomfield / Bernard,Bixi | Bloomfield / Van Horne,Bixi | Bourbonnière / du Mont-Royal,Bixi | Bourgeoys / Favard,Bixi | Bourget / St-Jacques,Bixi | Boyer / Beaubien,Bixi | Boyer / Bélanger,Bixi | Boyer / Jean-Talon,Bixi | Boyer / Rosemont,Bixi | Boyer / St-Zotique,Bixi | Boyer / du Mont-Royal,Bixi | Bélanger / St-Denis,Bixi | Bélanger / des Galeries d'Anjou,Bixi | CHSLD St-Michel (Jarry / 8e avenue),Bixi | CIUSSS (du Trianon / Pierre-de-Coubertin),Bixi | Calixa-Lavallée / Rachel,Bixi | Calixa-Lavallée / Sherbrooke,Bixi | Canning / Notre-Dame,Bixi | Cartier / Bélanger,Bixi | Cartier / Gauthier,Bixi | Cartier / Marie-Anne,Bixi | Cartier / Masson,Bixi | Cartier / Rosemont,Bixi | Cartier / St-Joseph,Bixi | Casgrain / Laurier,Bixi | Casgrain / Maguire,Bixi | Casgrain / Mozart,Bixi | Casgrain / St-Viateur,Bixi | Casino de Montréal,Bixi | Cavendish / Poirier,Bixi | Centre ÉPIC (St-Zotique / 40e avenue),Bixi | Chabanel / de l'Esplanade,Bixi | Chabanel / du Parc,Bixi | Chabot / Beaubien,Bixi | Chabot / Everett,Bixi | Chabot / du Mont-Royal,Bixi | Chambord / Beaubien,Bixi | Chambord / Jean-Talon,Bixi | Chapleau / du Mont-Royal,Bixi | Charlevoix / Lionel-Groulx,Bixi | Chomedey / de Maisonneuve,Bixi | City Councillors / du President-Kennedy,Bixi | Cité des Arts du Cirque (Paul Boutet / des Regrattiers),Bixi | Clark / Evans,Bixi | Clark / Fleury,Bixi | Clark / Prince-Arthur,Bixi | Clark / Rachel,Bixi | Clark / de Liège,Bixi | Collège Édouard-Montpetit (de Gentilly / de Normandie),Bixi | Coloniale / du Mont-Royal,Bixi | Complexe sportif Claude-Robillard,Bixi | Coolbrook / Queen-Mary,Bixi | Crescent / Ste-Catherine,Bixi | Crescent / de Maisonneuve,Bixi | Cypress / Peel,Bixi | Cégep André-Laurendeau,Bixi | Dandurand / Papineau,Bixi | Dandurand / de Lorimier,Bixi | Dante / de Gaspé,Bixi | Darling / Sherbrooke,Bixi | Davaar / de la Côte-Ste-Catherine,Bixi | Desjardins / Ontario,Bixi | Dollard / Bernard,Bixi | Dollard / Van Horne,Bixi | Dorion / Ontario,Bixi | Drolet / Beaubien,Bixi | Drolet / Faillon,Bixi | Drolet / Gounod,Bixi | Drolet / Jarry,Bixi | Drolet / Laurier,Bixi | Drolet / St-Zotique,Bixi | Drummond / Ste-Catherine,Bixi | Drummond / de Maisonneuve,Bixi | Duke / Brennan,Bixi | Duluth / St-Denis,Bixi | Duluth / St-Laurent,Bixi | Duluth / de l'Esplanade,Bixi | Dumesnil / Bélanger,Bixi | Durocher / Bernard,Bixi | Durocher / Van Horne,Bixi | Duvernay / Charlevoix,Bixi | Dézéry / Ontario,Bixi | Eadie / Dubois,Bixi | Elgar / de l'Île-des-Sœurs,Bixi | Ellendale / de la Côte-des-Neiges,Bixi | Ernest-Gendreau / du Mont-Royal,Bixi | Fabre / St-Zotique,Bixi | Faillon / St-Hubert,Bixi | Fleury / André-Jobin,Bixi | Fleury / Lajeunesse,Bixi | Fortune / Wellington,Bixi | Francis / Fleury,Bixi | François-Boivin / Bélanger,Bixi | Fullum / Gilford,Bixi | Fullum / Sherbrooke,Bixi | Fullum / de Rouen,Bixi | Gagne / LaSalle,Bixi | Gare Bois-de-Boulogne,Bixi | Gare d'autocars de Montréal (Berri / Ontario),Bixi | Garnier / St-Joseph,Bixi | Garnier / des Carrières,Bixi | Garnier / du Mont-Royal,Bixi | Gary-Carter / St-Laurent,Bixi | Gauthier / Parthenais,Bixi | Gauthier / de Lorimier,Bixi | Georges-Baril / Fleury,Bixi | Georges-Vanier / Notre-Dame,Bixi | Gilford / de Brébeuf,Bixi | Gilford / de Lanaudière,Bixi | Gordon / Wellington,Bixi | Graham / Brookfield,Bixi | Graham / Wicksteed,Bixi | Grand Boulevard / Sherbrooke,Bixi | Grand Boulevard / de Terrebonne,Bixi | Grand Trunk / Hibernia,Bixi | Guilbault / Clark,Bixi | Guizot / St-Denis,Bixi | Guy / Notre-Dame,Bixi | Guy / St-Catherine,Bixi | Hamel / Sauvé,Bixi | Hamilton / Jolicoeur,Bixi | Henri-Julien / Laurier,Bixi | Henri-Julien / Villeray,Bixi | Henri-Julien / de Castelnau,Bixi | Henri-Julien / du Carmel,Bixi | Hickson / Wellington,Bixi | Highlands / LaSalle,Bixi | Hillside / Ste-Catherine,Bixi | Hochelaga / Chapleau,Bixi | Hogan / Ontario,Bixi | Hutchison / Beaubien,Bixi | Hutchison / Prince-Arthur,Bixi | Hutchison / Sherbrooke,Bixi | Hutchison / des Pins,Bixi | Hélène-Baillargeon / St-Denis,Bixi | Hôpital Maisonneuve-Rosemont (Rosemont / Chatelain),Bixi | Hôpital Santa Cabrini (St-Zotique / Jeanne-Jugan),Bixi | Hôpital général juif (de la Côte Ste-Catherine / Légaré),Bixi | Island / Centre,Bixi | Jacques-Casault / Christophe-Colomb,Bixi | Jacques-Le Ber / de la Pointe Nord,Bixi | Jardin Botanique (Pie-IX / Sherbrooke),Bixi | Jean Langlois / Fullum,Bixi | Jean-Brillant / McKenna,Bixi | Jeanne-Mance / Beaubien,Bixi | Jeanne-Mance / René-Lévesque,Bixi | Jeanne-Mance / St-Viateur,Bixi | Jeanne-d'Arc / Ontario,Bixi | Jogues / Allard,Bixi | Joseph-Manseau / René-Lévesque,Bixi | Kirkfield / de Chambois,Bixi | La Ronde,Bixi | LaSalle / 67e avenue,Bixi | LaSalle / 90e avenue,Bixi | LaSalle / Crawford,Bixi | LaSalle/Godin,Bixi | Labadie / du Parc,Bixi | Laforest / Dudemaine,Bixi | Lajeunesse / Villeray,Bixi | Lajeunesse / de Castelnau,Bixi | Larivière / de Lorimier,Bixi | Laurier / de Bordeaux,Bixi | Laval / Duluth,Bixi | Laval / Rachel,Bixi | Laval / du Mont-Royal,Bixi | Le Caron / Marc-Sauvalle,Bixi | Legendre / Henri-Julien,Bixi | Leman / de Chateaubriand,Bixi | Lincoln / du Fort,Bixi | Lionel-Groulx / George-Vanier,Bixi | Liébert / Hochelaga,Bixi | Logan / Fullum,Bixi | Logan / d'Iberville,Bixi | Logan / de Champlain,Bixi | Louis-Hébert / Beaubien,Bixi | Louis-Hébert / Bélanger,Bixi | Louis-Hébert / St-Zotique,Bixi | Louis-Hémon / Rosemont,Bixi | Louis-Hémon / Villeray,Bixi | Lucien L'Allier / St-Jacques,Bixi | Lusignan / St-Jacques,Bixi | Léa-Roback / Sir-Georges-Etienne-Cartier,Bixi | Mackay / Ste-Catherine,Bixi | Mackay / de Maisonneuve,Bixi | Maguire / Henri-Julien,Bixi | Maguire / St-Laurent,Bixi | Mansfield / René-Lévesque,Bixi | Mansfield / Ste-Catherine,Bixi | Marcel-Laurin / Beaudet,Bixi | Marché Atwater,Bixi | Marché Jean-Talon (Henri-Julien / Jean-Talon),Bixi | Marché Maisonneuve,Bixi | Marcil / Sherbrooke,Bixi | Marie-Anne / St-Hubert,Bixi | Marie-Anne / de la Roche,Bixi | Marmier / St-Denis,Bixi | Marquette / Fleury,Bixi | Marquette / Jean-Talon,Bixi | Marquette / Laurier,Bixi | Marquette / Rachel,Bixi | Marquette / St-Grégoire,Bixi | Marquette / Villeray,Bixi | Marquette / du Mont-Royal,Bixi | McGill / Place d'Youville,Bixi | McGill / des Récollets,Bixi | McTavish / Sherbrooke,Bixi | McTavish / des Pins,Bixi | Messier / du Mont-Royal,Bixi | Metcalfe / St-Catherine,Bixi | Metcalfe / de Maisonneuve,Bixi | Metcalfe / du Square-Dorchester,Bixi | Metro Jean-Drapeau (Chemin Macdonald),Bixi | Meunier / Fleury,Bixi | Milton / Clark,Bixi | Milton / Durocher,Bixi | Milton / University,Bixi | Milton / du Parc,Bixi | Molson / Beaubien,Bixi | Montcalm / Ontario,Bixi | Montcalm / de Maisonneuve,Bixi | Mozart / St-Laurent,Bixi | Métro Acadie (de l'Acadie / Beaumont),Bixi | Métro Angrignon (des Trinitaires / Lamont),Bixi | Métro Assomption (Chauveau / de l'Assomption),Bixi | Métro Atwater (Atwater / Ste-Catherine),Bixi | Métro Beaubien (de Chateaubriand / Beaubien),Bixi | Métro Bonaventure (de la Gauchetière / de la Cathédrale),Bixi | Métro Cadillac (de Cadillac / Sherbrooke),Bixi | Métro Champ-de-Mars (Viger / Sanguinet),Bixi | Métro Charlevoix (Centre / Charlevoix),Bixi | Métro Crémazie (Crémazie / Lajeunesse),Bixi | Métro Côte-Vertu (Gohier / Edouard-Laurin),Bixi | Métro Côte-des-Neiges (Jean-Brillant / de la Côte-des-Neiges),Bixi | Métro Frontenac (Ontario / du Havre),Bixi | Métro Georges-Vanier (St-Antoine / Canning),Bixi | Métro Henri-Bourassa (Henri-Bourassa / Millen),Bixi | Métro Honoré-Beaugrand (Sherbrooke / Honoré-Beaugrand),Bixi | Métro Jarry (Lajeunesse / Jarry),Bixi | Métro Jean-Talon (de Chateaubriand / Jean-Talon),Bixi | Métro Jolicoeur (Drake / de Sève),Bixi | Métro Joliette  (Joliette / Hochelaga),Bixi | Métro Langelier (Langelier / Sherbrooke),Bixi | Métro Lasalle (de Rushbrooke / Caisse),Bixi | Métro Laurier (Rivard / Laurier),Bixi | Métro Lionel-Groulx (Atwater / Lionel-Groulx),Bixi | Métro Longueuil - Université de Sherbrooke,Bixi | Métro Lucien-L'Allier  (Lucien l'Allier / Argyle),Bixi | Métro Monk (Allard / Beaulieu),Bixi | Métro Mont-Royal (Rivard / du Mont-Royal),Bixi | Métro Namur (des Jockeys / Décarie),Bixi | Métro Outremont (Wiseman / Van Horne),Bixi | Métro Papineau (Cartier / Ste-Catherine),Bixi | Métro Parc  (Ogilvy / Hutchison),Bixi | Métro Peel (de Maisonneuve / Stanley),Bixi | Métro Pie-IX (Pierre-de-Coubertin / Pie-IX),Bixi | Métro Place St-Henri (St-Ferdinand / St-Jacques),Bixi | Métro Place-d'Armes (Viger / St-Urbain),Bixi | Métro Préfontaine (Moreau / Hochelaga),Bixi | Métro Radisson (Sherbrooke / des Groseilliers),Bixi | Métro Rosemont (Rosemont / de St-Vallier),Bixi | Métro Sauvé (Berri / Sauvé),Bixi | Métro Sherbrooke (de Rigaud / Berri),Bixi | Métro Snowdon (de Westbury / Queen-Mary),Bixi | Métro St-Laurent (de Maisonneuve / St-Laurent),Bixi | Métro St-Michel (Shaughnessy / St-Michel),Bixi | Métro Université de Montréal (Édouard-Montpetit / Louis-Collin),Bixi | Métro Vendôme (de Marlowe / de Maisonneuve),Bixi | Métro Verdun (Willibrord / de Verdun),Bixi | Métro Viau (Pierre-de-Coubertin / Viau),Bixi | Métro Villa-Maria (Décarie / de Monkland),Bixi | Métro de Castelnau (de Castelnau / Clark),Bixi | Métro de l'Église (Ross / de l'Église),Bixi | Métro de la Savane (de Sorel / Bougainville),Bixi | Métro du Collège (Cartier / Décarie),Bixi | Métro Édouard-Montpetit (du Mont-Royal / Vincent-d'Indy),Bixi | Newman / Senkus,Bixi | Nicolet / Sherbrooke,Bixi | Notre-Dame / Gauvin,Bixi | Notre-Dame / Liébert,Bixi | Notre-Dame / Peel,Bixi | Notre-Dame / St-Gabriel,Bixi | Notre-Dame / de la Montagne,Bixi | Notre-Dame / des Ormeaux,Bixi | Notre-Dame-de-Grâce / Décarie,Bixi | Omer-Lavallée / du Midway,Bixi | Ontario / Sicard,Bixi | Ontario / Viau,Bixi | Ottawa / Peel,Bixi | Ottawa / Prince,Bixi | Ottawa / William,Bixi | Palm / St-Remi,Bixi | Panet / de Maisonneuve,Bixi | Papineau / René-Lévesque,Bixi | Papineau / Émile-Journault,Bixi | Parc François-Perreault (F-Perreault / LO David),Bixi | Parc J.-Arthur-Champagne (de Chambly / du Mont-Royal),Bixi | Parc Jeanne Mance (monument sir George-Etienne Cartier),Bixi | Parc Kent (de Kent / Hudson),Bixi | Parc Outremont (Bloomfield / Elmwood),Bixi | Parc Plage,Bixi | Parc Père-Marquette (Chambord / Rosemont),Bixi | Parc Rosemont (Dandurand / d'Iberville),Bixi | Parc St-Henri (Laporte / Guay),Bixi | Parc d'Antioche,Bixi | Parc de Bullion (de Bullion / Prince-Arthur),Bixi | Parc de l'Hôtel-de-Ville (Dubé / Laurendeau),Bixi | Parc des Rapides (LaSalle / 6e avenue),Bixi | Parc du Pélican (2e avenue / St-Joseph),Bixi | Park Row O / Sherbrooke,Bixi | Parthenais / Laurier,Bixi | Parthenais / Ste-Catherine,Bixi | Parthenais / du Mont-Royal,Bixi | Paré / Mountain Sights,Bixi | Peel / de la Gauchetiere,Bixi | Pierre-de-Coubertin / Langelier,Bixi | Place Jean-Paul Riopelle (Viger / de Bleury),Bixi | Place Longueuil,Bixi | Place du Commerce,Bixi | Place Émilie-Gamelin (St-Hubert / de Maisonneuve),Bixi | Plessis / Ontario,Bixi | Plessis / René-Lévesque,Bixi | Poirier / O'Brien,Bixi | Pontiac / Gilford,Bixi | Poupart / Ontario,Bixi | Poupart / Ste-Catherine,Bixi | Pratt / Van Horne,Bixi | Prince-Arthur / St-Urbain,Bixi | Prince-Arthur / Ste-Famille,Bixi | Prince-Arthur / du Parc,Bixi | Quai de la navette fluviale,Bixi | Queen / Wellington,Bixi | Querbes / Laurier,Bixi | Quesnel / Vinet,Bixi | Rachel / de Brébeuf,Bixi | Regina / de Verdun,Bixi | Resther / St-Joseph,Bixi | Resther / du Mont-Royal,Bixi | Richardson / de Montmorency,Bixi | Rivard / Rachel,Bixi | Rockland / Lajoie,Bixi | Ropery / Augustin-Cantin,Bixi | Rose-de-Lima / Notre-Dame,Bixi | Rosemont / Viau,Bixi | Rousselot / Jarry,Bixi | Roy / St-André,Bixi | Roy / St-Denis,Bixi | Roy / St-Laurent,Bixi | Ryde / Charlevoix,Bixi | Sanguinet / Ontario,Bixi | Sanguinet / Ste-Catherine,Bixi | Sanguinet / de Maisonneuve,Bixi | Shearer / Centre,Bixi | Sherbrooke / Frontenac,Bixi | Smith / Peel,Bixi | Square Chaboillez (St-Jacques / de la Cathédrale),Bixi | Square Phillips,Bixi | Square St-Louis (du Square St-Louis / Laval),Bixi | Square Victoria (Viger / du Square-Victoria),Bixi | St-Alexandre / Ste-Catherine,Bixi | St-André / Laurier,Bixi | St-André / Ontario,Bixi | St-André / Robin,Bixi | St-André / St-Antoine,Bixi | St-André / St-Grégoire,Bixi | St-André / Ste-Catherine,Bixi | St-Antoine / St-François-Xavier,Bixi | St-Charles / Grant,Bixi | St-Charles / Montarville,Bixi | St-Charles / St-Jean,Bixi | St-Christophe / Cherrier,Bixi | St-Denis / René-Lévesque,Bixi | St-Denis / de Maisonneuve,Bixi | St-Dominique / Bernard,Bixi | St-Dominique / Gounod,Bixi | St-Dominique / Guizot,Bixi | St-Dominique / Napoléon,Bixi | St-Dominique / Rachel,Bixi | St-Dominique / René-Lévesque,Bixi | St-Dominique / St-Viateur,Bixi | St-Dominique / St-Zotique,Bixi | St-Germain / Hochelaga,Bixi | St-Hubert / Duluth,Bixi | St-Hubert / René-Lévesque,Bixi | St-Jacques / McGill,Bixi | St-Jacques / St-Laurent,Bixi | St-Jacques / St-Pierre,Bixi | St-Jacques / des Seigneurs,Bixi | St-Jean-Baptiste / Notre-Dame,Bixi | St-Jean-Baptiste / René-Lévesque,Bixi | St-Joseph / 34e avenue Lachine,Bixi | St-Joseph / 8e avenue Lachine,Bixi | St-Marc / Sherbrooke,Bixi | St-Mathieu / Sherbrooke,Bixi | St-Mathieu / Ste-Catherine,Bixi | St-Maurice / Robert-Bourassa,Bixi | St-Nicolas / Place d'Youville,Bixi | St-Patrick / Briand,Bixi | St-Urbain / Beaubien,Bixi | St-Urbain / de la Gauchetière,Bixi | St-Viateur / St-Laurent,Bixi | St-Zotique / Clark,Bixi | Stanley / Sherbrooke,Bixi | Stanley / Ste-Catherine,Bixi | Ste-Catherine / Dezery,Bixi | Ste-Catherine / Labelle,Bixi | Ste-Catherine / St-Laurent,Bixi | Ste-Catherine / St-Marc,Bixi | Ste-Croix / Tassé,Bixi | Ste-Famille / Sherbrooke,Bixi | Ste-Famille / des Pins,Bixi | Ste-Émilie / Sir-Georges-Etienne-Cartier,Bixi | Stuart / de la Côte-Ste-Catherine,Bixi | Swail / Decelles,Bixi | Tellier / des Futailles,Bixi | Terrasse Guindon / Fullum,Bixi | Terrasse Mercure / Fullum,Bixi | Thimens / Alexis-Nihon,Bixi | Tupper / du Fort,Bixi | Turgeon / Notre-Dame,Bixi | U. Concordia - Campus Loyola (Sherbrooke / West Broadway),Bixi | Union / Cathcart,Bixi | Union / René-Lévesque,Bixi | Union / de Maisonneuve,Bixi | University / Prince-Arthur,Bixi | University / des Pins,Bixi | Vallières / St-Laurent,Bixi | Valois / Ontario,Bixi | Valois / Ste-Catherine,Bixi | Vezina / Victoria,Bixi | Victoria / 18e avenue Lachine,Bixi | Victoria / de Maisonneuve,Bixi | Victoria Hall,Bixi | Viger / Chenneville,Bixi | Villeneuve / St-Laurent,Bixi | Villeneuve / St-Urbain,Bixi | Villeneuve / de l'Hôtel-de-Ville,Bixi | Villeneuve / du Parc,Bixi | Villeray / de Normanville,Bixi | Waverly / St-Viateur,Bixi | Waverly / St-Zotique,Bixi | Waverly / Van Horne,Bixi | Wilderton  / Van Horne,Bixi | William / Guy,Bixi | William / Robert-Bourassa,Bixi | William-Tremblay / Molson,Bixi | Wolfe / René-Lévesque,Bixi | Wolfe / Robin,Bixi | Wurtele / de Rouen,Bixi | Young / Wellington,Bixi | d'Orléans / Hochelaga,Bixi | d'Orléans / Masson,Bixi | d'Outremont / Ogilvy,Bixi | d'Oxford / de Monkland,Bixi | de Bellechasse / de St-Vallier,Bixi | de Belleville / Fleury,Bixi | de Bordeaux / Gilford,Bixi | de Bordeaux / Jean-Talon,Bixi | de Bordeaux / Marie-Anne,Bixi | de Bordeaux / Masson,Bixi | de Bordeaux / Sherbrooke,Bixi | de Bordeaux / St-Zotique,Bixi | de Brébeuf / Laurier,Bixi | de Brébeuf / St-Grégoire,Bixi | de Brébeuf / du Mont-Royal,Bixi | de Bullion / St-Joseph,Bixi | de Bullion / du Mont-Royal,Bixi | de Chambly / Rachel,Bixi | de Chambly / St-Joseph,Bixi | de Champlain / Ontario,Bixi | de Chateaubriand / Jarry,Bixi | de Darlington / de la Côte-Ste-Catherine,Bixi | de Drucourt / Garnier,Bixi | de Gaspé / Jarry,Bixi | de Gaspé / Marmier,Bixi | de Gaspé / St-Viateur,Bixi | de Gaspé / de Liège,Bixi | de Hampton / de Monkland,Bixi | de Kent / Victoria,Bixi | de Kent / de la Côte-des-Neiges,Bixi | de Lanaudière / Bélanger,Bixi | de Lanaudière / Laurier,Bixi | de Lanaudière / Marie-Anne,Bixi | de Lisieux / Jean-Talon,Bixi | de Liège / Lajeunesse,Bixi | de Maisonneuve / Aylmer (est),Bixi | de Maisonneuve / Aylmer (ouest),Bixi | de Maisonneuve / Greene,Bixi | de Maisonneuve / Mansfield (est),Bixi | de Maisonneuve / Mansfield (ouest),Bixi | de Maisonneuve / Peel,Bixi | de Maisonneuve / St-Denis,Bixi | de Melrose / Sherbrooke,Bixi | de Mentana / Gilford,Bixi | de Mentana / Laurier,Bixi | de Mentana / Marie-Anne,Bixi | de Mentana / Rachel,Bixi | de Monkland / Girouard,Bixi | de Normanville / Bélanger,Bixi | de St-Firmin / Fleury,Bixi | de St-Vallier / St-Zotique,Bixi | de Ville-Marie / Ste-Catherine,Bixi | de l'Arcade / Clark,Bixi | de l'Eglise / St-Germain,Bixi | de l'Esplanade / Fairmount,Bixi | de l'Esplanade / Laurier,Bixi | de l'Esplanade / du Mont-Royal,Bixi | de l'Hôtel-de-Ville / Roy,Bixi | de l'Hôtel-de-Ville / Sherbrooke,Bixi | de l'Hôtel-de-Ville / Ste-Catherine,Bixi | de l'Église / Bannantyne,Bixi | de l'Église / de Verdun,Bixi | de l'Épée / Jean-Talon,Bixi | de la Cathédrale / René-Lévesque,Bixi | de la Commune / Berri,Bixi | de la Commune / King,Bixi | de la Commune / Place Jacques-Cartier,Bixi | de la Commune / St-Sulpice,Bixi | de la Côte St-Antoine / Royal,Bixi | de la Côte St-Paul / St-Ambroise,Bixi | de la Gauchetière / Robert-Bourassa,Bixi | de la Grande-Allée / Ste-Catherine,Bixi | de la Montagne / Sherbrooke,Bixi | de la Roche /  de Bellechasse,Bixi | de la Roche / Everett,Bixi | de la Roche / St-Joseph,Bixi | de la Salle / Hochelaga,Bixi | de la Salle / Ste-Catherine,Bixi | des Récollets / Martial,Bixi | des Seigneurs / Notre-Dame,Bixi | des Écores / Jean-Talon,Bixi | des Érables / Bélanger,Bixi | des Érables / Rachel,Bixi | du Champ-de-Mars / Gosford,Bixi | du Havre / Hochelaga,Bixi | du Havre / de Rouen,Bixi | du Mont-Royal / Augustin-Frigon,Bixi | du Mont-Royal / Clark,Bixi | du Mont-Royal / du Parc,Bixi | du Parc-La Fontaine / Duluth,Bixi | du Parc-La Fontaine / Roy,Bixi | du President-Kennedy / Union,Bixi | du Président-Kennedy / Jeanne-Mance,Bixi | du Quesne / Pierre-de-Coubertin,Bixi | du Rosaire / St-Hubert,Bixi | du Tricentenaire / Prince-Albert,Bixi | du Tricentenaire / de Montigny,Bixi | Édouard-Montpetit / de Stirling,Bixi | Émile-Duployé / Sherbrooke,Bixi | Émile-Journault / de Chateaubriand,Bizi | Avda. Academia Gral. Militar - Avda. Salvador Alle,Bizi | Avda. Almozara - CDM Almozara,Bizi | Avda. Cesáreo Alierta - C/ Félix Burriel,Bizi | Avda. César Augusto - Avda. Conde Aranda,Bizi | Avda. Duquesa Villahermosa - Avda. Juan Carlos I,Bizi | Avda. Duquesa Villahermosa - C/ Franco y López,Bizi | Avda. G. Gómez de Avellaneda - C/ Clara Campoamor,Bizi | Avda. G. Gómez de Avellaneda - Intercambiador,Bizi | Avda. Goya - Avda. Anselmo Clavé,Bizi | Avda. Goya - C/ Arzobispo Domenech,Bizi | Avda. Goya - C/ Baltasar Gracián,Bizi | Avda. Gómez Laguna nº 6,Bizi | Avda. Juan Carlos I - C/ Ramón Sainz de Varanda,Bizi | Avda. Juan Pablo II - Avda. Gómez Laguna,Bizi | Avda. Madrid - Aljafería,Bizi | Avda. Madrid - Avda. Navarra,Bizi | Avda. Madrid - Pº Calanda,Bizi | Avda. Majas de Goya - C/ La Fragua,Bizi | Avda. Majas de Goya - Eroski,Bizi | Avda. Marqués de la Cadena - Avda. San Juan de la,Bizi | Avda. Marqués de la Cadena - C/ Miguel Asso,Bizi | Avda. Mª Zambrano - C/ Ildefonso Manuel Gil,Bizi | Avda. Mª Zambrano - C/ Julio García Condoy,Bizi | Avda. Mª Zambrano - C/ Pablo Iglesias,Bizi | Avda. Mª Zambrano - C/ Padre Marcellán Mayayo,Bizi | Avda. Navarra - C/ Alagón,Bizi | Avda. Navarra - C/ Rioja,Bizi | Avda. Pablo Gargallo - Avda. Puerta Sancho,Bizi | Avda. Pablo Gargallo - C/ Ignacio Menaya,Bizi | Avda. Pablo Ruiz Picasso - C/ Mújica Lainez,Bizi | Avda. Pablo Ruiz Picasso - C/ Pintor Luis Cernuda,Bizi | Avda. Pablo Ruiz Picasso - Torre del Agua,Bizi | Avda. Ranillas - Avda. Pablo Ruiz Picasso,Bizi | Avda. Ranillas - Puente de La Almozara,Bizi | Avda. Salvador Allende - Avda. Pablo Ruiz Picasso,Bizi | Avda. Salvador Allende - C/ Matías Pastor Sancho,Bizi | Avda. Salvador Allende - C/ Rubio de Francia,Bizi | Avda. San Juan Bosco - C/ La Milagrosa,Bizi | Avda. San Juan Bosco - C/ Menéndez Pelayo,Bizi | Avda. San Juan de la Peña - C/ Juslibol,Bizi | Avda. San Juan de la Peña - C/ Somport,Bizi | Avda. Tenor Fleta - C/ Uncastillo,Bizi | Avda. Valle de Broto - Avda. Pirineos,Bizi | Avda. Valle de Broto - Parque Tío Jorge,Bizi | Avda. Valle de Zuriza - Avda. Cataluña,Bizi | C/ Arzobispo Morcillo - C/ Fernando de Antequera,Bizi | C/ Asalto - C/ Miguel Servet,Bizi | C/ Asalto - Edificio Trovador,Bizi | C/ Asín y Palacios - C/ Pedro IV El Ceremonioso,Bizi | C/ Balbino Orensanz - C/ Carmelo Betoré Bergua,Bizi | C/ Bolivia - Pº Calanda,Bizi | C/ Bretón - C/ San Antonio Mª Claret,Bizi | C/ Ciudadela - C/ Andrés Vicente,Bizi | C/ Condes de Aragón - Vía Hispanidad,Bizi | C/ Corona de Aragón - C/ Lorente,Bizi | C/ Doctor Horno - C/ Madre Sacramento,Bizi | C/ Doctor Iranzo -  C/ Escultor Benlliure,Bizi | C/ Eduardo Ibarra - C/ Violante de Hungría,Bizi | C/ Florentino Ballesteros - C/ Matadero,Bizi | C/ Francia - Pabellón Puente,Bizi | C/ Gran Vía - Facultad Económicas,Bizi | C/ Graus - C/ Unceta,Bizi | C/ Julián Sánz Ibáñez - C/ Rioja,Bizi | C/ Lacarra de Miguel - C/ San Vicente Martir,Bizi | C/ Los Leñadores - Avda. Academia Gral. Militar,Bizi | C/ Luis Legaz Lacambra - C/ Octavio Paz,Bizi | C/ Luis Vives - C/ Manuel Lasala,Bizi | C/ Madre Rafols - Esquina D.G.A.,Bizi | C/ Margarita Xirgu - Avda. G. Gómez de Avellaneda,Bizi | C/ Monasterio de Samos - C/ Monasterio de Poblet,Bizi | C/ Pablo Gargallo - C/ Jardines de Atenas,Bizi | C/ Pablo Neruda - C/ Averroes,Bizi | C/ Pedro Joaquín Soler - Coso,Bizi | C/ Ramón y Cajal - C/ Madre Rafols,Bizi | C/ San Juan de la Cruz - C/ Manuel Lasala,Bizi | C/ Sangüesa Castañosa - C/ F. Oliván Bayle,Bizi | C/ Sixto Celorrio - C/ Peña Oroel,Bizi | Cno. de las Torres - Avda. Cesáreo Alierta,Bizi | Cno. de las Torres - C/ Roger de Tur,Bizi | Cno. de las Torres - C/ Silvestre Pérez,Bizi | Estación Intermodal Delicias (Llegadas),Bizi | Estación Intermodal Delicias (Salidas),Bizi | Estación de Cercanías El Portillo,Bizi | Glorieta Sasera - Pº Damas,Bizi | PLAZA DEL CARMEN,Bizi | Pasarela del Voluntariado - Avda. Almozara,Bizi | Pasarela del Voluntariado - Avda. Ranillas,Bizi | Plaza Emperador Carlos V,Bizi | Plaza España,Bizi | Plaza Magdalena,Bizi | Plaza Mariano Arregui,Bizi | Plaza Mozart,Bizi | Plaza Roma,"Bizi | Plaza Salamero, 14",Bizi | Plaza San Francisco - La Salle,Bizi | Plaza San Francisco - Universidad,Bizi | Plaza San Pedro Nolasco,Bizi | Plaza Schweitzer,Bizi | Plaza Tauromaquia - Avda. Academia Gral. Militar,Bizi | Plaza de Santa Engracia,Bizi | Plaza de los Sitios,Bizi | Plaza del Pilar - Edificio Turismo,Bizi | Plaza del Portillo - Plaza de Toros,Bizi | Pº Constitución - C/ Mefisto,Bizi | Pº Constitución - Plaza Aragón,Bizi | Pº Echegaray y Caballero - C/ Postigo del Ebro,Bizi | Pº Echegaray y Caballero - C/ Salvador Minguijón,Bizi | Pº Echegaray y Caballero - Pasarela del Huerva,Bizi | Pº Echegaray y Caballero - Puente de La Almozara,Bizi | Pº Echegaray y Caballero - Puente de Piedra,Bizi | Pº Echegaray y Caballero - Puente de Santiago,Bizi | Pº Echegaray y Caballero - Puente del Pilar,Bizi | Pº Isabel la Católica - C/ Gonzalo Calamita,Bizi | Pº Isabel la Católica - Vía Hispanidad,Bizi | Pº Longares - C/ Fuendejalón,Bizi | Pº Mª Agustín - C/ de la Aljafería,Bizi | Pº Mª Agustín - Colegio Joaquín Costa,Bizi | Pº Pamplona - Puerta del Carmen,Bizi | Pº Sagasta - Cno. de las Torres,Bizi | Pº de La Ribera - Pasarela Azud,Bizi | Pº de la Mina - C/ Pomarón,Bizi | Pº de la Ribera - C/ Sobrarbe,Bizi | Pº de la Ribera - Puente de Santiago,Bizi | Pº de la Ribera - Puente del Pilar,Bizi | Via Univérsitas - Avda. Duquesa Villahermosa,Bizi | Via Univérsitas - C/ Hermanos Gambra,Bizi | Vía Hispanidad - Avda. Duquesa Villahermosa,Bizi | Vía Hispanidad - Avda. Gómez Laguna,Bizi | Vía Hispanidad - Avda. Sainz de Varanda,Bizi | Vía Hispanidad - C/ Océano Atlántico,Blue Bikes | 175 N Harvard St,Blue Bikes | 191 Beacon St,Blue Bikes | 30 Dane St,Blue Bikes | 359 Broadway - Broadway at Fayette Street,Blue Bikes | 699 Mt Auburn St,Blue Bikes | 700 Huron Ave,Blue Bikes | 75 Binney St,Blue Bikes | 84 Cambridgepark Dr,Blue Bikes | Adams St at Lonsdale St,Blue Bikes | Airport T Stop - Bremen St at Brooks St,Blue Bikes | Albany St at E. Brookline St,Blue Bikes | Alewife MBTA at Steel Place,Blue Bikes | Alewife Station at Russell Field,Blue Bikes | Allston Green District - Griggs St at Commonwealth Ave,Blue Bikes | Ames St at Broadway,Blue Bikes | Ames St at Main St,Blue Bikes | Andrew T Stop - Dorchester Ave at Dexter St,Blue Bikes | Aquarium T Stop - 200 Atlantic Ave,Blue Bikes | Arch St at Franklin St,Blue Bikes | Archdale Rd at Washington St,Blue Bikes | Ashmont T Stop,Blue Bikes | Assembly Square T,Blue Bikes | B.U. Central - 725 Comm. Ave.,Blue Bikes | Back Bay T Stop - Dartmouth St at Stuart St,Blue Bikes | Ball Sq,Blue Bikes | Bartlett St at John Elliot Sq,Blue Bikes | Beacon St at Charles St,Blue Bikes | Beacon St at Massachusetts Ave,Blue Bikes | Beacon St at Tappan St,Blue Bikes | Beacon St at Washington / Kirkland,Blue Bikes | Belgrade Ave at Walworth St,Blue Bikes | Bennington St at Byron St,Blue Bikes | Bennington St at Constitution Beach,Blue Bikes | Big Papi Station,Blue Bikes | Binney St / Sixth St,Blue Bikes | Blue Hill Ave at Almont St,Blue Bikes | Blue Hill Ave at Southwood St,Blue Bikes | Boston City Hall - 28 State St,Blue Bikes | Boston Convention and Exhibition Center - Summer St at West Side Dr,Blue Bikes | Boston East - 126 Border St,Blue Bikes | Boston Medical Center - E Concord St at Harrison Ave,Blue Bikes | Boston Public Market,Blue Bikes | Bowdoin St at Quincy St,Blue Bikes | Boylston St at Arlington St,Blue Bikes | Boylston St at Berkeley St,Blue Bikes | Boylston St at Dartmouth St,Blue Bikes | Boylston St at Exeter St,Blue Bikes | Boylston St at Fairfield St,Blue Bikes | Boylston St at Jersey St,Blue Bikes | Boylston St at Massachusetts Ave,Blue Bikes | Brigham Circle - Francis St at Huntington Ave,Blue Bikes | Brighton Center - Washington St at Cambridge St,Blue Bikes | Brighton Mills - 370 Western Ave,Blue Bikes | Broadway St at Mt Pleasant St,Blue Bikes | Broadway T Stop,Blue Bikes | Broadway at Beacham St,Blue Bikes | Broadway at Central St,Blue Bikes | Broadway at Lynde St,Blue Bikes | Broadway at Maple St,Blue Bikes | Brookline Town Hall,Blue Bikes | Brookline Village - Station Street at MBTA,Blue Bikes | Bunker Hill Community College,Blue Bikes | Burlington Ave at Brookline Ave,Blue Bikes | Cambridge Dept. of Public Works -147 Hampshire St.,Blue Bikes | Cambridge Main Library at Broadway / Trowbridge St,Blue Bikes | Cambridge St - at Columbia St / Webster Ave,Blue Bikes | Cambridge St at Joy St,Blue Bikes | CambridgeSide Galleria - CambridgeSide PL at Land Blvd,Blue Bikes | Central Sq Post Office / Cambridge City Hall at Mass Ave / Pleasant St,Blue Bikes | Central Square at Mass Ave / Essex St,Blue Bikes | Centre St at Seaverns Ave,Blue Bikes | Charles Circle - Charles St at Cambridge St,Blue Bikes | Charlestown Navy Yard,Blue Bikes | Chelsea St at Saratoga St,Blue Bikes | Chelsea St at Vine St,Blue Bikes | Child St at North St,Blue Bikes | Chinatown Gate Plaza,Blue Bikes | Chinatown T Stop,Blue Bikes | Christian Science Plaza - Massachusetts Ave at Westland Ave,Blue Bikes | Clarendon Hill at Broadway,Blue Bikes | Clarendon St at Newbury St,Blue Bikes | Cleveland Circle,Blue Bikes | Codman Square Library,Blue Bikes | Colleges of the Fenway - Fenway at Avenue Louis Pasteur,Blue Bikes | Columbia Rd at Ceylon St,Blue Bikes | Columbia Rd at Tierney Community Center,Blue Bikes | Columbus Ave at Massachusetts Ave,Blue Bikes | Commonwealth Ave At Babcock St,Blue Bikes | Commonwealth Ave at Agganis Way,Blue Bikes | Commonwealth Ave at Chiswick Rd,Blue Bikes | Commonwealth Ave at Kelton St,Blue Bikes | Community Path at Cedar Street,Blue Bikes | Congress St at Northern Ave,Blue Bikes | Congress St at Sleeper St,Blue Bikes | Conway Park - Somerville Avenue,Blue Bikes | Coolidge Corner - Beacon St at Centre St,Blue Bikes | Copley Square - Dartmouth St at Boylston St,Blue Bikes | Craigie at Summer St,Blue Bikes | Curtis Hall - South St at Centre St,Blue Bikes | Cypress St at Clark Playground,Blue Bikes | Dana Park,Blue Bikes | Danehy Park,Blue Bikes | Dartmouth St at Newbury St,Blue Bikes | Davis Square,Blue Bikes | Deerfield St at Commonwealth Ave,Blue Bikes | Dorchester Ave at Gillette Park,Blue Bikes | Dorchester Ave at King St,Blue Bikes | Dudley Square - Dudley St at Warren St,Blue Bikes | Dudley Town Common - Mt Pleasant Ave at Blue Hill Ave,Blue Bikes | E Cottage St at Columbia Rd,Blue Bikes | EF - North Point Park,Blue Bikes | East Boston Neighborhood Health Center - 20 Maverick Square,Blue Bikes | East Somerville Library (Broadway and Illinois),Blue Bikes | Edgerly Education Center,Blue Bikes | Edwards Playground - Main St at Eden St,Blue Bikes | Egleston Square - Atherton St at Washington St,Blue Bikes | Elm St at White St,Blue Bikes | Encore,Blue Bikes | Everett Square (Broadway at Chelsea St),Blue Bikes | Fan Pier,Blue Bikes | Faneuil St at Arlington St,Blue Bikes | Farragut Rd at E. 6th St,Blue Bikes | Ferry St at Pleasantview Ave,Blue Bikes | Fields Corner T Stop,Blue Bikes | Forest Hills,Blue Bikes | Foss Park,Blue Bikes | Four Corners - 157 Washington St,Blue Bikes | Franklin Park - Seaver St at Humbolt Ave,Blue Bikes | Franklin Park Zoo - Franklin Park Rd at Blue Hill Ave,Blue Bikes | Fresh Pond Reservation,Blue Bikes | Gallivan Blvd at Adams St,Blue Bikes | Glendale Square (Ferry St at Broadway),Blue Bikes | Glendon St at Condor St,Blue Bikes | Government Center - Cambridge St at Court St,Blue Bikes | Green Street T Stop - Green St at Amory St,Blue Bikes | Grove Hall Library - 41 Geneva Ave,Blue Bikes | Grove St at Community Path,Blue Bikes | HMS/HSPH - Avenue Louis Pasteur at Longwood Ave,Blue Bikes | Harrison Ave at Bennet St,Blue Bikes | Harrison Ave at Mullins Way,Blue Bikes | Harvard Ave at Brainerd Rd,Blue Bikes | Harvard Kennedy School at Bennett St / Eliot St,Blue Bikes | Harvard Law School at Mass Ave / Jarvis St,Blue Bikes | Harvard Square at Brattle St / Eliot St,Blue Bikes | Harvard Square at Mass Ave/ Dunster,Blue Bikes | Harvard St at Greene-Rose Heritage Park,Blue Bikes | Harvard University / SEAS Cruft-Pierce Halls at 29 Oxford St,Blue Bikes | Harvard University Gund Hall at Quincy St / Kirkland S,Blue Bikes | Harvard University Housing - 115 Putnam Ave at Peabody Terrace,Blue Bikes | Harvard University Radcliffe Quadrangle at Shepard St / Garden St,Blue Bikes | Harvard University River Houses at DeWolfe St / Cowperthwaite St,Blue Bikes | Hayes Square - Vine St at Moulton St,Blue Bikes | High St at Cypress St,Blue Bikes | Honan Library,Blue Bikes | Huntington Ave at Mass Art,Blue Bikes | Huron Ave At Vassal Lane,Blue Bikes | Hyde Square - Barbara St at Centre St,Blue Bikes | ID Building East,Blue Bikes | ID Building West,Blue Bikes | Ink Block - Harrison Ave at Herald St,Blue Bikes | Inman Square at Springfield St.,Blue Bikes | Innovation Lab - 125 Western Ave at Batten Way,Blue Bikes | JFK Crossing at Harvard St. / Thorndike St.,Blue Bikes | JFK/UMass T Stop,Blue Bikes | Jackson Square T Stop,Blue Bikes | Kendall Street,Blue Bikes | Kendall T,Blue Bikes | Kenmore Square,Blue Bikes | Lafayette Square at Mass Ave / Main St / Columbia St,Blue Bikes | Lechmere Station at Cambridge St / First St,Blue Bikes | Lesley University,Blue Bikes | Lewis Wharf at Atlantic Ave,Blue Bikes | Linear Park - Mass. Ave. at Cameron Ave.,Blue Bikes | Longwood Ave at Binney St,Blue Bikes | Lower Cambridgeport at Magazine St / Riverside Rd,Blue Bikes | MIT Pacific St at Purrington St,Blue Bikes | MIT Stata Center at Vassar St / Main St,Blue Bikes | MIT Vassar St,Blue Bikes | MIT at Mass Ave / Amherst St,Blue Bikes | MLK Blvd at Washington St,Blue Bikes | Magoun Square at Trum Field,Blue Bikes | Main St at Austin St,Blue Bikes | Main St at Baldwin St,Blue Bikes | Main St at Beacon St,Blue Bikes | Main St at Thompson Sq,Blue Bikes | Main Street at Carter Street,Blue Bikes | Marion St at Harvard St,Blue Bikes | Mass Ave T Station,Blue Bikes | Mass Ave at Albany St,Blue Bikes | Mass Ave at Hadley/Walden,Blue Bikes | Mattapan Library,Blue Bikes | Mattapan T Stop,Blue Bikes | Maverick Square - Lewis Mall,Blue Bikes | Medford St at Charlestown BCYF,Blue Bikes | Morton St T,Blue Bikes | Mt Auburn,Blue Bikes | Mugar Way at Beacon St,Blue Bikes | Murphy Skating Rink - 1880 Day Blvd,Blue Bikes | Museum of Science,Blue Bikes | NCAAA - Walnut Ave at Crawford St,Blue Bikes | Nashua Street at Red Auerbach Way,Blue Bikes | New Balance - 20 Guest St,Blue Bikes | Newbury St at Hereford St,Blue Bikes | Newmarket Square T Stop - Massachusetts Ave at Newmarket Square,Blue Bikes | Norman St at Kelvin St,Blue Bikes | Northeastern University - North Parking Lot,Blue Bikes | Oak Square - 615 Washington St,Blue Bikes | One Brigham Circle,Blue Bikes | One Broadway / Kendall Sq at Main St / 3rd St,Blue Bikes | One Kendall Square at Hampshire St / Portland St,Blue Bikes | One Memorial Drive,Blue Bikes | Orient Heights T Stop - Bennington St at Saratoga St,Blue Bikes | Packard Ave at Powderhouse Blvd,Blue Bikes | Packard's Corner - Commonwealth Ave at Brighton Ave,Blue Bikes | Park Dr at Buswell St,Blue Bikes | Park Plaza at Charles St S.,Blue Bikes | Park St at Norwell St,Blue Bikes | Perry Park,Blue Bikes | Piers Park,Blue Bikes | Porter Square Station,Blue Bikes | Post Office Square,Blue Bikes | Powder House Circle - Nathan Tufts Park,Blue Bikes | Prudential Center - Belvedere St,Blue Bikes | Purchase St at Pearl St,Blue Bikes | Rindge Avenue - O'Neill Library,Blue Bikes | Ring Rd,Blue Bikes | Rogers St & Land Blvd,Blue Bikes | Roslindale Village - South St,Blue Bikes | Roslindale Village - Washington St,Blue Bikes | Rowes Wharf at Atlantic Ave,Blue Bikes | Roxbury Crossing T Stop - Columbus Ave at Tremont St,Blue Bikes | Roxbury YMCA - Warren St at MLK Blvd,Blue Bikes | Ruggles T Stop - Columbus Ave at Melnea Cass Blvd,Blue Bikes | Ryan Playground - Dorchester Ave at Harbor View St,Blue Bikes | S Huntington Ave at Heath St,Blue Bikes | Savin Hill T Stop - S Sydney St at Bay St,Blue Bikes | Seaport Blvd at Sleeper St,Blue Bikes | Seaport Hotel - Congress St at Seaport Ln,Blue Bikes | Seaport Square - Seaport Blvd at Northern Ave,Blue Bikes | Sennott Park  Broadway at Norfolk Street,Blue Bikes | Shawmut T Stop,Blue Bikes | Shawmut at Tremont St,Blue Bikes | Sidney Research Campus/ Erie Street at Waverly,Blue Bikes | Silber Way,Blue Bikes | Soldiers Field Park - 111 Western Ave,Blue Bikes | Somerville City Hall,Blue Bikes | Somerville City Hall Annex,Blue Bikes | Somerville Hospital,Blue Bikes | South Boston Library - 646 E Broadway,Blue Bikes | South End Library - Tremont St at W Newton St,Blue Bikes | South Station - 700 Atlantic Ave,Blue Bikes | Spaulding Rehabilitation Hospital - Charlestown Navy Yard,Blue Bikes | St Mary's,Blue Bikes | State Street at Channel Center,Blue Bikes | Stony Brook T Stop,Blue Bikes | Stuart St at Charles St,Blue Bikes | Surface Rd at India St,Blue Bikes | Sydney St at Carson St,Blue Bikes | Talbot Ave At Blue Hill Ave,Blue Bikes | Tappan St at Brookline Hills MBTA,Blue Bikes | Teele Square,Blue Bikes | The Eddy - New St at Sumner St,Blue Bikes | The Lawn on D,Blue Bikes | Thetford Ave at Norfolk St,Blue Bikes | Third at Binney,Blue Bikes | Tremont St at E Berkeley St,Blue Bikes | Tremont St at Hamilton Pl,Blue Bikes | Tremont St at Northampton St,Blue Bikes | Tremont St at W. Dedham St,Blue Bikes | Tremont St at West St,Blue Bikes | Troy Boston,Blue Bikes | Union Square - Brighton Ave at Cambridge St,Blue Bikes | Union Square - Somerville,Blue Bikes | University Park,Blue Bikes | University of Massachusetts Boston - Integrated Sciences Complex,Blue Bikes | Upham's Corner,Blue Bikes | Upham's Corner T Stop - Magnolia St at Dudley St,Blue Bikes | Vassal Lane at Tobin/VLUS,Blue Bikes | Verizon Innovation Hub 10 Ware Street,Blue Bikes | W Broadway at D St,Blue Bikes | W Broadway at Dorchester St,Blue Bikes | Walnut Ave at Warren St,Blue Bikes | Warren St at Chelsea St,Blue Bikes | Washington St at Bradlee St,Blue Bikes | Washington St at Brock St,Blue Bikes | Washington St at Egremont Rd,Blue Bikes | Washington St at Griggs Rd,Blue Bikes | Washington St at Lenox St,Blue Bikes | Washington St at Melnea Cass Blvd,Blue Bikes | Washington St at Myrtle St,Blue Bikes | Washington St at Peters Park,Blue Bikes | Washington St at Rutland St,Blue Bikes | Washington St at Talbot Ave,Blue Bikes | Washington St at Waltham St,Blue Bikes | Watermark Seaport - Boston Wharf Rd at Seaport Blvd,Blue Bikes | Wentworth Institute of Technology - Huntington Ave at Vancouver St,Blue Bikes | West End Park,Blue Bikes | Williams St at Washington St,Blue Bikes | Wilson Square,Boise GreenBike | 10 Barrel,Boise GreenBike | 10th & Bannock - Flex Hub,Boise GreenBike | 11th & Bannock - Flex Hub,Boise GreenBike | 15th & State,Boise GreenBike | 34th Street Market,Boise GreenBike | 5th & Jefferson - Flex Hub,Boise GreenBike | 5th & State,Boise GreenBike | 6th & Broad Streets,Boise GreenBike | ACHD Station Hub,Boise GreenBike | Ada County Courthouse,Boise GreenBike | Albertsons Library,Boise GreenBike | Ann Morrison Park - Gym,Boise GreenBike | Ann Morrison Park - Playground,Boise GreenBike | Ann Morrison Park - SE,Boise GreenBike | Athlos Academies - Flex Hub,Boise GreenBike | BSU Downtown,Boise GreenBike | Banner Bank - City Hall,Boise GreenBike | Barnes Towers,Boise GreenBike | Basque Block Bike Corral,Boise GreenBike | Bikes and Beans Flex Hub,Boise GreenBike | Bleymaier Football Center,Boise GreenBike | BoDo Hub,Boise GreenBike | Boise Bicycle Project,Boise GreenBike | Boise Co-op,Boise GreenBike | Boise Parks & Recreation HQ Flex Hub,Boise GreenBike | Boise Public Library - Flex Hub,Boise GreenBike | Brady Street,Boise GreenBike | Bronco Lane,Boise GreenBike | Business & Economics Bldg,Boise GreenBike | Business and Economics Building Northwest,Boise GreenBike | CCDC - Grove Plaza,Boise GreenBike | CCDC - Red Lion Downtowner,Boise GreenBike | Clairvoyant Brewing Flex Hub,Boise GreenBike | Cloud 9 Brewing,Boise GreenBike | Concordia Law School - Flex Hub,Boise GreenBike | Courtney's Corner,Boise GreenBike | Education Building,Boise GreenBike | Environmental Research,Boise GreenBike | Esther Simplot - Play Wave,Boise GreenBike | Esther Simplot Pathway,Boise GreenBike | Falcon Building,Boise GreenBike | Flying M Coffee House,Boise GreenBike | Fort Boise Community Center,Boise GreenBike | Fulton Street,Boise GreenBike | Georges - Flex Hub,Boise GreenBike | Harris Ranch,Boise GreenBike | Highlands Hollow,Boise GreenBike | Honors College,Boise GreenBike | Hyde Park,Boise GreenBike | ICCU - Interactive Learning Center,Boise GreenBike | ICCU - Student Union Building,Boise GreenBike | Idaho Botanical Garden Super Hub,Boise GreenBike | Idaho Power - 13th & Main,Boise GreenBike | Idaho Self Storage,Boise GreenBike | Java 6th & Idaho - Flex Hub,Boise GreenBike | Julia Davis Park - 5th Street Entrance,Boise GreenBike | Julia Davis Park - Tennis Court,Boise GreenBike | Julia Davis Park - Zoo Boise,Boise GreenBike | Kathyrn Albertson Park Flex Hub,Boise GreenBike | Khamu Solutions - Flex Hub,Boise GreenBike | Leon's hub,Boise GreenBike | Liberal Arts Building,Boise GreenBike | Library! at Bown Crossing,Boise GreenBike | Liquid District,Boise GreenBike | Lost Grove Temporary Hub,Boise GreenBike | Main Street Station,Boise GreenBike | McU Sports - Flex Hub,Boise GreenBike | Micron Engineering Building,Boise GreenBike | Midas Gold - Camel's Back,Boise GreenBike | Modern Hotel,Boise GreenBike | Morrison Center,Boise GreenBike | Municipal Park,Boise GreenBike | Norco Building,Boise GreenBike | Olympic Hotel/Mulligan's/Alaska Building - Flex Hub,Boise GreenBike | Parkway Station,Boise GreenBike | Payette Brewing,Boise GreenBike | Raptor Research Center,Boise GreenBike | Record Exchange - Flex Hub,Boise GreenBike | Recreation Center,Boise GreenBike | Rhodes Skate Park,Boise GreenBike | River Quarry,Boise GreenBike | Riverside Hotel,Boise GreenBike | Shoreline,"Boise GreenBike | St Luke's, Healthy U",Boise GreenBike | St. Luke's - URS Plaza,Boise GreenBike | St. Luke's Main Campus,Boise GreenBike | TVCCC - Borah Post Office,Boise GreenBike | Taco Bell Arena - Northeast,Boise GreenBike | Telaya Winery,Boise GreenBike | The Handlebar,Boise GreenBike | The Jefferson - Flex Hub,Boise GreenBike | Theatre Lane,Boise GreenBike | Trailhead Boise,Boise GreenBike | U of I - Boise,Boise GreenBike | University Park Apartments,Boise GreenBike | University Square,Boise GreenBike | Water Cooler,Boise GreenBike | Whole Foods - Flex Hub,Boise GreenBike | YMCA,Boise GreenBike | Yanke Research Center,Boulder B-cycle | 11th & Pearl,Boulder B-cycle | 13th & Arapahoe,Boulder B-cycle | 13th & College,Boulder B-cycle | 13th & Spruce,Boulder B-cycle | 14th & Canyon,Boulder B-cycle | 15th & Pearl,Boulder B-cycle | 19th @ Boulder Creek,Boulder B-cycle | 20th & Pearl,Boulder B-cycle | 21st & Arapahoe,Boulder B-cycle | 26th @ Pearl,Boulder B-cycle | 28th & Boulder Creek,Boulder B-cycle | 28th & Mapleton,Boulder B-cycle | 29th & Pearl,Boulder B-cycle | 30th & Glenwood,Boulder B-cycle | 30th & Marine,Boulder B-cycle | 31st & Pearl,Boulder B-cycle | 33rd & Walnut,Boulder B-cycle | 35th & Colorado,Boulder B-cycle | 38th & Arapahoe,Boulder B-cycle | 48th & Arapahoe,Boulder B-cycle | 6th & Canyon,Boulder B-cycle | 9th & Pearl,Boulder B-cycle | Boulder Junction,Boulder B-cycle | Broadway & Alpine,Boulder B-cycle | Broadway & Baseline,Boulder B-cycle | Broadway & Euclid,Boulder B-cycle | Broadway & University,Boulder B-cycle | Center for Community @ Regent Drive,Boulder B-cycle | Folsom & Colorado,Boulder B-cycle | Folsom & Pearl,Boulder B-cycle | Library @ Arapahoe,Boulder B-cycle | Municipal Building,Boulder B-cycle | North Boulder Recreation Center,Boulder B-cycle | Pearl Place,Boulder B-cycle | SEEC @ Discovery Drive,Boulder B-cycle | Settlers' Park,Boulder B-cycle | The Village,Boulder B-cycle | Timber Ridge @ Adams Circle,Boulder B-cycle | Twenty Ninth Street North,Boulder B-cycle | Twenty Ninth Street South,Boulder B-cycle | UCAR Center Green,Boulder B-cycle | UCAR Mitchell Lane,Boulder B-cycle | Williams Village,Breeze Bike Share | 01.  Annenberg Community Beach House SM,Breeze Bike Share | 02.  San Vicente Boulevard and Ocean Avenue SM,Breeze Bike Share | 03.  4th Street and San Vicente Boulevard SM,Breeze Bike Share | 04.  San Vicente Boulevard and 14th Street SM,Breeze Bike Share | 05.  San Vicente Boulevard and 26th Street SM,Breeze Bike Share | 05.5 Montana Over-pass and Beach Bike Path SM,Breeze Bike Share | 06.  Ocean Avenue and Montana Avenue SM,Breeze Bike Share | 07.  Montana Avenue and 7th Street SM,Breeze Bike Share | 08.  11th Street and Montana Avenue SM,Breeze Bike Share | 08.5 15th and Montana SM,Breeze Bike Share | 09.  16th Street and Montana Avenue SM,Breeze Bike Share | 10.  21st Street and Montana Avenue SM,Breeze Bike Share | 11.  4th Street and Washington Boulevard SM,Breeze Bike Share | 12.  Ocean Front Walk @ Lot 1 SM,Breeze Bike Share | 13.  Wilshire Boulevard and 2nd Street SM,Breeze Bike Share | 15.  Lincoln Boulevard and Wilshire Boulevard SM,Breeze Bike Share | 16.  11th Street and Wilshire Boulevard SM,Breeze Bike Share | 17.  14th Street and Wilshire Boulevard SM,Breeze Bike Share | 18.  25th Street and Wilshire Boulevard SM,Breeze Bike Share | 19.  Wilshire Boulevard and Berkeley Street SM,Breeze Bike Share | 20.  Ocean Avenue and Arizona Avenue SM,Breeze Bike Share | 21.  2nd Street and Arizona Avenue SM,Breeze Bike Share | 22.  Arizona Ave and 4th Street SM,Breeze Bike Share | 23.  7th Street and Arizona Avenue SM,Breeze Bike Share | 24.  Arizona Avenue and 16th Street SM,Breeze Bike Share | 25.  20th Street and Arizona Avenue SM,Breeze Bike Share | 26.  Santa Monica Boulevard and 5th Street SM,Breeze Bike Share | 27.  Santa Monica Boulevard and 11th Street SM,Breeze Bike Share | 28.  2nd Street and Broadway SM,Breeze Bike Share | 29.  Broadway and 6th Street SM,Breeze Bike Share | 30. Broadway and Lincoln Boulevard SM,Breeze Bike Share | 31.  Broadway Street and 16th Street SM,Breeze Bike Share | 32.  Broadway Street and 20th Street SM,Breeze Bike Share | 33.  Broadway Street and Cloverfield Boulevard SM,Breeze Bike Share | 34. Stanford St and Broadway St SM,Breeze Bike Share | 35.  Ocean Ave and Colorado SM,Breeze Bike Share | 36. Ocean Avenue and California Avenue  SM,Breeze Bike Share | 37.  11th Street and Colorado Avenue SM,Breeze Bike Share | 38.  Colorado Avenue and 17th Street EXPO SM,Breeze Bike Share | 39.  Colorado Avenue and Harvard Street SM,Breeze Bike Share | 43.  Michigan Avenue and Lincoln Boulveard SM,Breeze Bike Share | 44.  14th and Olympic SM,Breeze Bike Share | 45.  26th and Pennsylvania SM,Breeze Bike Share | 46. Stewart / Pennsylvania SM,Breeze Bike Share | 47.  Nebraska and Berkeley SM,Breeze Bike Share | 48. Stewart Street and Exposition Blvd SM,Breeze Bike Share | 49.  Centinela Avenue and Exposition Boulevard SM,Breeze Bike Share | 50.  Ocean Avenue and Bay Street SM,Breeze Bike Share | 51.  SMC Swim Center SM,Breeze Bike Share | 52.  SMC and 17th Street SM,Breeze Bike Share | 53.  Pico and 22nd Street SM,Breeze Bike Share | 54. 29th Street and Pico Boulevard SM,Breeze Bike Share | 56.  Main Street and Strand Street SM,Breeze Bike Share | 57.  Strand Street at 4th Street SM,Breeze Bike Share | 58.  Kensington Road and Beverly Avenue SM,Breeze Bike Share | 59.  11th Street and Pearl Street SM,Breeze Bike Share | 60.  Pearl Street and 17th Street SM,Breeze Bike Share | 61. Beach Bike Path and Ocean Park (Drop Zone) SM,Breeze Bike Share | 62.  Ocean Park Boulevard and 2nd street SM,Breeze Bike Share | 63.  Ocean Park Boulevard and 6th Street SM,Breeze Bike Share | 64.  Lincoln Blvd and Ocean Park Blvd SM,Breeze Bike Share | 65.  Ocean Park Boulevard and 16th Street SM,Breeze Bike Share | 66.  Clover Park SM,Breeze Bike Share | 67. Ocean Park and 29th Street SM,Breeze Bike Share | 68.  Santa Monica Business Park  SM,Breeze Bike Share | 69.  Barnard Way and Ashland SM,Breeze Bike Share | 70.  Main Street and Kinney Street SM,Breeze Bike Share | 71. Fairview Library (Drop Zone) SM,Breeze Bike Share | 74. 7th Street and Marine Street SM,Breeze Bike Share | 75.  Marine Street and Paula Drive SM,Breeze Bike Share | 76.  Airport Avenue and Donald Douglas Loop S. SM,Breeze Bike Share | 77. SMC Bundy Campus (Drop Zone) SM,Breeze Bike Share | 78. Bergamot Station EXPO SM,Breeze Bike Share | 79. 4th / Colorado EXPO SM,Breeze Bike Share | 80. 4th Court / Colorado EXPO SM,Breeze Bike Share | 81. Ocean Avenue and Olympic Place SM,Breeze Bike Share | 82. Main Street and Avenida Mazatlan SM,Breeze Bike Share | 83. Arizona and Chelsea SM,Breeze Bike Share | 84. Ocean Front Walk and Rose Avenue SM,Breeze Bike Share | 85. Virginia/ Cloverfield SM,Breeze Bike Share | 86. 12th Street / Michigan Ave SM,Breeze Bike Share | 87. Ocean front walk and Marine SM,Breeze Bike Share | 88. 4th St / Civic Center SM,Breeze Bike Share | 89. Ocean Front Walk / Park Ave SM,Breeze Bike Share | 90. 34th St / Pico Blvd SM,Breeze Bike Share | 91. Pearl St and 28th St SM,Breeze Bike Share | 93. Aquarium (Drop Zone) SM,Breeze Bike Share | 94. Rose Ave / 5th Ave SM,Breeze Bike Share | 95. California Avenue and Abbot Kinney SM,"Breeze Bike Share | 96. Abbot Kinney ave, and Venice Blvd SM",Breeze Bike Share | BH1. 3rd and Maple,Breeze Bike Share | BH10. Wilshire Bl / Beverly Dr,Breeze Bike Share | BH11. Wilshire and Doheny,Breeze Bike Share | BH2. Beverly and Gregory,Breeze Bike Share | BH3. Camden Dr / So SM Bl,Breeze Bike Share | BH4. City Hall - Crescent Dr/So SM Blvd,Breeze Bike Share | BH5. Civic Ctr Dr / Burton Way,Breeze Bike Share | BH6. La Cienega Tennis Center,Breeze Bike Share | BH7. La Peer and Olympic,Breeze Bike Share | BH8. Roxbury Park (Drop Zone),Breeze Bike Share | BH9. S. Santa Monica and Wilshire,Breeze Bike Share | CHWT,Breeze Bike Share | UCLA1. Dickson Court North,Breeze Bike Share | UCLA10. Luskin Conference Center,Breeze Bike Share | UCLA11. Charles E. Young Dr North,Breeze Bike Share | UCLA12. Drake Stadium,Breeze Bike Share | UCLA13. Dykstra Hall / De Neve,Breeze Bike Share | UCLA14. Westwood Village - Broxton,Breeze Bike Share | UCLA15. Westwood Village - Glendon/Kinross,Breeze Bike Share | UCLA16. KREC / Lot 36,Breeze Bike Share | UCLA17. Weyburn Terrace,Breeze Bike Share | UCLA18. Sunset Village,Breeze Bike Share | UCLA2. Faculty Center,Breeze Bike Share | UCLA3. Powell Library,Breeze Bike Share | UCLA4. Court of Sciences,Breeze Bike Share | UCLA5. Life Sciences,Breeze Bike Share | UCLA6. Geffen Hall,Breeze Bike Share | UCLA7. Medical Plaza,Breeze Bike Share | UCLA8. Neuroscience Research Center,Breeze Bike Share | UCLA9. PS-9 / Westwood Plaza,Breeze Bike Share | WH1. City Hall @ Sweetzer,Breeze Bike Share | WH10. Santa Monica Bl & Genesee Ave,Breeze Bike Share | WH11. Santa Monica Bl & Robertson Bl,Breeze Bike Share | WH12. Santa Monica Blvd &Willey,Breeze Bike Share | WH13. Beverly Blvd & San Vicente Bl,Breeze Bike Share | WH14. Sunset and Holloway,Breeze Bike Share | WH15. Santa Monica and Fairfax,Breeze Bike Share | WH16. Plummer Park,Breeze Bike Share | WH17. Runyon Canyon (Drop Zone),Breeze Bike Share | WH18. Farmers Market & Gilmore,Breeze Bike Share | WH19. Gilmore & 3rd,Breeze Bike Share | WH2. Santa Monica Blvd & Olive Dr,Breeze Bike Share | WH20. Melrose Ave & La Cienega,Breeze Bike Share | WH21. Doheny Dr & Melrose Ave,Breeze Bike Share | WH22. Santa Monica Bl & Fuller Ave,Breeze Bike Share | WH23. Fairfax and Willoughby (Drop Zone),Breeze Bike Share | WH3. San Vicente Bl @ West Hollywood Park,Breeze Bike Share | WH4. SM Bl & Crescent Heights,Breeze Bike Share | WH5. SM Blvd and Formosa (BevMo),Breeze Bike Share | WH6. Santa Monica Bl & Westmount Dr,Breeze Bike Share | WH7. Santa Monica Bl & Vista St,Breeze Bike Share | WH8. Santa Monica Bl & San Vicente Bl,Breeze Bike Share | WH9. Santa Monica Bl & Hancock Ave,BrindisiByBike | Cillarese,BrindisiByBike | Filomeno,BrindisiByBike | Spalato,BrindisiByBike | Stazione FF.SS.,BrindisiByBike | Vittorio Emanuele,Broward B-cycle | Atlantic & Briny,Broward B-cycle | Bayshore and A1A,Broward B-cycle | Broadwalk at Jefferson St.,Broward B-cycle | Convention Center @ 17th St.,Broward B-cycle | Courthouse (540 Bldg),Broward B-cycle | DC Alexander Park,Broward B-cycle | Dania Beach Pier,Broward B-cycle | Earl Lifshey,Broward B-cycle | Esplanade Park,Broward B-cycle | Galleria,Broward B-cycle | George English Park,Broward B-cycle | Hallandale Beach Water Tower,Broward B-cycle | Holiday Park at Sunrise,Broward B-cycle | Hollywood North Beach,Broward B-cycle | Las Olas & SE 10th Terr,Broward B-cycle | Lauderdale by the Sea,Broward B-cycle | Seabreeze & Las Olas,Broward B-cycle | Sebastian Lot,Broward B-cycle | South Beach Lot,Broward B-cycle | South Beach Lot #2,Broward B-cycle | Sunrise & Ocean,Broward B-cycle | Willingham Park,Bublr Bikes | 411 East Wisconsin,Bublr Bikes | 5th/National,Bublr Bikes | 6th/Reservoir,Bublr Bikes | 6th/Virginia,Bublr Bikes | Astor/Juneau,Bublr Bikes | Aurora,Bublr Bikes | Bradford Beach,Bublr Bikes | Brady/Humboldt,Bublr Bikes | Brady/Prospect,Bublr Bikes | Brewers,Bublr Bikes | Broadway/St Paul,Bublr Bikes | Burns Commons,Bublr Bikes | Cathedral Square,Bublr Bikes | Central Library,Bublr Bikes | City Hall (Wauwatosa),Bublr Bikes | City Hall (West Allis),Bublr Bikes | City Lights Brewery,Bublr Bikes | Cream City Hostel,Bublr Bikes | Discovery World,Bublr Bikes | Downer/Park Place,Bublr Bikes | Echelon Station (Discovery Pkwy & Eschweiler Dr),Bublr Bikes | Erie/Menomonee,Bublr Bikes | Farmers Market,Bublr Bikes | Golda Meir Library,Bublr Bikes | Hart Park,Bublr Bikes | Harwood Ave & Milwaukee Ave,Bublr Bikes | Humboldt/Commerce,Bublr Bikes | Intermodal Station,Bublr Bikes | Kenilworth Square,Bublr Bikes | Lakefront Brewery,Bublr Bikes | Ludington Triangle,Bublr Bikes | MCTS HQ,Bublr Bikes | MCW,Bublr Bikes | MLK/Brown,Bublr Bikes | Marquette University Student Union,Bublr Bikes | Metro Market,Bublr Bikes | N Oakland Ave & E Edgewood Ave,Bublr Bikes | N Oakland Ave & E Kensington Blvd,Bublr Bikes | N Oakland Ave & E Lake Bluff Blvd,Bublr Bikes | N Oakland Ave & E Shorewood Blvd,Bublr Bikes | N Wauwatosa Ave & W Hillcrest Dr,Bublr Bikes | N. 68th St. & W. Wells St.,Bublr Bikes | N. 74th St. & State St.,Bublr Bikes | N. Maryland Ave & E. Capitol Dr,Bublr Bikes | N. Wilson Dr. & E. Capitol Dr,Bublr Bikes | North/Cambridge,Bublr Bikes | North/Lake,Bublr Bikes | Oakland/Bradford,Bublr Bikes | Oakland/Kenwood,Bublr Bikes | Ogden/Jackson,Bublr Bikes | Ogden/Marshall,Bublr Bikes | Pleasant/Commerce,Bublr Bikes | Prospect/North,Bublr Bikes | Public Museum,Bublr Bikes | Red Arrow Park,Bublr Bikes | Riverside Park,Bublr Bikes | Riverview,Bublr Bikes | Robertson St & Harwood Ave,Bublr Bikes | S. 2nd/Freshwater,Bublr Bikes | S. 2nd/Virginia,Bublr Bikes | S. 2nd/Washington,Bublr Bikes | S. 63rd St. & W. Greenfield Ave,Bublr Bikes | S. 70th St. & W. Greenfield Ave,Bublr Bikes | S. 70th St. & W. National Ave.,Bublr Bikes | S. 75th St. & W. National Ave.,Bublr Bikes | Sandburg Hall,Bublr Bikes | Schlitz Park,Bublr Bikes | Six Points Crossing & W Greenfield Ave,Bublr Bikes | The Brewery District,Bublr Bikes | The Reef,Bublr Bikes | Trestle Park,Bublr Bikes | US Bank Center,Bublr Bikes | UWM Student Union,Bublr Bikes | Village South,Bublr Bikes | W. North Ave. / N. 56th St.,Bublr Bikes | W. North Ave/N. 64th Street,Bublr Bikes | W. North Ave/N. 69th Street,Bublr Bikes | W. North Ave/N. 72nd Street,Bublr Bikes | W. North Ave/N. 83rd Street,Bublr Bikes | W. North Ave/Swan Boulevard,Bublr Bikes | W. Washington St at Summit Place,Bublr Bikes | W. Wisconsin Ave / N. Plankinton Ave.,Bublr Bikes | Walker Square,Bublr Bikes | Water/Pleasant,Bublr Bikes | Water/Wisconsin,Bublr Bikes | Wisconsin Center,Bublr Bikes | Zeidler Union Square Park,Bublr Bikes | Zillman Park,Burgenland | Andau / Badesee,Burgenland | Breitenbrunn / Bhf,Burgenland | Breitenbrunn / Hauptplatz,Burgenland | Breitenbrunn / Seebad,Burgenland | Eisenstadt / Bahnhof,Burgenland | Eisenstadt / Domplatz,Burgenland | Eisenstadt / Krautgartenweg,Burgenland | Fertörakos / Drescher Line,Burgenland | Frauenkirchen / Bahnhof,Burgenland | Frauenkirchen / Basilika,Burgenland | Frauenkirchen/Therme St. Martin,Burgenland | Gols / Weinkulturhaus,Burgenland | Illmitz / Heuriger Gruber,Burgenland | Illmitz / Nationalparkzentrum,Burgenland | Illmitz / Seebad,Burgenland | Jois / Bahnhof,Burgenland | Jois / Hafen / Seejungfrau,Burgenland | Mörbisch / Bootsverleih Drescher,Burgenland | Neusiedl / Bahnhof Bad,Burgenland | Neusiedl / Bezirkshauptmannschaft,Burgenland | Neusiedl / Mole West,Burgenland | Neusiedl / Post,Burgenland | Pamhagen / Bhf,Burgenland | Parndorf / Designer Outlet,Burgenland | Parndorf Ort / Bhf,Burgenland | Podersdorf am See / Platz der Radchampions,Burgenland | Purbach / Bad im Erholungsgebiet,Burgenland | Purbach / Bhf,Burgenland | Rust / ELFENHOF-SCHENKE,Burgenland | Rust / Hotel am Greiner,Burgenland | Rust / Weingut ELFENHOF,Burgenland | St Andrä / Bhf,Burgenland | St. Andrä / Zicksee,Burgenland | Tadten / Gemeindeamt,Burgenland | Technologiezentrum Eisenstadt,Burgenland | Wallern / Bhf,Burgenland | Weiden / Bhf,Burgenland | Weiden am See / Hoteldorf Seepark Weiden,Bycyklen | AAU-CPH DROP-ZONE,Bycyklen | Amager Strand Metrostation,Bycyklen | Amagerbro Metrostation,Bycyklen | Amagerbrogade / Elbagade,Bycyklen | Amagerbrogade / Frankrigsgade,Bycyklen | Amagerbrogade/ Store Møllevej DZ,Bycyklen | Baggesensgade,Bycyklen | Balders Plads,Bycyklen | Bella Center Metrostation,Bycyklen | Bertel Thorvaldsens Plads DZ,Bycyklen | Bispebjerg Station,Bycyklen | Bopa Plads DZ,Bycyklen | Borgergade,Bycyklen | Bremen DZ,Bycyklen | Brønshøj Torv,Bycyklen | Bådsmandsstræde,Bycyklen | Bülowsvej / Thorvaldsensvej,Bycyklen | CPH street food/Reffen Dz,Bycyklen | Carlsberg St (Tapperitorvet 1) DZ,Bycyklen | DGI-byen DZ,Bycyklen | DR Byen Metro DZ,Bycyklen | Damhus Torv,Bycyklen | Dampfærgevej / Regionernes hus,"Bycyklen | Danneskiold-Samsøes Allé (""Holmen"")",Bycyklen | Danshøj Station,Bycyklen | Deloitte DZ,Bycyklen | Den Sorte Diamant,Bycyklen | Dronningensgade / Christianshavn,Bycyklen | Dybbølsbro Station,Bycyklen | Emdrup Station,Bycyklen | Emdrup Torv,Bycyklen | Enghavevej / Enghaveparken,Bycyklen | Experimentarium (Philip Heymans Alle 23) DZ,Bycyklen | Falkoner Allé / Hostrups Have,Bycyklen | Fasanvej Metrostation,Bycyklen | Flintholm Station / Busterminalen,Bycyklen | Flintholm Station / Stig Lommers Plads,Bycyklen | Folketinget / Slotsholmsgade,Bycyklen | Fortunstræde/ Ved Stranden DZ,Bycyklen | Forum Metrostation,Bycyklen | Fredericiagade / Bredgade,Bycyklen | Frederiksberg Bredegade / Rådhuset,Bycyklen | Frederiksberg Centret,Bycyklen | Frederiksberg Runddel,Bycyklen | Frederiksberg Rådhusplads,Bycyklen | Frederiksberg Svømmehal,Bycyklen | Fuglebakken Station Dropzone,"Bycyklen | Fælledkanten, Else Alfelts Vej (Ørestad Syd)",Bycyklen | Gammel Kongevej / Planetariet,Bycyklen | Gammel Strand no. 52 DZ,Bycyklen | Gammeltorv no. 8 DZ,Bycyklen | Gråbrødretorv/Kejsergade no. 1 DZ,Bycyklen | Grøndal Station,Bycyklen | Guldbergsgade/BRUS DZ,Bycyklen | Gunnar Nu Hansens Plads,Bycyklen | Göteborg Plads/ Nordhavn DZ,Bycyklen | H. C. Andersens Boulevard,Bycyklen | H.C Andersens Blvd 17 DZ,Bycyklen | Halmtorvet,Bycyklen | Halvtolv no. 4 DZ,Bycyklen | Havnegade,Bycyklen | Heerup Museum,Bycyklen | Hellerup Station,Bycyklen | Helligåndskirken (31 Amagertorv) DZ,Bycyklen | Hulgårds Plads Dropzone,Bycyklen | Husum Station,Bycyklen | Hvidovre St (Rødovre siden) DZ,Bycyklen | Højbro Plads no. 4 DZ,"Bycyklen | Høje Taastrup, City 2","Bycyklen | Høje Taastrup, Station",Bycyklen | Islands Brygge Kulturhus,Bycyklen | Islands Brygge Metrostation,Bycyklen | Islev Torv,Bycyklen | Israels Plads (Rømersgade 7) DZ,Bycyklen | Jarmers Plads (Jarmers Pl. 2) DZ,Bycyklen | Jyllingevej/ Tårnvej,Bycyklen | KB Hallen Station,Bycyklen | KVUC (Vognmagergade 8) DZ,Bycyklen | Kalvebod brygge (Kalvebod Brygge 3-5) DZ,Bycyklen | Kløvermarkens Idrætsanlæg (at the bikeracks) DZ,Bycyklen | Kongens Nytorv,Bycyklen | København H,Bycyklen | Københavns Lufthavn Terminal 3 DZ,Bycyklen | Københavns Rådhusplads,Bycyklen | Københavns Universitet DZ,Bycyklen | Langelinie,Bycyklen | Langgade Station / Valby,Bycyklen | Lergravsparken Station,Bycyklen | Lille triangel DZ,Bycyklen | Lindevang Metrostation,Bycyklen | Mindeankeret (Corner of Nyhavn/Kgs Nytorv) DZ,Bycyklen | Mozarts plads (corner of Mozartsvej) DZ,Bycyklen | Musiktorvet (Øresundsvej 4) DZ,Bycyklen | NIX,"Bycyklen | Nansensgade ""Hønsefødder"" DZ",Bycyklen | Ndr. Toldbod,Bycyklen | Nordhavn Station / Nordre Frihavnsgade,Bycyklen | Nordre Fasanvej / Nitivej,Bycyklen | Ny Ellebjerg Station,Bycyklen | Nytorv no. 19 DZ,Bycyklen | Nørre Campus,Bycyklen | Nørrebro Station,Bycyklen | Nørrebrogade 114,Bycyklen | Nørreport Station Midt,Bycyklen | Nørreport Station Nord,Bycyklen | Nørreport Station Syd,Bycyklen | Oceankaj / Nordhavn,Bycyklen | Oslobåden,Bycyklen | Parken / Øster Allé,Bycyklen | Peter Bangsvej / Sløjfen,Bycyklen | Pilestræde,Bycyklen | Prismen,Bycyklen | Rantzausgade / Den grønne sti,Bycyklen | Refshalevej,Bycyklen | Regnbuepladsen,Bycyklen | Rigshospitalet,Bycyklen | Roskildevej/Borgmester Fischersvej,Bycyklen | Rygaards Allé 110,Bycyklen | Ryparken Station,Bycyklen | Rødovre Centrum / Parkvej,Bycyklen | Rødovre Hallen,Bycyklen | Rødovre Stadion,Bycyklen | Rødovre Station,Bycyklen | SIF Gladsaxe,Bycyklen | SMK DZ,Bycyklen | Sankt Hans Torv,Bycyklen | Sankt Kjelds Plads,Bycyklen | Sankt Thomas Plads,Bycyklen | Scandic Front DZ,Bycyklen | Sifs Plads,Bycyklen | Sitael,Bycyklen | Sjælør Station,Bycyklen | Sluseholmen / Thad Jones Vej,Bycyklen | Solbjerg Plads / Frederiksberg,Bycyklen | Staunings Plads DZ,Bycyklen | Stefansgade,Bycyklen | Strandgade no. 108 DZ,Bycyklen | Studiestræde / Bispetorvet,Bycyklen | Sundby Metrostation,Bycyklen | Sundbyvester Plads DROP-ZONE,Bycyklen | Sundmolen/ Pakhus 48,Bycyklen | Super Marco (Støbegodsvej 1) DZ,Bycyklen | Svanemøllen Station,Bycyklen | Sydhavn Station,Bycyklen | Sølvtorvet,Bycyklen | Sønder Boulevard,Bycyklen | Sønder Boulevard / Enghavevej,Bycyklen | Søtorvet,Bycyklen | Trianglen,Bycyklen | Tæbyvej (Teknisk Forvaltning),Bycyklen | Valby Hallen,Bycyklen | Valby Station / Lyshøjgårdsvej,Bycyklen | Valby Station / Mellemtoftevej,Bycyklen | Vanløse St. (Vanløse Torv 1) DZ,Bycyklen | Ved Stadsgraven 1 /Amagerfælledvej DZ,Bycyklen | Vestbadet,Bycyklen | Vesterbros Torv,Bycyklen | Vesterport Station,Bycyklen | Victor Borges Plads,Bycyklen | Vigerslev Allé Station,Bycyklen | Waterfront Shoppingcenter DZ,Bycyklen | Zoologisk Have,Bycyklen | nix dropzone,Bycyklen | Ålholm Station,Bycyklen | Århusgade / Østerbrohuset,Bycyklen | Ørestad Metrostation,Bycyklen | Øresund Metrostation,Bycyklen | Østerport Station,Bydgoski rower aglomeracyjny | 01. Rondo Grunwaldzkie,Bydgoski rower aglomeracyjny | 02. Rondo Jagiellonów,Bydgoski rower aglomeracyjny | 03. Wojska Polskiego / Lecha Kaczyńskiego,Bydgoski rower aglomeracyjny | 04. Plac Wolności,Bydgoski rower aglomeracyjny | 05. Dworzec PKP,Bydgoski rower aglomeracyjny | 06. Dworzec PKS,Bydgoski rower aglomeracyjny | 07. Wyspa Młyńska,Bydgoski rower aglomeracyjny | 08. Plac Teatralny,Bydgoski rower aglomeracyjny | 09. Gdańska / stadion,Bydgoski rower aglomeracyjny | 10. Myślęcinek,Bydgoski rower aglomeracyjny | 11. Chodkiewicza / UKW,Bydgoski rower aglomeracyjny | 12. Sułkowskiego / Czerkaska,Bydgoski rower aglomeracyjny | 13. Skłodowskiej - Curie / Jurasza,Bydgoski rower aglomeracyjny | 14. Skłodowskiej - Curie / Bałtycka,Bydgoski rower aglomeracyjny | 15. Szubińska / Połtyna,Bydgoski rower aglomeracyjny | 16. Solskiego / Ugory,Bydgoski rower aglomeracyjny | 17. Wojska Polskiego / Ujejskiego,Bydgoski rower aglomeracyjny | 18. Rondo Fordońskie,Bydgoski rower aglomeracyjny | 19. Plac Kościeleckich,Bydgoski rower aglomeracyjny | 20. Nowy Rynek,Bydgoski rower aglomeracyjny | 21. Focha / Królowej Jadwigi,Bydgoski rower aglomeracyjny | 22. Szubińska / Żwirki i Wigury,Bydgoski rower aglomeracyjny | 23. Mickiewicza,Bydgoski rower aglomeracyjny | 24. Rondo Wielkopolskie,Bydgoski rower aglomeracyjny | 25. Dworcowa / Marcinkowskiego,Bydgoski rower aglomeracyjny | 26. Wojska Polskiego / Magnuszewska,Bydgoski rower aglomeracyjny | 27. Nakielska / Bronikowskiego,Bydgoski rower aglomeracyjny | 28. Kamienna / Fordońska,Bydgoski rower aglomeracyjny | 29. Wojska Polskiego / Trasa Uniwersytecka,Bydgoski rower aglomeracyjny | 30. Solskiego / Skorupki,Bydgoski rower aglomeracyjny | 31. Stary Rynek,Bydgoski rower aglomeracyjny | 32. Wyszyńskiego / Powstańców Wlkp.,Bydgoski rower aglomeracyjny | 33. Powstańców Warszawy / Powstania Listopadowego,Bydgoski rower aglomeracyjny | 34. Bocianowo / Kaszubska (Pl.Kościuszki),Bydgoski rower aglomeracyjny | 35. Glinki / Białostocka,Bydgoski rower aglomeracyjny | 36. Stary Fordon,Bydgoski rower aglomeracyjny | 37. Piłsudskiego / Swobodna,Bydgoski rower aglomeracyjny | 38. Andersa / Wolna,Bydgoski rower aglomeracyjny | 39. Pelplińska / Jarużyńska,Bydgoski rower aglomeracyjny | 40. Pelplińska / Skarżyńskiego,Bydgoski rower aglomeracyjny | 41. Brzechwy / Produkcyjna,Bydgoski rower aglomeracyjny | 42. Andersa / Kleeberga,Bydgoski rower aglomeracyjny | 43. Twardzickiego / Thommee,Bydgoski rower aglomeracyjny | 44. Twardzickiego / Teski,Bydgoski rower aglomeracyjny | 45. Kaliskiego / UTP,Bydgoski rower aglomeracyjny | 46. Romanowskiej / Centrum Onkologii,Bydgoski rower aglomeracyjny | 47. Akademicka / Korfantego,Bydgoski rower aglomeracyjny | 48. Kołobrzeska / Koszalińska,Bydgoski rower aglomeracyjny | 49. Gnieźnieńska / Gołębia,Bydgoski rower aglomeracyjny | 50. Kujawska / Konopnickiej,Bydgoski rower aglomeracyjny | 51. Boya-Żeleńskiego / Komuny Paryskiej,Bydgoski rower aglomeracyjny | 52. Grunwaldzka / Atos,Bydgoski rower aglomeracyjny | 53. Skandynawska / IKEA,Bydgoski rower aglomeracyjny | 54. Fordońska / Galeria Pomorska,Bysykkel | 7 Juni Plassen,Bysykkel | ADO arena,Bysykkel | AHO,Bysykkel | Abels gate,Bysykkel | Adamstuen,Bysykkel | Akersgata,Bysykkel | Akvariet,Bysykkel | Alexander Kiellands Plass,Bysykkel | Allehelgens plass,Bysykkel | Amalie Skrams vei Nord,Bysykkel | Amalie Skrams vei Sør,Bysykkel | Anker Hostel,Bysykkel | Annette Thommessens Plass,Bysykkel | Arendalsgata,Bysykkel | Arkaden Sør,Bysykkel | Arkitekt Rivertz Plass,Bysykkel | BI Nydalen,Bysykkel | Badebakken,Bysykkel | Bak Niels Treschows hus nord,Bysykkel | Bak Niels Treschows hus sør,Bysykkel | Bakke bru,Bysykkel | Bakklandet,Bysykkel | Bankplassen,Bysykkel | Bassengbakken,Bysykkel | Bentsebrugata,Bysykkel | Berg Studentby,Bysykkel | Bergen jernbanestasjon,Bysykkel | Bernt Ankers gate,Bysykkel | Birkelunden,Bysykkel | Biskop Gunnerus' gate,Bysykkel | Bislett Stadion,Bysykkel | Bislettgata,Bysykkel | Bjerregaards gate,Bysykkel | Bjerregaardsgate Øst,Bysykkel | Bjølsen Studentby,Bysykkel | Bjølsen mølle,Bysykkel | Bjølsendumpa,Bysykkel | Bjørnsonsgate,Bysykkel | Bjørvika,Bysykkel | Blindern studentparkering,Bysykkel | Bogstadveien,Bysykkel | Borgenveien,Bysykkel | Botanisk Hage sør,Bysykkel | Botanisk Hage vest,Bysykkel | Botanisk hage sør-vest,Bysykkel | Brann Stadion,Bysykkel | Brattørkaia,Bysykkel | Briskeby,Bysykkel | Brugata,Bysykkel | Bryn T-Bane,Bysykkel | Busstasjonen 1 Nord,Bysykkel | Busstasjonen 2 Vest,Bysykkel | Busstasjonen 3  Øst,Bysykkel | Busstasjonen 4 Sør,Bysykkel | Bygdøy allé,Bysykkel | Bøhmergaten,Bysykkel | Bøkkerveien,Bysykkel | Carl Berners plass sør,Bysykkel | Chr. Michelsens Gate,Bysykkel | Cicignons plass,Bysykkel | Colbjørnsens gate,Bysykkel | Colletts gate,Bysykkel | Colosseum Kino,Bysykkel | Cornerteateret,Bysykkel | Dalen hageby,Bysykkel | Damsgårdsallmenningen,Bysykkel | Damsgårdsveien,Bysykkel | Danmarksplass,Bysykkel | Den Nationale Scene,Bysykkel | Det Teologiske fakultet,Bysykkel | Diakonhjemmet,Bysykkel | Dokkparken,Bysykkel | Dokkveien,Bysykkel | Dora I,Bysykkel | Dragefjellsbakken,Bysykkel | Drammensveien,Bysykkel | Dreggsallmenningen Nord,Bysykkel | Dreggsallmenningen Sør,Bysykkel | Dronningens gate,Bysykkel | Dyvekes bru,Bysykkel | Dælenenggata,Bysykkel | Edvard Storms gate,Bysykkel | Edvards Grieg vei,Bysykkel | Elisenberg,Bysykkel | Enerhaugen,Bysykkel | Ensjø T-Bane,Bysykkel | Ensjøveien,Bysykkel | Erling Skakkes gate,Bysykkel | Fagerheimgata,Bysykkel | Falkenborg,Bysykkel | Festningskaien,Bysykkel | Festplassen,Bysykkel | Filipstadveien,Bysykkel | Finalebanen,Bysykkel | Finnmarksgata,Bysykkel | Fjordgata,Bysykkel | Flytårnet,Bysykkel | Fornebu S hovedinngang,Bysykkel | Fornebuporten,Bysykkel | Forskningsveien,Bysykkel | Fosswinckels gate,Bysykkel | Fram-gården,Bysykkel | Fred Olsens gate,Bysykkel | Fredensborg,Bysykkel | Friggfeltet,Bysykkel | Frogner Stadion,Bysykkel | Frogner Tennisklubb,Bysykkel | Frogner plass,Bysykkel | Frognerbadet,Bysykkel | Frognerstranda,Bysykkel | Frognerveien,Bysykkel | Frydenbø Marina,Bysykkel | Frøen T-bane,Bysykkel | Furulund,Bysykkel | Fyrstikktorget,Bysykkel | Fysikkbygningen,Bysykkel | Galgeberg,Bysykkel | Gaustad T-bane,Bysykkel | Georg Morgenstiernes hus,Bysykkel | Gimle Kino,Bysykkel | Gløshaugen,Bysykkel | Grenseveien,Bysykkel | Grieghallen,Bysykkel | Griffenfeldts gate,Bysykkel | Grønlands torg,Bysykkel | Grünerhagen Nord,Bysykkel | Gulating,Bysykkel | Gågaten,Bysykkel | HF-Bygget,Bysykkel | Hallings gate,Bysykkel | Hallénparken,Bysykkel | Hammersborg Torg,Bysykkel | Hans Hauges gate,Bysykkel | Hans Nielsen Hauges plass,Bysykkel | Haraldsplass,Bysykkel | Hasle,Bysykkel | Hasle Torg,Bysykkel | HasleLinje,Bysykkel | Haukeland sykehus,Bysykkel | Hausmanns bru,Bysykkel | Hausmanns gate,Bysykkel | Helga Helgesens plass,Bysykkel | Henrik Ibsens gate,Bysykkel | Henrik Wergelands allé,Bysykkel | Hesthagen,Bysykkel | HiOA,Bysykkel | Hoff terrasse holdeplass,Bysykkel | Hoffsveien,Bysykkel | Holbergs Plass,Bysykkel | Huitfeldts gate,Bysykkel | Huk,Bysykkel | Hundsund,Bysykkel | Hydroparken,Bysykkel | Håkon VIIs gate 8-10,Bysykkel | Håkonsgaten,Bysykkel | Høgskulen på Vestlandet,Bysykkel | Høyskoleringen,Bysykkel | Høyteknologisenteret,Bysykkel | Idioten,Bysykkel | Ila,Bysykkel | Ilabekken,Bysykkel | Ilaparken,Bysykkel | Ilevollen,Bysykkel | Jakob kirke,Bysykkel | Jarlsborgveien,Bysykkel | Jenny Braatens Plass,Bysykkel | Jens Bjelkes gate,Bysykkel | Jernbanetorget,Bysykkel | Jess Carlsens gate,Bysykkel | Johanneskirken,Bysykkel | John Colletts plass,Bysykkel | John Lunds plass,Bysykkel | Jomfrugateallmenningen,Bysykkel | Jonsvollkvartalet,Bysykkel | Jordalgata,Bysykkel | KJELLER,Bysykkel | Kalvskinnet,Bysykkel | Kampen park Øst,Bysykkel | Karenlyst allé,Bysykkel | Kirkegata 15,Bysykkel | Kirkeristen,Bysykkel | Kirkeveien,Bysykkel | Kjeld Stubs gate,Bysykkel | Klosteret,Bysykkel | Klostergata,Bysykkel | Kode 1,Bysykkel | Kode 2,Bysykkel | Koksa,Bysykkel | Kong Øysteins veg,Bysykkel | Kongens gate,Bysykkel | Kontraskjæret,Bysykkel | Krebs' gate,Bysykkel | Kristiansten,Bysykkel | Krohnsminde Parkering,Bysykkel | Krohnviken,Bysykkel | Kværnerbyen,Bysykkel | Københavngata busstopp,Bysykkel | LILLESTRØM STASJON,Bysykkel | Lade idrettsanlegg vest,Bysykkel | Lademoparken,Bysykkel | Lakkegata,Bysykkel | Laksevåg v/Kirkebukten,Bysykkel | Landstads gate,Bysykkel | Langkaia,Bysykkel | Lars Hilles,Bysykkel | Lerkendal,Bysykkel | Leutenhaven,Bysykkel | Lille Grensen,Bysykkel | Lilleborgbanen,Bysykkel | Lillegårdsbakken,Bysykkel | Linaaes gate,Bysykkel | Lindern,Bysykkel | Lodalen busstopp,Bysykkel | Lysaker Torg vest,Bysykkel | Lysaker havn,Bysykkel | Lysaker torg øst 1,Bysykkel | Lysaker torg øst 2,Bysykkel | Lysverket,Bysykkel | Lørenveien,Bysykkel | Magnus Lagabøtes Plass,Bysykkel | Mailundveien,Bysykkel | Majorstua skole,Bysykkel | Majorstuen,Bysykkel | Majorstuen t-bane,Bysykkel | Majorstuveien,Bysykkel | Mandalls gate,Bysykkel | Marcus Thranes gate,Bysykkel | Marienlyst,Bysykkel | Marienlystparken,Bysykkel | Media City,Bysykkel | Meltzers gate,Bysykkel | Monolittveien,Bysykkel | Munkedamsveien,Bysykkel | Munkegata trikkestopp,Bysykkel | Myraløkka Øst,Bysykkel | Møllenberg,Bysykkel | Møllendalsplass,Bysykkel | Mølleparken,Bysykkel | Møllergata,Bysykkel | Nedre Korskirkeallmenning,Bysykkel | Nedre Slottsgate,Bysykkel | Neumannsgate,Bysykkel | Nidarosdomen,Bysykkel | Nonneseterplass,Bysykkel | Nordre gate,Bysykkel | Norsk Folkemuseum,Bysykkel | Nydalen,Bysykkel | Nykirkekaien,Bysykkel | Nykirken,Bysykkel | Nylandsveien,Bysykkel | Nøstetorget,Bysykkel | OBOS visningssenter,Bysykkel | Olaf Ryes plass,Bysykkel | Olav Vs gate,Bysykkel | Oscars gate,Bysykkel | Oslo Handelsgymnasium,Bysykkel | Oslo Hospital,Bysykkel | Oslo Plaza,Bysykkel | Over Rådhusgata,Bysykkel | Paléhaven,Bysykkel | Parkveien,Bysykkel | Pilestredet,Bysykkel | Pilestredet 63,Bysykkel | Pilestredet Studenthus,Bysykkel | Pirbadet,Bysykkel | Prinsen kinosenter,Bysykkel | Riddervoldplass,Bysykkel | Ringnes Park,Bysykkel | Rolf Wickstrøms vei,Bysykkel | Rolfsbukta ved fergeanløp,Bysykkel | Rosenborg skole,Bysykkel | Ruseløkkgården,Bysykkel | Rådhusbrygge 4,Bysykkel | Rådhuset,Bysykkel | Rådhusgata,Bysykkel | Rådstuplassen,Bysykkel | S. P. Andersens vei,Bysykkel | STORTORGET,Bysykkel | Saga Kino,Bysykkel | Sagene bussholdeplass,Bysykkel | Salt,Bysykkel | Sandviken Brygge,Bysykkel | Sandviksbodene,Bysykkel | Sandvikstorget,Bysykkel | Schives gate,Bysykkel | Schous plass,Bysykkel | Schous plass trikkestopp,Bysykkel | Sentrum Scene,Bysykkel | Singsaker,Bysykkel | Sinsen T-bane,Bysykkel | Sinsenveien,Bysykkel | Sjølyst,Bysykkel | Sjøsiden vest,Bysykkel | Sjøsiden øst,Bysykkel | Skansen,Bysykkel | Skarpsnoparken,Bysykkel | Skillebekk,Bysykkel | Skippergata,Bysykkel | Skovveien,Bysykkel | Skråninga,Bysykkel | Skur 11,Bysykkel | Skutevikstorget,Bysykkel | Skøyen,Bysykkel | Skøyen Stasjon,Bysykkel | Slemdalsveien,Bysykkel | Slottsparken Øst,Bysykkel | Småstrandgaten,Bysykkel | Sofienberggata,Bysykkel | Sofienbergparken nord,Bysykkel | Sofienbergparken nordvest,Bysykkel | Sofienbergparken sør,Bysykkel | Sognsveien,Bysykkel | Solheimsgaten COOP Extra,Bysykkel | Solheimsviken,Bysykkel | Sommerfrydhagen,Bysykkel | Sorgenfri,Bysykkel | Sotahjørnet,Bysykkel | Spikersuppa Vest,Bysykkel | Spikersuppa Øst,Bysykkel | St Olavs gate,Bysykkel | St. Hanshaugen,Bysykkel | St. Hanshaugen park nord,Bysykkel | St. Hanshaugen park sør,Bysykkel | St. Hanshaugen park vest,Bysykkel | St. Jakobs Plass,Bysykkel | St. Olavs gate,Bysykkel | Stavangergata,Bysykkel | Stensgata,Bysykkel | Stensparken,Bysykkel | Stockfleths gate,Bysykkel | Storgata,Bysykkel | Storo Storsenter,Bysykkel | Storøya skole,Bysykkel | Strandveikaia,Bysykkel | Strømgaten,Bysykkel | Studentboligene,Bysykkel | Studenterlunden,Bysykkel | Studentersamfundet,Bysykkel | Studentparlamentet,Bysykkel | Studentsenteret UIB,Bysykkel | Suhms gate,Bysykkel | Sukkerbiten,Bysykkel | Søndre gate,Bysykkel | Sørvest for Slottsparken,Bysykkel | THON HOTEL ARENA,Bysykkel | TMV-odden,Bysykkel | TORVGATA,Bysykkel | Tannlegehøyskolen,Bysykkel | Technopolis,Bysykkel | Thereses gate,Bysykkel | Thomas Heftyes plass,Bysykkel | Thormøhlens gate 30,Bysykkel | Thornesparken,Bysykkel | Thune,Bysykkel | Tjuvholmen,Bysykkel | Tollboden,Bysykkel | Tordenskiolds gate,Bysykkel | Torget,Bysykkel | Torggata,Bysykkel | Torshovdalen øst,Bysykkel | Torshovparken vest,Bysykkel | Torvet I,Bysykkel | Trelastgata,Bysykkel | Trikkestallen på Lademoen,Bysykkel | Trondheim S,Bysykkel | Trondheimsveien,Bysykkel | Tyholttårnet,Bysykkel | Tårnplass,Bysykkel | Tåsen Senter,Bysykkel | Tåsenløkka,Bysykkel | Tøyen skole,Bysykkel | Tøyenbekken,Bysykkel | Tøyenparken,Bysykkel | Uelands gate,Bysykkel | Ullevål sykehus,Bysykkel | Ullevålsalléen,Bysykkel | Ullevålsveien,Bysykkel | Uranienborgparken,Bysykkel | Uranienborgveien,Bysykkel | Valentinlyst,Bysykkel | Valkyrieplassen,Bysykkel | Vaterlandsparken,Bysykkel | Verftet,Bysykkel | Verftsbrua,Bysykkel | Vestkanttorvet,Bysykkel | Vippetangen vest,Bysykkel | Vippetangen øst,Bysykkel | Vollabakken,Bysykkel | Volvat,Bysykkel | Vulkan,Bysykkel | Vågsallmenningen,Bysykkel | Vålerenga,Bysykkel | Vår Frelsers gravlund sør,Bysykkel | Zander Kaas gate,Bysykkel | ÅRÅSEN,Bysykkel | Årstad kirke,Bysykkel | Økernveien,Bysykkel | Østre Murallmenningen nedre,Bysykkel | Østre Murallmenningen øvre,Bysykkelen | 2020park,Bysykkelen | Amfi Madla,Bysykkelen | Archer Stangeland,Bysykkelen | Badehusgata 37,Bysykkelen | Bilhuset,Bysykkelen | Bogafjellhallen,Bysykkelen | Bouvet,Bysykkelen | Clarion Hotel Energy,Bysykkelen | Clarion Hotel Stavanger,Bysykkelen | Eidsvollsgata,Bysykkelen | Elsykkelsenteret,Bysykkelen | Equinor Vest,Bysykkelen | Equinor Øst,Bysykkelen | Fylkeskommunen,Bysykkelen | Gausel Stasjon,Bysykkelen | Hana Skippergata,Bysykkelen | Hinna Park v/ kanalen,Bysykkelen | Holmealmenningen,Bysykkelen | Hovedinngang SUS,Bysykkelen | Hurtigbåtterminalen,Bysykkelen | Inngang 5 SUS,Bysykkelen | Inngang 6 SUS,Bysykkelen | Ipark Ullandhaug,Bysykkelen | Jåttåvågen Stasjon,Bysykkelen | Kilden Kjøpesenter,Bysykkelen | Kruse Smith,Bysykkelen | Kulturhuset Sola,Bysykkelen | Kunstmuseet,Bysykkelen | Kvadrat Hovedinngang,Bysykkelen | Lervig Ryfylkegata,"Bysykkelen | Lyse, Mariero",Bysykkelen | Mariero Stasjon,Bysykkelen | Maskinveien 24,Bysykkelen | Møller Bil (Audi),Bysykkelen | Møller Bil (VW),Bysykkelen | Nytorget,Bysykkelen | Oljemuseet,Bysykkelen | Paradis Hillevågsveien,Bysykkelen | Psykiatrisk klinikk,Bysykkelen | Randaberg Arena,Bysykkelen | Randaberg kommunehus,Bysykkelen | Ranso Reperasjons senter,Bysykkelen | Rogaland Teater,Bysykkelen | Ruten Sandnes,Bysykkelen | SR Bank Bjerksted,Bysykkelen | Sandvika,Bysykkelen | Scandic Forus Hotel,Bysykkelen | Smedvigkvartalet Løkkeveien 111,Bysykkelen | Sola sentrum,Bysykkelen | Statens hus,Bysykkelen | Stavanger Aftenblad Nykirkebakken,Bysykkelen | Stavanger Offshore Tekniske Fagskole,Bysykkelen | Stavanger Stasjon Perrongen,Bysykkelen | Stavanger jernbanestasjon,Bysykkelen | Strandgata 147,Bysykkelen | Strondavika,Bysykkelen | Subsea7,Bysykkelen | Sørbøhallen,Bysykkelen | Sørmarka Arena,Bysykkelen | TB bygget Hillevågsveien,Bysykkelen | TOU,Bysykkelen | Tastasenteret,Bysykkelen | Tvedtsenteret,Bysykkelen | Varatun DPS Postveien,Bysykkelen | Veritasbygget,Bysykkelen | Åsenhallen Sola,C.Vélo | 001 Jaude,C.Vélo | 002 Parvis de la gare,C.Vélo | 003 Universités,C.Vélo | 004 Campus,C.Vélo | 005 Salins,C.Vélo | 006 CHU G.Montpied,C.Vélo | 007 Delille,C.Vélo | 008 Gaillard,C.Vélo | 009 Chamalières Mairie,C.Vélo | 010 Ballainvilliers,C.Vélo | 011 Gare - Terminal routier,C.Vélo | 012 Montferrand,C.Vélo | 013 1er mai,C.Vélo | 014 Les Carmes,C.Vélo | 015 Maison des sports,C.Vélo | 016 Fontgiève,C.Vélo | 017 Hôpital d'Estaing,C.Vélo | 018 Côte Blatin,C.Vélo | 019 Amboise,C.Vélo | 020 Pochet Lagaye,C.Vélo | 021 CROUS / Dolet,C.Vélo | 022 Jaures,C.Vélo | 023 Lagarlaye,C.Vélo | 024 Dumas,C.Vélo | 026 Clos Notre Dame,C.Vélo | 027 Berthelot,C.Vélo | 028 Morel Ladeuil,C.Vélo | 029 Regensburg,C.Vélo | 030 Coubertin,C.Vélo | 031 Poncillon,C.Vélo | 032 Liondards,C.Vélo | 033 La Fayette,C.Vélo | 034 République,C.Vélo | 035 Cataroux,C.Vélo | 036 Rodade,C.Vélo | 037 Musée d'art Roger Quilliot,C.Vélo | 038 Les Paulines,C.Vélo | 039 Oradou,C.Vélo | 040 Parking Gare,C.Vélo | 041 Cézeaux Pellez,C.Vélo | 042 Les pistes,C.Vélo | 043 Chandiots,C.Vélo | 044 Braga,C.Vélo | 045 Trois coquins,C.Vélo | 046 Musset,C.Vélo | 047 Carnot,C.Vélo | 048 Voltaire,C.Vélo | 049 Galaxie,C.Vélo | 050 Sabourin,C.Vélo | 051 Montjuzet,C.Vélo | 052 La Glacière,Cagliari | Marina Piccola,Cagliari | Parco di Terramaini,Cagliari | Piazza Giovanni XXIII,Cagliari | Piazza Matteotti,Cagliari | Piazza Palestrina,Cagliari | Piazza Repubblica,Cagliari | Piazzale Cimitero Bonaria,Cagliari | Sonnino,Cagliari | Via Is Mirrionis,Cagliari | Viale Buoncammino,Capital BikeShare | 10th & E St NW,Capital BikeShare | 10th & Florida Ave NW,Capital BikeShare | 10th & G St NW,Capital BikeShare | 10th & K St NW,Capital BikeShare | 10th & Monroe St NE,Capital BikeShare | 10th & U St NW,Capital BikeShare | 10th St & Constitution Ave NW,Capital BikeShare | 10th St & L'Enfant Plaza SW,Capital BikeShare | 11th & C St SE,Capital BikeShare | 11th & F St NW,Capital BikeShare | 11th & Girard St NW,Capital BikeShare | 11th & H St NE,Capital BikeShare | 11th & Kenyon St NW,Capital BikeShare | 11th & M St NW,Capital BikeShare | 11th & O St NW,Capital BikeShare | 11th & Park Rd NW,Capital BikeShare | 11th & S St NW,Capital BikeShare | 12th & Irving St NE,Capital BikeShare | 12th & L St NW,Capital BikeShare | 12th & Newton St NE,Capital BikeShare | 12th & U St NW,Capital BikeShare | 12th St & Pennsylvania Ave SE,Capital BikeShare | 1301 McCormick Dr / Wayne K. Curry Admin Bldg,Capital BikeShare | 13th & D St NE,Capital BikeShare | 13th & E St SE,Capital BikeShare | 13th & H St NE,Capital BikeShare | 13th St & Eastern Ave,Capital BikeShare | 13th St & New York Ave NW,Capital BikeShare | 14th & Belmont St NW,Capital BikeShare | 14th & D St NW / Ronald Reagan Building,Capital BikeShare | 14th & G St NW,Capital BikeShare | 14th & Girard St NW,Capital BikeShare | 14th & Harvard St NW,Capital BikeShare | 14th & Irving St NW,Capital BikeShare | 14th & L St NW,Capital BikeShare | 14th & Luzon St NW,Capital BikeShare | 14th & Newton St NW,Capital BikeShare | 14th & R St NW,Capital BikeShare | 14th & Rhode Island Ave NW,Capital BikeShare | 14th & Upshur St NW,Capital BikeShare | 14th & V St NW,Capital BikeShare | 14th St & Colorado Ave NW,Capital BikeShare | 14th St & New York Ave NW,Capital BikeShare | 14th St & Spring Rd NW,Capital BikeShare | 14th St Heights / 14th & Crittenden St NW,Capital BikeShare | 15th & East Capitol St NE,Capital BikeShare | 15th & Euclid St  NW,Capital BikeShare | 15th & F St NE,Capital BikeShare | 15th & K St NW,Capital BikeShare | 15th & L St NW,Capital BikeShare | 15th & M St NW,Capital BikeShare | 15th & P St NW,Capital BikeShare | 15th & W St NW,Capital BikeShare | 15th St & Constitution Ave NW,Capital BikeShare | 15th St & Massachusetts Ave SE,Capital BikeShare | 15th St & N Scott St,Capital BikeShare | 15th St & Pennsylvania Ave NW,Capital BikeShare | 16th & Harvard St NW,Capital BikeShare | 16th & Irving St NW,Capital BikeShare | 16th & Q St SE / Anacostia HS,Capital BikeShare | 16th & R St NW,Capital BikeShare | 17th & Corcoran St NW,Capital BikeShare | 17th & G St NW,Capital BikeShare | 17th & K St NW,Capital BikeShare | 17th & K St NW / Farragut Square,Capital BikeShare | 17th & Upshur St NW,Capital BikeShare | 17th St & Independence Ave SW,Capital BikeShare | 17th St & Massachusetts Ave NW,Capital BikeShare | 18th & C St NW,Capital BikeShare | 18th & L St NW,Capital BikeShare | 18th & M St NW,Capital BikeShare | 18th & Monroe St NE,Capital BikeShare | 18th & New Hampshire Ave NW,Capital BikeShare | 18th & R St NW,Capital BikeShare | 18th St & Pennsylvania Ave NW,Capital BikeShare | 18th St & Rhode Island Ave NE,Capital BikeShare | 18th St & S Eads St,Capital BikeShare | 18th St & Wyoming Ave NW,Capital BikeShare | 19th & E Street NW,Capital BikeShare | 19th & East Capitol St SE,Capital BikeShare | 19th & G St NW,Capital BikeShare | 19th & K St NW,Capital BikeShare | 19th & Savannah St SE,Capital BikeShare | 19th St & Constitution Ave NW,Capital BikeShare | 19th St & Pennsylvania Ave NW,Capital BikeShare | 1st & D St SE,Capital BikeShare | 1st & H St NW,Capital BikeShare | 1st & K St SE,Capital BikeShare | 1st & M St NE,Capital BikeShare | 1st & M St SE,Capital BikeShare | 1st & N St  SE,Capital BikeShare | 1st & O St NW,Capital BikeShare | 1st & Rhode Island Ave NW,Capital BikeShare | 1st & S Capitol St SE / Oxon Run Trail,Capital BikeShare | 1st & Washington Hospital Center NW,Capital BikeShare | 20th & E St NW,Capital BikeShare | 20th & L St NW,Capital BikeShare | 20th & O St NW / Dupont South,Capital BikeShare | 20th St & Florida Ave NW,Capital BikeShare | 20th St & Virginia Ave NW,Capital BikeShare | 21st & I St NW,Capital BikeShare | 21st & M St NW,Capital BikeShare | 21st St & Constitution Ave NW,Capital BikeShare | 21st St & N Pierce St,Capital BikeShare | 21st St & Pennsylvania Ave NW,Capital BikeShare | 22nd & H St NW,Capital BikeShare | 22nd & I St NW / Foggy Bottom,Capital BikeShare | 22nd & P ST NW,Capital BikeShare | 22nd St & Constitution Ave NW,Capital BikeShare | 23rd & E St NW,Capital BikeShare | 23rd & M St NW,Capital BikeShare | 24th & N St NW,Capital BikeShare | 24th & R St NE / National Arboretum,Capital BikeShare | 25th St & Pennsylvania Ave NW,Capital BikeShare | 28th St & S Meade St,Capital BikeShare | 2nd & G St NE,Capital BikeShare | 2nd St & Massachusetts Ave NE,Capital BikeShare | 2nd St & Seaton Pl NE,Capital BikeShare | 3000 Connecticut Ave NW / National Zoo,Capital BikeShare | 31st & Water St NW,Capital BikeShare | 31st St & S Woodrow St,Capital BikeShare | 34th & Water St NW,Capital BikeShare | 34th St & Wisconsin Ave NW,Capital BikeShare | 36th & Calvert St NW / Glover Park,Capital BikeShare | 37th & Ely Pl SE,Capital BikeShare | 37th & O St NW / Georgetown University,Capital BikeShare | 39th & Calvert St NW / Stoddert,Capital BikeShare | 39th & Veazey St NW,Capital BikeShare | 3rd & D St SE,Capital BikeShare | 3rd & Elm St NW,Capital BikeShare | 3rd & G St SE,Capital BikeShare | 3rd & H St NE,Capital BikeShare | 3rd & H St NW,Capital BikeShare | 3rd & M St NE,Capital BikeShare | 3rd & Tingey St SE,Capital BikeShare | 3rd & Underwood St NW,Capital BikeShare | 3rd St & Pennsylvania Ave SE,Capital BikeShare | 3rd St & Riggs Rd NE,Capital BikeShare | 47th & Elm St,Capital BikeShare | 48th Pl & MacArthur Blvd NW,Capital BikeShare | 4th & C St SW,Capital BikeShare | 4th & D St NW / Judiciary Square,Capital BikeShare | 4th & E St SW,Capital BikeShare | 4th & East Capitol St NE,Capital BikeShare | 4th & M St SE,Capital BikeShare | 4th & M St SW,Capital BikeShare | 4th & W St NE,Capital BikeShare | 4th St & Madison Dr NW,Capital BikeShare | 4th St & Mississippi Ave SE,Capital BikeShare | 5th & F St NW,Capital BikeShare | 5th & K St NW,Capital BikeShare | 5th & Kennedy St NW,Capital BikeShare | 5th St & Massachusetts Ave NW,Capital BikeShare | 61st St & Banks Pl NE,Capital BikeShare | 6th & H St NE,Capital BikeShare | 6th & K St NE,Capital BikeShare | 6th St & Indiana Ave NW,Capital BikeShare | 7th & E St SW,Capital BikeShare | 7th & F St NW / National Portrait Gallery,Capital BikeShare | 7th & K St NW,Capital BikeShare | 7th & R St NW / Shaw Library,Capital BikeShare | 7th & S St NW,Capital BikeShare | 7th & T St NW,Capital BikeShare | 7th St & Massachusetts Ave NE,Capital BikeShare | 8th & D St NW,Capital BikeShare | 8th & East Capitol St NE,Capital BikeShare | 8th & Eye St SE / Barracks Row,Capital BikeShare | 8th & F St NE,Capital BikeShare | 8th & H St NW,Capital BikeShare | 8th & O St NW,Capital BikeShare | 9th & Upshur St NW,Capital BikeShare | Adams Mill & Columbia Rd NW,Capital BikeShare | Alabama & MLK Ave SE,Capital BikeShare | Alabama Ave & Stanton Rd SE / Shops at Park Village,Capital BikeShare | American University East Campus,Capital BikeShare | Amherst Ave & Elkins St,Capital BikeShare | Amherst Ave & Prichard Rd,Capital BikeShare | Anacostia Ave & Benning Rd NE / River Terrace,Capital BikeShare | Anacostia Library,Capital BikeShare | Anacostia Metro,Capital BikeShare | Anacostia Park,Capital BikeShare | Arlington Blvd & Fillmore St,Capital BikeShare | Arlington Blvd & N Queen St,Capital BikeShare | Arlington Blvd & S George Mason Dr,Capital BikeShare | Arlington Mill Cmty Center / Columbia Pike & S Dinwiddie St,Capital BikeShare | Army Navy Dr & S Joyce St,Capital BikeShare | Army Navy Dr & S Nash St,Capital BikeShare | Aurora Hills Cmty Ctr / 18th St & S Hayes St,Capital BikeShare | Ballenger Ave & Dulaney St,Capital BikeShare | Ballston Metro / Stuart St & 9th St N,Capital BikeShare | Baltimore Ave & Jefferson St,Capital BikeShare | Baltimore Ave & Van Buren St / Riverdale Park Station,Capital BikeShare | Barcroft Community Center,Capital BikeShare | Barton St & 10th St N,Capital BikeShare | Battery Ln & Trolley Trail,Capital BikeShare | Benning Branch Library,Capital BikeShare | Benning Rd & East Capitol St NE / Benning Rd Metro,Capital BikeShare | Bethesda Ave & Arlington Rd,Capital BikeShare | Bethesda Metro / Wisconsin Ave & Old Georgetown Rd,Capital BikeShare | Bladensburg Rd & Benning Rd NE,Capital BikeShare | Blueridge Ave & Elkin St,Capital BikeShare | Braddock Rd Metro,Capital BikeShare | Branch & Pennsylvania Ave SE,Capital BikeShare | Broschart & Blackwell Rd,Capital BikeShare | C & O Canal & Wisconsin Ave NW,Capital BikeShare | California St & Florida Ave NW,Capital BikeShare | Calvert & Biltmore St NW,Capital BikeShare | Calvert St & Woodley Pl NW,Capital BikeShare | Campus Commons,Capital BikeShare | Carlin Springs Rd & N Thomas St,Capital BikeShare | Carroll & Ethan Allen Ave,Capital BikeShare | Carroll & Westmoreland Ave,Capital BikeShare | Central Library / Quincy St & 10th St N,Capital BikeShare | Chillum Rd & Riggs Rd / Riggs Plaza,Capital BikeShare | Citadel Ave & McGrath Blvd,Capital BikeShare | Clarendon Blvd & N Fillmore St,Capital BikeShare | Clarendon Blvd & Pierce St,Capital BikeShare | Clarendon Metro / Wilson Blvd & N Highland St,Capital BikeShare | Clark St & 26th St S,Capital BikeShare | Columbia & Ontario Rd NW,Capital BikeShare | Columbia Pike & S Courthouse Rd,Capital BikeShare | Columbia Pike & S Oakland St,Capital BikeShare | Columbia Pike & S Orme St,Capital BikeShare | Columbia Pike & S Taylor St,Capital BikeShare | Columbia Pike & S Walter Reed Dr,Capital BikeShare | Columbia Rd & Belmont St NW,Capital BikeShare | Columbia Rd & Georgia Ave NW,Capital BikeShare | Columbus Ave & Gramercy Blvd,Capital BikeShare | Columbus Ave & Tribeca St,Capital BikeShare | Columbus Circle / Union Station,Capital BikeShare | Commerce St & Fayette St,Capital BikeShare | Commonwealth Ave & E Monroe Ave,Capital BikeShare | Commonwealth Ave & Oak St,Capital BikeShare | Congress Heights Metro,Capital BikeShare | Congressional Ln & E Jefferson St,Capital BikeShare | Connecticut & Nebraska Ave NW,Capital BikeShare | Connecticut Ave & Chevy Chase Lake Dr,Capital BikeShare | Connecticut Ave & McKinley St NW,Capital BikeShare | Connecticut Ave & Newark St NW / Cleveland Park,Capital BikeShare | Connecticut Ave & R St NW,Capital BikeShare | Connecticut Ave & Tilden St NW,Capital BikeShare | Connecticut Ave & Yuma St NW,Capital BikeShare | Constitution Ave & 2nd St NW/DOL,Capital BikeShare | Convention Center / 7th & M St NW,Capital BikeShare | Cordell & Norfolk Ave,Capital BikeShare | Corporate Blvd & Omega Dr,Capital BikeShare | Court House Metro / 15th St & N Uhle St,Capital BikeShare | Crabbs Branch Way & Calhoun Pl,Capital BikeShare | Crabbs Branch Way & Redland Rd,Capital BikeShare | Crystal City Metro / 18th St & S Bell St,Capital BikeShare | Crystal Dr & 15th St S,Capital BikeShare | Crystal Dr & 20th St S,Capital BikeShare | Crystal Dr & 23rd St S,Capital BikeShare | Crystal Dr & 27th St S,Capital BikeShare | Crystal Dr & Potomac Ave,Capital BikeShare | D St & Maryland Ave NE,Capital BikeShare | Deanwood Rec Center,Capital BikeShare | Dennis Ave & Amherst Ave,Capital BikeShare | Division Ave & Foote St NE,Capital BikeShare | Duke St & John Carlyle St,Capital BikeShare | Dunn Loring Metro,Capital BikeShare | E Fairfax St & S Washington St,Capital BikeShare | E Montgomery Ave & Maryland Ave,Capital BikeShare | Eads St & 12th St S,Capital BikeShare | Eads St & 15th St S,Capital BikeShare | Eads St & 22nd St S,Capital BikeShare | East Falls Church Metro / Sycamore St & 19th St N,Capital BikeShare | East West Hwy & 16th St,Capital BikeShare | East West Hwy & Blair Mill Rd,Capital BikeShare | Eastern Market / 7th & North Carolina Ave SE,Capital BikeShare | Eastern Market Metro / Pennsylvania Ave & 7th St SE,Capital BikeShare | Eckington Pl & Q St NE,Capital BikeShare | Eisenhower Ave & Mill Race Ln,Capital BikeShare | Executive Blvd & E Jefferson St,Capital BikeShare | Fairfax Dr & N Randolph St,Capital BikeShare | Fairfax Dr & Wilson Blvd,Capital BikeShare | Fairfax Village,Capital BikeShare | Falls Church City Hall / Park Ave & Little Falls St,Capital BikeShare | Fallsgrove Blvd & Fallsgrove Dr,Capital BikeShare | Fallsgrove Dr & W Montgomery Ave,Capital BikeShare | Fenton St & Ellsworth Dr,Capital BikeShare | Fenton St & Gist Ave,Capital BikeShare | Fenton St & New York Ave,Capital BikeShare | Fessenden St & Wisconsin Ave NW,Capital BikeShare | Fishers Ln & Rock Creek Mill Rd,Capital BikeShare | Fleet St & Ritchie Pkwy,Capital BikeShare | Fleet St & Waterfront St,Capital BikeShare | Florida Ave & R St NW,Capital BikeShare | Fort Totten Metro,Capital BikeShare | Four Mile Run Dr & S Shirlington Rd,Capital BikeShare | Four Mile Run Dr & S Walter Reed Dr,Capital BikeShare | Franklin St & S Washington St,Capital BikeShare | Frederick Ave & Horners Ln,Capital BikeShare | Friendship Blvd & Willard Ave,Capital BikeShare | Friendship Hts Metro / Wisconsin Ave & Wisconsin Cir,Capital BikeShare | GMU / Fairfax Dr & Kenmore St,Capital BikeShare | Gallaudet / 8th St & Florida Ave NE,Capital BikeShare | Garland Ave & Walden Rd,Capital BikeShare | George Mason Dr & Wilson Blvd,Capital BikeShare | George Mason High School / Haycock Rd & Leesburg Pike,Capital BikeShare | Georgetown Harbor / 30th St NW,Capital BikeShare | Georgia & Missouri Ave NW,Capital BikeShare | Georgia & New Hampshire Ave NW,Capital BikeShare | Georgia Ave & Emerson St NW,Capital BikeShare | Georgia Ave & Kennedy St NW,Capital BikeShare | Georgia Ave & Morton St NW,Capital BikeShare | Georgia Ave & Piney Branch Rd NW,Capital BikeShare | Georgia Ave & Spring St,Capital BikeShare | Georgia Ave and Fairmont St NW,Capital BikeShare | Glebe Rd & 11th St N,Capital BikeShare | Good Hope & Naylor Rd SE,Capital BikeShare | Good Hope Rd & 14th St SE,Capital BikeShare | Good Hope Rd & MLK Ave SE,Capital BikeShare | Grandview & Blueridge Ave,Capital BikeShare | Gravelly Point,Capital BikeShare | Greensboro & International Dr,Capital BikeShare | Greensboro & Pinnacle Dr,Capital BikeShare | Hains Point/Buckeye & Ohio Dr SW,Capital BikeShare | Hamlin & 7th St NE,Capital BikeShare | Harvard St & Adams Mill Rd NW,Capital BikeShare | Henry Bacon Dr & Lincoln Memorial Circle NW,Capital BikeShare | Henry St & Pendleton St,Capital BikeShare | Hyattsville Library / Adelphi Rd & Toledo Rd,Capital BikeShare | Independence Ave & L'Enfant Plaza SW/DOE,Capital BikeShare | Iwo Jima Memorial / Meade & 14th St N,Capital BikeShare | Jefferson Dr & 14th St SW,Capital BikeShare | Jefferson Memorial,Capital BikeShare | John McCormack Dr & Michigan Ave NE,Capital BikeShare | Joliet St & MLK Ave SW/Bald Eagle Rec Ctr,Capital BikeShare | Jones Branch & Westbranch Dr,Capital BikeShare | Jones Branch Drive & Scotts Crossing Rd,Capital BikeShare | Joyce St & 16th St S,Capital BikeShare | Kansas Ave & Sherman Cr NW,Capital BikeShare | Kenmore St & 24th St S,Capital BikeShare | Kennebec St & 11th St N,Capital BikeShare | Kennedy Center,Capital BikeShare | Key Blvd & N Quinn St,Capital BikeShare | Key West Ave & Diamondback Dr,Capital BikeShare | Key West Ave & Great Seneca Hwy,Capital BikeShare | Key West Ave & Siesta Key Way,Capital BikeShare | King Farm Blvd & Piccard Dr,Capital BikeShare | King Farm Blvd & Pleasant Dr,Capital BikeShare | King Greenleaf Rec Center,Capital BikeShare | King St & Patrick St,Capital BikeShare | King St Metro North / Cameron St,Capital BikeShare | King St Metro South,Capital BikeShare | L'Enfant Plaza / 7th & C St SW,Capital BikeShare | Lamont & Mt Pleasant NW,Capital BikeShare | Largo Rd & Campus Way / Prince Georges's Comm Col,Capital BikeShare | Largo Town Center Metro,Capital BikeShare | Lee Center,Capital BikeShare | Lee Hwy & N Adams St,Capital BikeShare | Lee Hwy & N Cleveland St,Capital BikeShare | Lee Hwy & N Kirkwood Rd,Capital BikeShare | Lee Hwy & N Monroe St,Capital BikeShare | Lee Hwy & N Scott St,Capital BikeShare | Lee Hwy & N Woodstock St,Capital BikeShare | Library St & Freedom Dr,Capital BikeShare | Lincoln Memorial,Capital BikeShare | Lincoln Park / 13th & East Capitol St NE,Capital BikeShare | Lincoln Rd & Seaton Pl NE/Harry Thomas Rec Center,Capital BikeShare | Livingston Rd & 3rd St SE,Capital BikeShare | Long Bridge Park / Long Bridge Dr & 6th St S,Capital BikeShare | Lynn St & 19th St North,Capital BikeShare | Lyttonsville Rd & Lyttonsville Pl,Capital BikeShare | M St & New Jersey Ave SE,Capital BikeShare | M St & Pennsylvania Ave NW,Capital BikeShare | Madison St & Fairfax St,Capital BikeShare | Madison St & N Henry St,Capital BikeShare | Maine Ave & 7th St SW,Capital BikeShare | Maine Ave & 9th St SW,Capital BikeShare | Maple & Ritchie Ave,Capital BikeShare | Market Square / King St & Royal St,Capital BikeShare | Maryland Ave & 17th St NE,Capital BikeShare | Maryland Ave & E St NE,Capital BikeShare | Massachusetts Ave & 6th St NE,Capital BikeShare | Massachusetts Ave & Dupont Circle NW,Capital BikeShare | McLean Metro,Capital BikeShare | Medical Center Dr & Key West Ave,Capital BikeShare | Medical Center Metro,Capital BikeShare | Merrifield Cinema & Merrifield Town Center,Capital BikeShare | Merrilee Dr & Lauren Elizabeth Lane,Capital BikeShare | Metro Center / 12th & G St NW,Capital BikeShare | Minnesota Ave Metro/DOES,Capital BikeShare | Mississippi Ave & 19th St SE / THEARC,Capital BikeShare | Monroe Ave & Leslie Ave,Capital BikeShare | Monroe St & Monroe Pl,Capital BikeShare | Montello Ave & Holbrook Terr NE,Capital BikeShare | Montgomery & East Ln,Capital BikeShare | Montgomery Ave & Waverly St,Capital BikeShare | Montgomery College / W Campus Dr & Mannakee St,Capital BikeShare | Mount Vernon Ave & Bruce St,Capital BikeShare | Mount Vernon Ave & E Del Ray Ave,Capital BikeShare | Mount Vernon Ave & E Nelson Ave,Capital BikeShare | Mount Vernon Ave & Four Mile Run Park,Capital BikeShare | Mount Vernon Ave & Kennedy St,Capital BikeShare | N Lynn St & Fairfax Dr,Capital BikeShare | N Oak St & W Broad St,Capital BikeShare | N Quincy St & Glebe Rd,Capital BikeShare | N Roosevelt St & Roosevelt Blvd,Capital BikeShare | N Veitch St & 20th St N,Capital BikeShare | N Veitch St & Key Blvd,Capital BikeShare | Nannie Helen Burroughs & Minnesota Ave NE,Capital BikeShare | Nannie Helen Burroughs Ave & 49th St NE,Capital BikeShare | Neal St & Trinidad Ave NE,Capital BikeShare | Needwood Rd & Eagles Head Ct,Capital BikeShare | New Dominion Pkwy & Fountain Dr,Capital BikeShare | New Hampshire & Gallatin St NW,Capital BikeShare | New Hampshire & Kirklynn Ave,Capital BikeShare | New Hampshire Ave & 24th St NW,Capital BikeShare | New Hampshire Ave & East-West Hwy,Capital BikeShare | New Hampshire Ave & T St NW,Capital BikeShare | New Jersey Ave & F St NW,Capital BikeShare | New Jersey Ave & L St NW,Capital BikeShare | New Jersey Ave & N St NW/Dunbar HS,Capital BikeShare | New Jersey Ave & R St NW,Capital BikeShare | New York Ave & 15th St NW,Capital BikeShare | New York Ave & Hecht Ave NE,Capital BikeShare | Norfolk & Rugby Ave,Capital BikeShare | Norfolk Ave & Fairmont St,Capital BikeShare | North Capitol & R St NE,Capital BikeShare | North Capitol St & F St NW,Capital BikeShare | North Capitol St & G Pl NE,Capital BikeShare | North Shore & Cameron Crescent Dr/Crescent Apartments,Capital BikeShare | North Shore Dr & Village Rd,Capital BikeShare | Northwestern High School,Capital BikeShare | Offutt Ln & Chevy Chase Dr,Capital BikeShare | Oglethorpe St & 42nd Ave,Capital BikeShare | Ohio Dr & West Basin Dr SW / MLK & FDR Memorials,Capital BikeShare | Oklahoma Ave & D St NE,Capital BikeShare | Old Georgetown Rd & Southwick St,Capital BikeShare | Oxon Hill Park & Ride,Capital BikeShare | Park Rd & Holmead Pl NW,Capital BikeShare | Park Run & Onyx Dr,Capital BikeShare | Pennsylvania & Minnesota Ave SE,Capital BikeShare | Pennsylvania Ave & Park Ave,Capital BikeShare | Pentagon City Metro / 12th St & S Hayes St,Capital BikeShare | Perry & 35th St,Capital BikeShare | Pershing Dr & N George Mason Dr,Capital BikeShare | Pershing Dr & Wayne St,Capital BikeShare | Philadelphia & Maple Ave,Capital BikeShare | Piccard & W Gude Dr,Capital BikeShare | Pleasant St & MLK Ave SE,Capital BikeShare | Pooks Hill Rd & Linden Ave,Capital BikeShare | Potomac & M St NW,Capital BikeShare | Potomac & Pennsylvania Ave SE,Capital BikeShare | Potomac Ave & 35th St S,Capital BikeShare | Potomac Ave & 8th St SE,Capital BikeShare | Potomac Ave & Half St SW,Capital BikeShare | Potomac Ave & Main Line Blvd,Capital BikeShare | Potomac Ave & Swann Ave,Capital BikeShare | Potomac Greens Dr & Slaters Ln,Capital BikeShare | Powhatan St & Bashford Ln,Capital BikeShare | Prince St & Union St,Capital BikeShare | Queens Chapel & Hamilton St,Capital BikeShare | Radford St & Osage St,Capital BikeShare | Randle Circle & Minnesota Ave SE,Capital BikeShare | Reston Pkwy & Spectrum Dr,Capital BikeShare | Reston Regional Library,Capital BikeShare | Reston Town Center Transit Station,Capital BikeShare | Reston YMCA,Capital BikeShare | Rhode Island & Connecticut Ave NW,Capital BikeShare | Rhode Island Ave & 39th St / Brentwood Arts Exchange,Capital BikeShare | Rhode Island Ave & Montana Ave NE,Capital BikeShare | Rhode Island Ave & V St NE,Capital BikeShare | Rhode Island Ave Metro,Capital BikeShare | Rhodes St & 16th St N,Capital BikeShare | Riggs Rd & East West Hwy,Capital BikeShare | Ripley & Bonifant St,Capital BikeShare | River Rd & Landy Ln,Capital BikeShare | Rockville Metro East,Capital BikeShare | Rockville Metro West,Capital BikeShare | Rockville Pike & Meeting St,Capital BikeShare | Rockville Pike & Old Georgetown Rd,Capital BikeShare | Rolfe St & 9th St S,Capital BikeShare | Roosevelt Island,Capital BikeShare | Rosedale Rec Center,Capital BikeShare | Rosslyn Metro / Wilson Blvd & Ft Myer Dr,Capital BikeShare | Royal St & Wilkes St,Capital BikeShare | S Arlington Mill Dr & Campbell Ave,Capital BikeShare | S George Mason & Four Mile Run Dr,Capital BikeShare | S Glebe Rd & Potomac Ave,Capital BikeShare | S Maple Ave & S Washington St,Capital BikeShare | Saint Asaph St & Madison St,Capital BikeShare | Saint Asaph St & Pendleton  St,Capital BikeShare | Shady Grove Hospital,Capital BikeShare | Shady Grove Metro East,Capital BikeShare | Shady Grove Metro West,Capital BikeShare | Shirlington Transit Center / Quincy St & Randolph St,Capital BikeShare | Silver Spring Metro / Colesville Rd & Wayne Ave,Capital BikeShare | Sligo Ave & Carroll Ln,Capital BikeShare | Smithsonian-National Mall / Jefferson Dr & 12th St SW,Capital BikeShare | South Capitol & Atlantic St SW,Capital BikeShare | Southern Ave Metro,Capital BikeShare | Spring Hill Metro,Capital BikeShare | Spring St & 2nd Ave,Capital BikeShare | Stanton Square SE,Capital BikeShare | State Theatre / Park Pl & N Washington St,Capital BikeShare | Sunset Hills & Old Reston Ave,Capital BikeShare | Sunset Hills Rd & Discovery Square,Capital BikeShare | Sunset Hills Rd & Isaac Newton Square,Capital BikeShare | TJ Cmty Ctr / 2nd St & S Old Glebe Rd,Capital BikeShare | Taft St & E Gude Dr,Capital BikeShare | Takoma Metro,Capital BikeShare | Takoma Park Rec Center,Capital BikeShare | Tanger Outlets,Capital BikeShare | Temporary Rd & Old Reston Ave,Capital BikeShare | Tenleytown / Wisconsin Ave & Albemarle St NW,Capital BikeShare | Thomas Circle,Capital BikeShare | Towers Crescent Dr & Tysons One Pl,Capital BikeShare | Town Center Pkwy & Bowman Towne Dr,Capital BikeShare | Town Center Pkwy & Sunset Hills Rd,Capital BikeShare | Traville Gateway Dr & Gudelsky Dr,Capital BikeShare | Trinidad Rec Center,Capital BikeShare | Troy St & 26th St S,Capital BikeShare | Twinbrook Metro,Capital BikeShare | Tysons Corner Station,Capital BikeShare | Tysons One Pl & Chain Bridge Rd,Capital BikeShare | Tysons West Transit Center,Capital BikeShare | US Dept of State / Virginia Ave & 21st St NW,Capital BikeShare | USDA / 12th & C St SW,Capital BikeShare | Union Market,Capital BikeShare | United Medical Center,Capital BikeShare | Utah St & 11th St N,Capital BikeShare | Van Ness Metro / UDC,Capital BikeShare | Vermont Ave & I St NW,Capital BikeShare | Veterans Pl & Pershing Dr,Capital BikeShare | Virginia Ave & 25th St NW,Capital BikeShare | Virginia Square Metro / Monroe St & 9th St N,Capital BikeShare | W Broad St & Little Falls St,Capital BikeShare | W Columbia St & N Washington St,Capital BikeShare | WAU / Flower Ave & Division St,Capital BikeShare | Walter Reed Dr & 16th St S,Capital BikeShare | Walter Reed Dr & 8th St S,Capital BikeShare | Ward Circle / American University,Capital BikeShare | Washington & Independence Ave SW/HHS,Capital BikeShare | Washington Blvd & 10th St N,Capital BikeShare | Washington Blvd & 7th St N,Capital BikeShare | Washington Blvd & N Frederick St,Capital BikeShare | Washington Blvd & Walter Reed Dr,Capital BikeShare | Washington-Liberty High School / N Stafford St & Generals Way,Capital BikeShare | West Falls Church Metro,Capital BikeShare | Westover Library / Washington Blvd & N McKinley Rd,Capital BikeShare | Westpark & Jones Branch Dr,Capital BikeShare | Westpark & Park Run Dr,Capital BikeShare | Westpark Dr & Leesburg Pike,Capital BikeShare | Wheaton Metro / Georgia Ave & Reedie Dr,Capital BikeShare | White Flint Metro,Capital BikeShare | Wiehle Ave & Reston Station Blvd,Capital BikeShare | Wilson Blvd & N Edgewood St,Capital BikeShare | Wilson Blvd & N Franklin Rd,Capital BikeShare | Wilson Blvd & N Illinois St,Capital BikeShare | Wilson Blvd & N Quincy St,Capital BikeShare | Wilson Blvd & N Troy St,Capital BikeShare | Wilson Blvd & N Uhle St,Capital BikeShare | Windham Ln & Amherst Ave,Capital BikeShare | Wisconsin Ave & Brandywine St NW,Capital BikeShare | Wisconsin Ave & Ingomar St NW,Capital BikeShare | Wisconsin Ave & Newark St NW,Capital BikeShare | Wisconsin Ave & O St NW,Capital BikeShare | Woodglen Dr & Executive Blvd,Capital BikeShare | Woodley Park Metro / Calvert St & Connecticut Ave NW,Capital BikeShare | Woodmont Ave & Strathmore St,Capital BikeShare | Yuma St & Tenley Circle NW,Carbonia | Caterina,Carbonia | Centro Intermodale,Carbonia | Cittadini,Carbonia | Gramsci,Carbonia | Grande Miniera di  Serbariu,Carbonia | Manno,Carbonia | Minatori,Carbonia | Primo Maggio,Carbonia | Repubblica,Carbonia | Rinascita,Cassano d'Adda | Comune,Cassano d'Adda | Stazione FF.SS.,Castellucchio | Castellucchio,Charlotte B-cycle | 1201 Central Ave,Charlotte B-cycle | 4th & Cedar,Charlotte B-cycle | 4th & College,Charlotte B-cycle | 6th & Pine,Charlotte B-cycle | 7th St. Public Market,Charlotte B-cycle | Berkshire Dilworth,Charlotte B-cycle | Bland St.,Charlotte B-cycle | Carolinas Medical Center,Charlotte B-cycle | Convention Center,Charlotte B-cycle | East/West Blvd.,Charlotte B-cycle | Elizabeth Ave./Presbyterian Hospital,Charlotte B-cycle | Freedom Park,Charlotte B-cycle | Gateway Village,Charlotte B-cycle | Government Center,Charlotte B-cycle | Johnson C. Smith University,Charlotte B-cycle | Kings Dr./CPCC,Charlotte B-cycle | Levine Ave. of the Arts,Charlotte B-cycle | Metropolitan,Charlotte B-cycle | Montford,Charlotte B-cycle | New Bern,Charlotte B-cycle | ONE305,Charlotte B-cycle | Romare Bearden Park,Charlotte B-cycle | S. Tryon & Morehead,Charlotte B-cycle | Skyhouse,Charlotte B-cycle | Trade & Tryon,Charlotte B-cycle | Tryon & 3rd,Charlotte B-cycle | Tryon & 7th,Charlotte B-cycle | UNC Charlotte Uptown,Charlotte B-cycle | Whole Foods,Chartered Bike | 10.5 NO.,"Chartered Bike | 10.NO MARKET, BMC PARKING",Chartered Bike | 1100 QUARTERS,Chartered Bike | 5 NO. MARKET,Chartered Bike | 6 NO. MARKET,Chartered Bike | ADITYA AVENUE,Chartered Bike | AIIMS 1 (TRAUMA CENTER),Chartered Bike | AIIMS 2 (NURSING HOSTEL),Chartered Bike | AKRITI ECO CITY BLUE SKY,Chartered Bike | ARMY CANT,Chartered Bike | ARMY CANT 2,Chartered Bike | ASHOKA SOACIETY E7 AREARA COLONY,Chartered Bike | AURA MALL,Chartered Bike | AVADHPURI TIRAHA,"Chartered Bike | BAGMUGALIA, KATARA HILLS RD.",Chartered Bike | BAIRAGARH POLICE STATION,Chartered Bike | BASANT KUNJ E8 ARERA COLONY,Chartered Bike | BDA COMPLEX,"Chartered Bike | BEEMA HOSPITAL, SECTOR C",Chartered Bike | BHEL SANGAM CHAURAHA,Chartered Bike | BITTAN SQUARE,Chartered Bike | BMC PARKING ZONE II,Chartered Bike | BOAT CLUB 1,Chartered Bike | BOAT CLUB 2,Chartered Bike | CHITRAGUPT MARG 1 (DB MALL),Chartered Bike | DANISH SQUARE,Chartered Bike | DEPOT SQUARE,Chartered Bike | DRM ROAD 1,Chartered Bike | E-2 NURSERY,Chartered Bike | EKANT PARK,Chartered Bike | FOUNTAIN PARK MINAAL CAMPUS,Chartered Bike | GAUHAR MAHAL,Chartered Bike | GAYATRI PARISAR,Chartered Bike | GOVT. MIDDLE SCHOOL JATKHEDI,Chartered Bike | HOSHANGABAD 1,Chartered Bike | HOSHANGABAD 10,Chartered Bike | HOSHANGABAD 2,Chartered Bike | HOSHANGABAD 3,Chartered Bike | HOSHANGABAD 4,Chartered Bike | HOSHANGABAD 5,Chartered Bike | HOSHANGABAD 6,Chartered Bike | HOSHANGABAD 7,Chartered Bike | HOSHANGABAD 8,Chartered Bike | HOSHANGABAD 9,Chartered Bike | INDRAPURI PARK SECTOR C,Chartered Bike | ISBT,Chartered Bike | J.K. SQUARE,Chartered Bike | KAMLA NAGAR THANA,Chartered Bike | KAMLA NEHRU GIRLS SCHOOL T.T. NAGAR,Chartered Bike | LALGHATI SQUARE (VIP ROAD),Chartered Bike | MAHAKALI SOCIETY (TRILANGA),Chartered Bike | MANIT SQUARE,Chartered Bike | MAYUR PARK LINK ROAD NO.1,Chartered Bike | MINAAL MALL,Chartered Bike | MOGLI PARK MINAAL CAMPUS,Chartered Bike | NANDAN KANAN PARK (CHARIMLI),Chartered Bike | NIZAMUDDIN ROAD 1,Chartered Bike | NIZAMUDDIN ROAD 2,Chartered Bike | NIZAMUDDIN ROAD 3,Chartered Bike | NUTAN COLLEGE,Chartered Bike | P&T SQUARE,Chartered Bike | PANCHVATI MARKET,Chartered Bike | PATRAKAAR COLONY,Chartered Bike | POLICE CONTROL ROOM,Chartered Bike | POLYTECHNIC SQUARE,Chartered Bike | RACHNA NAGAR (Underbridge),Chartered Bike | RAJIV GANDHI CHOWK,Chartered Bike | RCVP NORONHA ACADEMY,Chartered Bike | RM MARG 1,Chartered Bike | RM MARG 2,Chartered Bike | ROSHANPURA SQUARE,Chartered Bike | SAIR SAPATA,Chartered Bike | SANKET NAGAR AIIMS ROAD 1,Chartered Bike | SANKET NAGAR AIIMS ROAD 2,Chartered Bike | SELFIE POINT VIP ROAD,Chartered Bike | SHAHPURA LAKE,Chartered Bike | SHAKTI NAGAR MARKET,Chartered Bike | SHALIMAR ENCLAVE,Chartered Bike | SHIVNEER WATER PLANT ZONE 2,Chartered Bike | SMART CITY,Chartered Bike | SMART PARKING T.T. NAGAR,Chartered Bike | SOUTH AVENUE,Chartered Bike | SWARNA JAYANTI PARK,Chartered Bike | TULSI NAGAR,Chartered Bike | VAN VIHAR (RAMU GATE),Chartered Bike | VAN VIHAR GATE NO. 1,Chartered Bike | VARDHMAAN PARK,Chartered Bike | VINDHYACHAL BHAWAN,Chartered Bike | VIP ROAD (KARBALA),Chivasso | ASL,Chivasso | Blatta Scuole,Chivasso | Borgo Sud Est / ASL,Chivasso | Cappuccini,Chivasso | Chivasso Est,Chivasso | Chivasso Ovest,Chivasso | Municipio,Chivasso | Ospedale,Chivasso | Palazzo Einaudi,Chivasso | Piazzale Ceresa,Chivasso | Piazzale Libertini,Chivasso | Stazione Ferroviaria,CicloSampa | Berrini,CicloSampa | Butantã,CicloSampa | Campinas,CicloSampa | Cidade Jardim,CicloSampa | Delfina,CicloSampa | Europa,CicloSampa | Hcor,CicloSampa | Helio Pelegrino,CicloSampa | Itapeva,CicloSampa | Oscar Freire,CicloSampa | Pamplona,CicloSampa | Parada Inglesa,CicloSampa | Parque Ibirapuera II,CicloSampa | Parque Vila Lobos,CicloSampa | Pedroso,CicloSampa | Praça Panamericana,CicloSampa | Teatro Renaissance,CicloSampa | Vila Olímpia,CicloSampa | inovaBra,Ciclopi | Aeroporto,Ciclopi | Borgo Stretto,Ciclopi | C. Marchesi,Ciclopi | CEP,Ciclopi | CNR-Praticelli,Ciclopi | CUS Pisa,Ciclopi | Cavalieri,Ciclopi | Comune Palazzo Blu,Ciclopi | Duomo,Ciclopi | Edificio 3,Ciclopi | Edificio 6,Ciclopi | Galleria Gerace,Ciclopi | Guerrazzi,Ciclopi | I Passi,Ciclopi | Isola Verde,Ciclopi | La Fontina,Ciclopi | Livornese,Ciclopi | M. Liberta`,Ciclopi | Ospedale Cisanello,Ciclopi | Palacongressi,Ciclopi | Paparelli,Ciclopi | Park Cisanello,Ciclopi | Pietrasantina,Ciclopi | Polo Marzotto,Ciclopi | Porta a Lucca,Ciclopi | Pratale,Ciclopi | Praticelli,Ciclopi | San Giusto,Ciclopi | San Paolo,Ciclopi | San Rossore F.S.,Ciclopi | San Silvestro,Ciclopi | Sesta Porta,Ciclopi | Sms Biblioteca,Ciclopi | Solferino,Ciclopi | Stazione F.S.,Ciclopi | Teatro Tribunale,Ciclopi | USL Garibaldi,Ciclopi | Vecchi Macelli,Ciclopi | Vittorio Emanuele,Ciechanowski Rower Miejski | Armii Krajowej,Ciechanowski Rower Miejski | Ciechanów Przemysłowy,Ciechanowski Rower Miejski | Dworzec PKP,Ciechanowski Rower Miejski | Gostkowska Cmentarz,Ciechanowski Rower Miejski | Kąpielisko Krubin,Ciechanowski Rower Miejski | MOSiR Kryta Pływalnia,Ciechanowski Rower Miejski | Plac Kościuszki,Ciechanowski Rower Miejski | Powstańców Wielkoposkich,Ciechanowski Rower Miejski | Ratusz,Cincy Red Bike | 12th & Vine,Cincy Red Bike | 15th & Vine,Cincy Red Bike | 2nd & Rosa Parks,Cincy Red Bike | 3rd & Plum,Cincy Red Bike | 4th & Vine,Cincy Red Bike | 8th & Broadway,Cincy Red Bike | Aronoff Center,Cincy Red Bike | Ball Park,Cincy Red Bike | Calhoun & Dennis,Cincy Red Bike | Casino,Cincy Red Bike | Cincy State,Cincy Red Bike | City Hall,Cincy Red Bike | CityLink Center,Cincy Red Bike | Clifton Library & Burnet Woods,Cincy Red Bike | Clifton at Stratford Heights,Cincy Red Bike | Convention Center,Cincy Red Bike | Duveneck Square,Cincy Red Bike | East Row Historic District,Cincy Red Bike | Eden Park,Cincy Red Bike | Elm & Henry,Cincy Red Bike | Ezzard Charles,Cincy Red Bike | Fairfield & Ward,Cincy Red Bike | Findlay Market,Cincy Red Bike | Fountain Square,Cincy Red Bike | Freedom Center,Cincy Red Bike | Gateway College & Library,Cincy Red Bike | Hoffner Park,Cincy Red Bike | Howell & Clifton,Cincy Red Bike | Jefferson & University,Cincy Red Bike | Kingsgate,Cincy Red Bike | Longworth Hall,Cincy Red Bike | MLK & Eden,Cincy Red Bike | Main & Central Parkway,Cincy Red Bike | Main & Orchard,Cincy Red Bike | MainStrasse,Cincy Red Bike | McMillan & W Clifton,Cincy Red Bike | Monmouth,Cincy Red Bike | Newport on the Levee East,Cincy Red Bike | Newport on the Levee West,Cincy Red Bike | P & G,Cincy Red Bike | Pendleton,Cincy Red Bike | Port Bellevue,Cincy Red Bike | Prospect Hill,Cincy Red Bike | Public Library,Cincy Red Bike | Rivercenter & NKY Convention Center,Cincy Red Bike | Roebling Point,Cincy Red Bike | Sawyer Point,Cincy Red Bike | Short Vine & Corry,Cincy Red Bike | Short Vine & Daniels,Cincy Red Bike | Smale Riverfront Park,Cincy Red Bike | Theodore M. Berry International Friendship Park,Cincy Red Bike | UC Health,Cincy Red Bike | Vine & Court,Cincy Red Bike | Washington Park,Cincy Red Bike | West 3rd & Bakewell,Cincy Red Bike | YMCA,Cincy Red Bike | Zoo,Citi Bike Miami | 101 - Inside South Pointe Park,Citi Bike Miami | 102 - Entrance to South Pointe Park,Citi Bike Miami | 103 - Ocean Dr & 1st Street,Citi Bike Miami | 105 - 1st Street & Alton Rd,Citi Bike Miami | 106 - Ocean Dr & 2nd Street,Citi Bike Miami | 107 - 2nd Street & Collins Ave,Citi Bike Miami | 109 - Michigan Ave & 3rd Street,Citi Bike Miami | 111 - 4th Street & Alton Rd,Citi Bike Miami | 112 - Washington Ave & 3rd Street,Citi Bike Miami | 114 - Ocean Dr & 5th Street,Citi Bike Miami | 116 - Ocean Dr & 7th Street,Citi Bike Miami | 117 - Ocean Dr & 9th Street,Citi Bike Miami | 118 - Ocean Dr and 10th Street (Art Deco Welcome Center),Citi Bike Miami | 119 - Ocean Dr and 12th Street,Citi Bike Miami | 121 - Ocean Dr at 14th Street,Citi Bike Miami | 122 - Ocean Dr & 14th Place,Citi Bike Miami | 123 - Washington Ave & 7th Street,Citi Bike Miami | 124 - 7th Street Parking Garage,Citi Bike Miami | 126 - Meridian Ave & 6th St,Citi Bike Miami | 127 - Jefferson Ave & 6th Street,Citi Bike Miami | 128 - Michigan Ave & 5th Street,Citi Bike Miami | 129 - Lenox Ave & 6th Street,Citi Bike Miami | 132 - 9th Street & Lenox Ave,Citi Bike Miami | 133 - 9th Street & Meridian Ave,Citi Bike Miami | 134 - 8th Street & Jefferson Ave,Citi Bike Miami | 136 - 9th Street & Washington Ave,Citi Bike Miami | 138 - 11th Street & Washington Ave,Citi Bike Miami | 139 - West Ave & 10th Street (Whole Foods),Citi Bike Miami | 141 - Jefferson Ave & 11th Street (Flamingo Park),Citi Bike Miami | 142 - Alton Rd at 11th Street (Flamingo Park),Citi Bike Miami | 143 - 12th Street & West Ave,Citi Bike Miami | 144 - Meridian Ave & 13th Street (Flamingo Park),Citi Bike Miami | 146 - Pennsylvania Ave & 13th Street,Citi Bike Miami | 147 - Washington & 13th Street,Citi Bike Miami | 148 - 13th Steet & Collins Ave,Citi Bike Miami | 149 - 14th Street & Collins Ave,Citi Bike Miami | 151 - Michigan Ave & 14th Street,Citi Bike Miami | 154 - Bay Rd & 15th Street,Citi Bike Miami | 156 - 16th Street & Bay Rd,Citi Bike Miami | 157 - 15th Street & Alton Rd,Citi Bike Miami | 158 - Euclid & 15th Street,Citi Bike Miami | 159 - 15th Street & Washington Ave,Citi Bike Miami | 161 - 15th Street & Collins Ave,Citi Bike Miami | 162 - Pennsylvania Ave & 16th Street,Citi Bike Miami | 163 - Lincoln Rd & James Ave (CVS Pharmacy),Citi Bike Miami | 164 - Washington Ave & 17th Street (The Fillmore),Citi Bike Miami | 166 - Drexel Ave & Lincoln Rd (MB Community Church),Citi Bike Miami | 167 - Pennsylvania Ave & Lincoln Rd (H & M),Citi Bike Miami | 169 - Meridian Ave & Lincoln Lane (Macy's),Citi Bike Miami | 171 - Jefferson Ave & Lincoln Rd (DogBar),Citi Bike Miami | 172 - Michigan Ave & Lincoln Rd (The Gap),Citi Bike Miami | 173 - Lenox Ave & Lincoln Rd (YardHouse),Citi Bike Miami | 174 - Lincoln Road & West Ave,Citi Bike Miami | 175 - Lincoln Rd & Bay Rd,Citi Bike Miami | 176 - Venetian Causeway & Island Ave (The Standard Hotel,Citi Bike Miami | 177 - Purdy Ave & 18th Street (Marina),Citi Bike Miami | 178 - 17th Street & Convention Center Dr (City Hall),Citi Bike Miami | 179 - Convention Center Dr @ Hall C Entrance,Citi Bike Miami | 181 - 17th Street & Collins Ave,Citi Bike Miami | 182 - 18th Street & Collins Ave,Citi Bike Miami | 183 - Washington Ave & 20th Street,Citi Bike Miami | 184 - 19th Street & Dade Blvd (Publix),Citi Bike Miami | 187 - West Ave & 20th Street (Publix on the Bay),Citi Bike Miami | 2 - DEMO DeocBike,Citi Bike Miami | 201 - 21st Street & Collins Ave,Citi Bike Miami | 202 - 22nd Street & Collins Ave (W Hotel),Citi Bike Miami | 203 - 23rd Street & Collins Ave (Walgreens),Citi Bike Miami | 205 - 24th and Collins Ave,Citi Bike Miami | 206 - 25th Street & Collins Ave,Citi Bike Miami | 207 - 26th Street & Collins Ave,Citi Bike Miami | 208 - 26th Street & Pine Tree Dr,Citi Bike Miami | 210 - 31st Street & Collins Ave,Citi Bike Miami | 211 - 35th Street & Collins Ave,Citi Bike Miami | 212 - 40th Street & Collins Ave,Citi Bike Miami | 214 - Royal Palm Ave Between 41St & 42St,Citi Bike Miami | 215 - Chase Ave Between 40st & 41st,Citi Bike Miami | 216 - 39th Street & Alton Rd,Citi Bike Miami | 218 - Prarie Between Chase & 44 Terr,Citi Bike Miami | 220 - Collins Ave & 44th Street (Fountainbleau Hotel),Citi Bike Miami | 221 - 46th Street & Collins Ave (Parking Lot),Citi Bike Miami | 302 - Collins Ave & 5300 Block,Citi Bike Miami | 304 - 64th Street & Collins Ave (parking lot),Citi Bike Miami | 305 - 67th Street & Collins Ave,Citi Bike Miami | 306 - 69th Street & Collins Ave (Publix),Citi Bike Miami | 308 - 71st Street & Byron Ave,Citi Bike Miami | 309 - Vichy Dr & 71st Street,Citi Bike Miami | 310 - Rue Notre Dame & 71 Street,Citi Bike Miami | 311 - Trouville Esplanade & Normandy Dr,Citi Bike Miami | 313 - 73rd Street & Dickens Ave,Citi Bike Miami | 314 - Collins Ave & 73rd Street,Citi Bike Miami | 315 - 76th Street & Collins Ave,Citi Bike Miami | 316 - 79th Street & Collins Ave,Citi Bike Miami | 401 - 88th Street & Harding Ave,Citi Bike Miami | 402 - Collins Ave & 93rd Street,Citi Bike Miami | 403 - 94th Street & Harding Ave (Publix),Citi Bike Miami | 405 - 96th Street (Entrance to beach),Citi Bike Miami | 5 - Demo CycloShare  Lab,Citi Bike Miami | 501 - W Bay Harbor Dr & 97th Street,Citi Bike Miami | 502 - 103rd Street btw W and E Bay Harbor Dr,Citi Bike Miami | 601 - Grand Ave & Main Hwy,Citi Bike Miami | 605 - Virginia St & Florida Ave,Citi Bike Miami | 606 - S Bayshor Dr & Aviation Ave,Citi Bike Miami | 608 - City Hall,Citi Bike Miami | 609 - Charthouse Dr & S. Bayshore Dr,Citi Bike Miami | 610 - S. Bayshore Dr btw Kirk & Emathia,Citi Bike Miami | 611 - 32 Rd & South Miami Ave,Citi Bike Miami | 612 - SE Brickell Ave & 25th Rd,Citi Bike Miami | 615 - Brickell Ave & SW 18 Road,Citi Bike Miami | 616 - 150 SW 15th Road,Citi Bike Miami | 617 - S Miami Ave & 13th Street,Citi Bike Miami | 618 - SE 5th Street & Brickell Ave,Citi Bike Miami | 620 - 14th Street & SE Brickell Ave,Citi Bike Miami | 621 - SE 14th St & S Miami Ave,Citi Bike Miami | 624 - SW 9th St & S Miami Ave,Citi Bike Miami | 625 - SE 10th St & S Miami Ave,Citi Bike Miami | 627 - SW 9th St & 1st Ave,Citi Bike Miami | 629 - SW 3rd Ave & 7th St,Citi Bike Miami | 630 - 10th Ave & SW 8th St,Citi Bike Miami | 632 - 1st CT & SW 7th St,Citi Bike Miami | 633 - SW 12th Street & S Miami Ave,Citi Bike Miami | 634 - Brickell Ave & SE 8th Street (east side),Citi Bike Miami | 639 - Chopin Plaza & Biscayne Blvd,Citi Bike Miami | 640 - SE 2nd Ave & 4st ( James L. Knight Center),Citi Bike Miami | 643 - NE 3rd Ave & 2 Street,Citi Bike Miami | 645 - Biscayne Blvd btw NE 5th & 6th street,Citi Bike Miami | 646 - NE 3 Street & Biscayne Blvd,Citi Bike Miami | 647 - Biscayne Blvd & NE 8th Street,Citi Bike Miami | 648 - Museum Park,Citi Bike Miami | 650 - NE 14th Terr & Biscayne Blvd,Citi Bike Miami | 651 - Biscayne Blvd & NE 15th Terr,Citi Bike Miami | 652 - NE 15th St & Herald Plaza,Citi Bike Miami | 653 - N. Bayshore Dr btw NE 17th & 18th St,Citi Bike Miami | 654 - NE 19th St & Biscayne Blvd,Citi Bike Miami | 655 - NW 2nd Ave & 24th St,Citi Bike Miami | 656 - NE 25th St & Biscayne Blvd,Citi Bike Miami | 657 - NE 30th St & Biscayne Blvd,Citi Bike Miami | 658 - NE 39th Street & Biscayne Blvd,Citi Bike Miami | 664 - NW 3rd Ave & 27th Terr,Citi Bike Miami | 665 - 26th St & NW 2nd Ave,Citi Bike Miami | 666 - NE 27th St & N. Miami Ave,Citi Bike Miami | 667 - SE 3 Ave & North of 1 Street,Citi Bike Miami | 674 - 48 NW 2nd Street,Citi Bike Miami | 675 - 444 SW 2 Ave (Miami River Side Center),Citi Bike Miami | 676 - NW 1st Street & 1st Ave,Citi Bike Miami | 677 - Biscayne Blvd NE 48 Street,Citi Bike Miami | 678 - Biscayne Blvd NE 55th Ter,Citi Bike Miami | 680 - Biscayne Blvd NE 65th Street,Citi Bike | 1 Ave & E 110 St,Citi Bike | 1 Ave & E 16 St,Citi Bike | 1 Ave & E 18 St,Citi Bike | 1 Ave & E 30 St,Citi Bike | 1 Ave & E 44 St,Citi Bike | 1 Ave & E 62 St,Citi Bike | 1 Ave & E 68 St,Citi Bike | 1 Ave & E 78 St,Citi Bike | 1 Ave & E 94 St,Citi Bike | 1 Pl & Clinton St,Citi Bike | 10 Ave & W 28 St,Citi Bike | 10 St & 2 Ave,Citi Bike | 10 St & 5 Ave,Citi Bike | 10 St & 7 Ave,Citi Bike | 11 Ave & W 27 St,Citi Bike | 11 Ave & W 41 St,Citi Bike | 11 Ave & W 59 St,Citi Bike | 11 St & 35 Ave,Citi Bike | 11 St & 43 Ave,Citi Bike | 12 Ave & W 40 St,Citi Bike | 12 St & 4 Ave,Citi Bike | 14 St & 5 Ave,Citi Bike | 14 St & 7 Ave,Citi Bike | 19 St & 24 Ave,Citi Bike | 2 Ave & 36 St - Citi Bike HQ at Industry City,Citi Bike | 2 Ave & E 104 St,Citi Bike | 2 Ave & E 122 St,Citi Bike | 2 Ave & E 31 St,Citi Bike | 2 Ave & E 72 St,Citi Bike | 2 Ave & E 96 St,Citi Bike | 2 Ave & E 99 St,Citi Bike | 21 St & 31 Dr,Citi Bike | 21 St & 36 Ave,Citi Bike | 21 St & 38 Ave,Citi Bike | 21 St & 43 Ave,Citi Bike | 21 St & Hoyt Ave S,Citi Bike | 21 St & Queens Plaza North,Citi Bike | 23 Ave & 27 St,Citi Bike | 24 Ave & 26 St,Citi Bike | 24 Ave & 29 St,Citi Bike | 24 St & 41 Ave,Citi Bike | 27 Ave & 4 St,Citi Bike | 27 Ave & 9 St,Citi Bike | 27 St & Hunter St,Citi Bike | 28 Ave & 35 St,Citi Bike | 28 Ave & 44 St,Citi Bike | 28 St & 36 Ave,Citi Bike | 28 St & 38 Ave,Citi Bike | 28 St & 41 Ave,Citi Bike | 3 Ave & 14 St,Citi Bike | 3 Ave & Carroll St,Citi Bike | 3 Ave & E 100 St,Citi Bike | 3 Ave & E 112 St,Citi Bike | 3 Ave & E 62 St,Citi Bike | 3 Ave & E 71 St,Citi Bike | 3 Ave & E 72 St,Citi Bike | 3 Ave & E 95 St,Citi Bike | 3 Ave & Schermerhorn St,Citi Bike | 3 St & 3 Ave,Citi Bike | 3 St & 7 Ave,Citi Bike | 3 St & Hoyt St,Citi Bike | 3 St & Prospect Park West,Citi Bike | 30 Ave & 21 St,Citi Bike | 31 Ave & 14 St,Citi Bike | 31 Ave & 30 St,Citi Bike | 31 Ave & 34 St,Citi Bike | 31 Ave & Crescent St,Citi Bike | 31 Ave & Steinway St,Citi Bike | 31 St & 23 Ave,Citi Bike | 31 St & Astoria Blvd,Citi Bike | 31 St & Broadway,Citi Bike | 31 St & Hoyt Ave N,Citi Bike | 31 St & Newtown Ave,Citi Bike | 31 St & Northern Blvd,Citi Bike | 31 St & Thomson Ave,Citi Bike | 34 Ave & 13 St,Citi Bike | 34 Ave & 21 St,Citi Bike | 34 Ave & 38 St,Citi Bike | 34 St & 35 Ave,Citi Bike | 35 Ave & 10 St,Citi Bike | 35 Ave & 37 St,Citi Bike | 35 St & 34 Ave,Citi Bike | 35 St & Broadway,Citi Bike | 36 Ave & 10 St,Citi Bike | 36 Ave & 31 St,Citi Bike | 37 Ave & 35 St,Citi Bike | 37 St & 24 Ave,Citi Bike | 39 St & 2 Ave - Citi Bike HQ at Industry City,Citi Bike | 4 Ave & 9 St,Citi Bike | 40 Ave & 9 St,Citi Bike | 40 Ave & Crescent St,Citi Bike | 44 Dr & 21 St,Citi Bike | 44 Dr & Jackson Ave,Citi Bike | 45 Rd & 11 St,Citi Bike | 46 Ave & 5 St,Citi Bike | 47 Ave & 31 St,Citi Bike | 47 Ave & Skillman Ave,Citi Bike | 48 Ave & 30 Pl,Citi Bike | 48 Ave & 5 St,Citi Bike | 49 Ave & 21 St,Citi Bike | 5 Ave & 3 St,Citi Bike | 5 Ave & E 103 St,Citi Bike | 5 Ave & E 126 St,Citi Bike | 5 Ave & E 29 St,Citi Bike | 5 Ave & E 63 St,Citi Bike | 5 Ave & E 73 St,Citi Bike | 5 Ave & E 78 St,Citi Bike | 5 Ave & E 88 St,Citi Bike | 5 Ave & E 93 St,Citi Bike | 5 Corners Library,Citi Bike | 5 St & 51 Ave,Citi Bike | 5 St & 6 Ave,Citi Bike | 5 St & Market St,Citi Bike | 6 Ave & 12 St,Citi Bike | 6 Ave & 9 St,Citi Bike | 6 Ave & Broome St,Citi Bike | 6 Ave & Canal St,Citi Bike | 6 Ave & W 33 St,Citi Bike | 6 Ave & W 34 St,Citi Bike | 6 St & 7 Ave,Citi Bike | 7 Ave & Central Park South,Citi Bike | 7 Ave & Park Pl,Citi Bike | 7 St & 3 Ave,Citi Bike | 7 St & 5 Ave,Citi Bike | 8 Ave & W 31 St,Citi Bike | 8 Ave & W 33 St,Citi Bike | 8 Ave & W 52 St,Citi Bike | 9 Ave & W 18 St,Citi Bike | 9 Ave & W 28 St,Citi Bike | 9 Ave & W 45 St,Citi Bike | 9 St & 44 Rd,Citi Bike | Adam Clayton Powell Blvd & W 115 St,Citi Bike | Adam Clayton Powell Blvd & W 118 St,Citi Bike | Adam Clayton Powell Blvd & W 123 St,Citi Bike | Adam Clayton Powell Blvd & W 126 St,Citi Bike | Adelphi St & Myrtle Ave,Citi Bike | Albany Ave & Fulton St,Citi Bike | Allen St & Hester St,Citi Bike | Allen St & Rivington St,Citi Bike | Allen St & Stanton St,Citi Bike | Amsterdam Ave & W 119 St,Citi Bike | Amsterdam Ave & W 125 St,Citi Bike | Amsterdam Ave & W 66 St,Citi Bike | Amsterdam Ave & W 73 St,Citi Bike | Amsterdam Ave & W 79 St,Citi Bike | Amsterdam Ave & W 82 St,Citi Bike | Astor Place,Citi Bike | Astoria Park S & Shore Blvd,Citi Bike | Atlantic Ave & Fort Greene Pl,Citi Bike | Atlantic Ave & Furman St,Citi Bike | Avenue C & E 18 St,Citi Bike | Avenue D & E 12 St,Citi Bike | Avenue D & E 3 St,Citi Bike | Avenue D & E 8 St,Citi Bike | Baldwin at Montgomery,Citi Bike | Baltic St & 5 Ave,Citi Bike | Bank St & Hudson St,Citi Bike | Bank St & Washington St,Citi Bike | Banker St & Meserole Ave,Citi Bike | Barclay St & Church St,Citi Bike | Barrow St & Hudson St,Citi Bike | Bayard St & Baxter St,Citi Bike | Bayard St & Leonard St,Citi Bike | Bedford Ave & Bergen St,Citi Bike | Bedford Ave & Nassau Ave,Citi Bike | Bedford Ave & S 9 St,Citi Bike | Bergen Ave,Citi Bike | Bergen St & Flatbush Ave,Citi Bike | Bergen St & Smith St,Citi Bike | Bergen St & Vanderbilt Ave,Citi Bike | Berkeley Pl & 6 Ave,Citi Bike | Berkeley Pl & 7 Ave,Citi Bike | Berry St & N 8 St,Citi Bike | Bialystoker Pl & Delancey St,Citi Bike | Boerum St & Broadway,Citi Bike | Bond St & Bergen St,Citi Bike | Bond St & Fulton St,Citi Bike | Broad St & Bridge St,Citi Bike | Broadway & 12 St,Citi Bike | Broadway & Battery Pl,Citi Bike | Broadway & Berry St,Citi Bike | Broadway & E 14 St,Citi Bike | Broadway & E 22 St,Citi Bike | Broadway & Moylan Pl,Citi Bike | Broadway & Roebling St,Citi Bike | Broadway & W 122 St,Citi Bike | Broadway & W 25 St,Citi Bike | Broadway & W 29 St,Citi Bike | Broadway & W 36 St,Citi Bike | Broadway & W 37 St,Citi Bike | Broadway & W 38 St,Citi Bike | Broadway & W 41 St,Citi Bike | Broadway & W 49 St,Citi Bike | Broadway & W 51 St,Citi Bike | Broadway & W 53 St,Citi Bike | Broadway & W 56 St,Citi Bike | Broadway & W 60 St,Citi Bike | Broadway & Whipple St,Citi Bike | Brooklyn Bridge Park - Pier 2,Citi Bike | Brunswick & 6th,Citi Bike | Brunswick St,Citi Bike | Bus Slip & State St,Citi Bike | Bushwick Ave & McKibbin St,Citi Bike | Bushwick Ave & Powers St,Citi Bike | Bushwick Ave & Stagg St,Citi Bike | Butler St & Court St,Citi Bike | Cadman Plaza E & Johnson St,Citi Bike | Cadman Plaza E & Red Cross Pl,Citi Bike | Cadman Plaza West & Montague St,Citi Bike | Cambridge Pl & Gates Ave,Citi Bike | Canal St & Rutgers St,Citi Bike | Carlton Ave & Dean St,Citi Bike | Carlton Ave & Flushing Ave,Citi Bike | Carlton Ave & Park Ave,Citi Bike | Carmine St & 6 Ave,Citi Bike | Carroll St & 5 Ave,Citi Bike | Carroll St & 6 Ave,Citi Bike | Carroll St & Bond St,Citi Bike | Carroll St & Columbia St,Citi Bike | Carroll St & Franklin Ave,Citi Bike | Carroll St & Smith St,Citi Bike | Carroll St & Washington Ave,Citi Bike | Cathedral Pkwy & Broadway,Citi Bike | Catherine St & Monroe St,Citi Bike | Cedar St & Myrtle Ave,Citi Bike | Center Blvd & 48 Ave,Citi Bike | Center Blvd & 51 Ave,Citi Bike | Central Ave & Flushing Ave,Citi Bike | Central Ave & Starr Street,Citi Bike | Central Park North & Adam Clayton Powell Blvd,Citi Bike | Central Park S & 6 Ave,Citi Bike | Central Park W & W 96 St,Citi Bike | Central Park West & W 100 St,Citi Bike | Central Park West & W 102 St,Citi Bike | Central Park West & W 68 St,Citi Bike | Central Park West & W 72 St,Citi Bike | Central Park West & W 76 St,Citi Bike | Central Park West & W 85 St,Citi Bike | Centre St & Chambers St,Citi Bike | Centre St & Worth St,Citi Bike | Cherry St,Citi Bike | Christ Hospital,Citi Bike | Christopher St & Greenwich St,Citi Bike | City Hall,Citi Bike | Clark St & Henry St,Citi Bike | Classon Ave & St Marks Ave,Citi Bike | Clermont Ave & Lafayette Ave,Citi Bike | Clermont Ave & Park Ave,Citi Bike | Cleveland Pl & Spring St,Citi Bike | Cliff St & Fulton St,Citi Bike | Clinton Ave & Flushing Ave,Citi Bike | Clinton St & 4 Place,Citi Bike | Clinton St & Centre St,Citi Bike | Clinton St & Grand St,Citi Bike | Clinton St & Joralemon St,Citi Bike | Clinton St & Union St,Citi Bike | Coffey St & Conover St,Citi Bike | Columbia Heights & Cranberry St,Citi Bike | Columbia St & Degraw St,Citi Bike | Columbia St & Kane St,Citi Bike | Columbia St & Lorraine St,Citi Bike | Columbia St & Rivington St,Citi Bike | Columbia St & W 9 St,Citi Bike | Columbus Ave & W 103 St,Citi Bike | Columbus Ave & W 72 St,Citi Bike | Columbus Ave & W 95 St,Citi Bike | Columbus Dr at Exchange Pl,Citi Bike | Columbus Drive,Citi Bike | Commerce St & Van Brunt St,Citi Bike | Communipaw & Berry Lane,Citi Bike | Concord St & Bridge St,Citi Bike | Congress St & Clinton St,Citi Bike | Cooper Square & Astor Pl,Citi Bike | Court St & Nelson St,Citi Bike | Court St & State St,Citi Bike | Crescent St & 30 Ave,Citi Bike | Crescent St & 34 Ave,Citi Bike | Crescent St & 35 Ave,Citi Bike | Crescent St & Broadway,Citi Bike | Crescent St & Ditmars Blvd,Citi Bike | Cumberland St & Lafayette Ave,Citi Bike | DeKalb Ave & Franklin Ave,Citi Bike | DeKalb Ave & Hudson Ave,Citi Bike | DeKalb Ave & S Portland Ave,Citi Bike | DeKalb Ave & Vanderbilt Ave,Citi Bike | Dean St & 4 Ave,Citi Bike | Dean St & Franklin Ave,Citi Bike | Dean St & Hoyt St,Citi Bike | Degraw St & Hoyt St,Citi Bike | Degraw St & Smith St,Citi Bike | Devoe St & Lorimer St,Citi Bike | Devoe St & Morgan Ave,Citi Bike | Dey St,Citi Bike | Ditmars Blvd & 19 St,Citi Bike | Division Av & Hooper St,Citi Bike | Division Ave & Marcy Ave,Citi Bike | Division St & Bowery,Citi Bike | Dixon Mills,Citi Bike | Dock 72 Way & Market St,Citi Bike | Douglass St & 3 Ave,Citi Bike | Douglass St & 4 Ave,Citi Bike | Driggs Ave & Lorimer St,Citi Bike | Driggs Ave & N 9 St,Citi Bike | Driggs Ave & N Henry St,Citi Bike | Duane St & Greenwich St,Citi Bike | Duffield St & Willoughby St,Citi Bike | Dwight St & Van Dyke St,Citi Bike | E 10 St & 5 Ave,Citi Bike | E 10 St & Avenue A,Citi Bike | E 102 St & 1 Ave,Citi Bike | E 102 St & Park Ave,Citi Bike | E 103 St & Lexington Ave,Citi Bike | E 106 St & 1 Ave,Citi Bike | E 106 St & Lexington Ave,Citi Bike | E 106 St & Madison Ave,Citi Bike | E 109 St & 3 Ave,Citi Bike | E 11 St & 1 Ave,Citi Bike | E 11 St & 2 Ave,Citi Bike | E 11 St & Avenue B,Citi Bike | E 110 St & Madison Ave,Citi Bike | E 114 St & 1 Ave,Citi Bike | E 115 St & Lexington Ave,Citi Bike | E 115 St & Madison Ave,Citi Bike | E 116 St & 2 Ave,Citi Bike | E 118 St & 1 Ave,Citi Bike | E 118 St & 3 Ave,Citi Bike | E 118 St & Madison Ave,Citi Bike | E 118 St & Park Ave,Citi Bike | E 12 St & 3 Ave,Citi Bike | E 12 St & 4 Av,Citi Bike | E 123 St & Lexington Ave,Citi Bike | E 128 St & Madison Ave,Citi Bike | E 13 St & Avenue A,Citi Bike | E 15 St & 3 Ave,Citi Bike | E 16 St & 5 Ave,Citi Bike | E 16 St & Irving Pl,Citi Bike | E 17 St & Broadway,Citi Bike | E 19 St & 3 Ave,Citi Bike | E 2 St & 2 Ave,Citi Bike | E 2 St & Avenue A,Citi Bike | E 2 St & Avenue B,Citi Bike | E 2 St & Avenue C,Citi Bike | E 20 St & 2 Ave,Citi Bike | E 20 St & FDR Drive,Citi Bike | E 20 St & Park Ave,Citi Bike | E 23 St & 1 Ave,Citi Bike | E 24 St & Park Ave S,Citi Bike | E 25 St & 1 Ave,Citi Bike | E 25 St & 2 Ave,Citi Bike | E 27 St & 1 Ave,Citi Bike | E 30 St & Park Ave S,Citi Bike | E 31 St & 3 Ave,Citi Bike | E 32 St & Park Ave,Citi Bike | E 33 St & 1 Ave,Citi Bike | E 33 St & 5 Ave,Citi Bike | E 39 St & 2 Ave,Citi Bike | E 39 St & 3 Ave,Citi Bike | E 4 St & 2 Ave,Citi Bike | E 41 St & Madison Ave,Citi Bike | E 43 St & 2 Ave,Citi Bike | E 43 St & 5 Ave,Citi Bike | E 45 St & 3 Ave,Citi Bike | E 47 St & 1 Ave,Citi Bike | E 47 St & 2 Ave,Citi Bike | E 47 St & Park Ave,Citi Bike | E 48 St & 3 Ave,Citi Bike | E 48 St & 5 Ave,Citi Bike | E 5 St & Avenue C,Citi Bike | E 51 St & 1 Ave,Citi Bike | E 51 St & Lexington Ave,Citi Bike | E 53 St & 3 Ave,Citi Bike | E 53 St & Madison Ave,Citi Bike | E 55 St & 2 Ave,Citi Bike | E 58 St &  1 Ave (NW Corner),Citi Bike | E 58 St & 1 Ave (NE Corner),Citi Bike | E 58 St & 3 Ave,Citi Bike | E 59 St & Madison Ave,Citi Bike | E 6 St & Avenue B,Citi Bike | E 6 St & Avenue D,Citi Bike | E 60 St & York Ave,Citi Bike | E 65 St & 2 Ave,Citi Bike | E 66 St & Madison Ave,Citi Bike | E 67 St & Park Ave,Citi Bike | E 68 St & 3 Ave,Citi Bike | E 68 St & Madison Ave,Citi Bike | E 7 St & Avenue A,Citi Bike | E 72 St & Park Ave,Citi Bike | E 72 St & York Ave,Citi Bike | E 74 St & 1 Ave,Citi Bike | E 75 St & 3 Ave,Citi Bike | E 76 St & Park Ave,Citi Bike | E 77 St & 3 Ave,Citi Bike | E 78 St & 2 Ave,Citi Bike | E 81 St & 2 Ave,Citi Bike | E 81 St & 3 Ave,Citi Bike | E 81 St & York Ave,Citi Bike | E 82 St & East End Ave,Citi Bike | E 84 St & 1 Ave,Citi Bike | E 84 St & 3 Ave,Citi Bike | E 84 St & Park Ave,Citi Bike | E 85 St & York Ave,Citi Bike | E 88 St & 1 Ave,Citi Bike | E 88 St & Park Ave,Citi Bike | E 89 St & 3 Ave,Citi Bike | E 89 St & York Ave,Citi Bike | E 9 St & Avenue C,Citi Bike | E 91 St & 2 Ave,Citi Bike | E 91 St & Park Ave,Citi Bike | E 93 St & 2 Ave,Citi Bike | E 97 St & 3 Ave,Citi Bike | E 97 St & Madison Ave,Citi Bike | E 98 St & Park Ave,Citi Bike | East End Ave & E 86 St,Citi Bike | Eastern Pkwy & Franklin Ave,Citi Bike | Eastern Pkwy & Washington Ave,Citi Bike | Eckford St & Engert Ave,Citi Bike | Emerson Pl & Myrtle Ave,Citi Bike | Essex Light Rail,Citi Bike | FDR Drive & E 35 St,Citi Bike | Fairmount Ave,Citi Bike | Flushing Ave & Vanderbilt Ave,Citi Bike | Forsyth St & Broome St,Citi Bike | Forsyth St & Canal St,Citi Bike | Franklin Ave & Empire Blvd,Citi Bike | Franklin Ave & Myrtle Ave,Citi Bike | Franklin Ave & St Marks Ave,Citi Bike | Franklin St & Dupont St,Citi Bike | Franklin St & W Broadway,Citi Bike | Frederick Douglass Blvd & W 112 St,Citi Bike | Frederick Douglass Blvd & W 115 St,Citi Bike | Frederick Douglass Blvd & W 117 St,Citi Bike | Frederick Douglass Blvd & W 129 St,Citi Bike | Front St & Gold St,Citi Bike | Front St & Maiden Ln,Citi Bike | Front St & Washington St,Citi Bike | Frost St & Meeker Ave,Citi Bike | Fulton St & Adams St,Citi Bike | Fulton St & Broadway,Citi Bike | Fulton St & Clermont Ave,Citi Bike | Fulton St & Irving Pl,Citi Bike | Fulton St & Rockwell Pl,Citi Bike | Fulton St & Utica Ave,Citi Bike | Fulton St & Waverly Ave,Citi Bike | Fulton St & William St,Citi Bike | Gansevoort St & Hudson St,Citi Bike | Garfield Pl & 8 Ave,Citi Bike | George St & Wilson Ave,Citi Bike | Glenwood Ave,Citi Bike | Graham Ave & Conselyea St,Citi Bike | Graham Ave & Grand St,Citi Bike | Graham Ave & Herbert St,Citi Bike | Graham Ave & Withers St,Citi Bike | Grand Army Plaza & Central Park S,Citi Bike | Grand Army Plaza & Plaza St West,Citi Bike | Grand Ave & Bergen St,Citi Bike | Grand St,Citi Bike | Grand St & Elizabeth St,Citi Bike | Grand St & Havemeyer St,Citi Bike | Great Jones St,Citi Bike | Greene Av & Myrtle Av,Citi Bike | Greene Ave & Nostrand Ave,Citi Bike | Greene Ave & Throop Ave,Citi Bike | Greenpoint Ave & Manhattan Ave,Citi Bike | Greenwich Ave & 8 Ave,Citi Bike | Greenwich Ave & Charles St,Citi Bike | Greenwich St & W Houston St,Citi Bike | Grove St PATH,Citi Bike | Halsey St & Tompkins Ave,Citi Bike | Hamilton Park,Citi Bike | Hancock St & Bedford Ave,Citi Bike | Hanson Pl & Ashland Pl,Citi Bike | Harborside,Citi Bike | Harrison St & Hudson St,Citi Bike | Hart St & Wyckoff Ave,Citi Bike | Heights Elevator,Citi Bike | Henry St & Atlantic Ave,Citi Bike | Henry St & Bay St,Citi Bike | Henry St & Degraw St,Citi Bike | Henry St & Grand St,Citi Bike | Henry St & Middagh St,Citi Bike | Henry St & W 9 St,Citi Bike | Hicks St & Montague St,Citi Bike | Hilltop,Citi Bike | Hoboken Ave at Monmouth St,Citi Bike | Hope St & Union Ave,Citi Bike | Howard St & Centre St,Citi Bike | Hudson St & Reade St,Citi Bike | Humboldt St & Varet St,Citi Bike | Huron St & Franklin St,Citi Bike | India St & Manhattan Ave,Citi Bike | India St & West St,Citi Bike | Irving Ave & DeKalb Ave,Citi Bike | Irving Ave & Jefferson St,Citi Bike | JC Medical Center,Citi Bike | Jackson Ave & 46 Rd,Citi Bike | Jackson Square,Citi Bike | Jackson St & Leonard St,Citi Bike | Jay St & Tech Pl,Citi Bike | Jay St & York St,Citi Bike | Jersey & 3rd,Citi Bike | Jersey & 6th St,Citi Bike | John St & William St,Citi Bike | Johnson St & Gold St,Citi Bike | Journal Square,Citi Bike | Kane St & Clinton St,Citi Bike | Kent Ave & N 7 St,Citi Bike | Kent Ave & S 11 St,Citi Bike | Kingston Ave & Herkimer St,Citi Bike | Knickerbocker Ave & George St,Citi Bike | Knickerbocker Ave & Thames St,Citi Bike | Kosciuszko St & Nostrand Ave,Citi Bike | Kosciuszko St & Tompkins Ave,Citi Bike | LaGuardia Pl & W 3 St,Citi Bike | Lafayette Ave & Classon Ave,Citi Bike | Lafayette Ave & Fort Greene Pl,Citi Bike | Lafayette Ave & St James Pl,Citi Bike | Lafayette Park,Citi Bike | Lafayette St & E 8 St,Citi Bike | Lafayette St & Jersey St,Citi Bike | Laight St & Hudson St,Citi Bike | Lawrence St & Willoughby St,Citi Bike | Lefferts Pl & Franklin Ave,Citi Bike | Lenox Ave & W 111 St,Citi Bike | Lenox Ave & W 115 St,Citi Bike | Lenox Ave & W 117 St,Citi Bike | Lenox Ave & W 126 St,Citi Bike | Lenox Ave & W 130 St,Citi Bike | Leonard Gordon Park,Citi Bike | Leonard St & Boerum St,Citi Bike | Leonard St & Church St,Citi Bike | Leonard St & Maujer St,Citi Bike | Leonard St & Nassau Ave,Citi Bike | Lewis Ave & Decatur St,Citi Bike | Lewis Ave & Kosciuszko St,Citi Bike | Lewis Ave & Madison St,Citi Bike | Lexington Ave & Classon Ave,Citi Bike | Lexington Ave & E 111 St,Citi Bike | Lexington Ave & E 120 St,Citi Bike | Lexington Ave & E 127 St,Citi Bike | Lexington Ave & E 26 St,Citi Bike | Lexington Ave & E 29 St,Citi Bike | Lexington Ave & E 36 St,Citi Bike | Lexington Ave & E 63 St,Citi Bike | Liberty Light Rail,Citi Bike | Liberty St & Broadway,Citi Bike | Lincoln Park,Citi Bike | Lincoln Pl & Classon Ave,Citi Bike | Lispenard St & Broadway,Citi Bike | Little West St & 1 Pl,Citi Bike | Lorimer St & Broadway,Citi Bike | MacDougal St & Prince St,Citi Bike | MacDougal St & Washington Sq,Citi Bike | Macon St & Nostrand Ave,Citi Bike | Madison Ave & E 120 St,Citi Bike | Madison Ave & E 82 St,Citi Bike | Madison Ave & E 99 St,Citi Bike | Madison St & Clinton St,Citi Bike | Madison St & Montgomery St,Citi Bike | Maiden Ln & Pearl St,Citi Bike | Manila & 1st,Citi Bike | Marcus Garvey Blvd & Macon St,Citi Bike | Marcy Ave & Lafayette Ave,Citi Bike | Marin Light Rail,Citi Bike | Market St & Cherry St,Citi Bike | McGinley Square,Citi Bike | McGuinness Blvd & Eagle St,Citi Bike | McKibbin St & Bogart St,Citi Bike | McKibbin St & Manhattan Ave,Citi Bike | Mercer St & Bleecker St,Citi Bike | Mercer St & Spring St,Citi Bike | Meserole Ave & Manhattan Ave,Citi Bike | Metropolitan Ave & Bedford Ave,Citi Bike | Metropolitan Ave & Meeker Ave,Citi Bike | Milton St & Franklin St,Citi Bike | Monmouth and 6th,Citi Bike | Monroe St & Bedford Ave,Citi Bike | Monroe St & Classon Ave,Citi Bike | Monroe St & Tompkins Ave,Citi Bike | Montgomery St,Citi Bike | Montgomery St & Franklin Ave,Citi Bike | Montrose Ave & Bushwick Ave,Citi Bike | Morningside Ave & W 123 St,Citi Bike | Morningside Dr & Amsterdam Ave,Citi Bike | Morris Canal,Citi Bike | Mott St & Prince St,Citi Bike | Mt Morris Park W & W 120 St,Citi Bike | Murray St & Greenwich St,Citi Bike | Murray St & West St,Citi Bike | Myrtle Ave & Lewis Ave,Citi Bike | Myrtle Ave & Marcy Ave,Citi Bike | Myrtle Ave & St Edwards St,Citi Bike | N 11 St & Kent Ave,Citi Bike | N 12 St & Bedford Ave,Citi Bike | N 15 St & Wythe Ave,Citi Bike | N 6 St & Bedford Ave,Citi Bike | Nassau Ave & Newell St,Citi Bike | Nassau Ave & Russell St,Citi Bike | Nassau St & Navy St,Citi Bike | Newark Ave,Citi Bike | Newport PATH,Citi Bike | Newport Pkwy,Citi Bike | Newton Rd & 44 St,Citi Bike | Newtown Ave & 23 St,Citi Bike | Norfolk St & Broome St,Citi Bike | North Moore St & Greenwich St,Citi Bike | Nostrand Ave & Myrtle Ave,Citi Bike | Oakland Ave,Citi Bike | Old Fulton St,Citi Bike | Old Slip & Front St,Citi Bike | Pacific St & Classon Ave,Citi Bike | Pacific St & Nevins St,Citi Bike | Park Ave & E 124 St,Citi Bike | Park Ave & Marcus Garvey Blvd,Citi Bike | Park Ave & St Edwards St,Citi Bike | Park Pl & Church St,Citi Bike | Park Pl & Franklin Ave,Citi Bike | Park Pl & Vanderbilt Ave,Citi Bike | Paulus Hook,Citi Bike | Pearl St & Hanover Square,Citi Bike | Peck Slip & Front St,Citi Bike | Perry St & Bleecker St,Citi Bike | Pershing Field,Citi Bike | Pershing Square North,Citi Bike | Pershing Square South,Citi Bike | Picnic Point,Citi Bike | Pier 40 - Hudson River Park,Citi Bike | Pierrepont St & Monroe Pl,Citi Bike | Pike St & E Broadway,Citi Bike | Pike St & Monroe St,Citi Bike | Pioneer St & Richards St,Citi Bike | Pioneer St & Van Brunt St,Citi Bike | Pitt St & Stanton St,Citi Bike | Plaza St West & Flatbush Ave,Citi Bike | Pleasant Ave & E 116 St,Citi Bike | Pleasant Ave & E 120 St,Citi Bike | Powers St & Olive St,Citi Bike | President St & Henry St,Citi Bike | Prospect Park West & 8 St,Citi Bike | Prospect Pl & 6 Ave,Citi Bike | Prospect Pl & Underhill Ave,Citi Bike | Pulaski St & Marcus Garvey Blvd,Citi Bike | Putnam Ave & Nostrand Ave,Citi Bike | Putnam Ave & Throop Ave,Citi Bike | Queens Plaza North & Crescent St,Citi Bike | Railroad Ave & Kay Ave,Citi Bike | Reade St & Broadway,Citi Bike | Richards St & Delavan St,Citi Bike | Richardson St & N Henry St,Citi Bike | Riverside Blvd & W 67 St,Citi Bike | Riverside Dr & W 104 St,Citi Bike | Riverside Dr & W 72 St,Citi Bike | Riverside Dr & W 78 St,Citi Bike | Riverside Dr & W 82 St,Citi Bike | Riverside Dr & W 91 St,Citi Bike | Riverview Park,Citi Bike | Rivington St & Chrystie St,Citi Bike | Rivington St & Ridge St,Citi Bike | Roebling St & N 4 St,Citi Bike | Rogers Ave & Sterling St,Citi Bike | S 3 St & Bedford Ave,Citi Bike | S 4 St & Rodney St,Citi Bike | S 4 St & Wythe Ave,Citi Bike | S 5 Pl & S 5 St,Citi Bike | S Portland Ave & Hanson Pl,Citi Bike | Schermerhorn St & Bond St,Citi Bike | Schermerhorn St & Court St,Citi Bike | Scholes St & Manhattan Ave,Citi Bike | Sharon St & Olive St,Citi Bike | Sigourney St & Columbia St,Citi Bike | Sip Ave,Citi Bike | Smith St & 3 St,Citi Bike | Smith St & 9 St,Citi Bike | Soissons Landing,Citi Bike | South End Ave & Liberty St,Citi Bike | South St & Gouverneur Ln,Citi Bike | South St & Whitehall St,Citi Bike | Spruce St & Nassau St,Citi Bike | St James Pl & Oliver St,Citi Bike | St James Pl & Pearl St,Citi Bike | St Johns Pl & Washington Ave,Citi Bike | St Marks Pl & 1 Ave,Citi Bike | St Marks Pl & 2 Ave,Citi Bike | St Nicholas Ave & Manhattan Ave,Citi Bike | St. Nicholas Ave & W 126 St,Citi Bike | Stagg St & Morgan Ave,Citi Bike | Stagg St & Union Ave,Citi Bike | Stanton St & Chrystie St,Citi Bike | Stanton St & Mangin St,Citi Bike | Stanton St & Norfolk St,Citi Bike | State St & Smith St,Citi Bike | Steinway St & 23 Ave,Citi Bike | Steinway St & 28 Ave,Citi Bike | Sterling Pl & Bedford Ave,Citi Bike | Sterling St & Bedford Ave,Citi Bike | Stockholm St & Wilson Ave,Citi Bike | Suffolk St & Stanton St,Citi Bike | Sullivan Pl & Bedford Ave,Citi Bike | Sullivan St & Washington Sq,Citi Bike | Suydam St & Knickerbocker Ave,Citi Bike | Throop Ave & Myrtle Ave,Citi Bike | Tompkins Ave & Hopkins St,Citi Bike | Underhill Ave & Lincoln Pl,Citi Bike | Underhill Ave & Pacific St,Citi Bike | Union Ave & Jackson St,Citi Bike | Union Ave & N 12 St,Citi Bike | Union Ave & Wallabout St,Citi Bike | Union St,Citi Bike | Union St & 4 Ave,Citi Bike | Union St & Bedford Ave,Citi Bike | Union St & Nevins St,Citi Bike | University Pl & E 14 St,Citi Bike | University Pl & E 8 St,Citi Bike | Van Brunt St & Van Dyke St,Citi Bike | Van Brunt St & Wolcott St,Citi Bike | Van Vorst Park,Citi Bike | Vernon Blvd & 10 St,Citi Bike | Vernon Blvd & 30 Rd,Citi Bike | Vernon Blvd & 31 Ave,Citi Bike | Vernon Blvd & 41 Rd,Citi Bike | Vernon Blvd & 47 Rd,Citi Bike | Vernon Blvd & 50 Ave,Citi Bike | Verona Pl & Fulton St,Citi Bike | Vesey Pl & River Terrace,Citi Bike | W 100 St & Broadway,Citi Bike | W 100 St & Manhattan Ave,Citi Bike | W 104 St & Amsterdam Ave,Citi Bike | W 106 St & Amsterdam Ave,Citi Bike | W 106 St & Central Park West,Citi Bike | W 107 St & Columbus Ave,Citi Bike | W 11 St & 6 Ave,Citi Bike | W 110 St & Amsterdam Ave,Citi Bike | W 113 St & Broadway,Citi Bike | W 116 St & Amsterdam Ave,Citi Bike | W 116 St & Broadway,Citi Bike | W 120 St & Claremont Ave,Citi Bike | W 129 St & Convent Ave,Citi Bike | W 13 St & 5 Ave,Citi Bike | W 13 St & 7 Ave,Citi Bike | W 15 St & 10 Ave,Citi Bike | W 15 St & 7 Ave,Citi Bike | W 16 St & The High Line,Citi Bike | W 17 St & 8 Ave,Citi Bike | W 18 St & 6 Ave,Citi Bike | W 20 St & 11 Ave,Citi Bike | W 20 St & 7 Ave,Citi Bike | W 20 St & 8 Ave,Citi Bike | W 21 St & 6 Ave,Citi Bike | W 22 St & 10 Ave,Citi Bike | W 22 St & 8 Ave,Citi Bike | W 24 St & 7 Ave,Citi Bike | W 25 St & 6 Ave,Citi Bike | W 26 St & 10 Ave,Citi Bike | W 26 St & 8 Ave,Citi Bike | W 27 St & 7 Ave,Citi Bike | W 31 St & 7 Ave,Citi Bike | W 33 St & 7 Ave,Citi Bike | W 34 St & 11 Ave,Citi Bike | W 35 St & Dyer Ave,Citi Bike | W 37 St & 10 Ave,Citi Bike | W 37 St & 5 Ave,Citi Bike | W 38 St & 8 Ave,Citi Bike | W 4 St & 7 Ave S,Citi Bike | W 40 St & 5 Ave,Citi Bike | W 41 St & 8 Ave,Citi Bike | W 42 St & 8 Ave,Citi Bike | W 42 St & Dyer Ave,Citi Bike | W 43 St & 10 Ave,Citi Bike | W 44 St & 5 Ave,Citi Bike | W 45 St & 6 Ave,Citi Bike | W 45 St & 8 Ave,Citi Bike | W 46 St & 11 Ave,Citi Bike | W 47 St & 10 Ave,Citi Bike | W 49 St & 8 Ave,Citi Bike | W 50 St & 9 Ave,Citi Bike | W 52 St & 11 Ave,Citi Bike | W 52 St & 5 Ave,Citi Bike | W 52 St & 6 Ave,Citi Bike | W 53 St & 10 Ave,Citi Bike | W 54 St & 9 Ave,Citi Bike | W 56 St & 10 Ave,Citi Bike | W 59 St & 10 Ave,Citi Bike | W 63 St & Broadway,Citi Bike | W 64 St & Thelonious Monk Circle,Citi Bike | W 67 St & Broadway,Citi Bike | W 70 St & Amsterdam Ave,Citi Bike | W 74 St & Columbus Ave,Citi Bike | W 76 St & Columbus Ave,Citi Bike | W 78 St & Broadway,Citi Bike | W 82 St & Central Park West,Citi Bike | W 84 St & Broadway,Citi Bike | W 84 St & Columbus Ave,Citi Bike | W 87 St & Amsterdam Ave,Citi Bike | W 88 St & West End Ave,Citi Bike | W 89 St & Columbus Ave,Citi Bike | W 90 St & Amsterdam Ave,Citi Bike | W 92 St & Broadway,Citi Bike | W 95 St & Broadway,Citi Bike | W Broadway & Spring Street,Citi Bike | Warren St,Citi Bike | Warren St & Court St,Citi Bike | Washington Ave & Greene Ave,Citi Bike | Washington Ave & Park Ave,Citi Bike | Washington Park,Citi Bike | Washington Pl & 6 Ave,Citi Bike | Washington Pl & Broadway,Citi Bike | Washington St,Citi Bike | Washington St & Gansevoort St,Citi Bike | Water - Whitehall Plaza,Citi Bike | Waterbury St & Stagg St,Citi Bike | Watts St & Greenwich St,Citi Bike | West Drive & Prospect Park West,Citi Bike | West End Ave & W 107 St,Citi Bike | West End Ave & W 94 St,Citi Bike | West St & Chambers St,Citi Bike | West Thames St,Citi Bike | White St & Johnson Ave,Citi Bike | White St & Moore St,Citi Bike | William St & Pine St,Citi Bike | Willoughby Ave & Hall St,Citi Bike | Willoughby Ave & Tompkins Ave,Citi Bike | Willoughby Ave & Walworth St,Citi Bike | Willoughby Ave & Wyckoff Ave,Citi Bike | Willoughby St & Fleet St,Citi Bike | Wolcott St & Dwight St,Citi Bike | Wyckoff Av & Jefferson St,Citi Bike | Wyckoff St & 3 Ave,Citi Bike | Wyckoff St & Bond St,Citi Bike | Wythe Ave & Metropolitan Ave,Citi Bike | Yankee Ferry Terminal,Citi Bike | York St,City bikes | A.I. Virtasen aukio,"City bikes | Aalto-yliopisto (M), Korkeakouluaukio","City bikes | Aalto-yliopisto (M), Tietotie",City bikes | Aapraminkaari,City bikes | Abraham Wetterin tie,City bikes | Agnetankuja,City bikes | Agronominkatu,City bikes | Ahertajantie,City bikes | Ainontie,City bikes | Alakiventie,City bikes | Albertinkatu,City bikes | Annankatu,City bikes | Ansatie,City bikes | Antaksentie,City bikes | Apollonkatu,City bikes | Arabian kauppakeskus,City bikes | Arabiankatu,City bikes | Arielinkatu,City bikes | Armas Launiksen katu,City bikes | Asentajanpuisto,City bikes | Aulangontie,City bikes | Auringonkatu,City bikes | Aurinkokivenpiha,City bikes | Aurinkolahden puistotie 2,City bikes | Avaruuskatu,City bikes | Avia-aukio,City bikes | Baana,City bikes | Betonimies,City bikes | Brahen kenttä,City bikes | Brahen puistikko,City bikes | Cygnaeuksenkatu,City bikes | Designmuseo,City bikes | Diakoniapuisto,City bikes | Eerikinkatu,City bikes | Ehrenströmintie,City bikes | Elfvik,City bikes | Elimäenkatu,City bikes | Eläinmuseo,City bikes | Energia Arena,City bikes | Erottajan aukio,City bikes | Eränkävijäntori,City bikes | Esterinportti,City bikes | Eteläesplanadi,City bikes | Eteläinen Hesperiankatu,City bikes | Etuniementie,City bikes | Fleminginkatu,City bikes | Friisilänaukio,City bikes | Gallen-Kallelan tie,City bikes | Gebhardinaukio,City bikes | Golfpolku,City bikes | Gransinmäki,City bikes | Gunillantie,City bikes | Gyldenintie,City bikes | Haagan tori,City bikes | Haakoninlahdenkatu,City bikes | Haapaniemenkatu,City bikes | Hagalundinpuisto,City bikes | Hagelstaminpuisto,City bikes | Hagelstamintie,City bikes | Hakalehto,City bikes | Hakaniemi (M),City bikes | Hanasaari,City bikes | Hauenkallio,City bikes | Hauenkalliontie,City bikes | Haukilahdenaukio,City bikes | Haukilahdenkatu,City bikes | Haukilahdenranta,City bikes | Heikkilänaukio,City bikes | Heikkiläntie,City bikes | Hernepellontie,City bikes | Hernetie,City bikes | Hertanmäenkatu,City bikes | Herttoniemen kirkko,City bikes | Herttoniemenranta,City bikes | Herttoniemi (M),City bikes | Heureka,City bikes | Hiekkaharju sports park,City bikes | Hiekkaharju station,City bikes | Hietalahdentori,City bikes | Hietaniemenkatu,City bikes | Hollolantie,City bikes | Honkasuo,City bikes | Humalniementie,City bikes | Huopalahden asema,City bikes | Huopalahdentie,City bikes | Huovitie,City bikes | Hylkeenpyytäjänkatu,City bikes | Hämeenlinnanväylä,City bikes | Ida Aalbergin tie,City bikes | Ilmalan asema,City bikes | Innopoli,City bikes | Intiankatu,City bikes | Isoisänsilta,City bikes | Isosaarentie,City bikes | Itäkeskus (M),City bikes | Itälahdenkatu,City bikes | Itämerentori,City bikes | Itäportti,City bikes | Jalavatie,City bikes | Jokiniemenkatu,City bikes | Juhana Herttuan tie,City bikes | Jumbo P1-level,City bikes | Jumbo P3-level,City bikes | Jämeräntaival,City bikes | Jännetie,City bikes | Jätkäsaarenlaituri,City bikes | Jäähalli,City bikes | Kaironkatu,City bikes | Kaisaniemenpuisto,City bikes | Kaivokselantie,City bikes | Kaivopuisto,City bikes | Kalasatama (M),City bikes | Kalevalantie,City bikes | Kalevankatu,City bikes | Kalkkipellonmäki,City bikes | Kallvikintie 67,City bikes | Kamppi (M),City bikes | Kanavaranta,City bikes | Kansallismuseo,City bikes | Kapteeninpuistikko,City bikes | Karhulantie,City bikes | Karhumäenportti,City bikes | Karhupuisto,City bikes | Kartanonkoski sports park,City bikes | Kasarmitori,City bikes | Katariina Saksilaisen katu,City bikes | Kauppakartanonkuja,City bikes | Kauppakorkeakoulu,City bikes | Kauppalaivurintie,City bikes | Keilalahti,City bikes | Keilaniemi (M),City bikes | Keilaranta,City bikes | Keimolantie,City bikes | Kesäkatu,City bikes | Kiasma,City bikes | Kilterinaukio,City bikes | Kirjurinkuja,City bikes | Kirkkoherrantie,City bikes | Kiskanpuisto,City bikes | Kiskontie,City bikes | Kivistö station,City bikes | Koivu-Mankkaa,City bikes | Koivukylä station,City bikes | Koivutori,City bikes | Koivuvaarankuja,City bikes | Komeetankatu,City bikes | Komentajankatu,City bikes | Korjaamo,City bikes | Korppaanmäentie,City bikes | Koskelantie,City bikes | Kriikunakuja,City bikes | Kuikkarinne,City bikes | Kukinkuja,City bikes | Kulosaari (M),City bikes | Kulttuuriaukio,City bikes | Kuohukuja,City bikes | Kurjenpolvenpuisto,City bikes | Kustaankartano,City bikes | Kustaankatu,City bikes | Kutsuntatie,City bikes | Kuunkatu,City bikes | Kuusitie,City bikes | Kydönaukio,City bikes | Kylävoudintie,City bikes | Käpylän asema,City bikes | Käpyläntie,City bikes | Käskynhaltijantie,City bikes | Laajalahden aukio,City bikes | Laajalahden keskus,City bikes | Laajasalon ostoskeskus,City bikes | Laajavuorentie,City bikes | Laivalahden puistotie,City bikes | Laivasillankatu,City bikes | Lammasrinne,City bikes | Lastenlehto,City bikes | Lauttasaaren ostoskeskus,City bikes | Lauttasaarensilta,City bikes | Lehtisaarentie,City bikes | Leikosaarentie,City bikes | Leikosaarentie 48,City bikes | Leinelä station,City bikes | Leinikkitie,City bikes | Lepolantie,City bikes | Leppäsuonaukio,City bikes | Leppävaaran uimahalli,City bikes | Leppävaaran urheilupuisto,City bikes | Leppävaaranaukio,City bikes | Leppävaarankäytävä,City bikes | Liesikuja,City bikes | Liisanpuistikko,City bikes | Liljatie,City bikes | Lincolninaukio,City bikes | Linnakepolku,City bikes | Linnanmäki,City bikes | Linnuntie,City bikes | Lintulahdenkatu,City bikes | Louhela station,City bikes | Louhentori,City bikes | Luhtimäki,City bikes | Lukutori,City bikes | Luoteisväylä,City bikes | Lystimäensilta,City bikes | Lystimäki,City bikes | Läkkitori,City bikes | Länsisatamankatu,City bikes | Länsisatamankuja,City bikes | Länsiterminaali,City bikes | Länsituuli,City bikes | Maalitori,City bikes | Maarinranta,City bikes | Maistraatintori,City bikes | Maitikka-aukio,City bikes | Majurinkulma,City bikes | Malminiitynpolku,City bikes | Malminiitynpuisto,City bikes | Mamsellimyllynkatu,City bikes | Mankkaanaukio,City bikes | Mankkaanlaaksontie,City bikes | Mannerheimintie,City bikes | Margareetankuja,City bikes | Marian sairaala,City bikes | Marjaniementie,City bikes | Marjaniemi,City bikes | Martinkyläntie,City bikes | Martinlaakso station,City bikes | Martinlaakso swimming hall,City bikes | Martinlaaksontie,City bikes | Marttila,City bikes | Mastokatu,City bikes | Matinkartanontie,City bikes | Matinkyläntie,City bikes | Matinlahdenranta,City bikes | Maunula,City bikes | Meilahden sairaala,City bikes | Melkonkuja,City bikes | Mellstenintie,City bikes | Merihaka,City bikes | Meripihkatori,City bikes | Merisotilaantori,City bikes | Messeniuksenkatu,City bikes | Messitytönkatu,City bikes | Mestarintie,City bikes | Metsänneidonpolku,City bikes | Munkkiniemen aukio,City bikes | Munkkivuoren ostoskeskus,City bikes | Mustikkamaa,City bikes | Muurarinkuja,City bikes | Muusantori,City bikes | Myllypuro (M),City bikes | Myyrmäki ice hall,City bikes | Myyrmäki station,City bikes | Myyrmäki swimming hall,City bikes | Mäkelänkatu,City bikes | Mäkitorpantie,City bikes | Mäkkylän asema,City bikes | Männistönpolku,City bikes | Mäntyviita,City bikes | Narinkka,City bikes | Nelikkotie,City bikes | Niittykumpu (M),City bikes | Niittymaa,City bikes | Nokkala,City bikes | Nordenskiöldinaukio,City bikes | Nuijatie,City bikes | Nuottaniementie,City bikes | Näkinsilta,City bikes | Näyttelijäntie,City bikes | O'Bike Station,City bikes | Olarinluoma,City bikes | Oljenkorsi,City bikes | Ollaksentie,City bikes | Olympiastadion,City bikes | Ooppera,City bikes | Opastinsilta,City bikes | Oravannahkatori,City bikes | Orionintie,City bikes | Orpaanporras,City bikes | Osumakuja,City bikes | Otaranta,City bikes | Otsolahti,City bikes | Otto Brandtin tie,City bikes | Oulunkylän asema,City bikes | Paavalinpuisto,City bikes | Paciuksenkaari,City bikes | Paciuksenkatu,City bikes | Painiitty,City bikes | Pajamäki,City bikes | Pakkalan puistotie,City bikes | Peltolantori,City bikes | Pernajantie,City bikes | Perämiehenkatu,City bikes | Petikontie,City bikes | Petter Wetterin tie,City bikes | Peukaloisentie,City bikes | Pihlajamäki,City bikes | Piispankallio,City bikes | Piispanportti,City bikes | Piispansilta,City bikes | Pitäjänmäen asema,City bikes | Pohjankulma,City bikes | Pohjois-Haagan asema,City bikes | Pohjolanaukio,City bikes | Pohjolankatu,City bikes | Porkkalankatu,City bikes | Porolahden koulu,City bikes | Porthania,City bikes | Postipuun koulu,City bikes | Prinsessantie,City bikes | Puistokaari,City bikes | Puotila (M),City bikes | Puotilan ostoskeskus,City bikes | Puotilantie,City bikes | Puotinharju,City bikes | Puotinkylän kartano,City bikes | Puutarhatie,City bikes | Pyhtäänkorventie,City bikes | Pähkinärinne library,City bikes | Päijänteentie,City bikes | Radiokatu,City bikes | Rajasaarentie,City bikes | Ratapihantie,City bikes | Ratsutori,City bikes | Rautatieläisenkatu,City bikes | Rautatientori / itä,City bikes | Rautatientori / länsi,City bikes | Reiherintie,City bikes | Rekola station,City bikes | Relanderinaukio,City bikes | Revontulentie,City bikes | Riistakuja,City bikes | Rillitori,City bikes | Ritarikatu,City bikes | Robert Huberin tie,City bikes | Roihupelto,City bikes | Rubiinipuisto,City bikes | Rummunlyöjänkatu,City bikes | Ruomelantie,City bikes | Ruskeasuon varikko,City bikes | Ruutikatu,City bikes | Rälssitie,City bikes | Sairaalakatu,City bikes | Salmisaarenranta,City bikes | Sammonpuistikko,City bikes | Sananjalanpolku,City bikes | Satamakaari 20/Paulig,City bikes | Sateentie,City bikes | Saunalahdentie,City bikes | Sauvatie,City bikes | Senaatintori,City bikes | Sepetlahdentie,City bikes | Sepänkatu,City bikes | Seurasaari,City bikes | Siilitie (M),City bikes | Siilitie 13,City bikes | Siilitie 9,City bikes | Siltavoudintie,City bikes | Silvola,City bikes | Sofianlehdonkatu,City bikes | Solvikinkatu 21,City bikes | Stenbäckinkatu,City bikes | Suokalliontie,City bikes | Suomenlahdentie,City bikes | Suopursunaukio,City bikes | Suurpellonaukio,City bikes | Sähkömies,City bikes | Säteri,City bikes | Säterinniitty,City bikes | Säterinrinne,City bikes | Sörnäinen (M),City bikes | Tahkotie,City bikes | Takomotie,City bikes | Talkootori,City bikes | Tammisalon aukio,City bikes | Tammiston kauppatie,City bikes | Tammistonkatu,City bikes | Tammistontie,City bikes | Tapaninkyläntie,City bikes | Tapiolan urheilupuisto,City bikes | Tapionaukio,City bikes | Tarhurinaukio,City bikes | Tasetie,City bikes | Tekniikantie,City bikes | Teknobulevardi,City bikes | Teletie,City bikes | Teljäntie,City bikes | Tenholantie,City bikes | Teollisuuskatu,City bikes | Teurastamo,City bikes | Thalianaukio,City bikes | Tietäjä,City bikes | Tiistiläntie,City bikes | Tiistinkallio,City bikes | Tikkuraitti,City bikes | Tikkurila sports park,City bikes | Tikkurila station,City bikes | Tilkantori,City bikes | Tilkanvierto,City bikes | Tiurintie,City bikes | Toinen linja,City bikes | Tontunmäentie,City bikes | Toppelundinportti,City bikes | Toppelundintie,City bikes | Torpanranta,City bikes | Tulisuontie,City bikes | Tunnelitie,City bikes | Tupasaarentie,City bikes | Tuulimäki,City bikes | Tuupakankuja,City bikes | Tyynenmerenkatu,City bikes | Töölönkatu,City bikes | Töölönlahden puisto,City bikes | Töölönlahdenkatu,City bikes | Töölöntori,City bikes | Töölöntulli,City bikes | Uimastadion,City bikes | Ulvilantie,City bikes | Unioninkatu,City bikes | Upseerinkatu,City bikes | Urheilupuisto (M),City bikes | Urheilutie,City bikes | Valimon asema,City bikes | Valimotie,City bikes | Vallikatu,City bikes | Vallipolku,City bikes | Vanha Kauppahalli,City bikes | Vanha Viertotie,City bikes | Vanha kirkkopuisto,City bikes | Vantaankoski station,City bikes | Vantaanlaaksontie,City bikes | Vantaanpuisto,City bikes | Varsapuistikko,City bikes | Vehkala station,City bikes | Velodrominrinne,City bikes | Venttiilikuja,City bikes | Verkatehtaanpuisto,City bikes | Vesakkotie,City bikes | Vetokuja,City bikes | Veturitori,City bikes | Vihdintie,City bikes | Viikin normaalikoulu,City bikes | Viikin tiedepuisto,City bikes | Viiskulma,City bikes | Vilhonvuorenkatu,City bikes | Virnatie,City bikes | Voikukantie,City bikes | Von Daehnin katu,City bikes | Vuorimestarintori,City bikes | Vuosaarentie Itä,City bikes | Väinö Tannerin tie,City bikes | Westendinasema,City bikes | Westendintie,City bikes | Yhdyskunnankuja,City bikes | Ympyrätalo,City bikes | aurinkolahti tori,City bikes | metro itä,City bikes | metro länsi,City bikes | Вход в сколково,CityCycle | 1 - EDWARD ST / QUEEN ST,CityCycle | 10 - EDWARD STREET / QUEEN STREET,CityCycle | 100 - MELBOURNE ST / EDMONDSTONE ST,CityCycle | 101 - RUSSELL ST / EDMONDSTONE ST,CityCycle | 102 - BESANT ST / VULTURE ST,CityCycle | 103 - VULTURE ST / THOMAS ST,CityCycle | 104 - HARDGRAVE RD / SKINNER ST,CityCycle | 105 - DORNOCH TCE / HARDGRAVE RD,CityCycle | 106 - ORLEIGH ST / HOOGLEY ST,CityCycle | 107 - DRURY ST / MONTAGUE RD,CityCycle | 108 - ROGERS ST / MONTAGUE RD,CityCycle | 109 - MONTAGUE RD / SKINNER ST,CityCycle | 11 - KING GEORGE SQUARE / ANN ST,CityCycle | 110 - JANE ST / MONTAGUE RD,CityCycle | 1101 - KING GEORGE SQUARE 2,CityCycle | 111 - DONKIN ST / MONTAGUE RD,CityCycle | 112 - BANK ST / MOLLISON ST,CityCycle | 113 - EDMONDSTONE ST / VULTURE ST,CityCycle | 114 - COLCHESTER ST / ERNEST ST,CityCycle | 115 - MONTAGUE RD / BRERETON ST,CityCycle | 116 - CORDELIA ST / ERNEST ST,CityCycle | 117 - VULTURE ST / TRIBUNE ST,CityCycle | 118 - MELBOURNE ST / MERIVALE ST,CityCycle | 119 - SIDON ST / LITTLE STANLEY ST,CityCycle | 12 - ALBERT ST MALL / ADELAIDE ST,CityCycle | 120 - BOUNDARY ST / VULTURE ST,CityCycle | 121 - VULTURE ST / STANLEY ST,CityCycle | 122 - LOWER RIVER TCE / ELLIS ST,CityCycle | 123 - CHARLOTTE ST / ALBERT ST,CityCycle | 124 - ANNERLEY ROAD / GROVE ST,CityCycle | 125 - ANNERLEY RD / BOGGO RD,CityCycle | 126 - JANE ST / BOUNDARY ST,CityCycle | 127 - GLADSTONE RD / ANNERLEY RD,CityCycle | 128 - BOUQUET ST / MONTAGUE RD,CityCycle | 129 - LOWER RIVER TCE / PARKLANDS,CityCycle | 13 - ALBERT STREET MALL / ADELAIDE STREET,CityCycle | 130 - O'CONNELL ST / LAMBERT ST,CityCycle | 131 - SHAFSTON AVE / THORN ST,CityCycle | 132 - LITTLE CRIBB ST / BOOMERANG ST,CityCycle | 133 - CORONATION DR / GO BETWEEN BRIDGE,CityCycle | 134 - RAILWAY TCE / CRIBB ST,CityCycle | 135 - PARK RD / RAILWAY TCE,CityCycle | 136 - PARK RD / DOUGLAS ST,CityCycle | 137 - KILROE ST / DORSEY ST,CityCycle | 138 - ROY ST / LANG PDE,CityCycle | 139 - BI-CENTENNIAL BIKE WAY / LANG PDE,CityCycle | 14 - ALBERT STREET MALL / ELIZABETH STREET,CityCycle | 140 - DUNMORE TCE / KINGSFORD ST,CityCycle | 141 - LAND ST / CORONATION DR,CityCycle | 142 - SYLVAN RD / CORONATION DR,CityCycle | 143 - REGATTA FERRY TERMINAL / SYLVAN RD,CityCycle | 144 - JEPHSON ST / SHERWOOD RD,CityCycle | 145 - CORONATION DR / ARCHER ST,CityCycle | 146 - BRISBANE ST / GLEN RD,CityCycle | 147 - SANDFORD ST / BRISBANE ST,CityCycle | 148 - SANDFORD ST / AUSTRAL ST,CityCycle | 149 - MACQUARIE ST / GUYATT PARK,CityCycle | 15 - ALBERT STREET MALL / ELIZABETH STREET,CityCycle | 150 - MACQUARIE ST / MUNRO ST,CityCycle | 16 - MARY STREET / ALBERT STREET,CityCycle | 17 - MARGARET ST / ALBERT ST,CityCycle | 18 - LITTLE STANLEY ST / TRIBUNE ST,CityCycle | 19 - GARDENS POINT ROAD / ADJ. BRIDGE,CityCycle | 2 - QUEEN ST / EAGLE ST,CityCycle | 20 - GARDENS POINT RD / SE OF GOODWILL BRIDGE,CityCycle | 21 - BOTANICAL GARDENS / QUT,CityCycle | 22 - GEORGE ST / TANK ST,CityCycle | 24 - SIR WILLIAM MCGREGOR DR / SIR FRED SCHONNELL,CityCycle | 25 - REDDACLIFF PL / QUEEN ST,CityCycle | 26 - NORTH QUAY / REDDACLIFF PLACE,CityCycle | 27 - BLAIR DR / SIR WILLIAM MACGREGOR DR,CityCycle | 28 - GEORGE ST / ADELAIDE ST,CityCycle | 29 - GEORGE STREET / ANN STREET,CityCycle | 3 - CREEK ST / ELIZABETH ST,CityCycle | 30 - ROMA ST / ANN ST,CityCycle | 31 - ROMA ST / TURBOT ST,CityCycle | 32 - TANK ST / GEORGE ST,CityCycle | 33 - ROMA ST / HERSCHEL ST,CityCycle | 34 - MAKERSTON ST / ROMA ST,CityCycle | 35 - ANNERLEY ROAD / STANLEY STREET,CityCycle | 36 - ROMA STREET / GARRICK STREET,CityCycle | 37 - UPPER ROMA ST / EAGLE TCE,CityCycle | 38 - ANN ST / CREEK ST,CityCycle | 39 - TURBOT ST / WICKHAM TCE,CityCycle | 4 - CHARLOTTE STREET / EAGLE STREET,CityCycle | 40 - ANN STREET / CREEK STREET,CityCycle | 41 - ANN ST / WHARF ST,CityCycle | 42 - WHARF STREET / ADELAIDE STREET,CityCycle | 43 - QUEEN ST / WHARF ST,CityCycle | 44 - QUEEN STREET / ADELAIDE STREET,CityCycle | 45 - TURBOT ST / BOWEN ST,CityCycle | 46 - ANN ST / BOUNDARY ST,CityCycle | 47 - TURBOT ST / BARRY PDE,CityCycle | 48 - ANN ST / GOTHA ST,CityCycle | 49 - ANN STREET / GIPPS STREET,CityCycle | 5 - MARKET STREET / MARY STREET,CityCycle | 50 - GIPPS ST / WICKHAM ST,CityCycle | 51 - BRUNSWICK ST / ALFRED ST,CityCycle | 52 - BRUNSWICK ST MALL / WICKHAM ST,CityCycle | 53 - BOWEN TCE / BRADFIELD HWY,CityCycle | 54 - MCLACHLAN ST / WINN ST,CityCycle | 55 - ALDEN ST / WICKHAM ST,CityCycle | 56 - CONSTANCE ST / ST PAULS TCE,CityCycle | 57 - BRIDGE ST / WICKHAM ST,CityCycle | 58 - EAST ST / ANN ST,CityCycle | 59 - JAMES ST / MCLACHLAN ST,CityCycle | 6 - ALICE STREET / EDWARD STREET,CityCycle | 60 - WICKHAM STREET / BROOKES STREET,CityCycle | 61 - WICKHAM ST / MURRI WAY,CityCycle | 62 - ANN ST / CHESTER ST,CityCycle | 63 - ANN ST / MURRI WAY,CityCycle | 64 - SKYRING TCE / CUNNINGHAM ST,CityCycle | 65 - CHERMSIDE ST / COMMERCIAL RD,CityCycle | 66 - COMMERCIAL RD / SKYRING TCE,CityCycle | 67 - COMMERCIAL RD / TENERIFFE FERRY TERMINAL,CityCycle | 68 - VERNON TCE / ETHEL ST,CityCycle | 69 - VERNON TCE / FLORENCE ST,CityCycle | 7 - MARGARET STREET / EDWARD STREET,CityCycle | 70 - MACQUARIE ST / BEESTON ST,CityCycle | 71 - HASTINGS ST / MACQUARIE ST,CityCycle | 72 - LAMINGTON ST / POWERHOUSE,CityCycle | 73 - LAMINGTON ST / REFINERY PDE,CityCycle | 74 - MERTHYR RD / JAMES ST,CityCycle | 75 - BROWNE ST / JAMES ST,CityCycle | 76 - WATERLOO ST (GASWORKS PARK) / NEWSTEAD TCE,CityCycle | 77 - JAMES ST / HARCOURT ST,CityCycle | 78 - MALT ST / BRUNSWICK ST,CityCycle | 79 - BALFOUR ST / BRUNSWICK ST,CityCycle | 8 - RIVERSIDE DR / VICTORIA ST,CityCycle | 80 - BARKER ST / BRUNSWICK ST,CityCycle | 81 - GRIFFITH ST / RIVERVIEW CT,CityCycle | 82 - BRUNSWICK ST / MERTHYR RD,CityCycle | 83 - SYDNEY ST / BRUNSWICK ST,CityCycle | 84 - NEW FARM FERRY TERMINAL / NEW FARM PARK,CityCycle | 85 - OXLADE DR / TURNER AVE,CityCycle | 86 - SYDNEY ST / MORAY ST,CityCycle | 87 - MERTHYR RD / REGINALD ST,CityCycle | 88 - SYDNEY ST FERRY TERMINAL / PARK,CityCycle | 89 - HOLMAN ST / MAIN ST,CityCycle | 9 - CHARLOTTE STREET / EDWARD STREET,CityCycle | 90 - MAIN ST / ROTHERHAM ST (MAHONEY PARK),CityCycle | 91 - MAIN ST / DARRAGH ST,CityCycle | 92 - THORNTON ST FERRY TERMINAL / MAIN ST,CityCycle | 93 - GREY ST / QCA,CityCycle | 94 - GLENELG ST / MERIVALE ST,CityCycle | 95 - STANLEY ST / MELBOURNE ST,CityCycle | 96 - GREY ST / MELBOURNE ST,CityCycle | 97 - THYNNE RD / COLLEGE RD,CityCycle | 98 - KURILPA POINT / MONTAGUE RD,CityCycle | 99 - CORDELIA ST / PEEL ST,Citybike Wien | Albertgasse,Citybike Wien | Alser Straße U6,Citybike Wien | Alser Straße/Feldgasse,Citybike Wien | Althanstraße,Citybike Wien | Arbeitergasse,Citybike Wien | Arbeiterkammer,Citybike Wien | Aumannplatz,Citybike Wien | Bahngasse,Citybike Wien | Bauernfeldplatz,Citybike Wien | Berggasse,Citybike Wien | Blumengasse,Citybike Wien | Boltzmanngasse,Citybike Wien | Brestelgasse,Citybike Wien | Burggasse U6,Citybike Wien | Dornerplatz,Citybike Wien | Elterleinplatz,Citybike Wien | Falco Stiege,Citybike Wien | Fasanplatz,Citybike Wien | Frankhplatz,Citybike Wien | Friedensbrücke,Citybike Wien | Friedrich Engels Platz,Citybike Wien | Friedrich Schmidtplatz,Citybike Wien | Fröbelgasse,Citybike Wien | Gersthof,Citybike Wien | Gertrudplatz,Citybike Wien | Gumpendorfer Gürtel,Citybike Wien | Gymnasiumstraße,Citybike Wien | Hartmanngasse,Citybike Wien | Hauptbahnhof,Citybike Wien | Hauptbahnhof West,Citybike Wien | Heinestraße,Citybike Wien | Hellwagstraße,Citybike Wien | Hernals S45,Citybike Wien | Heumühlgasse,Citybike Wien | Hofferplatz,Citybike Wien | Hoher Markt,Citybike Wien | Johannesgasse,Citybike Wien | Josefstädter Straße U6,Citybike Wien | Juchgasse,Citybike Wien | Julius Raab Platz,Citybike Wien | Julius-Tandler-Platz,Citybike Wien | Jägerstraße U6,Citybike Wien | Karmeliterplatz,Citybike Wien | Kollergerngasse,Citybike Wien | Krieau,Citybike Wien | Kundmanngasse,Citybike Wien | Kärntner Ring,Citybike Wien | Längenfeldgasse,Citybike Wien | Löblichgasse,Citybike Wien | Margaretengürtel U4,Citybike Wien | Markgraf-Rüdiger-Straße,Citybike Wien | Markthalle Alsergrund,Citybike Wien | Matzleinsdorfer Platz,Citybike Wien | Mayerhofgasse,Citybike Wien | Meiselmarkt,Citybike Wien | Messeplatz,Citybike Wien | Michelbeuern,Citybike Wien | Millennium Tower,Citybike Wien | Mittersteig,Citybike Wien | Museumsplatz,Citybike Wien | Nepomukgasse,Citybike Wien | Novaragasse,Citybike Wien | Nussdorfer Straße U6,Citybike Wien | Obere Donaustraße,Citybike Wien | Oper,Citybike Wien | Ottakring U3,Citybike Wien | Palffygasse,Citybike Wien | Petrusgasse,Citybike Wien | Pilgramgasse U4,Citybike Wien | Praterstern,Citybike Wien | Radetzkyplatz,Citybike Wien | Radingerstraße,Citybike Wien | Rathausplatz,Citybike Wien | Reinprechtsdorfer Brücke,Citybike Wien | Reschgasse,Citybike Wien | Richard-Wagner-Platz,Citybike Wien | Rosensteingasse,Citybike Wien | Roßauer Lände U4,Citybike Wien | Salmgasse,Citybike Wien | Sankt-Elisabeth-Platz,Citybike Wien | Schmelzbrücke,Citybike Wien | Schottenfeldgasse,Citybike Wien | Schottenring U4,Citybike Wien | Schuhmeierplatz,Citybike Wien | Schwarzenbergplatz,Citybike Wien | Schwedenplatz,Citybike Wien | Schweglerstraße,Citybike Wien | Schwendermarkt,Citybike Wien | Schönbrunn Haupteingang,Citybike Wien | Schönbrunner Brücke,Citybike Wien | Selzergasse,Citybike Wien | Sensengasse,Citybike Wien | Siebenbrunnenplatz,Citybike Wien | Siebensternplatz,Citybike Wien | Sigmund Freud Park,Citybike Wien | Singerstraße,Citybike Wien | Spittelau U4/U6,Citybike Wien | Stadion Center,Citybike Wien | Stadtpark Stubenring,Citybike Wien | Südportalstraße,Citybike Wien | Technisches Museum,Citybike Wien | Thaliastraße U6,Citybike Wien | Traisengasse,Citybike Wien | Treitlstraße,Citybike Wien | Turnergasse,Citybike Wien | Universitätsring,Citybike Wien | Urban Loritz Platz,Citybike Wien | Vivenotgasse,Citybike Wien | Volksgarten,Citybike Wien | Wallensteinplatz,Citybike Wien | Wallnerstraße,Citybike Wien | Wassergasse,Citybike Wien | Webgasse,Citybike Wien | Weghuberpark,Citybike Wien | Westbahnhof Europaplatz,Citybike Wien | Westbahnhof Felberstraße,Citybike Wien | Wien Mitte,Citybike Wien | Wieningerplatz,Citybike Wien | Währinger Straße U6,Citybike Wien | Yppenplatz,Civitavecchia | 01. Baccelli,Civitavecchia | 02. Parco Antonelli,Civitavecchia | 03. Parco Uliveto,Civitavecchia | 04. Stadio del nuoto,Cluj Bike | 1 decembrie 1918,Cluj Bike | 21 decembrie,Cluj Bike | 21 decembrie BRD,Cluj Bike | Apahida (la primarie),Cluj Bike | Apahida Agrotransilvania,Cluj Bike | Apahida Victoria,Cluj Bike | Aurel Vlaicu,Cluj Bike | B-Dul Muncii,Cluj Bike | Babes B,Cluj Bike | Biblioteca Centrala,Cluj Bike | Calea Floresti,Cluj Bike | Calea Motilor,Cluj Bike | Constantin Brancusi,Cluj Bike | Dragalina,Cluj Bike | Emil Isac,Cluj Bike | Fabricii,Cluj Bike | Floresti - Polus,Cluj Bike | Floresti - Primarie,Cluj Bike | Floresti - Tauti,Cluj Bike | Floresti/Somesului,Cluj Bike | G.Cosbuc,Cluj Bike | Gh. Dima,Cluj Bike | Hasdeu,Cluj Bike | Horea - Baritiu,Cluj Bike | Horea - Gara,Cluj Bike | Horea - Roth,Cluj Bike | Independentei,Cluj Bike | Ion Ratiu,Cluj Bike | Iuliu Hossu,Cluj Bike | Iulius Mall,Cluj Bike | Kogalniceanu,Cluj Bike | Maramuresului,Cluj Bike | Motilor 7,Cluj Bike | Observatorului LDL,Cluj Bike | Observatorului MOL,Cluj Bike | Pasteur,Cluj Bike | Petuniei,Cluj Bike | Piata 14 iulie,Cluj Bike | Piata Abator,Cluj Bike | Piata Detunata,Cluj Bike | Piata Ion Agarbiceanu,Cluj Bike | Piata Mihai Viteazul,Cluj Bike | Primaverii Gutenberg,Cluj Bike | Splaiul Independetei,Cluj Bike | Stefan cel Mare,Cluj Bike | Str Fabricii de zahar,Cluj Bike | Str Izlazului,Cluj Bike | Str Miraslau,Cluj Bike | T.Turcului,Cluj Bike | Titulescu,Co-bikes | Central train station,Co-bikes | Civic Centre,Co-bikes | County Hall,Co-bikes | Digby & Sowton,"Co-bikes | St Lukeâ€™s Campus, University of Exeter",Co-bikes | St. David's Train Station,Co-bikes | The Forum University of Exeter,CoGo | 3rd St & Gay St,CoGo | 3rd St & Sycamore St,CoGo | 4th St & Rich St,CoGo | Bank St & Frankfort St,CoGo | Bexley City Hall at Main St,CoGo | Bicentennial Park,CoGo | COSI,CoGo | Champion Ave & Main St,CoGo | City Hall,CoGo | Cleveland Ave & 4th Ave,CoGo | Cleveland Ave & Mt Vernon Ave,CoGo | Columbus College of Art & Design,CoGo | Columbus Commons - Rich St,CoGo | Columbus Museum of Art,CoGo | Convention Center,CoGo | Dorrian Commons - Mound St,CoGo | Franklin Park at Fairwood Ave,CoGo | Front St & Beck St,CoGo | Front St & Town St,CoGo | GO FITNESS IV (Italian Village) 4th/1st,CoGo | Grandon Ave & Main St,CoGo | Grandview Ave & 3rd Ave,CoGo | Grandview Library at Oakland Ave,CoGo | Grant Ave & Main St,CoGo | High St & 11th Ave,CoGo | High St & 17th Ave,CoGo | High St & 2nd Ave,CoGo | High St & 4th Ave,CoGo | High St & Broad St,CoGo | High St & Crestview Rd,CoGo | High St & Hudson St,CoGo | High St & King Ave,CoGo | High St & Lane Ave,CoGo | High St & Spring St,CoGo | High St & Warren,CoGo | Jaeger St & Whittier St,CoGo | Jeffrey Park on Clifton Ave,CoGo | Kilbourne St & Vine St,CoGo | Lane Ave at Olentangy Trail,CoGo | Library - Main Branch,CoGo | Livingston Park,CoGo | Lucas St & Town St,CoGo | Mallway Park at Arlington Ave,CoGo | Market District & 3rd Ave,CoGo | Michigan Ave & 3rd Ave,CoGo | Nationwide Arena - Front St,CoGo | Neil Ave & 11th Ave,CoGo | Neil Ave & Buttles Ave,CoGo | Neil Ave & King Ave,CoGo | Neil Ave & Nationwide Blvd,CoGo | North Bank Park,CoGo | North Market,CoGo | North Star Rd & Northwest Blvd,CoGo | Northwest Blvd & 1st Ave,CoGo | Northwest Blvd & 3rd Ave,CoGo | Northwest Blvd & Chambers Rd,CoGo | Northwest Blvd and Zollinger Rd,CoGo | Parsons Ave & Oak St,CoGo | Pleasant Ridge Ave & Mound St,CoGo | Schiller Park - Stewart Ave,CoGo | Scioto Audubon Center,CoGo | Sensenbrenner Park,CoGo | Summit St & 17th Ave,CoGo | Summit St & Hudson St,CoGo | Taylor Ave & Long St,CoGo | Thompson Park at Hunter Ave,CoGo | Thurman Ave & Bruck St,CoGo | Topiary Park - Town St,CoGo | Tremont Center at Tremont Rd,CoGo | Weinland Park - 6th Ave,CoGo | Wellesley Dr & Lane Ave,CoGo | Yard St & Burr Ave,Coast Bike Share | SP - 11th Street N & Central Ave,Coast Bike Share | SP - 1st Ave S & 3rd Street,Coast Bike Share | SP - 1st Ave s & 8th Street,Coast Bike Share | SP - 1st St N & 3rd Ave N,Coast Bike Share | SP - 1st St N & 5th Ave N,Coast Bike Share | SP - 1st Street S & 1st Ave S,Coast Bike Share | SP - 22nd st & 5th ave S,Coast Bike Share | SP - 2nd Ave N & 5th Street,Coast Bike Share | SP - 2nd Ave S and 3rd Street,Coast Bike Share | SP - 2nd Street & 1st Ave N,Coast Bike Share | SP - 2nd Street & 6th Ave S.,Coast Bike Share | SP - 3rd Ave N & 3rd St N,Coast Bike Share | SP - 3rd Ave S & 5th Street,Coast Bike Share | SP - 5th St N & Central Ave,Coast Bike Share | SP - 6th Street and 6th Ave S,Coast Bike Share | SP - 7th Ave N & Dartmoor St,Coast Bike Share | SP - 7th St S & Central Ave,Coast Bike Share | SP - 9th Ave S & 22nd Street,Coast Bike Share | SP - Bay Shore Dr & 5th Ave N,Coast Bike Share | SP - Beach Dr & 5th Ave N,Coast Bike Share | SP - Central Ave & 14th Street,Coast Bike Share | SP - Central Ave & 21st Street,Coast Bike Share | SP - Central Ave & 31st Street,Coast Bike Share | SP - Central Ave and 27th st,Coast Bike Share | SP - MLK Jr St & 3rd Ave S,Coast Bike Share | SP - Mirror Lake Dr and 7th St,Coast Bike Share | SP - N Shore & 9th ave N- hub,Coast Bike Share | SP - North Shore Dr and 12th Ave NE,Coast Bike Share | SP - VIRTUAL - 1 Ave S & Rowdies,Coast Bike Share | SP - VIRTUAL - 16th St & 5th Ave S,Coast Bike Share | SP - VIRTUAL - 1st Ave S & 20th St,Coast Bike Share | SP - VIRTUAL - 2nd St & 7th Ave N,Coast Bike Share | SP - VIRTUAL - 3rd Ave S at Gate 1,Coast Bike Share | SP - VIRTUAL - 4th St S & 15th Ave S Bus Stop,Coast Bike Share | SP - VIRTUAL - 4th St S & 17th Ave S Bus Stop,Coast Bike Share | SP - VIRTUAL - Bartlett Park Recreation Center,Coast Bike Share | SP - VIRTUAL - Burlington Ave N & 30th St,Coast Bike Share | SP - VIRTUAL - Campbell Recreation Center,Coast Bike Share | SP - VIRTUAL - Childs Park Recreation Center,Coast Bike Share | SP - VIRTUAL - Enoch D. Davis Center,Coast Bike Share | SP - VIRTUAL - Left Bank,Coast Bike Share | SP - VIRTUAL - Neighborhood Joe,Coast Bike Share | SP - VIRTUAL - Sanderlin Neighborhood Center Bus Stop,Coast Bike Share | SP - VIRTUAL - St Pete College Midtown,Coast Bike Share | SP - VIRTUAL - Sunset Grille,Coast Bike Share | SP - VIRTUAL - The Trop - Gate 6,Coast Bike Share | SP - VIRTUAL - Wildwood Recreation Center,Coast Bike Share | SP- VIRTUAL- Central & 25th,Coca-Cola Zero® Bikes | Abbey Bridge,Coca-Cola Zero® Bikes | Arthur's Quay,Coca-Cola Zero® Bikes | Baker Place,Coca-Cola Zero® Bikes | Bandfield,Coca-Cola Zero® Bikes | Bedford Row,Coca-Cola Zero® Bikes | Bishop St.,Coca-Cola Zero® Bikes | Bishop's Quay,Coca-Cola Zero® Bikes | Bodkin,Coca-Cola Zero® Bikes | Brian Boru Bridge,Coca-Cola Zero® Bikes | Brown Doorway,Coca-Cola Zero® Bikes | Bus Station,Coca-Cola Zero® Bikes | Camden Quay,Coca-Cola Zero® Bikes | Cathedral,Coca-Cola Zero® Bikes | Claddagh Basin,Coca-Cola Zero® Bikes | Clancy's Strand,Coca-Cola Zero® Bikes | Clontarf Street,Coca-Cola Zero® Bikes | Coburg St.,Coca-Cola Zero® Bikes | Colbert Station,Coca-Cola Zero® Bikes | College of Commerce,Coca-Cola Zero® Bikes | Cork City Hall,Coca-Cola Zero® Bikes | Cork School of Music,Coca-Cola Zero® Bikes | Corn Market St.,Coca-Cola Zero® Bikes | County Hall,Coca-Cola Zero® Bikes | Dyke Parade,Coca-Cola Zero® Bikes | Emmet Place,Coca-Cola Zero® Bikes | Eyre Square South,Coca-Cola Zero® Bikes | Fairgreen,Coca-Cola Zero® Bikes | Father Burke Road,Coca-Cola Zero® Bikes | Father Mathew Statue,Coca-Cola Zero® Bikes | Fitzgerald's Park,Coca-Cola Zero® Bikes | Galway City Hall,Coca-Cola Zero® Bikes | Gaol Road,Coca-Cola Zero® Bikes | Gaol Walk,Coca-Cola Zero® Bikes | Glenina,Coca-Cola Zero® Bikes | Grand Parade,Coca-Cola Zero® Bikes | Grattan St.,Coca-Cola Zero® Bikes | Headford Road,Coca-Cola Zero® Bikes | Island Road Junction,Coca-Cola Zero® Bikes | Kent East,Coca-Cola Zero® Bikes | Kent Station,Coca-Cola Zero® Bikes | Kent West,Coca-Cola Zero® Bikes | King John's Castle,"Coca-Cola Zero® Bikes | Kingfisher, NUIG",Coca-Cola Zero® Bikes | Lapp's Quay,Coca-Cola Zero® Bikes | Lough Atalia,Coca-Cola Zero® Bikes | Lower Glanmire Rd.,Coca-Cola Zero® Bikes | Mainguard Street,Coca-Cola Zero® Bikes | Mary Immaculate College,Coca-Cola Zero® Bikes | Merchants Gate,Coca-Cola Zero® Bikes | Mercy Hospital,Coca-Cola Zero® Bikes | Mount Saint Alphonsus,Coca-Cola Zero® Bikes | Mount Saint Vincent,Coca-Cola Zero® Bikes | New Dock Street,Coca-Cola Zero® Bikes | Newenham St.,Coca-Cola Zero® Bikes | Newtown Mahon,Coca-Cola Zero® Bikes | Newtownsmith,Coca-Cola Zero® Bikes | North Main St.,Coca-Cola Zero® Bikes | O'Callaghan Strand,Coca-Cola Zero® Bikes | O'Connell Avenue,Coca-Cola Zero® Bikes | O'Connell Street,Coca-Cola Zero® Bikes | O'Shaughnessy Bridge,Coca-Cola Zero® Bikes | Park & Ride NUIG,Coca-Cola Zero® Bikes | Peace Park,Coca-Cola Zero® Bikes | Pery Square,Coca-Cola Zero® Bikes | Pope's Quay,Coca-Cola Zero® Bikes | Roches Street,Coca-Cola Zero® Bikes | Sacred Heart (Seamus Quirke Rd),Coca-Cola Zero® Bikes | Saint John's Cathedral,Coca-Cola Zero® Bikes | Saint Mary's Cathedral,Coca-Cola Zero® Bikes | South Gate Bridge,Coca-Cola Zero® Bikes | South Main St.,Coca-Cola Zero® Bikes | South Mall,Coca-Cola Zero® Bikes | St. Fin Barre's Bridge,Coca-Cola Zero® Bikes | St. Patricks St.,Coca-Cola Zero® Bikes | The Granary,Coca-Cola Zero® Bikes | The Milk Market,Coca-Cola Zero® Bikes | University Hospital Galway,Coca-Cola Zero® Bikes | Wandesford Quay,Coca-Cola Zero® Bikes | Wood Quay,Columbia County B-cycle | Evans Towne Center Park,Comunità Montana Valli dell'Ossola | Druogno Campo Sportivo,Comunità Montana Valli dell'Ossola | Druogno Municipio,Comunità Montana Valli dell'Ossola | Druogno Stazione Ferroviaria,Comunità Montana Valli dell'Ossola | Malesco,Comunità Montana Valli dell'Ossola | Re,Comunità Montana Valli dell'Ossola | Santa Maria Maggiore,Cristolib | 01 - LATTRE DE TASSIGNY,Cristolib | 02 - HOPITAL INTERCOMMUNAL (CHIC),Cristolib | 03 - RUE DU GENERAL LECLERC - CENTRE ANCIEN,Cristolib | 04 - UNIVERSITE - MAIL DES MECHES,Cristolib | 05 - GENERAL LECLERC / BARRAGE,Cristolib | 06 - AVENUE DE LA BRECHE,Cristolib | 07- AVENUE DU DOCTEUR PAUL CASALIS,Cristolib | 08 - ROND POINT HOTEL DE VILLE,Cristolib | 09 - EUROPARC,Cristolib | 10 - MAGELLAN,Cuneo | 1. Piazza Torino,Cuneo | 2. Municipio - Piazza Audiffredi,Cuneo | 3. Largo Caraglio,Cuneo | 4. Stazione Ferroviaria,Cuneo | 5. Piazza Europa,Cuneo | 6. Ascensore Panoramico,Cuneo | 7. Via Bonelli,Cuneo | 8. Park Palazzi Finanziari,Cuneo | 9. Corso Nizza,Cyclocity | 1-ARKIKATEDRA,Cyclocity | 10-KALNŲ PARKAS,Cyclocity | 11-KARALIAUS MINDAUGO TILTAS,Cyclocity | 12-V. KUDIRKOS AIKŠTĖ,Cyclocity | 13-A. VIENUOLIO,Cyclocity | 14-LUKIŠKIŲ AIKŠTĖ,Cyclocity | 15-M. MAŽVYDO BIBLIOTEKA,Cyclocity | 16-TAURO KALNAS,Cyclocity | 17-JOGAILOS,Cyclocity | 18-RADVILŲ RŪMAI,Cyclocity | 19-S. NĖRIES GIMNAZIJA,Cyclocity | 2-BARBOROS RADVILAITĖS,Cyclocity | 20-TRAKŲ,Cyclocity | 21-VAŠINGTONO AIKŠTĖ,Cyclocity | 22-VCUP,Cyclocity | 23-EUROPOS AIKŠTĖ,Cyclocity | 24-FORUM PALACE,Cyclocity | 25-PANORAMA,Cyclocity | 26-EDUKOLOGIJOS UNIVERSITETAS,Cyclocity | 27-ŽALIASIS TILTAS,Cyclocity | 28-OPEROS IR BALETO TEATRAS,Cyclocity | 29-ŽALGIRIO STADIONAS,Cyclocity | 3-K. SIRVYDO SKVERAS,Cyclocity | 30-IKI MINSKAS,Cyclocity | 31-OLANDŲ ŽIEDAS,Cyclocity | 33-LIETUVOS VAIKŲ IR JAUNIMO CENTRAS,Cyclocity | 35-VILNIAUS VARTAI,Cyclocity | 36-AUTOBUSŲ STOTIS,Cyclocity | 38-ŠILO TILTAS,Cyclocity | 39-ŠIAURĖS MIESTELIS,Cyclocity | 4-ROTUŠĖ,Cyclocity | 40-OGMIOS MIESTAS,Cyclocity | 5-FILHARMONIJA,Cyclocity | 6-HALĖS TURGAVIETĖ,Cyclocity | 7-STOTIS,Cyclocity | 9-UŽUPIS,Cyclopolis | 12 ΒΡΥΣΕΣ,Cyclopolis | AGHIA PARASKEVI,Cyclopolis | AGHIAS LAVRAS SQUARE,Cyclopolis | AGHIOU KONSTANTINOU,Cyclopolis | ARCHEA OLYMPIA TOWNHALL,Cyclopolis | ARTAKIS,Cyclopolis | DROUVA,Cyclopolis | IROON SQUARE,Cyclopolis | ISAP MAROUSSI,Cyclopolis | ISAP NERATZIOTISSA,Cyclopolis | LYSIPPOS SQUARE,Cyclopolis | MARATHON TOWNHALL,Cyclopolis | MAROUSSI TOWNHALL,Cyclopolis | NEA MAKRI TOWNHALL,Cyclopolis | NEA SMYRNI SQUARE,Cyclopolis | OLYMPIC ACADEMY,Cyclopolis | OSE SQUARE,Cyclopolis | PARALIA MARATHONA,Cyclopolis | PARALIA NEA MAKRI,Cyclopolis | PEFKIAS - KATO DIMINIO,Cyclopolis | PEZODROMOS CLEISTHENOUS,Cyclopolis | SUBURBAN RAILWAY,Cyclopolis | ΠΛΑΤΕΙΑ ΑΓΙΑΣ ΛΑΥΡΑΣ,Cyclopolis | ΨΗΛΑ ΑΛΩΝΙΑ,Cykl | Asserpark,Cykl | Atlas,Cykl | Axis Z,Cykl | Bellostraat,Cykl | Bornsesteeg,Cykl | Campus Plaza,Cykl | Cantil,Cykl | Dijkgraaf,Cykl | Dreijen,Cykl | Duivendaal,Cykl | Ede-Wageningen North,Cykl | Forum,Cykl | Haarweg,Cykl | Helix,Cykl | Hoevestein,Cykl | Impulse,Cykl | Javastraat,Cykl | Leeuwenb.,Cykl | Marijkeweg,Cykl | Mouterij,Cykl | Orion,Cykl | Plantsoen,Cykl | Plus Ultra,Cykl | Radix,Cykl | Rijnveste,Cykl | Sports centre,Cykl | Zodiac,Częstochowski Rower Miejski | Armii Krajowej / Politechnika,Częstochowski Rower Miejski | Boh. Monte Cassino/Korczaka,Częstochowski Rower Miejski | Dekabrystów/Armii Krajowej,Częstochowski Rower Miejski | III Aleja NMP,Częstochowski Rower Miejski | Jadwigi/Park Wypoczynkowy,Częstochowski Rower Miejski | Jesienna/Szkoła,Częstochowski Rower Miejski | Niepodległości/Basen,Częstochowski Rower Miejski | Norwida,Częstochowski Rower Miejski | Okulickiego/Łódzka,Częstochowski Rower Miejski | Orkana/Szkoła,Częstochowski Rower Miejski | Pasaż Bareły/Jasna Góra,Częstochowski Rower Miejski | Pasaż Opolczyka/Urząd Miasta,Częstochowski Rower Miejski | Plac Biegańskiego,Częstochowski Rower Miejski | Plac Daszyńskiego,Częstochowski Rower Miejski | Promenada/Amfiteatr,Częstochowski Rower Miejski | Promenada/Kiedrzyńska,Częstochowski Rower Miejski | Rondo Jerzego Kuleja,Częstochowski Rower Miejski | Wyzwolenia/Fieldorfa Nila,Częstochowski Rower Miejski | Żużlowa/Hala Sportowa,DK'Vélo | Abbé Pierre,DK'Vélo | Angelier,DK'Vélo | Atrium,DK'Vélo | Beffroi,DK'Vélo | Claudel,DK'Vélo | Concorde,DK'Vélo | Escale / FRAC,DK'Vélo | Europe,DK'Vélo | Fort Louis,DK'Vélo | Gare SNCF,DK'Vélo | Glacis,DK'Vélo | Grand Large,DK'Vélo | Hopital,DK'Vélo | Hotel de Ville / Coudekerque-Branche,DK'Vélo | Jean Bart,DK'Vélo | Kursaal,DK'Vélo | Liberté,DK'Vélo | Louis XIV,DK'Vélo | Mairie St-Pol-sur-Mer,DK'Vélo | Mairie de Dunkerque,DK'Vélo | Mairie de Rosendael,DK'Vélo | Maison Communale,DK'Vélo | Maison des services,DK'Vélo | Mole 1,DK'Vélo | Méridien,DK'Vélo | Neptune,DK'Vélo | Nicolas II,DK'Vélo | Paul Emile Victor,DK'Vélo | Petit Steendam,DK'Vélo | Place Leclerc,DK'Vélo | Plage,DK'Vélo | Pole Marine,DK'Vélo | République,DK'Vélo | Sainte Germaine,DK'Vélo | St Jacques,DK'Vélo | St Nicolas,DK'Vélo | Sécurité Sociale,DK'Vélo | Terminus,DK'Vélo | Theatre,DK'Vélo | Tribut,DK'Vélo | Trois Ponts,DK'Vélo | Turenne,DK'Vélo | Universite,DK'Vélo | Vauban,DK'Vélo | Villette,DK'Vélo | Westhoek,Denver B-cycle | 10th & Osage,Denver B-cycle | 11th & Broadway,Denver B-cycle | 11th & Delaware,Denver B-cycle | 11th & Emerson,Denver B-cycle | 11th & Ogden,Denver B-cycle | 12th & Columbine,Denver B-cycle | 12th & Sherman,Denver B-cycle | 1350 Larimer,Denver B-cycle | 13th & Marion,Denver B-cycle | 13th & Speer,Denver B-cycle | 1450 Wazee,Denver B-cycle | 14th & Elati,Denver B-cycle | 14th & Ogden,Denver B-cycle | 14th & Stout,Denver B-cycle | 14th & Welton,Denver B-cycle | 14th & Zuni,Denver B-cycle | 1550 Glenarm,Denver B-cycle | 1551 Lafayette,Denver B-cycle | 15th & Cleveland,Denver B-cycle | 15th & Curtis,Denver B-cycle | 15th & Delgany,Denver B-cycle | 16th & Boulder,Denver B-cycle | 16th & Broadway,Denver B-cycle | 16th & Chestnut,Denver B-cycle | 16th & Little Raven,Denver B-cycle | 16th & Platte,Denver B-cycle | 16th & Sherman,Denver B-cycle | 16th & Wynkoop,Denver B-cycle | 17th & Blake,Denver B-cycle | 17th & Curtis,Denver B-cycle | 17th & Downing,Denver B-cycle | 17th & Franklin,Denver B-cycle | 17th & Larimer,Denver B-cycle | 17th & Pearl,Denver B-cycle | 17th & Race,Denver B-cycle | 17th & Wewatta,Denver B-cycle | 18th & Arapahoe,Denver B-cycle | 18th & California,Denver B-cycle | 18th & California Light Rail,Denver B-cycle | 19th & Market,Denver B-cycle | 19th & Pearl,Denver B-cycle | 1st & Broadway,Denver B-cycle | 2045 Franklin,Denver B-cycle | 20th & Chestnut,Denver B-cycle | 21st & Lawrence,Denver B-cycle | 21st & Market,Denver B-cycle | 22nd & Market,Denver B-cycle | 23rd & Clay,Denver B-cycle | 24th & Court Place,Denver B-cycle | 25th & Lawrence,Denver B-cycle | 28th & Larimer,Denver B-cycle | 29th & Brighton,Denver B-cycle | 29th & Zuni,Denver B-cycle | 30th & Lawrence,Denver B-cycle | 32nd & Clay,Denver B-cycle | 32nd & Julian,Denver B-cycle | 32nd & Pecos,Denver B-cycle | 33rd & Arapahoe,Denver B-cycle | 39th & Fox,Denver B-cycle | 3rd & Milwaukee,Denver B-cycle | 4th & Walnut,Denver B-cycle | 6th & Clarkson,Denver B-cycle | 7th & Grant,Denver B-cycle | 7th & Sherman,Denver B-cycle | 9th & Curtis,Denver B-cycle | 9th & Downing,Denver B-cycle | 9th & Logan,Denver B-cycle | 9th & Santa Fe,Denver B-cycle | Bayaud & Emerson,Denver B-cycle | Bayaud & Pennsylvania,Denver B-cycle | Broadway & Walnut,Denver B-cycle | Cherry Creek Mall,Denver B-cycle | Colfax & Columbine,Denver B-cycle | Colfax & Garfield,Denver B-cycle | Colfax & Pearl,Denver B-cycle | Colfax & Steele,Denver B-cycle | Decatur Federal Light Rail,Denver B-cycle | Denver Botanic Gardens,Denver B-cycle | Denver Health,Denver B-cycle | Denver Museum of Nature & Science,Denver B-cycle | Denver Public Library,Denver B-cycle | Denver Zoo,Denver B-cycle | Five Points,Denver B-cycle | Louisiana & Franklin,Denver B-cycle | Pepsi Center,Denver B-cycle | REI,Denver B-cycle | Webb Building,Des Moines B-cycle | 10th & Walnut,Des Moines B-cycle | 13th & Grand,Des Moines B-cycle | 1722 Grand Ave. - Meredith Corporation,Des Moines B-cycle | 19th St. & Cottage Grove,Des Moines B-cycle | 2nd & Court,Des Moines B-cycle | 30th St. & Carpenter Ave.,Des Moines B-cycle | 33rd St. & Forest Ave.,Des Moines B-cycle | 3rd St. & Market St.,Des Moines B-cycle | 5th & Grand/YMCA,Des Moines B-cycle | Brenton Skating Plaza,Des Moines B-cycle | Cityville SW 9th & Murphy,Des Moines B-cycle | DART Central Station,Des Moines B-cycle | DMACC Urban Campus,Des Moines B-cycle | E. 4th & Locust,Des Moines B-cycle | Forest Ave. & 27th St.,Des Moines B-cycle | Hy-Vee - 4th & Court Ave.,Des Moines B-cycle | Iowa State Capitol,Des Moines B-cycle | Jackson & Indianola,Des Moines B-cycle | ML King & Ingersoll,Des Moines B-cycle | Raccoon River Park,Des Moines B-cycle | Soll Apartments,Des Moines B-cycle | University Ave. & 24th St.,Divvy | 2112 W Peterson Ave,Divvy | 63rd St Beach,Divvy | 900 W Harrison St,Divvy | Aberdeen St & Jackson Blvd,Divvy | Aberdeen St & Monroe St,Divvy | Aberdeen St & Randolph St,Divvy | Ada St & Washington Blvd,Divvy | Adler Planetarium,Divvy | Albany Ave & 26th St,Divvy | Albany Ave & Bloomingdale Ave,Divvy | Albany Ave & Montrose Ave,Divvy | Archer (Damen) Ave & 37th St (*),Divvy | Artesian Ave & Hubbard St,Divvy | Ashland Ave & 13th St,Divvy | Ashland Ave & 21st St,Divvy | Ashland Ave & 50th St,Divvy | Ashland Ave & 63rd St,Divvy | Ashland Ave & 66th St,Divvy | Ashland Ave & 69th St,Divvy | Ashland Ave & Archer Ave,Divvy | Ashland Ave & Augusta Blvd,Divvy | Ashland Ave & Belle Plaine Ave,Divvy | Ashland Ave & Blackhawk St,Divvy | Ashland Ave & Chicago Ave,Divvy | Ashland Ave & Division St,Divvy | Ashland Ave & Garfield Blvd,Divvy | Ashland Ave & Grace St,Divvy | Ashland Ave & Grand Ave,Divvy | Ashland Ave & Lake St,Divvy | Ashland Ave & McDowell Ave,Divvy | Ashland Ave & Pershing Rd,Divvy | Ashland Ave & Wellington Ave,Divvy | Ashland Ave & Wrightwood Ave,Divvy | Austin Blvd & Chicago Ave,Divvy | Austin Blvd & Lake St,Divvy | Austin Blvd & Madison St,Divvy | Avers Ave & Belmont Ave,Divvy | Avondale Ave & Irving Park Rd,Divvy | Bennett Ave & 79th St,Divvy | Benson Ave & Church St,Divvy | Bernard St & Elston Ave,Divvy | Bissell St & Armitage Ave,Divvy | Blackstone Ave & Hyde Park Blvd,Divvy | Blue Island Ave & 18th St,Divvy | Bosworth Ave & Howard St,Divvy | Broadway & Argyle St,Divvy | Broadway & Barry Ave,Divvy | Broadway & Belmont Ave,Divvy | Broadway & Berwyn Ave,Divvy | Broadway & Cornelia Ave,Divvy | Broadway & Granville Ave,Divvy | Broadway & Ridge Ave,Divvy | Broadway & Sheridan Rd,Divvy | Broadway & Thorndale Ave,Divvy | Broadway & Waveland Ave,Divvy | Broadway & Wilson Ave,Divvy | Buckingham Fountain (Temp),Divvy | Budlong Woods Library,Divvy | Burling St (Halsted) & Diversey Pkwy (Temp),Divvy | Burnham Harbor,Divvy | California Ave & 21st St,Divvy | California Ave & 23rd Pl,Divvy | California Ave & 26th St,Divvy | California Ave & Altgeld St,Divvy | California Ave & Byron St,Divvy | California Ave & Cortez St,Divvy | California Ave & Division St,Divvy | California Ave & Fletcher St,Divvy | California Ave & Francis Pl,Divvy | California Ave & Lake St,Divvy | California Ave & Milwaukee Ave,Divvy | California Ave & Montrose Ave,Divvy | California Ave & North Ave,Divvy | Calumet Ave & 18th St,Divvy | Calumet Ave & 21st St,Divvy | Calumet Ave & 33rd St,Divvy | Calumet Ave & 35th St,Divvy | Calumet Ave & 51st St,Divvy | Calumet Ave & 71st St,Divvy | Campbell Ave & Fullerton Ave,Divvy | Campbell Ave & Montrose Ave,Divvy | Campbell Ave & North Ave,Divvy | Canal St & Adams St,Divvy | Canal St & Harrison St,Divvy | Canal St & Jackson Blvd,Divvy | Canal St & Madison St,Divvy | Canal St & Monroe St (*),Divvy | Canal St & Taylor St,Divvy | Cannon Dr & Fullerton Ave,Divvy | Carpenter St & 63rd St,Divvy | Carpenter St & Huron St,Divvy | Central Ave & Chicago Ave,Divvy | Central Ave & Harrison St,Divvy | Central Ave & Lake St,Divvy | Central Ave & Madison St,Divvy | Central Park Ave & 24th St,Divvy | Central Park Ave & Bloomingdale Ave,Divvy | Central Park Ave & Elbridge Ave,Divvy | Central Park Ave & North Ave,Divvy | Central Park Ave & Ogden Ave,Divvy | Central Park Blvd & 5th Ave,Divvy | Central St & Girard Ave,Divvy | Central St Metra,Divvy | Chicago Ave & Dempster St,Divvy | Chicago Ave & Sheridan Rd,Divvy | Chicago Ave & Washington St,Divvy | Christiana Ave & Lawrence Ave,Divvy | Cicero Ave & Flournoy St,Divvy | Cicero Ave & Lake St,Divvy | Cicero Ave & Quincy St,Divvy | Cityfront Plaza Dr & Pioneer Ct,Divvy | Claremont Ave & Hirsch St,Divvy | Clarendon Ave & Gordon Ter,Divvy | Clarendon Ave & Junior Ter,Divvy | Clarendon Ave & Leland Ave,Divvy | Clark St & 9th St (AMLI),Divvy | Clark St & Armitage Ave,Divvy | Clark St & Berwyn Ave,Divvy | Clark St & Bryn Mawr Ave,Divvy | Clark St & Chicago Ave,Divvy | Clark St & Columbia Ave,Divvy | Clark St & Drummond Pl,Divvy | Clark St & Elm St,Divvy | Clark St & Elmdale Ave,Divvy | Clark St & Grace St,Divvy | Clark St & Ida B Wells Dr,Divvy | Clark St & Jarvis Ave,Divvy | Clark St & Lake St,Divvy | Clark St & Leland Ave,Divvy | Clark St & Lincoln Ave,Divvy | Clark St & Lunt Ave,Divvy | Clark St & Montrose Ave,Divvy | Clark St & Newport St,Divvy | Clark St & North Ave,Divvy | Clark St & Randolph St,Divvy | Clark St & Schiller St,Divvy | Clark St & Schreiber Ave,Divvy | Clark St & Touhy Ave,Divvy | Clark St & Wellington Ave,Divvy | Clark St & Winnemac Ave,Divvy | Clark St & Wrightwood Ave,Divvy | Clifton Ave & Armitage Ave,Divvy | Clinton St & 18th St,Divvy | Clinton St & Jackson Blvd (*),Divvy | Clinton St & Lake St,Divvy | Clinton St & Madison St,Divvy | Clinton St & Polk St,Divvy | Clinton St & Roosevelt Rd,Divvy | Clinton St & Tilden St,Divvy | Clinton St & Washington Blvd,Divvy | Clybourn Ave & Division St,Divvy | Columbus Dr & Randolph St,Divvy | Commercial Ave & 83rd St,Divvy | Conservatory Dr & Lake St,Divvy | Cornell Ave & Hyde Park Blvd,Divvy | Cornell Dr & Hayes Dr,Divvy | Cottage Grove Ave & 43rd St,Divvy | Cottage Grove Ave & 47th St,Divvy | Cottage Grove Ave & 51st St,Divvy | Cottage Grove Ave & 63rd St,Divvy | Cottage Grove Ave & 67th St,Divvy | Cottage Grove Ave & 71st St,Divvy | Cottage Grove Ave & 78th St,Divvy | Cottage Grove Ave & 83rd St,Divvy | Cottage Grove Ave & Oakwood Blvd,Divvy | Daley Center Plaza,Divvy | Damen Ave & 51st St,Divvy | Damen Ave & 59th St,Divvy | Damen Ave & Charleston St,Divvy | Damen Ave & Chicago Ave,Divvy | Damen Ave & Clybourn Ave,Divvy | Damen Ave & Cortland St,Divvy | Damen Ave & Coulter St,Divvy | Damen Ave & Cullerton St,Divvy | Damen Ave & Division St,Divvy | Damen Ave & Foster Ave,Divvy | Damen Ave & Grand Ave,Divvy | Damen Ave & Leland Ave,Divvy | Damen Ave & Madison St,Divvy | Damen Ave & Melrose Ave,Divvy | Damen Ave & Pershing Rd,Divvy | Damen Ave & Pierce Ave,Divvy | Damen Ave & Sunnyside Ave,Divvy | Damen Ave & Thomas St (Augusta Blvd),Divvy | Damen Ave & Walnut (Lake) St (*),Divvy | Damen Ave & Wellington Ave,Divvy | Dayton St & North Ave,Divvy | Dearborn Pkwy & Delaware Pl,Divvy | Dearborn St & Adams St,Divvy | Dearborn St & Erie St,Divvy | Dearborn St & Monroe St,Divvy | Dearborn St & Van Buren St (*),Divvy | Delano Ct & Roosevelt Rd,Divvy | Desplaines St & Jackson Blvd,Divvy | Desplaines St & Kinzie St,Divvy | Desplaines St & Randolph St,Divvy | Dodge Ave & Church St,Divvy | Dodge Ave & Mulford St,Divvy | Dorchester Ave & 49th St,Divvy | Dorchester Ave & 63rd St,Divvy | Drake Ave & Addison St,Divvy | Drake Ave & Fullerton Ave,Divvy | Drake Ave & Montrose Ave,Divvy | DuSable Museum,Divvy | Dusable Harbor,Divvy | Eastlake Ter & Rogers Ave,Divvy | Eberhart Ave & 61st St,Divvy | Eckhart Park,Divvy | Eggleston Ave & 69th St (*),Divvy | Elizabeth (May) St & Fulton St,Divvy | Elizabeth St & 47th St,Divvy | Elizabeth St & 59th St,Divvy | Ellis Ave & 53rd St,Divvy | Ellis Ave & 55th St,Divvy | Ellis Ave & 58th St,Divvy | Ellis Ave & 60th St,Divvy | Ellis Ave & 83rd St,Divvy | Elmwood Ave & Austin St,Divvy | Elston Ave & Wabansia Ave,Divvy | Emerald Ave & 28th St,Divvy | Emerald Ave & 31st St,Divvy | Evans Ave & 75th St,Divvy | Evanston Civic Center,Divvy | Exchange Ave & 79th St,Divvy | Fairbanks Ct & Grand Ave,Divvy | Fairbanks St & Superior St,Divvy | Fairfield Ave & Roosevelt Rd,Divvy | Federal St & Polk St,Divvy | Field Blvd & South Water St,Divvy | Field Museum,Divvy | Financial Pl & Ida B Wells Dr (Temp),Divvy | Fort Dearborn Dr & 31st St,Divvy | Francisco Ave & Foster Ave,Divvy | Franklin St & Chicago Ave,Divvy | Franklin St & Jackson Blvd,Divvy | Franklin St & Lake St,Divvy | Franklin St & Monroe St,Divvy | Franklin St & Quincy St,Divvy | Glenwood Ave & Morse Ave,Divvy | Glenwood Ave & Touhy Ave,Divvy | Green St & Madison St,Divvy | Green St & Randolph St,Divvy | Greenview Ave & Diversey Pkwy,Divvy | Greenview Ave & Fullerton Ave,Divvy | Greenview Ave & Jarvis Ave,Divvy | Greenwood Ave & 47th St,Divvy | Greenwood Ave & 79th St,Divvy | Halsted St & 18th St,Divvy | Halsted St & 21st St,Divvy | Halsted St & 35th St (*),Divvy | Halsted St & 37th St,Divvy | Halsted St & 47th Pl,Divvy | Halsted St & 51st St,Divvy | Halsted St & 56th St,Divvy | Halsted St & 59th St,Divvy | Halsted St & 63rd St,Divvy | Halsted St & 69th St,Divvy | Halsted St & Archer Ave,Divvy | Halsted St & Clybourn Ave (*),Divvy | Halsted St & Dickens Ave,Divvy | Halsted St & Maxwell St,Divvy | Halsted St & North Branch St,Divvy | Halsted St & Polk St,Divvy | Halsted St & Roosevelt Rd,Divvy | Halsted St & Roscoe St,Divvy | Halsted St & Willow St,Divvy | Halsted St & Wrightwood Ave,Divvy | Harper Ave & 59th St,Divvy | Hermitage Ave & Polk St,Divvy | Honore St & Division St,Divvy | Hoyne Ave & 47th St,Divvy | Hoyne Ave & Balmoral Ave,Divvy | Humboldt Blvd & Armitage Ave,Divvy | Indiana Ave & 26th St,Divvy | Indiana Ave & 31st St,Divvy | Indiana Ave & 40th St,Divvy | Indiana Ave & Roosevelt Rd,Divvy | Jefferson St & Monroe St,Divvy | Jeffery Blvd & 67th St,Divvy | Jeffery Blvd & 71st St,Divvy | Jeffery Blvd & 76th St,Divvy | Karlov Ave & Madison St,Divvy | Kedzie Ave & 21st St,Divvy | Kedzie Ave & 24th St,Divvy | Kedzie Ave & Bryn Mawr Ave,Divvy | Kedzie Ave & Chicago Ave,Divvy | Kedzie Ave & Foster Ave,Divvy | Kedzie Ave & Harrison St,Divvy | Kedzie Ave & Lake St,Divvy | Kedzie Ave & Leland Ave,Divvy | Kedzie Ave & Milwaukee Ave,Divvy | Kedzie Ave & Palmer Ct,Divvy | Kedzie Ave & Roosevelt Rd,Divvy | Kenton Ave & Madison St,Divvy | Keystone Ave & Fullerton Ave,Divvy | Keystone Ave & Montrose Ave,Divvy | Kilbourn Ave & Irving Park Rd,Divvy | Kilbourn Ave & Milwaukee Ave,Divvy | Kildare Ave & Montrose Ave,Divvy | Kimball Ave & Belmont Ave,Divvy | Kimbark Ave & 53rd St,Divvy | Kingsbury St & Erie St (Temp),Divvy | Kingsbury St & Kinzie St,Divvy | Knox Ave & Montrose Ave,Divvy | Kosciuszko Park,Divvy | Kostner Ave & Adams St,Divvy | Kostner Ave & Lake St,Divvy | LaSalle Dr & Huron St (*),Divvy | LaSalle St & Adams St,Divvy | LaSalle St & Illinois St,Divvy | LaSalle St & Jackson Blvd,Divvy | LaSalle St & Washington St,Divvy | Lake Park Ave & 35th St,Divvy | Lake Park Ave & 47th St,Divvy | Lake Park Ave & 53rd St,Divvy | Lake Park Ave & 56th St,Divvy | Lake Shore Dr & Belmont Ave,Divvy | Lake Shore Dr & Diversey Pkwy,Divvy | Lake Shore Dr & Monroe St,Divvy | Lake Shore Dr & North Blvd,Divvy | Lake Shore Dr & Ohio St,Divvy | Lake Shore Dr & Wellington Ave,Divvy | Lakefront Trail & Bryn Mawr Ave,Divvy | Lakefront Trail & Wilson Ave,Divvy | Lakeview Ave & Fullerton Pkwy,Divvy | Laramie Ave & Gladys Ave,Divvy | Laramie Ave & Kinzie St,Divvy | Laramie Ave & Madison St,Divvy | Larrabee St & Armitage Ave,Divvy | Larrabee St & Division St,Divvy | Larrabee St & Kingsbury St,Divvy | Larrabee St & Menomonee St,Divvy | Larrabee St & North Ave,Divvy | Larrabee St & Oak St,Divvy | Larrabee St & Webster Ave,Divvy | Latrobe Ave & Chicago Ave,Divvy | Leavitt St & Addison St,Divvy | Leavitt St & Archer Ave,Divvy | Leavitt St & Armitage Ave,Divvy | Leavitt St & Belmont Ave (*),Divvy | Leavitt St & Chicago Ave,Divvy | Leavitt St & Division St (*),Divvy | Leavitt St & Lawrence Ave,Divvy | Leavitt St & North Ave,Divvy | Lincoln Ave & Addison St,Divvy | Lincoln Ave & Belle Plaine Ave,Divvy | Lincoln Ave & Belmont Ave,Divvy | Lincoln Ave & Diversey Pkwy,Divvy | Lincoln Ave & Fullerton Ave,Divvy | Lincoln Ave & Roscoe St,Divvy | Lincoln Ave & Sunnyside Ave,Divvy | Lincoln Ave & Waveland Ave,Divvy | Lincoln Ave & Winona St,Divvy | Lincolnwood Dr & Central St,Divvy | Logan Blvd & Elston Ave,Divvy | Loomis St & Archer Ave,Divvy | Loomis St & Jackson Blvd,Divvy | Loomis St & Lexington St,Divvy | MLK Jr Dr & 29th St,Divvy | MLK Jr Dr & 47th St,Divvy | MLK Jr Dr & 56th St (*),Divvy | MLK Jr Dr & 63rd St,Divvy | MLK Jr Dr & 83rd St,Divvy | MLK Jr Dr & Pershing Rd,Divvy | Malcolm X College,Divvy | Manor Ave & Leland Ave,Divvy | Maplewood Ave & Peterson Ave,Divvy | Marine Dr & Ainslie St,Divvy | Marshfield Ave & 44th St,Divvy | Marshfield Ave & 59th St,Divvy | Marshfield Ave & Cortland St,Divvy | May St & 69th St,Divvy | May St & Cullerton St,Divvy | May St & Taylor St,Divvy | McClurg Ct & Erie St,Divvy | McClurg Ct & Illinois St,Divvy | McCormick Place,Divvy | Michigan Ave & 14th St,Divvy | Michigan Ave & 18th St,Divvy | Michigan Ave & 71st St,Divvy | Michigan Ave & 8th St,Divvy | Michigan Ave & Ida B Wells Dr,Divvy | Michigan Ave & Jackson Blvd,Divvy | Michigan Ave & Lake St,Divvy | Michigan Ave & Madison St,Divvy | Michigan Ave & Oak St,Divvy | Michigan Ave & Pearson St,Divvy | Michigan Ave & Washington St,Divvy | Mies van der Rohe Way & Chestnut St,Divvy | Mies van der Rohe Way & Chicago Ave,Divvy | Millard Ave & 26th St,Divvy | Millennium Park,Divvy | Milwaukee Ave & Cuyler Ave,Divvy | Milwaukee Ave & Grand Ave,Divvy | Milwaukee Ave & Rockwell St,Divvy | Milwaukee Ave & Wabansia Ave,Divvy | Monticello Ave & Irving Park Rd,Divvy | Montrose Harbor,Divvy | Morgan Ave & 14th Pl,Divvy | Morgan St & 18th St,Divvy | Morgan St & 31st St,Divvy | Morgan St & Lake St,Divvy | Morgan St & Pershing Rd,Divvy | Morgan St & Polk St,Divvy | Museum of Science and Industry,Divvy | Noble St & Milwaukee Ave,Divvy | Normal Ave & Archer Ave,Divvy | Oakley Ave & Irving Park Rd,Divvy | Oakley Ave & Touhy Ave,Divvy | Ogden Ave & Chicago Ave,Divvy | Ogden Ave & Congress Pkwy,Divvy | Ogden Ave & Race Ave,Divvy | Ogden Ave & Roosevelt Rd,Divvy | Orleans St & Chestnut St (NEXT Apts),Divvy | Orleans St & Elm St (*),Divvy | Orleans St & Hubbard St (*),Divvy | Orleans St & Merchandise Mart Plaza,Divvy | Paulina Ave & North Ave,Divvy | Paulina St & 18th St,Divvy | Paulina St & Flournoy St,Divvy | Paulina St & Howard St,Divvy | Paulina St & Montrose Ave,Divvy | Peoria St & Jackson Blvd,Divvy | Perry Ave & 69th St,Divvy | Phillips Ave & 79th St,Divvy | Phillips Ave & 83rd St,Divvy | Pine Grove Ave & Irving Park Rd,Divvy | Pine Grove Ave & Waveland Ave,Divvy | Prairie Ave & 43rd St,Divvy | Prairie Ave & Garfield Blvd,Divvy | Princeton Ave & 47th St,Divvy | Princeton Ave & Garfield Blvd,Divvy | Pulaski Rd & Congress Pkwy,Divvy | Pulaski Rd & Eddy St (Temp),Divvy | Pulaski Rd & Lake St,Divvy | Racine Ave & 13th St,Divvy | Racine Ave & 15th St,Divvy | Racine Ave & 18th St,Divvy | Racine Ave & 35th St,Divvy | Racine Ave & 61st St,Divvy | Racine Ave & 65th St,Divvy | Racine Ave & Belmont Ave,Divvy | Racine Ave & Congress Pkwy,Divvy | Racine Ave & Fullerton Ave,Divvy | Racine Ave & Garfield Blvd,Divvy | Racine Ave & Randolph St,Divvy | Racine Ave & Washington Blvd (*),Divvy | Racine Ave & Wrightwood Ave,Divvy | Rainbow Beach,Divvy | Ravenswood Ave & Berteau Ave,Divvy | Ravenswood Ave & Irving Park Rd,Divvy | Ravenswood Ave & Lawrence Ave,Divvy | Rhodes Ave & 32nd St,Divvy | Rhodes Ave & 71st St,Divvy | Richmond St & Diversey Ave,Divvy | Ridge Blvd & Howard St,Divvy | Ridge Blvd & Touhy Ave,Divvy | Ritchie Ct & Banks St,Divvy | Rockwell St & Eastwood Ave,Divvy | Rush St & Cedar St,Divvy | Rush St & Hubbard St,Divvy | Rush St & Superior St,Divvy | Sacramento Blvd & Franklin Blvd,Divvy | Sangamon St & Washington Blvd,Divvy | Sawyer Ave & Irving Park Rd,Divvy | Sedgwick St & Huron St,Divvy | Sedgwick St & North Ave,Divvy | Sedgwick St & Schiller St,Divvy | Sedgwick St & Webster Ave,Divvy | Seeley Ave & Garfield Blvd,Divvy | Seeley Ave & Roscoe St,Divvy | Shedd Aquarium,Divvy | Sheffield Ave & Fullerton Ave,Divvy | Sheffield Ave & Kingsbury St,Divvy | Sheffield Ave & Waveland Ave,Divvy | Sheffield Ave & Webster Ave,Divvy | Sheffield Ave & Wellington Ave,Divvy | Sheffield Ave & Willow St,Divvy | Sheffield Ave & Wrightwood Ave,Divvy | Sheridan Rd & Buena Ave,Divvy | Sheridan Rd & Columbia Ave,Divvy | Sheridan Rd & Greenleaf Ave,Divvy | Sheridan Rd & Irving Park Rd,Divvy | Sheridan Rd & Lawrence Ave,Divvy | Sheridan Rd & Loyola Ave,Divvy | Sheridan Rd & Montrose Ave,Divvy | Sheridan Rd & Noyes St (NU),Divvy | Shields Ave & 28th Pl,Divvy | Shields Ave & 31st St,Divvy | Shields Ave & 43rd St,Divvy | Shore Dr & 55th St,Divvy | Smith Park (*),Divvy | South Chicago Ave & 83rd St,Divvy | South Chicago Ave & Elliot Ave,Divvy | South Shore Dr & 67th St,Divvy | South Shore Dr & 71st St,Divvy | South Shore Dr & 74th St,Divvy | Southport Ave & Belmont Ave,Divvy | Southport Ave & Clark St,Divvy | Southport Ave & Clybourn Ave,Divvy | Southport Ave & Irving Park Rd,Divvy | Southport Ave & Roscoe St,Divvy | Southport Ave & Waveland Ave,Divvy | Southport Ave & Wellington Ave,Divvy | Southport Ave & Wrightwood Ave,Divvy | Spaulding Ave & Armitage Ave,Divvy | Spaulding Ave & Division St,Divvy | St. Clair St & Erie St,Divvy | St. Louis Ave & Balmoral Ave,Divvy | State St & 19th St,Divvy | State St & 29th St,Divvy | State St & 33rd St,Divvy | State St & 35th St,Divvy | State St & 54th St,Divvy | State St & 76th St,Divvy | State St & 79th St,Divvy | State St & Harrison St,Divvy | State St & Kinzie St,Divvy | State St & Pearson St,Divvy | State St & Pershing Rd,Divvy | State St & Randolph St,Divvy | State St & Van Buren St,Divvy | Stave St & Armitage Ave,Divvy | Stetson Ave & South Water St,Divvy | Stewart Ave & 63rd St (*),Divvy | Stockton Dr & Wrightwood Ave,Divvy | Stony Island Ave & 64th St,Divvy | Stony Island Ave & 67th St,Divvy | Stony Island Ave & 71st St,Divvy | Stony Island Ave & 75th St,Divvy | Stony Island Ave & 82nd St,Divvy | Stony Island Ave & South Chicago Ave,Divvy | Streeter Dr & Grand Ave,Divvy | Talman Ave & Addison St,Divvy | Theater on the Lake,Divvy | Throop (Loomis) St & Taylor St,Divvy | Throop St & 52nd St,Divvy | Troy St & Elston Ave,Divvy | Troy St & North Ave,Divvy | Union Ave & Root St,Divvy | University Ave & 57th St,Divvy | University Library (NU),Divvy | Valli Produce - Evanston Plaza,Divvy | Vernon Ave & 75th St,Divvy | Vernon Ave & 79th St,Divvy | Vincennes Ave & 75th St,Divvy | Wabash Ave & 16th St,Divvy | Wabash Ave & 83rd St,Divvy | Wabash Ave & 87th St,Divvy | Wabash Ave & 9th St,Divvy | Wabash Ave & Adams St,Divvy | Wabash Ave & Cermak Rd,Divvy | Wabash Ave & Grand Ave,Divvy | Wabash Ave & Roosevelt Rd,Divvy | Wabash Ave & Wacker Pl,Divvy | Wacker Dr & Washington St,Divvy | Wallace St & 35th St,Divvy | Walsh Park,Divvy | Warren Park East,Divvy | Warren Park West,Divvy | Washtenaw Ave & Lawrence Ave,Divvy | Washtenaw Ave & Ogden Ave (*),Divvy | Wells St & 19th St,Divvy | Wells St & Concord Ln,Divvy | Wells St & Elm St,Divvy | Wells St & Evergreen Ave,Divvy | Wells St & Hubbard St,Divvy | Wells St & Huron St,Divvy | Wells St & Polk St,Divvy | Wells St & Walton St,Divvy | Wentworth Ave & 24th St,Divvy | Wentworth Ave & 33rd St,Divvy | Wentworth Ave & 35th St,Divvy | Wentworth Ave & 63rd St,Divvy | Wentworth Ave & Cermak Rd (Temp),Divvy | Western Ave & 21st St,Divvy | Western Ave & 24th St,Divvy | Western Ave & 28th St,Divvy | Western Ave & Congress Pkwy,Divvy | Western Ave & Division St,Divvy | Western Ave & Fillmore St (*),Divvy | Western Ave & Granville Ave,Divvy | Western Ave & Howard St,Divvy | Western Ave & Leland Ave,Divvy | Western Ave & Lunt Ave,Divvy | Western Ave & Monroe St,Divvy | Western Ave & Roscoe St,Divvy | Western Ave & Walton St,Divvy | Western Ave & Winnebago Ave,Divvy | Western Blvd & 48th Pl,Divvy | Wilton Ave & Belmont Ave,Divvy | Wilton Ave & Diversey Pkwy,Divvy | Winchester (Ravenswood) Ave & Balmoral Ave,Divvy | Winchester Ave & Elston Ave,Divvy | Winthrop Ave & Lawrence Ave,Divvy | Wolcott (Ravenswood) Ave & Montrose Ave (*),Divvy | Wolcott Ave & Fargo Ave,Divvy | Wolcott Ave & Polk St,Divvy | Wood St & 35th St,Divvy | Wood St & Augusta Blvd,Divvy | Wood St & Chicago Ave (*),Divvy | Wood St & Hubbard St,Divvy | Wood St & Milwaukee Ave,Divvy | Wood St & Taylor St,Divvy | Woodlawn Ave & 55th St,Divvy | Woodlawn Ave & 75th St,Divvy | Woodlawn Ave & Lake Park Ave,Divvy | Yates Blvd & 75th St,EasyBike | 4 martyres,EasyBike | Agia Varvara,EasyBike | Agora Arguri,EasyBike | Alsos,EasyBike | Diadoxou Pavlou,EasyBike | Dimarxeio,EasyBike | Eforia,EasyBike | Ellinoxori,EasyBike | Fanari - ProinAstynomiko Tmima,EasyBike | G. Kalentziotis,EasyBike | Gipedo Tennis,EasyBike | Hotel Pearl,EasyBike | Isaakeio,EasyBike | KTEL,EasyBike | Kentriki Plateia,EasyBike | Kosmopolis,EasyBike | Ktiniatriki,EasyBike | Ktirio Delfini,EasyBike | Lappa,EasyBike | Leonidio,EasyBike | Limani,EasyBike | Limenarxeio,EasyBike | Malagari,EasyBike | Merarxia,EasyBike | Nomarxia,EasyBike | Notios Limenas,EasyBike | OLPA Patron,EasyBike | OSE,EasyBike | Parking Limenos,EasyBike | Pausilippou,EasyBike | Perifereia,EasyBike | Pezodromos Trion Navarxon,EasyBike | Plaka,EasyBike | Plateia 28is Oktovriou,EasyBike | Plateia Dimokrateias,EasyBike | Plateia Eleutherias,EasyBike | Plateia Ethnikis Antistasis,EasyBike | Plateia Georgiou A,EasyBike | Plateia Kapnergati,EasyBike | Plateia Kapodistria,EasyBike | Plateia Mavili,EasyBike | Plateia Vergoti,EasyBike | Plateia Ypsilon Alonion,EasyBike | Trion Simmaxon,EasyBike | Vivliothiki,EasyBike | Zimvrakaki,EasyBike | dimarxeio,EasyBike | Ανατολική Μάνη 1,EasyBike | Ανατολική Μάνη 2,EasyBike | Ηράκλειο 1,EasyBike | Ηράκλειο 2,EasyBike | Ηράκλειο 3,EcoBici | 1 RIO SENA-RIO BALSAS,EcoBici | 10 REFORMA-RAMIREZ,EcoBici | 100 20 DE NOVIEMBRE-MESONES,EcoBici | 101 1ER. CALLEJÓN DE MESONES-MESONES,EcoBici | 102 ECHEVESTE-BOLIVAR,EcoBici | 103 JOAQUÍN VELÁZQUEZ DE LEÓN-GARCÍA ICAZBALCETA,EcoBici | 104 SAN JERONIMO-ISABEL LA CATOLICA,EcoBici | 105 SAN JERONIMO-5 DE FEBRERO,EcoBici | 106 SAN JERONIMO-JOSE MARIA PINO SUAREZ,EcoBici | 107 TOLSA-BALDERAS,EcoBici | 109 NEZAHUALCOYOTL-ISABEL LA CATOLICA,EcoBici | 11 RIO AMAZONAS-RIO LERMA,EcoBici | 110 DR. VALENZUELA-DR. RÍO DE LA LOZA,EcoBici | 111 GUILLERMO PRIETO-JOAQUÍN VELÁZQUEZ DE LEÓN,EcoBici | 112 AV. MORELOS-ABRAHAM GONZALEZ,EcoBici | 113 GENERAL PRIM-VERSALLES,EcoBici | 114 LUCERNA-ABRAHAM GONZALEZ,EcoBici | 115 ROMA-DINAMARCA,EcoBici | 116 LONDRES-ROMA,EcoBici | 117 LONDRES-NAPOLES,EcoBici | 118 LIVERPOOL-DINAMARCA,EcoBici | 119 TURÍN-ABRAHAM GONZÁLEZ,EcoBici | 12 RIO LERMA-VILLALONGIN,EcoBici | 120 MARSELLA-NAPOLES,EcoBici | 121 NIZA-CHAPULTEPEC,EcoBici | 122 JOSE MARIA VERTIZ-AV.DR. RIO DE LA LOZA,EcoBici | 123 CLAUDIO BERNARD-DR. LAVISTA,EcoBici | 124 CLAUDIO BERNARD-DR. LICEAGA,EcoBici | 125 MORELIA-CIRCULAR DE MORELIA,EcoBici | 126 JALAPA-PUEBLA,EcoBici | 127 PUEBLA-MERIDA,EcoBici | 128 ORIZABA-RIO DE JANEIRO,EcoBici | 129 TONALÁ-DURANGO,EcoBici | 13 REFORMA-RIO MISSISSIPPI,EcoBici | 130 MÉRIDA-DURANGO,EcoBici | 131 COLIMA-JALAPA,EcoBici | 132 COLIMA-FRONTERA,EcoBici | 133 COLIMA-MORELIA,EcoBici | 134 ÁLVARO OBREGÓN-ORIZABA,EcoBici | 135 ÁLVARO OBREGÓN-MORELIA,EcoBici | 136 ÁLVARO OBREGÓN-TONALÁ,EcoBici | 137 ÁLVARO OBREGÓN-MÉRIDA,EcoBici | 138 GUANAJUATO-FRONTERA,EcoBici | 14 REFORMA-RIO DE PLATA,EcoBici | 140 MÉRIDA-ZACATECAS,EcoBici | 141 ZACATECAS-LUIS CABRERA,EcoBici | 142 SAN LUIS POTOSI-EJE 2 PTE. MONTERREY,EcoBici | 143 CÓRDOBA-SAN LUIS POTOSÍ,EcoBici | 144 FRONTERA-SAN LUIS POTOSÍ,EcoBici | 145 EJE 2 SUR YUCATÁN-CHIAPAS,EcoBici | 146 COAHUILA-MANZANILLO,EcoBici | 147 COAHUILA-ORIZABA,EcoBici | 148 COAHUILA-AV.CUAUHTEMOC,EcoBici | 149 MÉRIDA-ANTONIO ANZA,EcoBici | 15 REFORMA-RIO MISSISSIPPI,EcoBici | 150 CAMPECHE-MEDELLÍN,EcoBici | 151 CAMPECHE-TONALÁ,EcoBici | 152 TLACOTALPAN-CAMPECHE,EcoBici | 153 MANZANILLO-TLAXCALA,EcoBici | 154 TUXPAN-TLAXCALA,EcoBici | 156 TEPIC-AMENALCO,EcoBici | 157 TEPIC-TLACOTALPAN,EcoBici | 158 HUATABAMPO-EJE 1PTE. CUAUHTÉMOC,EcoBici | 159 HUATABAMPO-EJE 1 PTE. AV. CUAUHTÉMOC,EcoBici | 16 REFORMA-RÍO TIBER,EcoBici | 161 QUINTANA ROO-MANZANILLO,EcoBici | 162 TEHUANTEPEC-MEDELLÍN,EcoBici | 163 TOLUCA-BAJÍO,EcoBici | 164 BAJÍO-TLACOTALPAN,EcoBici | 165 BAJÍO-EJE 2 PTE. MONTERREY,EcoBici | 166 PROGRESO-CDA. ANTONIO MACEO,EcoBici | 167 GENERAL SALVADOR ALVARADO-PROGRESO,EcoBici | 168 COMERCIO-PROGRESO,EcoBici | 169 PROSPERIDAD-PROGRESO,EcoBici | 17 REFORMA-RIO TIBER,EcoBici | 170 OBSERVATORIO ORIENTE-REVOLUCIÓN,EcoBici | 171 COMERCIO-JOSE MARTÍ,EcoBici | 172 GENERAL FRANCISCO MURGUIA-JOSE MARTÍ,EcoBici | 173 MINERÍA-JOSÉ MARTÍ,EcoBici | 174 JOAQUÍN GARCIA-IGNACIO MANUEL ALTAMIRANO,EcoBici | 176 AV. JESÜS GARCÏA-LUIS DONALDO COLOSIO,EcoBici | 177 BENJAMIN HILL-CARLOS ZETINA,EcoBici | 178 TAMAULIPAS-FRANCISCO MURGUÍA,EcoBici | 179 NUEVO LEÓN-QUINTANA ROO,EcoBici | 18 REFORMA-RIO RHIN,EcoBici | 180 QUINTANA ROO-VILLA HERMOSA,EcoBici | 181 BENJAMIN FRANKLIN-OMETUSCO,EcoBici | 182 PROGRESO-ASTRONOMOS,EcoBici | 183 GABINO BARRERA-GUILLERMO PRIETO,EcoBici | 184 GRAL GÓMEZ PEDRAZA-GOBERNADOR TIBURCIO M,EcoBici | 185 GRAL ANTONIO LÉON-GRAL PEDRO A DE LOS S.,EcoBici | 186 GREGORIO V GELATI-FRANCISCO MOLINOS DEL C,EcoBici | 187 GENERAL CANO-GOBERNADOR GREGORIO V GELATI,EcoBici | 188 GDOR MELCHOR MÚZQUIZ-GDOR IGNACIO ESTEVA,EcoBici | 189 GDOR RAFAEL REBOLLAR-GDOR JOSÉ CEBALLOS,EcoBici | 19 REFORMA-RIO RHIN,EcoBici | 191 GDOR RAFAEL REBOLLAR-GDOR VICENTE EGUIA,EcoBici | 192 RUBEN DARIO-REFORMA,EcoBici | 193 RUBEN DARIO-REFORMA,EcoBici | 194 CTO MAHATMA GANDHI-AV. PASEO DE LA REFORMA,EcoBici | 195 AV. PASEO DE LA REFORMA-CTO MAHATMA GANDHI,EcoBici | 196 LAGO TANGANICA-AV. EJERCITO NACIONAL,EcoBici | 197 MIGUEL DE CERVANTES-FC DE CUERNAVACA,EcoBici | 198 SÓCRATES-EJERCITO NACIONAL,EcoBici | 199 ANATOLE FRANCE-AV. EJERCITO NACIONAL,EcoBici | 2 RIO GUADALQUIVIR-RIO BALSAS,EcoBici | 20 REFORMA-RIO TAMESIS,EcoBici | 200 EMERSON-AV. EJERCITO NACIONAL,EcoBici | 201 LOPE DE VEGA-EJERCITO NACIONAL,EcoBici | 202 CALDERON DE LA BARCA-AV. HOMERO,EcoBici | 203 TENNYSON-AV. HOMERO,EcoBici | 204 TEMISTOCLES-HOMERO,EcoBici | 205 TAINE-HOMERO,EcoBici | 206 MOLIERE-HOMERO,EcoBici | 207 TASSO-HOMERO,EcoBici | 208 HESIODO-LAMARTINE,EcoBici | 209 SOLON-HORACIO,EcoBici | 21 REFORMA-DUBLIN,EcoBici | 210 EUGENIO SUE-HORACIO,EcoBici | 211 NEWTON-HORACIO,EcoBici | 212 HEGEL-HORACIO,EcoBici | 213 SOLÓN-CICERÓN,EcoBici | 214 PLATÓN-HORACIO,EcoBici | 215 EDGAR ALAN POE-HORACIO,EcoBici | 216 ALEJANDRO DUMAS-HORACIO,EcoBici | 217 EULER-AV. HORACIO,EcoBici | 218 HEGEL-IBARBOUROU,EcoBici | 219 ESOPO-FC DE CUERNAVACA,EcoBici | 22 REFORMA-MANCHESTER,EcoBici | 220 PLINIO-PRESIDENTE MASARYK,EcoBici | 221 EMILIO CASTELAR-PRESIDENTE MASARYK,EcoBici | 223 NEWTON-PRESIDENTE MASARYK,EcoBici | 224 HEGEL-PRESIDENTE MASARYK,EcoBici | 225 PETRARCA-PRESIDENTE MASARYK,EcoBici | 226 WALLON-PRESIDENTE MASARYK,EcoBici | 227 CAMPOS ELÍSEOS-PERIFÉRICO,EcoBici | 228 CAMPOS ELÍSEOS-JEAN DE LA FONTAINE,EcoBici | 229 DICKENS-SENECA,EcoBici | 23 REFORMA-PRAGA,EcoBici | 230 EDGAR ALAN POE-DICKENS,EcoBici | 231 NEWTON-ARISTOTELES,EcoBici | 232 TAINE-RUBEN DARÍO,EcoBici | 233 JULIO VERNE-LUIS G. URBINA,EcoBici | 234 TRES PICOS-ARQUÍMIDES,EcoBici | 235 CAMPOS ELISEOS-MOLIERE,EcoBici | 236 CAMPOS ELISEOS-MOLIERE,EcoBici | 237 ANDRÉS BELLO-ELLIOT,EcoBici | 238 ANDRÉS BELLO-ELLIOT,EcoBici | 239 RINCON DEL BOSQUE-RUBEN DARÍO,EcoBici | 24 REFORMA-VARSOVIA,EcoBici | 240 EJERCITO NACIONAL-F.C. DE CUERNAVACA,EcoBici | 242 MIGUEL DE CERVANTES SAAVEDRA-PROL MOLIERE,EcoBici | 243 MIGUEL DE CERVANTES SAAVEDRA-LAGO FILT,EcoBici | 244 MIGUEL DE CERVANTES SAAVEDRA-LAGO VICTORIA,EcoBici | 245 LAGO ONEGA-AV. EJERCITO NACIONAL,EcoBici | 246 LEIBNITZ-THIERS,EcoBici | 248 SHAKESPEARE-LAFAYETTE,EcoBici | 249 SHAKESPEARE-DARWIN,EcoBici | 25 REFORMA-ESTOCOLMO,EcoBici | 250 DARWIN-MARIANO ESCOBEDO,EcoBici | 251 GOETHE-DARWIN,EcoBici | 252 VICTOR HUGO-SHAKESPEARE,EcoBici | 253 DANTE-TOLSTOI,EcoBici | 254 ALFONSO HERRERA-MIGUEL SHULTZ,EcoBici | 255 JOSE ROSAS MORENO-GUILLERMO PRIETO,EcoBici | 256 GÓMEZ FARÍAS-SADI CARNOT,EcoBici | 258 CIRCUITO INTERIOR-JUAN ESCUTIA,EcoBici | 259 TÓMAS ALVA EDISON-PONCIANO ARRIAGA,EcoBici | 26 REFORMA-VERSALLES,EcoBici | 261 PASEO DE LA REFORMA - RÍO DE LA PLATA,EcoBici | 262 REPUBLICA DE CUBA-REPUBLICA DE BRASIL,EcoBici | 263 SADI CARNOT-GÓMEZ FARIAS,EcoBici | 264 HÉROES FERROCARRILEROS-AV. CENTRAL,EcoBici | 265 HÉROES FERROCARRILEROS-JESÚS GARCIA,EcoBici | 266 AV. JESÚS GARCIA-CARLOS J. MENESES,EcoBici | 267 AV. JESÜS GARCÏA-CARLOS J. MENESES,EcoBici | 268 LUIS DONALDO COLOSIO-AV.JESÚS GARCÍA,EcoBici | 269 LUIS DONALDO COLOSIO-ALDAMA,EcoBici | 27 REFORMA-HAVRE,EcoBici | 270 DE LA REPUBLICA-PONCIANO ARRIAGA,EcoBici | 271 AV. CENTRAL-J. MENESES,EcoBici | 272 AV. CENTRAL-J. MENESES,EcoBici | 273 LUIS DONALDO COLOSIO-AV. CENTRAL,EcoBici | 274 LUIS DONALDO COLOSIO-AV INSURGENTES NORTE,EcoBici | 275 HÉROES FERROCARRILEROS-AV. INSURGENTES NORTE,EcoBici | 276 ANAXÁGORAS-OBRERO MUNDIAL,EcoBici | 277 AMPLIACIÓN TONALÁ-OBRERO MUNDIAL,EcoBici | 278 MIER Y PESADO-OBRERO MUNDIAL,EcoBici | 279 LA MORENA-PROVIDENCIA,EcoBici | 28 TOLEDO-TOKIO,EcoBici | 280 ANAXÁGORAS-OBRERO MUNDIAL,EcoBici | 281 PITÁGORAS-LA MORENA,EcoBici | 282 LA MORENA-EJE 2 PONIENTE GABRIEL MANCERA,EcoBici | 283 AV. COYOACÁN-RAFAEL DONDE,EcoBici | 284 DAKOTA-VERMONT,EcoBici | 285 12 DE OCTUBRE-MINERIA,EcoBici | 286 13 DE SEPTIEMBRE-AVENIDA PATRIOTISMO,EcoBici | 287 13 DE SEPTIEMBRE-PUENTE DE LA MORENA,EcoBici | 288 11 DE ABRIL-AVENIDA 2,EcoBici | 289 CHICAGO-YOSEMITE,EcoBici | 29 REFORMA-BUCARELI,EcoBici | 290 YOSEMITE-COLORADO,EcoBici | 291 MAGDALENA-DIVISIÓN DEL NORTE,EcoBici | 292 ADOLFO PRIETO-EJE 4 SUR XOLA,EcoBici | 293 MIER Y PESADO-EJE 4 SUR XOLA,EcoBici | 294 NICOLÁS SAN JUAN-EJE 4 SUR XOLA,EcoBici | 295 ANAXÁGORAS-EJE 4 SUR XOLA,EcoBici | 297 DIAGONAL SAN ANTONIO-ENRIQUE RÉBSAMEN,EcoBici | 298 ROMERO DE TERREROS-GABRIEL MANCERA,EcoBici | 299 ROMERO DE TERREROS-MIER Y PESADO,EcoBici | 3 REFORMA-INSURGENTES,EcoBici | 30 HAMBURGO-GENOVA,EcoBici | 301 LUZ SAVIÑÓN-MAGDALENA,EcoBici | 302 LUZ SAVIÑON-MAGDALENA,EcoBici | 303 MONTESITO-AV. INSURGENTES,EcoBici | 304 MONTESITO-DAKOTA,EcoBici | 305 AVENIDA DEL PARQUE-ARIZONA,EcoBici | 306 DAKOTA-FILADELFIA,EcoBici | 307 MINESOTA-DAKOTA,EcoBici | 308 NUEVA YORK-ARIZONA,EcoBici | 309 PENNSYLVANIA-ARIZONA,EcoBici | 31 HAMBURGO-INSURGENTES,EcoBici | 310 CALLE 1-AV. PATRIOTISMO,EcoBici | 311 CALLE 5-AVENIDA REVOLUCIÓN,EcoBici | 312 AVENIDA 2-CALLE 7,EcoBici | 313 PENNSYLVANIA-OKLAHOMA,EcoBici | 314 NUERVA YORK-LOUISIANA,EcoBici | 315 ALABAMA-MONTANA,EcoBici | 316 SAN FRANCISCO-CONCEPCIÓN BEISTEGUI,EcoBici | 317 AVENIDA COYOACÁN-TORRES ADALID,EcoBici | 318 LUZ SAVIÑÓN-AMORES,EcoBici | 319 DIAGONAL SAN ANTONIO-LUZ SAVIÑON,EcoBici | 32 LONDRES-SEVILLA,EcoBici | 320 ENRIQUE RÉBSAMEN-LUZ SAVIÑON,EcoBici | 321 TORRES ADALID-ANAXÁGORAS,EcoBici | 322 HERIBERTO FRÍAS-CONCEPCIÓN BEISTEGUI,EcoBici | 323 CONCEPCIÓN BEISTEGUI-GABRIEL MANCERA,EcoBici | 324 AMORES-AVENIDA EUGENIA,EcoBici | 325 PROVIDENCIA -AVENIDA DEL VALLE,EcoBici | 326 EUGENIA-NEBRASKA,EcoBici | 328 AVENIDA 1-CALLE 7,EcoBici | 329 CALLE 13-AVENIDA 1,EcoBici | 330 CALLE 15-AVENIDA PATRIOTISMO,EcoBici | 331 AVENIDA 2-CALLE 17,EcoBici | 332 SUR DE CALLE 27-AVENIDA 3,EcoBici | 333 GEORGIA -CAROLINA,EcoBici | 334 NUEVA YORK-AV. INSURGENTES,EcoBici | 335 MAGDALENA-AMEYALCO,EcoBici | 336 SAN BORJA-CDA. BARTOLOCHE,EcoBici | 337 SAN BORJA-MARTÍN MENLALDE,EcoBici | 338 NICOLAS SAN JUAN-SAN BORJA,EcoBici | 339 ENRIQUE RÉBSAMEN-AVENIDA EUGENIA,EcoBici | 34 LIVERPOOL-GENOVA,EcoBici | 340 ANAXÁGORAS-AVENIDA EUGENIA,EcoBici | 341 SAN BORJA-AVENIDA CUAUHTEMOC,EcoBici | 342 ANAXÁGORAS-ANGEL URRAZA EJE 6 SUR,EcoBici | 343 ENRIQUE RÉBSAMEN-DIVISIÓN DEL NORTE,EcoBici | 344 HERIBERTO FRÍAS-ANGEL URRAZA EJE 6 SUR,EcoBici | 345 MIRAFLORES-PATRICIO SANZ,EcoBici | 346 SAN FRANCISCO-SANTA MARGARITA,EcoBici | 347 PENNSYLVANIA-MAXIMINO AVILA CAMACHO,EcoBici | 348 INDIANA-AVENIDA SAN ANTONIO,EcoBici | 349 AUGUSTO RODIN-AVENIDA SAN ANTONIO,EcoBici | 35 LIVERPOOL-GENOVA,EcoBici | 350 JOSE CLEMENTE OROZCO-CORREGGIO,EcoBici | 351 CALLE 27-AVENIDA REVOLUCIÓN,EcoBici | 352 TINTORETO-GIORGINE,EcoBici | 353 CAROLINA-HOLBEIN,EcoBici | 354 BOSTON-AV. INSURGENTES,EcoBici | 355 CALIFORNIA-SACRAMENTO,EcoBici | 356 MATIAS ROMERO -ADOLFO PRIETO,EcoBici | 357 MATIAS ROMERO -AMORES,EcoBici | 358 NICOLAS SAN JUAN-MATIAS ROMERO,EcoBici | 359 MATIAS ROMERO -PESTALLOZZI,EcoBici | 36 PUEBLA-VERACRUZ,EcoBici | 361 PORFIRIO DÍAZ-CAPULÍN,EcoBici | 362 AUGUSTO RODIN-ALBERTO BALDERAS,EcoBici | 363 HOLBEIN-PAULO UCELLO,EcoBici | 364 BOTICHELLI-CDA. DE GIORGONE,EcoBici | 365 HOLBEIN-AVENIDA REVOLUCIÓN,EcoBici | 366 PORFIRIO DÍAZ-AUGUSTO RODÍN,EcoBici | 367 BOSTON -AUGUSTO RODÍN,EcoBici | 368 PORFIRIO DÍAZ-CINCINATTI,EcoBici | 369 PORFIRIO DÍAZ-AV. INSURGENTES,EcoBici | 37 GUADALAJARA-PUEBLA,EcoBici | 370 TLACOQUEMECATL-AV. INSURGENTES,EcoBici | 371 TLACOQUEMECATL-CAPULIN,EcoBici | 372 DR. ROBERTO GAYOL-TLACOQUEMECATL,EcoBici | 373 PILARES-GABRIEL MANCERA,EcoBici | 374 PITÁGORAS-PILARES,EcoBici | 375 TENAYUCA-DIVISIÓN DEL NORTE,EcoBici | 376 PITÁGORAS-AV. UNIVERSIDAD,EcoBici | 377 HERIBERTO FRÍAS-MIGUEL LAURENT,EcoBici | 378 MIGUEL LAURENT-AMORES,EcoBici | 379 DR. ROBERTO GAYOL-MIGUEL LAURENT,EcoBici | 38 COZUMEL-PUEBLA,EcoBici | 380 MORAS-SAN LORENZO,EcoBici | 381 SAN LORENZO-MANZANAS,EcoBici | 382 SAN LORENZO-AV. INSURGENTES,EcoBici | 383 LUIS CARACCI-2DA. LUIS CARACCI,EcoBici | 384 EMPRESA-POUSSIN,EcoBici | 385 POUSSIN-EMPRESA,EcoBici | 386 POUSSIN-DONATELLO,EcoBici | 387 CADIZ-EMPRESA,EcoBici | 388 VALENCIA-MALAGA,EcoBici | 389 SANTANDER-FELIX CUEVAS,EcoBici | 39 PUEBLA-MEDELLÍN,EcoBici | 390 OSO-FELIX CUEVAS,EcoBici | 392 PATRICIO SANZ-FELIX CUEVAS,EcoBici | 393 ADOLFO PRIETO-FELIX CUEVAS,EcoBici | 394 DR. ROBERTO GAYOL-FELIX CUEVAS,EcoBici | 395 SAN LORENZO-CALLEJÓN MARTÍN MENLALDE,EcoBici | 396 MARTÍN MENLALDE-FELIX CUEVAS,EcoBici | 397 SAN LORENZO-GABRIEL MANCERA,EcoBici | 398 SANCHEZ AZCONA-FELIX CUEVAS,EcoBici | 399 HERIBERTO FRÍAS-SAN LORENZO,EcoBici | 4 RIO NILO-RIO PANUCO,EcoBici | 40 OAXACA-PUEBLA,EcoBici | 400 SAN LORENZO-HERIBERTO FRIAS,EcoBici | 401 SAN LORENZO-AVENIDA CUAUHTEMOC,EcoBici | 402 UXMAL-MUNICIPIO LIBRE,EcoBici | 403 UXMAL-MUNICIPIO LIBRE,EcoBici | 404 MIGUEL LAURENT-AVENIDA DIVISIÓN DEL NORTE,EcoBici | 405 DIVISIÓN DEL NORTE-MUNICIPIO LIBRE,EcoBici | 406 PARROQUIA AV. MEXICO-COYOACAN,EcoBici | 407 PROL. XOCHICALCO-GENERAL EMILIANO ZAPATA,EcoBici | 408 PROLONGACIÓN PETÉN-GENERAL EMILIANO ZAPATA,EcoBici | 409 AZORES-DIVISIÓN DEL NORTE,EcoBici | 41 REFORMA-AV. DE LA REPUBLICA,EcoBici | 410 PROLONGACIÓN TAJÍN-PROLONGACIÓN REPÚBLICAS,EcoBici | 411 PARROQUIA-AVENIDA MÉXICO-COYOACAN,EcoBici | 412 PARROQUIA-AVENIDA UNIVERSIDAD,EcoBici | 413 PARROQUIA-AVENIDA COYOACÁN,EcoBici | 414 PARROQUIA-JOSÉ IGNACIO BARTOLACHE,EcoBici | 415 SAN FRANCISCO-PARROQUÍA,EcoBici | 416 RECREO-PARROQUÍA,EcoBici | 417 GOYA-AUGUSTO RODÍN,EcoBici | 418 GALICIA-ACTIPAN,EcoBici | 419 ACTIPAN-CADIZ,EcoBici | 42 SINALOA-VALLADOLID,EcoBici | 420 MARÍA LUZ BRINGAS-OSO,EcoBici | 421 MARÍA LUZ BRINGAS-OSO,EcoBici | 422 BUFALO-JOSÉ MARÍA RICO (EJE 8),EcoBici | 423 MORAS-JOSÉ MARÍA RICO (EJE 8),EcoBici | 424 AMORES-JOSÉ MARÍA RICO (EJE 8),EcoBici | 425 NICOLAS SAN JUAN-AVENIDA UNIVERSIDAD,EcoBici | 426 CERRADA DE POPOCATEPETL-AV. POPOCATEPETL (EJE,EcoBici | 427 AVENIDA MÉXICO-COYOACAN-AV. POPOCATEPETL (EJE,EcoBici | 428 PROLONGACIÓN UXMAL-AV. POPOCATEPETL (EJE 8),EcoBici | 429 PIRINEOS-AV. POPOCATEPETL (EJE 8),EcoBici | 43 JUAREZ-REVILLAGIGEDO,EcoBici | 430 TRIPOLI-AV. POPOCATEPETL (EJE 8),EcoBici | 431 BRUNO TRAVEN-PAZ MONTES DE OCA,EcoBici | 432 CARRILLO PUERTO-AV. MÉXICO-COYOACÁN,EcoBici | 433 JOSE MARÍA OLLOQUI-LOPÉZ COSTILLA,EcoBici | 435 RODRIGUEZ SARO-AVENIDA COYOACÁN,EcoBici | 436 RODRIGUEZ SARO-BUFALLO,EcoBici | 437 MORAS-COMUNAL,EcoBici | 438 ADOLFO PRIETO-JOSÉ MARÍA OLLOQUI,EcoBici | 439 AMORES-AVENIDA COYOACÁN,EcoBici | 44 DURANGO-VERACRUZ,EcoBici | 440 REAL DE MAYORAZGO-PUENTE XOCO,EcoBici | 441 PUENTE XOCO-REAL DE MAYORAZGO,EcoBici | 442 REAL DE MAYORAZGO-AVENIDA MÉXICO-COYOACAN,EcoBici | 443 BRUNO TRAVEN-GOLONDRINAS,EcoBici | 444 GENERAL MANUEL RINCÓN-AGUSTÍN GUTIERREZ,EcoBici | 446 RIFF-AVENIDA RIO CHURUBUSCO,EcoBici | 447 AGUSTÍN MELGAR-ZAMORA,EcoBici | 448 DR. ANDRADE - ARCOS DE BELÉN,EcoBici | 45 DURANGO-SONORA,EcoBici | 450 RAMOS ARIZPE-PUENTE DE ALVARADO,EcoBici | 451 CAMPOS ELÍSEOS-GOLDSMITH,EcoBici | 452 LEIBNITZ-AV. EJERCITO NACIONAL,EcoBici | 453 PEDREGAL-TEAPA,EcoBici | 455 PEDREGAL-FERROCARRIL DE CUERNAVACA,EcoBici | 456 ALPES-MONTES ESCANDINAVOS,EcoBici | 458 MONTES URALES-VOLCÁN,EcoBici | 46 DURANGO-SALAMANCA,EcoBici | 460 JUAN VÁZQUEZ DE MELLA-HOMERO,EcoBici | 461 PRESA DON MARTÍN-BOULEVARD MIGUEL DE CERVANTES,EcoBici | 462 PRESA FALCÓN-DANXHÓ,EcoBici | 463 LAGO ANDRÓMACO-LAGO ZURICH,EcoBici | 465 LAGUNA DE GINEBRA-LAGO WETTER,EcoBici | 466  LAGO ONEGA-LAGO LADOGA,EcoBici | 468 LAGO XOCHIMILCO-AV. EJÉRCITO NACIONAL,EcoBici | 47 GLORIETA CIBELES-OAXACA,EcoBici | 470 BAHÍA DE LAS PALMAS-BAHÍA DE TODOS LOS SANTOS,EcoBici | 471 BAHÍA DE CHACHALACAS-BAHÍA SANTA BÁRBARA,EcoBici | 473 BAHÍA DEL ESPÍRITU SANTO-BAHÍA DE BANDERAS,EcoBici | 474 BAHÍA DE SAN HIPÓLITO-BAHÍA DEL ESPÍRITU SANTO,EcoBici | 475 LAGO MURITZ-LAGO ALBERTO,EcoBici | 476 LAGO COMO-LAGUNA DE MAYRÁN,EcoBici | 477 LAGO ISEO-LAGUNA DE MAYRÁN,EcoBici | 478 LAGUNA DE MAYRÁN-LAGO CHALCO,EcoBici | 48 INDEPENDENCIA-AZUETA,EcoBici | 480 LAGO ISEO-AV. MARINA NACIONAL,EcoBici | 49 MAZATLAN-JUAN DE LA BARRERA,EcoBici | 5 RIO PANUCO-RIO TIBER,EcoBici | 50 CUERNAVACA-VERACRUZ,EcoBici | 51 COLIMA-OAXACA,EcoBici | 52 HIDALGO-TRUJANO,EcoBici | 53 FERNANDO MONTES DE OCA-TULA,EcoBici | 54 PARQUE ESPAÑA-SONORA,EcoBici | 55 5 DE MAYO-BOLIVAR,EcoBici | 56 ALVARO OBREGON-MEDELLIN,EcoBici | 57 CUERNAVACA-JUAN ESCUTIA,EcoBici | 58 PARQUE ESPAÑA-JUAN DE LA BARRERA,EcoBici | 59 POPOCATEPETL-AMSTERDAM,EcoBici | 6 RIO PANUCO-RIO SENA,EcoBici | 60 MAZATLAN-FERNANDO MONTES DE OCA,EcoBici | 61 AVENIDA MEXICO-SONORA,EcoBici | 62 FERNANDO MONTES DE OCA-AMATLAN,EcoBici | 63 NUEVO LEON- LAREDO,EcoBici | 64 SONORA-AMSTERDAM,EcoBici | 65 MARCONI-TACUBA,EcoBici | 66 MAZATLAN-FRANCISCO MARQUEZ,EcoBici | 67 VICENTE SUAREZ-MICHOACAN,EcoBici | 68 TAMAULIPAS-MICHOACAN,EcoBici | 69 MICHOACAN-AMSTERDAM,EcoBici | 7 RIO ELBA-RIO LERMA,EcoBici | 70 PARQUE MEXICO-MICHOACAN,EcoBici | 71 AMSTERDAM-MICHOACAN,EcoBici | 72 MAZATLAN-ALFONSO REYES,EcoBici | 73 CAMPECHE-TAMAULIPAS,EcoBici | 74 NUEVO LEON-OZULAMA,EcoBici | 75 ALFONSO REYES-ATLIXCO,EcoBici | 76 CHILPANCINGO-CAMPECHE,EcoBici | 77 CHOAPAN-TAMAULIPAS,EcoBici | 78 BENJAMIN HILL-TAMAULIPAS,EcoBici | 79 SALTILLO-ALFONSO REYES,EcoBici | 8 REFORMA-GENERAL PRIM,EcoBici | 80 NUEVO LEON-AGUASCALIENTES,EcoBici | 81 AGUASCALIENTES-INSURGENTES,EcoBici | 82 INDEPENDENCIA-MARROQUI,EcoBici | 83 NUEVO LEON-ALFONSO REYES,EcoBici | 84 CHILPANCINGO-TLAXCALA,EcoBici | 85 ROSAS MORENO-SULLIVAN,EcoBici | 86 SULLIVAN-INSURGENTES,EcoBici | 87 GANTE-VENUSTIANO CARRANZA,EcoBici | 88 2A CDA 5 DE MAYO-PALMA,EcoBici | 89 REPUBLICA DE GUATEMALA-MONTE DE PIEDAD,EcoBici | 9 RIO GUADALQUIVIR-RIO LERMA,EcoBici | 90 JOSE MARIA PINO SUAREZ-CORREGIDORA,EcoBici | 91 REPUBLICA DE CUBA-ALLENDE,EcoBici | 92 SAN ILDEFONSO-REPUBLICA DE ARGENTINA,EcoBici | 93 PALMA NORTE-REPUBLICA DE CUBA,EcoBici | 94 LIC. VERDAD-MONEDA,EcoBici | 95 20 DE NOVIEMBRE-VENUSTIANO CARRANZA,EcoBici | 96 LOPEZ-AYUNTAMIENTO,EcoBici | 97 REPUBLICA DE SALVADOR-PINO SUAREZ,EcoBici | 98 EMILIO DONDE-AV. BALDERAS,EcoBici | 99 ERNESTO PUGIBET-LUIS MOYA,EcoBici | E108 TOLSA-BALDERAS,EcoBici | E139 TONALÁ-GUANJUATO,EcoBici | E155 JALAPA-TLAXCALA,EcoBici | E160 ALFONSO HERRERA-GABINO BARRERA,EcoBici | E175 MUTUALISMO-JOSÉ MARTí,EcoBici | E190 GDOR IGNACIO ESTEVA-MTRO JOSÉ VASCONCELOS,EcoBici | E222 ALEJANDRO DUMAS-PRESIDENTE MASARYK,EcoBici | E241 EJERCITO NAL-JUAN VAZQUEZ DE LA MELLA,EcoBici | E247 HERSCHEL-ROUSSEAU,EcoBici | E257 MANUEL MARIA CONTRERAS-VILLALONGIN,EcoBici | E260 AV JUAREZ-BALDERAS,EcoBici | E296 DIAGONAL SAN ANTONIO-ENRIQUE RÉBSAMEN,EcoBici | E300 PROVIDENCIA -LUZ SAVIÑON,EcoBici | E327 GEORGIA -PENNSYLVANIA,EcoBici | E33 LONDRES-FLORENCIA,EcoBici | E360 HERIBERTO FRÍAS-MATIAS ROMERO,EcoBici | E391 OSO-FELIX CUEVAS,EcoBici | E434 JOSE MARÍA OLLOQUI-AMORES,EcoBici | E445 RIFF-AVENIDA RIO CHURUBUSCO,EcoBici | E449 ACAPULCO-PUEBLA,EcoBici | E454 MONTES URALES-MONTE PELVOUX,EcoBici | E457 AV. PRADO NORTE-EXPLANADA,EcoBici | E459 VOLCÁN-MONTES URALES,EcoBici | E464 MATEO ALEMÁN-PROLONGACIÓN MOLIERE,EcoBici | E467  LAGO MAYOR-LAGO ALBERTO,EcoBici | E469 BAHÍA DE LA CONCEPCIÓN-BAHÍA DE TODOS LOS SAN,EcoBici | E472 BAHÍA SANTA BÁRBARA-BAHÍA DE BALLENAS,EcoBici | E479 LAGO MURITZ-AV. MARINA NACIONAL,Ecobici | 001 - FACULTAD DE DERECHO,Ecobici | 002 - Retiro I,Ecobici | 003 - ADUANA,Ecobici | 004 - Plaza Roma,Ecobici | 005 - Plaza Italia,Ecobici | 006 - Parque Lezama,Ecobici | 007 - OBELISCO,Ecobici | 008 - Congreso,Ecobici | 009 - Parque Las Heras,Ecobici | 010 - Madero UCA,Ecobici | 011 - Tribunales,Ecobici | 012 - Plaza Vicente Lopez,Ecobici | 013 - ONCE,Ecobici | 014 - Pacifico,Ecobici | 015 - JUANA MANSO II,Ecobici | 016 - Legislatura,Ecobici | 017 - Plaza Almagro,Ecobici | 018 - Independencia,Ecobici | 019 - PLAZA SAN MARTIN,Ecobici | 020 - Distrito Audiovisual,Ecobici | 021 - Parque Patricios,Ecobici | 022 - Arenales,Ecobici | 023 - Suipacha,Ecobici | 024 - ALSINA,Ecobici | 025 - Plaza Guemes,Ecobici | 026 - JUANA MANSO I,Ecobici | 027 - Montevideo,Ecobici | 028 - Plaza Boedo,Ecobici | 029 - Parque Centenario,Ecobici | 030 - Peña,Ecobici | 031 - Padilla,Ecobici | 032 - Catedral,Ecobici | 033 - Facultad de Medicina,Ecobici | 034 - Colonia Express,Ecobici | 035 - INGENIERO BUTTY,Ecobici | 036 - MAIPÚ,Ecobici | 037 - Claudia Pia Braudacco,Ecobici | 038 - Plaza Libertad,Ecobici | 039 - CONGRESO II,Ecobici | 040 - Sarmiento,Ecobici | 041 - URQUIZA,Ecobici | 042 - Diagonal Norte,Ecobici | 044 - Ecoparque,Ecobici | 045 - Uruguay,Ecobici | 046 - Chile,Ecobici | 047 - Colegio Nacional de Buenos Aires,Ecobici | 048 - Perón,Ecobici | 049 - 33 Orientales,Ecobici | 050 - Hospital Rivadavia,Ecobici | 051 - TUCUMAN,Ecobici | 052 - SANCHEZ DE BUSTAMANTE,Ecobici | 053 - Ricardo Rojas,Ecobici | 054 - Acuña de Figueroa,Ecobici | 055 - Bouchard,Ecobici | 056 - Plaza Palermo Viejo,Ecobici | 057 - BELGRANO,Ecobici | 058 - Ministro Carranza,Ecobici | 059 - Coronel Diaz,Ecobici | 060 - 25 De Mayo,Ecobici | 061-Ministerio de Economia,Ecobici | 062 - Córdoba,Ecobici | 063 - Reconquista,Ecobici | 064 - RIOBAMBA,Ecobici | 065 - Julián Álvarez,Ecobici | 066 - Billinghurst,Ecobici | 067 - Senillosa,Ecobici | 068 - Rivarola,Ecobici | 069 - Ecuador,Ecobici | 070 - ARAOZ,Ecobici | 071 - CERRITO,Ecobici | 072 - Venezuela,Ecobici | 073 - Ruy Díaz de Guzmán,Ecobici | 074 - INSTITUTO  LELOIR,Ecobici | 075 - Plaza Primero de Mayo,Ecobici | 076 - Ayacucho,Ecobici | 077 - SARANDI,Ecobici | 078 - SUIPACHA Y ARROYO,Ecobici | 079 - AZUCENA VILLAFLOR,Ecobici | 080 - DOBLAS,Ecobici | 081 -Balcarce,Ecobici | 082 - HOSPITAL ITALIANO,Ecobici | 083 - Paraná,Ecobici | 084 - Lavalle,Ecobici | 085 - AGUERO,Ecobici | 086 - SAAVEDRA,Ecobici | 087 - Guayaquil,Ecobici | 088 - MISIONES,Ecobici | 089 - Cabello,Ecobici | 090 - GUTIERREZ,Ecobici | 091 - Pasco,Ecobici | 092 - Salcedo,Ecobici | 093 - CARLOS CALVO,Ecobici | 094 - GÚZMAN,Ecobici | 095 - ESMERALDA,Ecobici | 096 - Carlos Gardel,Ecobici | 097 - Avelino Diaz,Ecobici | 098 - Moreno,Ecobici | 099 - Malabia,Ecobici | 100 - Plaza Gurruchaga,Ecobici | 101 - Fitz Roy,Ecobici | 102 - ROSETI,Ecobici | 103 - MALBA,Ecobici | 104 - Federico Lacroze,Ecobici | 105 - 15 DE NOVIEMBRE,Ecobici | 106 - RINCÓN,Ecobici | 107 - HOSPITAL GARRAHAN,Ecobici | 108 - Usina del Arte,Ecobici | 109 - Lerma,Ecobici | 110 - Guardia Vieja,Ecobici | 111 - MACACHA GUEMES,Ecobici | 112 - 9 de Julio,Ecobici | 113 - Guatemala,Ecobici | 114 - DELLA PAOLERA,Ecobici | 115 - QUINTANA,Ecobici | 116 - HOSPITAL ALEMÁN,Ecobici | 117 - HUMBERTO 1°,Ecobici | 118 - MEXICO,Ecobici | 119 - EMILIO MITRE,Ecobici | 120 - HOSPITAL RAMOS MEJIA,Ecobici | 121 - YATAY,Ecobici | 122 - COSTA RICA,Ecobici | 123 - Armenia,Ecobici | 124 - UGARTECHE,Ecobici | 125 - F.J.Santamaria de Oro,Ecobici | 126 - Ministerio de Justicia y Seguridad,Ecobici | 127 - SANTOS DUMONT Y OTERO,Ecobici | 128 - PARQUE DEL BAJO,Ecobici | 129 - Velasco,Ecobici | 130 - RETIRO II,Ecobici | 131- HOSPITAL DE CLÍNICAS,Ecobici | 132 - CORRIENTES,Ecobici | 133 - Nicaragua,Ecobici | 134 - DON BOSCO,Ecobici | 135 - MARCELO T. DE ALVEAR,Ecobici | 136 - Acevedo,Ecobici | 137 - AZOPARDO Y CHILE,Ecobici | 138 - Hospital Britanico,Ecobici | 139 - Virrey Liniers,Ecobici | 140 - Las Casas,Ecobici | 141 - SOLIS Y ALSINA,Ecobici | 142 - Armenia y Gorriti,Ecobici | 143 - BILLINGHURST Y VALENTÍN GOMEZ,Ecobici | 144 - PUEYRREDÓN,Ecobici | 145 - RAVIGNANI,Ecobici | 146 - Hospital Francés,Ecobici | 147 - Constitución,Ecobici | 148 - Paternal,Ecobici | 149 - LIMA,Ecobici | 150 - VERA PEÑALOZA,Ecobici | 151 - AIME PAINÉ,Ecobici | 152 - JULIETA LANTERI,Ecobici | 153 - JUAN MANUEL DE BLANES,Ecobici | 154 - GALLO,Ecobici | 155 - Parque José Evaristo Uriburu,Ecobici | 156 - Plaza Alemania,Ecobici | 157 - Senillosa y Zuviria,Ecobici | 158 - VILLARROEL,Ecobici | 159 - Fitz Roy & Gorriti,Ecobici | 160 - Godoy Cruz y Libertador,Ecobici | 161 - Humahuaca,Ecobici | 162 - LARREA Y BARTOLOMÉ MITRE,Ecobici | 163 - ONCE II,Ecobici | 164 - FACULTAD DE INGENERIA,Ecobici | 165 - PLAZA MONSEÑOR MIGUEL DE ANDREA,Ecobici | 166 - Cementerio de Recoleta,Ecobici | 167 - Hipólito Yrigoyen,Ecobici | 168 - Estados Unidos,Ecobici | 169 - FACULTAD DE PSICOLOGIA,Ecobici | 170 - SAN LUIS Y ECUADOR,Ecobici | 171 - Pasteur,Ecobici | 172 - BRASIL,Ecobici | 173 - PLAZA CECILIA GRIERSON,Ecobici | 174 - MINISTERIO DE EDUCACION,Ecobici | 175 - Esmeralda y Corrientes,Ecobici | 176 - PINZÓN Y MARTÍN RODRIGUEZ,Ecobici | 177 -PLANETARIO,Ecobici | 178 - José Marmol,Ecobici | 179 - LA BOCA,Ecobici | 180 - CASTRO Y MEXICO,Ecobici | 181 - BILLINGHURST Y MANSILLA,Ecobici | 182 - RAVIGNANI Y GUATEMALA,Ecobici | 183 - VIRREY CEVALLOS,Ecobici | 184 - Pedro Echague,Ecobici | 185 - AV. PAVÓN Y 33 ORIENTALES,Ecobici | 186 - MANZANA 66,Ecobici | 187 - Jose Maria Moreno,Ecobici | 188 - Aranguren,Ecobici | 189 - POSADAS,Ecobici | 190 - JUNCAL,Ecobici | 191 - Rivadavia y 9 de Julio,Ecobici | 192 - Talcahuano,Ecobici | 193 - ARENALES Y AGUERO,Ecobici | 194 - PERÓN Y ACUÑA DE FIGUEROA,Ecobici | 195 - Plaza Garay,Ecobici | 196 - HOSPITAL ARGERICH,Ecobici | 197 - Quintino Bocayuva,Ecobici | 198 - HOSPITAL SARDÁ,Ecobici | 199 - ESTADOS UNIDOS Y BOEDO,Ecobici | 200 - AUSTRIA Y FRENCH,Ecobici | 201 - JUAN AGUSTIN GARCIA,Ecobici | 202 - Nogoya Y Argerich,Ecobici | 203 - Beiro,Ecobici | 204 - Biarritz,Ecobici | 205 - SAN MARTIN,Ecobici | 206 - Galicia,Ecobici | 207 - PLAZA ARENALES,Ecobici | 208 - Segui,Ecobici | 209 - PAYSANDU,Ecobici | 210 - Terrero,Ecobici | 211 - ARANGUREN Y SEGUI,Ecobici | 212 - SOR JUANA,Ecobici | 213 - Hospital Alvear,Ecobici | 214 - Flores,Ecobici | 215 - HOSPITAL ALVAREZ,Ecobici | 216 - Margariños Cervantes y Argerich,Ecobici | 217 - Cachimayo,Ecobici | 218 - Campana,Ecobici | 219 - Parque Chacabuco II,Ecobici | 220 - GIRIBONE,Ecobici | 221 - CULPINA,Ecobici | 222 - SIMON BOLIVAR,Ecobici | 223 - GAINZA,Ecobici | 224 - FERROCARRIL OESTE,Ecobici | 225 - HOSPITAL TORNU,Ecobici | 226 - Parque La Paternal,Ecobici | 227 -Club Ciudad de Buenos Aires,Ecobici | 228 - BALDOMERO,Ecobici | 229 - RIGLOS,Ecobici | 230 - Parque Las Heras II,Ecobici | 231 - Margariños Cervantes,Ecobici | 232 - Sucre y Martinez,Ecobici | 233 - MONROE,Ecobici | 234 - Valdenegro,Ecobici | 235 - Colegiales,Ecobici | 236 - Guemes,Ecobici | 237 - Madero Office,Ecobici | 238 - RIVERA,Ecobici | 239 - Vidal,Ecobici | 240 - ECHEVERRIA,Ecobici | 241 - Sanatorio Mendez,Ecobici | 242 - Plazoleta Rafael del Riego,Ecobici | 243 - PLAZOLETA CELEDONIO FLORES,Ecobici | 244 - UADE,Ecobici | 245 - Arribeños,Ecobici | 246 - EDUARDO OLIVERA,Ecobici | 247 - Plaza Lucio Demare,Ecobici | 248 - Husares,Ecobici | 249 - Balbín,Ecobici | 250 - Fleni,Ecobici | 251 - Solar de la Abadía,Ecobici | 252 - Tamborini,Ecobici | 253 - Plaza Colegiales,Ecobici | 254 - Plaza Rafael Hernandez,Ecobici | 255 - BARRANCAS DE BELGRANO,Ecobici | 256 - PLAZA NORUEGA,Ecobici | 257 - Plaza Francisco Ramirez,Ecobici | 258 - Plaza J.J. Paso,Ecobici | 259 - PLAZA CASTELLI,Ecobici | 260 - SAN MIGUEL DE GARICOITS,Ecobici | 261 - QUINTEROS LIDORO,Ecobici | 262 - Holmberg,Ecobici | 263 - Plaza Echeverria,Ecobici | 264 - Plaza Marcos Sastre,Ecobici | 265 - Plaza Exodo Jujeño,Ecobici | 266 - Plaza Alfredo Nobel,Ecobici | 267 - Plaza 25 De Agosto,Ecobici | 268 - Plaza Aristóbulo Del Valle,Ecobici | 269 - Plaza De La Misericordia,Ecobici | 270 - PLAZA DEL ANGEL GRIS,Ecobici | 271 - Plazoleta 11 de Noviembre,Ecobici | 272 - Plaza Bruno Giordano,Ecobici | 273 - Plazoleta Colombia,Ecobici | 274 - Plaza Nuestra Señora de la Asuncion,Ecobici | 275 - PLAZA 24 DE SEPTIEMBRE,Ecobici | 276 - PRIMERA JUNTA,Ecobici | 277 - Coghlan,Ecobici | 278 - Donato Alvarez,Ecobici | 279 - Andonaegui,Ecobici | 280 - JURAMENTO,Ecobici | 281 - JUAN MANUEL DE ROSAS,Ecobici | 282 - Tronador,Ecobici | 283 - CNEL. JUAN CRUZ CZETZ,Ecobici | 284 - BONIFACIO Y CARABOBO,Ecobici | 285 - ESPINOSA,Ecobici | 286 - OEA,Ecobici | 287 - Belaustegui,Ecobici | 288- 11 de septiembre,Ecobici | 289 - MONTAÑESES,Ecobici | 290 - Club Excursionistas,Ecobici | 291 - UNIVERSIDAD DE BELGRANO,Ecobici | 292 - PLAZA BOLIVIA,Ecobici | 293 - PEDERNERA,Ecobici | 294 - Bonifacio,Ecobici | 295 - Larralde,Ecobici | 296 - FREIRE,Ecobici | 297 - TRONADOR Y GARCÍA DEL RÍO,Ecobici | 298 - IRALA,Ecobici | 299 - HIDALGO,Ecobici | 301 - Arregui Y Terrada,Ecobici | 302 - Plaza Jose Marti,Ecobici | 303 - Huaura,Ecobici | 304 - Navarro,Ecobici | 305 - Plaza Martin Rodriguez,Ecobici | 306 - Tres Arroyos Y Olaya,Ecobici | 307 - LEONARDO PEREYRA,Ecobici | 308 - Artigas Y Melincue,Ecobici | 309 - HOMERO MANZI,Ecobici | 310 - Gregoria Perez,Ecobici | 311 - CONCORDIA,Ecobici | 312 - Parque Chacabuco  I,Ecobici | 313 - De Los Incas,Ecobici | 314 - Ramón Falcon,Ecobici | 315 - BEIRO Y SAN MARTÍN,Ecobici | 317 - Cero Más Infinito,Ecobici | 318 - Plaza Y Carbajal,Ecobici | 319 - Cervantes y Trelles,Ecobici | 320 - QUIRNO,Ecobici | 321 - PERITO MORENO,Ecobici | 322 - MARTÍ Y DIRECTORIO,Ecobici | 323 - Parque Avellaneda II,Ecobici | 324 - Las Victorias,Ecobici | 325 - CASTELLI Y PERON,Ecobici | 326 - Emma De La Barra,Ecobici | 327 - ACUÑA DE FIGUEROA Y POTOSI,Ecobici | 328 - Centro Cultural San Martin,Ecobici | 329 - PASO Y LAVALLE,Ecobici | 330 - Parque Avellaneda,Ecobici | 331 - PLAZA HERRERA,Ecobici | 332 - PLAZOLETA PORTUGAL,Ecobici | 333 - MIRO,Ecobici | 334 - CENTRO DE EXPOSICIONES,Ecobici | 335 - General Urquiza,Ecobici | 336 - La Pampa,Ecobici | 337 - UTN,Ecobici | 338 - Sucre y Dragones,Ecobici | 339 - AMANCIO ALCORTA,Ecobici | 340 - PLAZA NUEVA POMPEYA,Ecobici | 341 - TILCARA,Ecobici | 342 - SAENZ,Ecobici | 343 - POMAR,Ecobici | 344 - UNIVERSIDAD DI TELLA,Ecobici | 345 - Plaza Mafalda,Ecobici | 346 - Plaza Zapiola,Ecobici | 347 - PLAZA MALAVER,Ecobici | 348 - Villa del Parque,Ecobici | 349 - Plaza Saenz Peña,Ecobici | 350 - Plaza Irlanda,Ecobici | 351 - Plaza De Los Periodistas,Ecobici | 352 - San Jose de Flores,Ecobici | 353 - PLAZA VELEZ SARSFIELD,Ecobici | 354 - Plaza Tupac Amaru,Ecobici | 355 - PLAZA RICARDO LLERAS,Ecobici | 356 - Plaza Sergio Karakachoff,Ecobici | 357 - PLAZA MARTIN FIERRO,Ecobici | 358 - Plaza Almirante Brown,Ecobici | 359 - Plaza Balcarce,Ecobici | 360 - Plaza Ramon Falcon,Ecobici | 361 - Plaza Don Segundo Sombra,Ecobici | 362 - PARQUE DE LA MEMORIA,Ecobici | 363 - Udaondo,Ecobici | 364 - Carranza Y Gorriti,Ecobici | 365 - Venancio Flores,Ecobici | 366 - Plaza Diaz Velez,Ecobici | 367 - Mariano Castex,Ecobici | 368 - Ensenada,Ecobici | 369 - Ciudad De La Paz,Ecobici | 370 - Beauchef,Ecobici | 371 - Paseo de las Americas,Ecobici | 372 - Villa Soldati,Ecobici | 373 - Jorgelina De Simone,Ecobici | 374 - Puan,Ecobici | 375 - Ciudad Universitaria I,Ecobici | 376 - Ciudad Universitaria II,Ecobici | 377 - Ciudad Universitaria III,Ecobici | 378 - Agronomia,Ecobici | 379 - BERG,Ecobici | 380 - Paysandu y Galicia,Ecobici | 381 - Matienzo Y Arce,Ecobici | 382 - CMD,Ecobici | 383 - Boedo & Venezuela,Ecobici | 384 - PLAZA BENITO NAZAR,Ecobici | 385 - Franklin,Ecobici | 386 - Gavilan Y Vallese,Ecobici | 387 - Luna,Ecobici | 388 - Plaza Jose C Paz,Ecobici | 389 - Plaza República De Mexico,Ecobici | 390 - De Los Ombues,Ecobici | 391 - Plaza República de Ecuador,Ecobici | 392 - Calasanz,Ecobici | 393 - Barrio 31,Ecobici | 394 - Av. La Plata,Ecobici | 395 - Agronomia II,Ecobici | 396 - PLAZA ALBERTI,Ecobici | 397 - PLAZA MATHEU,Ecobici | 398 - Rojas,Ecobici | 399 - GARCIA DEL RIO,Ecobici | 400 - Reserva Ecologica,Ecobici | 43 - Plaza Houssay,El Paso B-cycle | Anthony Street,El Paso B-cycle | Ballpark West Durango,El Paso B-cycle | City Hall,El Paso B-cycle | Cleveland Square,El Paso B-cycle | Downtown Transfer Center,El Paso B-cycle | El Paso County Courthouse,El Paso B-cycle | Kern Place,El Paso B-cycle | Madeline Park,El Paso B-cycle | Mundy Park,El Paso B-cycle | Oregon & University,El Paso B-cycle | San Jacinto Plaza,El Paso B-cycle | UTEP Academic Services,El Paso B-cycle | UTEP Library,El Paso B-cycle | UTEP Sun Bowl Drive North,El Paso B-cycle | UTEP Sun Bowl Drive South,Enna | Diaz,Enna | Lombardia,Enna | Pergusa,Enna | Sant'Anna,Enna | Toscana,FRee Bike sharing | Campo CONI,FRee Bike sharing | Cavoni,FRee Bike sharing | Conservatorio Refice,FRee Bike sharing | Stazione FF.SS.,FRee Bike sharing | Via Aldo Moro,FRee Bike sharing | Villa Comunale,Ford GoBike | 10th Ave at E 15th St,Ford GoBike | 10th St at Empire St,Ford GoBike | 10th St at Fallon St,Ford GoBike | 10th St at Mission St,Ford GoBike | 10th St at University Ave,Ford GoBike | 11th St at Bryant St,Ford GoBike | 11th St at Natoma St,Ford GoBike | 13th St at Franklin St,Ford GoBike | 14th St at Filbert St,Ford GoBike | 14th St at Mandela Pkwy,Ford GoBike | 14th St at Mission St,Ford GoBike | 15th St at Potrero Ave,Ford GoBike | 16th St Mission BART,Ford GoBike | 16th St Mission BART Station 2,Ford GoBike | 16th St at Prosper St,Ford GoBike | 17th & Folsom Street Park (17th St at Folsom St),Ford GoBike | 17th St at Dolores St,Ford GoBike | 17th St at Santa Clara St,Ford GoBike | 17th St at Valencia St,Ford GoBike | 18th St at Noe St,Ford GoBike | 19th St at Florida St,Ford GoBike | 19th St at Mission St,Ford GoBike | 19th Street BART Station,Ford GoBike | 1st St at Folsom St,Ford GoBike | 1st St at San Carlos Ave,Ford GoBike | 1st St at Younger Ave,Ford GoBike | 20th St at Bryant St,Ford GoBike | 20th St at Dolores St,Ford GoBike | 2100 Powell St,Ford GoBike | 21st Ave at International Blvd,Ford GoBike | 21st St at Santa Clara St,Ford GoBike | 22nd St Caltrain Station,Ford GoBike | 22nd St at Dolores St,Ford GoBike | 23rd Ave at Foothill Blvd,Ford GoBike | 23rd St at San Bruno Ave,Ford GoBike | 23rd St at Taylor St,Ford GoBike | 23rd St at Tennessee St,Ford GoBike | 24th St at Bartlett St,Ford GoBike | 24th St at Chattanooga St,Ford GoBike | 24th St at Market St,Ford GoBike | 26th Ave at International Blvd,Ford GoBike | 27th St at MLK Jr Way,Ford GoBike | 29th St at Church St,Ford GoBike | 29th St at Tiffany Ave,Ford GoBike | 2nd Ave at E 18th St,Ford GoBike | 2nd St at Folsom St,Ford GoBike | 2nd St at Julian St,Ford GoBike | 2nd St at Townsend St,Ford GoBike | 30th St at San Jose Ave,Ford GoBike | 32nd St at Adeline St,Ford GoBike | 34th St at Telegraph Ave,Ford GoBike | 37th St at West St,Ford GoBike | 3rd St at Keyes St,Ford GoBike | 3rd St at Townsend St,Ford GoBike | 45th St at MLK Jr Way,Ford GoBike | 45th St at Manila,Ford GoBike | 47th St at San Pablo Ave,Ford GoBike | 49th St at Telegraph Ave,Ford GoBike | 4th Ave at E 12th St (Temporary Location),Ford GoBike | 4th St at 16th St,Ford GoBike | 4th St at Harrison St,Ford GoBike | 4th St at Mission Bay Blvd S,Ford GoBike | 4th St at San Carlos St,Ford GoBike | 53rd St at Hollis St,Ford GoBike | 55th St at Telegraph Ave,Ford GoBike | 59th St at Horton St,Ford GoBike | 5th St at Brannan St,Ford GoBike | 5th St at Folsom,Ford GoBike | 5th St at San Salvador St,Ford GoBike | 5th St at Taylor St,Ford GoBike | 5th St at Virginia St,Ford GoBike | 65th St at Hollis St,Ford GoBike | 6th Ave at E 12th St (Temporary Location),Ford GoBike | 7th St at Brannan St,Ford GoBike | 8th St at Brannan St,Ford GoBike | 8th St at Ringold St,Ford GoBike | 9th St at San Fernando St,Ford GoBike | Addison St at Fourth St,Ford GoBike | Adeline St at 40th St,Ford GoBike | Alamo Square (Steiner St at Fulton St),Ford GoBike | Alcatraz Ave at Shattuck Ave,Ford GoBike | Almaden Blvd at Balbach St,Ford GoBike | Almaden Blvd at San Fernando St,Ford GoBike | Asbury St at The Alameda,Ford GoBike | Ashby BART Station,Ford GoBike | Autumn Parkway at Coleman Ave,Ford GoBike | Auzerais Ave at Lincoln Ave,Ford GoBike | Auzerais Ave at Los Gatos Creek Trail,Ford GoBike | Backesto Park (Jackson St at 13th St),Ford GoBike | Balboa Park BART Station,Ford GoBike | Bancroft Way at College Ave,Ford GoBike | Bancroft Way at Telegraph Ave,Ford GoBike | Bay Pl at Vernon St,Ford GoBike | Bay St at Fillmore St,Ford GoBike | Beale St at Harrison St,Ford GoBike | Berkeley Civic Center,Ford GoBike | Berry St at 4th St,Ford GoBike | Berry St at King St,Ford GoBike | Bestor Art Park,Ford GoBike | Bird Ave at Coe Ave,Ford GoBike | Bird Ave at Willow St,Ford GoBike | Broadway at 30th St,Ford GoBike | Broadway at 40th St,Ford GoBike | Broadway at Battery St,Ford GoBike | Broadway at Coronado Ave,Ford GoBike | Broadway at Kearny,Ford GoBike | Broderick St at Oak St,Ford GoBike | Bryant St at 15th St,Ford GoBike | Bryant St at 2nd St,Ford GoBike | Bryant St at 6th St,Ford GoBike | Buchanan St at North Point St,Ford GoBike | Bushrod Park,Ford GoBike | Cahill Park,Ford GoBike | California St at University Ave,Ford GoBike | Carl St at Cole St,Ford GoBike | Central Ave at Fell St,Ford GoBike | Cesar Chavez St at Dolores St,Ford GoBike | Channing Way at San Pablo Ave,Ford GoBike | Channing Way at Shattuck Ave,Ford GoBike | China Basin St at 3rd St,Ford GoBike | Church St at Duboce Ave,Ford GoBike | Civic Center/UN Plaza BART Station (Market St at McAllister St),Ford GoBike | Clay St at Battery St,Ford GoBike | College Ave at Alcatraz Ave,Ford GoBike | College Ave at Bryant Ave,Ford GoBike | College Ave at Harwood Ave,Ford GoBike | College Ave at Taft Ave,Ford GoBike | Commercial St at Montgomery St,Ford GoBike | Cyril Magnin St at Ellis St,Ford GoBike | Davis St at Jackson St,Ford GoBike | DeFremery Park,Ford GoBike | Delmas Ave and San Fernando St,Ford GoBike | Delmas Ave at Virginia St,Ford GoBike | Derby St at College Ave,Ford GoBike | Division St at Potrero Ave,Ford GoBike | Dolores St at 15th St,Ford GoBike | Dover St at 57th St,Ford GoBike | Downtown Berkeley BART,Ford GoBike | Doyle St at 59th St,Ford GoBike | Duboce Park,Ford GoBike | El Embarcadero at Grand Ave,Ford GoBike | Ellsworth St at Russell St,Ford GoBike | Embarcadero BART Station (Beale St at Market St),Ford GoBike | Emeryville Public Market,Ford GoBike | Emeryville Town Hall,Ford GoBike | Empire St at 1st St,Ford GoBike | Empire St at 7th St,Ford GoBike | Esprit Park,Ford GoBike | Eureka Valley Recreation Center,Ford GoBike | Father Alfred E Boeddeker Park,Ford GoBike | Fell St at Stanyan St,Ford GoBike | Fern St at Polk St,Ford GoBike | Fifth St at Delaware St,Ford GoBike | Folsom St at 13th St,Ford GoBike | Folsom St at 15th St,Ford GoBike | Folsom St at 19th St,Ford GoBike | Folsom St at 3rd St,Ford GoBike | Folsom St at 9th St,Ford GoBike | Foothill Blvd at 42nd Ave,Ford GoBike | Foothill Blvd at Fruitvale Ave,Ford GoBike | Foothill Blvd at Harrington Ave,Ford GoBike | Fountain Alley at S 2nd St,Ford GoBike | Frank H Ogawa Plaza,Ford GoBike | Franklin Square,Ford GoBike | Franklin St at 9th St,Ford GoBike | Fruitvale Ave at International Blvd,Ford GoBike | Fruitvale BART Station,Ford GoBike | Fulton St at Ashby Ave,Ford GoBike | Fulton St at Bancroft Way,Ford GoBike | Garfield Square (25th St at Harrison St),Ford GoBike | Gennessee St at Monterey Blvd,Ford GoBike | Genoa St at 55th St,Ford GoBike | George St at 1st St,Ford GoBike | Gish Rd at 1st St,Ford GoBike | Glen Park BART Station,Ford GoBike | Goettingen St at Bacon St,Ford GoBike | Golden Gate Ave at Franklin St,Ford GoBike | Golden Gate Ave at Hyde St,Ford GoBike | Golden Gate Ave at Polk St,Ford GoBike | Grand Ave at Perkins St,Ford GoBike | Grand Ave at Santa Clara Ave,Ford GoBike | Grand Ave at Webster St,Ford GoBike | Greenwich St at Webster St,Ford GoBike | Grove St at Divisadero,Ford GoBike | Grove St at Masonic Ave,Ford GoBike | Guerrero Park,Ford GoBike | Harmon St at Adeline St,Ford GoBike | Harrison St at 17th St,Ford GoBike | Harrison St at 20th St,Ford GoBike | Haste St at College Ave,Ford GoBike | Haste St at Telegraph Ave,Ford GoBike | Hearst Ave at Euclid Ave,Ford GoBike | Horton St at 40th St,Ford GoBike | Howard St at 2nd St,Ford GoBike | Howard St at 8th St,Ford GoBike | Howard St at Beale St,Ford GoBike | Howard St at Mary St,Ford GoBike | Hubbell St at 16th St,Ford GoBike | Hyde St at Post St,Ford GoBike | Illinois St at 20th St,Ford GoBike | Illinois St at Cesar Chavez St,Ford GoBike | Indiana St at Cesar Chavez St,Ford GoBike | Irwin St at 8th St,Ford GoBike | Isabella St at San Pablo Ave,Ford GoBike | Jack London Square,Ford GoBike | Jackson Playground,Ford GoBike | Jackson St at 11th St,Ford GoBike | Jackson St at 5th St,Ford GoBike | Jackson St at Polk St,Ford GoBike | Jersey St at Castro St,Ford GoBike | Jersey St at Church St,Ford GoBike | Jones St at Post St,Ford GoBike | Judson Ave at Gennessee St,Ford GoBike | Julian St at 6th St,Ford GoBike | Julian St at The Alameda,Ford GoBike | Kerley Dr at Rosemary St,Ford GoBike | Koshland Park,Ford GoBike | Laguna St at Hayes St,Ford GoBike | Lake Merritt BART Station,Ford GoBike | Lakeshore Ave at Trestle Glen Rd,Ford GoBike | Lakeside Dr at 14th St,Ford GoBike | Lane St at Revere Ave,Ford GoBike | Leavenworth St at Broadway,Ford GoBike | Locust St at Grant St,Ford GoBike | Lombard St at Columbus Ave,Ford GoBike | MLK Jr Way at 14th St,Ford GoBike | MLK Jr Way at University Ave,Ford GoBike | MacArthur BART Station,Ford GoBike | MacArthur Blvd at Telegraph Ave,Ford GoBike | Madison St at 17th St,Ford GoBike | Market St at 10th St,Ford GoBike | Market St at 40th St,Ford GoBike | Market St at 45th St,Ford GoBike | Market St at 8th St,Ford GoBike | Market St at Brockhurst St,Ford GoBike | Market St at Dolores St,Ford GoBike | Market St at Franklin St,Ford GoBike | Market St at Park St,Ford GoBike | Marston Campbell Park,Ford GoBike | Masonic Ave at Turk St,Ford GoBike | McAllister St at Baker St,Ford GoBike | McCoppin St at Valencia St,Ford GoBike | Mechanics Monument Plaza (Market St at Bush St),Ford GoBike | Mendell St at Fairfax Ave,Ford GoBike | Metro Dr at Technology Dr,Ford GoBike | Miles Ave at Cavour St,Ford GoBike | Milvia St at Derby St,Ford GoBike | Mission Bay Kids Park,Ford GoBike | Mission Dolores Park,Ford GoBike | Mission Playground,Ford GoBike | Mission St at 1st St,Ford GoBike | Mississippi St at 17th St,Ford GoBike | Montgomery St BART Station (Market St at 2nd St),Ford GoBike | Morrison Ave at Julian St,Ford GoBike | Mosswood Park,Ford GoBike | Myrtle St at Polk St,Ford GoBike | Newhall St at 3rd St,Ford GoBike | Ninth St at Heinz Ave,Ford GoBike | Ninth St at Parker St,Ford GoBike | North Berkeley BART Station,Ford GoBike | O'Farrell St at Divisadero St,Ford GoBike | Oak St at 1st St,Ford GoBike | Octavia Blvd at Page St,Ford GoBike | Oregon St at Adeline St,Ford GoBike | Page St at Scott St,Ford GoBike | Palm St at Willow St,Ford GoBike | Park Ave at Race St,Ford GoBike | Parker Ave at McAllister St,Ford GoBike | Parker St at Fulton St,Ford GoBike | Parkmoor Ave at Race St,Ford GoBike | Paseo De San Antonio at 2nd St,Ford GoBike | Pierce Ave at Market St,Ford GoBike | Pierce St at Haight St,Ford GoBike | Post St at Kearny St,Ford GoBike | Potrero Ave and Mariposa St,Ford GoBike | Potrero del Sol Park (25th St at Utah St),Ford GoBike | Powell St BART Station (Market St at 4th St),Ford GoBike | Powell St BART Station (Market St at 5th St),Ford GoBike | Precita Park,Ford GoBike | Prototype Lab LBSNYC Headquarters,Ford GoBike | Randall St at Chenery St,Ford GoBike | Raymond Bernal Jr Memorial Park (8th St at Hedding St),Ford GoBike | Raymond Kimbell Playground,Ford GoBike | Rhode Island St at 17th St,Ford GoBike | Rockridge BART Station,Ford GoBike | Russell St at College Ave,Ford GoBike | Ryland Park,Ford GoBike | S Park St at 3rd St,Ford GoBike | S Van Ness Ave at Market St,Ford GoBike | SAP Center,Ford GoBike | Saint James Park,Ford GoBike | Salesforce Transit Center (Natoma St at 2nd St),Ford GoBike | San Antonio Park,Ford GoBike | San Carlos St at 11th St,Ford GoBike | San Carlos St at Market St,Ford GoBike | San Carlos St at Meridian Ave,Ford GoBike | San Fernando St at 4th St,Ford GoBike | San Fernando St at 7th St,Ford GoBike | San Francisco Caltrain (Townsend St at 4th St),Ford GoBike | San Francisco Caltrain Station 2  (Townsend St at 4th St),Ford GoBike | San Francisco City Hall (Polk St at Grove St),Ford GoBike | San Francisco Ferry Building (Harry Bridges Plaza),Ford GoBike | San Francisco Public Library (Grove St at Hyde St),Ford GoBike | San Jose City Hall,Ford GoBike | San Jose Diridon Station,Ford GoBike | San Pablo Ave at 27th St,Ford GoBike | San Pablo Ave at MLK Jr Way,Ford GoBike | San Pablo Park,Ford GoBike | San Pedro Square,Ford GoBike | San Pedro St at Hedding St,Ford GoBike | San Salvador St at 9th St,Ford GoBike | Sanchez St at 15th St,Ford GoBike | Sanchez St at 17th St,Ford GoBike | Santa Clara St at 7th St,Ford GoBike | Santa Clara St at Almaden Blvd,Ford GoBike | Scott St at Golden Gate Ave,Ford GoBike | Shattuck Ave at 51st St,Ford GoBike | Shattuck Ave at 55th St,Ford GoBike | Shattuck Ave at Hearst Ave,Ford GoBike | Shattuck Ave at Telegraph Ave,Ford GoBike | Skyport Dr at Technology Dr,Ford GoBike | Snow Park,Ford GoBike | Sonora Ave at 1st St,Ford GoBike | South San Jose State (7th St at Humboldt St),Ford GoBike | Spear St at Folsom St,Ford GoBike | Stanford Ave at Hollis St,Ford GoBike | Steuart St at Market St,Ford GoBike | Stockton Ave at Lenzen Ave,Ford GoBike | Sunol St at San Carlos St,Ford GoBike | Taylor St at 9th St,Ford GoBike | Telegraph Ave at 19th St,Ford GoBike | Telegraph Ave at 23rd St,Ford GoBike | Telegraph Ave at 27th St,Ford GoBike | Telegraph Ave at 58th St,Ford GoBike | Telegraph Ave at Alcatraz Ave,Ford GoBike | Telegraph Ave at Ashby Ave,Ford GoBike | Telegraph Ave at Carleton St,Ford GoBike | The Alameda at Bush St,Ford GoBike | The Embarcadero at Bryant St,Ford GoBike | The Embarcadero at Sansome St,Ford GoBike | The Embarcadero at Steuart St,Ford GoBike | The Embarcadero at Vallejo St,Ford GoBike | Townsend St at 5th St,Ford GoBike | Townsend St at 7th St,Ford GoBike | Turk St at Fillmore St,Ford GoBike | Union Square (Powell St at Post St),Ford GoBike | Union St at 10th St,Ford GoBike | University Ave at Oxford St,Ford GoBike | Valencia St at 16th St,Ford GoBike | Valencia St at 21st St,Ford GoBike | Valencia St at 22nd St,Ford GoBike | Valencia St at 24th St,Ford GoBike | Valencia St at Cesar Chavez St,Ford GoBike | Valencia St at Clinton Park,Ford GoBike | Victoria Manalo Draves Park,Ford GoBike | Vine St at Shattuck Ave,Ford GoBike | Virginia St at Shattuck Ave,Ford GoBike | Washington St at 8th St,Ford GoBike | Washington St at Kearny St,Ford GoBike | Webster St at 19th St,Ford GoBike | Webster St at 2nd St,Ford GoBike | Webster St at Grove St,Ford GoBike | Webster St at O'Farrell St,Ford GoBike | West Oakland BART Station,Ford GoBike | West St at 40th St,Ford GoBike | West St at University Ave,Ford GoBike | William St at 10th St,Ford GoBike | Williams Ave at 3rd St,Ford GoBike | Williams Ave at Apollo St,Ford GoBike | Willow St at Vine St,Ford GoBike | Woolsey St at Sacramento St,Ford GoBike | Yerba Buena Center for the Arts (Howard St at 3rd St),Fort Worth Bike Sharing | 5th & Penn,Fort Worth Bike Sharing | 777 Main,Fort Worth Bike Sharing | Art Museums,Fort Worth Bike Sharing | Belknap & Taylor,Fort Worth Bike Sharing | Burnett Park,Fort Worth Bike Sharing | Central Library,Fort Worth Bike Sharing | City Hall,Fort Worth Bike Sharing | City Place,Fort Worth Bike Sharing | Convention Center,Fort Worth Bike Sharing | Cook Children's,Fort Worth Bike Sharing | Crockett Row,Fort Worth Bike Sharing | Forest Park & Park Hill,Fort Worth Bike Sharing | Fort Worth Bike Sharing,Fort Worth Bike Sharing | Gendy & Lansford,Fort Worth Bike Sharing | ITC North,Fort Worth Bike Sharing | Magnolia & 7th,Fort Worth Bike Sharing | Magnolia & Henderson,Fort Worth Bike Sharing | Magnolia & Lipscomb,Fort Worth Bike Sharing | Moncrief Cancer Institute,Fort Worth Bike Sharing | Montgomery Plaza,Fort Worth Bike Sharing | Museum Place,Fort Worth Bike Sharing | Omni Hotel Fort Worth,Fort Worth Bike Sharing | Panther Island Pavilion,Fort Worth Bike Sharing | Park Place and Enderly,Fort Worth Bike Sharing | Rahr & Sons,Fort Worth Bike Sharing | Riverfront Drive,Fort Worth Bike Sharing | S. Main & Daggett,Fort Worth Bike Sharing | Shamblee Library,Fort Worth Bike Sharing | Stockyards Station,Fort Worth Bike Sharing | Sundance Square North,Fort Worth Bike Sharing | Sundance Square South,Fort Worth Bike Sharing | T&P North,Fort Worth Bike Sharing | T&P South,Fort Worth Bike Sharing | TCU,Fort Worth Bike Sharing | Texas & Florence,Fort Worth Bike Sharing | The T Offices,Fort Worth Bike Sharing | The Trailhead at Clearfork,Fort Worth Bike Sharing | Trinity Park North,Fort Worth Bike Sharing | Trinity Park South,Fort Worth Bike Sharing | Trinity Uptown,Fort Worth Bike Sharing | UNT Health Science Center,Fort Worth Bike Sharing | W. 7th St. & Stayton,Fort Worth Bike Sharing | W. Berry & University,Fort Worth Bike Sharing | Weatherford & Main,Fort Worth Bike Sharing | WestBend,Frelo | Agentur für Arbeit,Frelo | Albertstraße/Institutsviertel,Frelo | Bahnhof Herdern,Frelo | Bahnhof Littenweiler/PH,Frelo | Bahnhof Messe/Universität,Frelo | Bahnhof Wiehre,Frelo | Bahnhof Zähringen,Frelo | Basler Landstraße/Blumenstraße,Frelo | Berliner Allee,Frelo | Bugginger Straße,Frelo | Dorfbrunnen,Frelo | Engelbergerstraße,Frelo | Europaplatz,Frelo | Event Station,Frelo | Fahnenbergplatz,Frelo | Gundelfinger Straße,Frelo | Haltestelle Emil-Gött-Straße,Frelo | Haltestelle Hasemannstraße,Frelo | Haltestelle Römerhof,Frelo | Haslach Bad,Frelo | Hauptbahnhof,Frelo | Hauptbahnhof West,Frelo | Herrmann-Herder-Straße,Frelo | Hornusstraße,Frelo | Händelstraße,Frelo | Johanneskirche,Frelo | Killianstraße,Frelo | Laßbergstraße,Frelo | Lehener Straße/Wentzingerstraße,Frelo | Lorettobad,Frelo | Lorettostraße,Frelo | Ludwigstraße/Landratsamt,Frelo | Lörracher Straße,Frelo | Maria-Hilf-Kirche,Frelo | Maria-von-Rudloff-Platz,Frelo | Moosweiher,Frelo | Munzinger Straße,Frelo | Musikhochschule,Frelo | Paduaallee,Frelo | Peter-Thumb-Straße,Frelo | Rathaus im Stühlinger,Frelo | Rempartstraße/Mensa,Frelo | Rotteckring,Frelo | Sandfangweg/Uni-Sportzentrum,Frelo | Schwabentor,Frelo | Schwarzwaldstraße/Strandbad,Frelo | Studentendorf Vauban,Frelo | Tullastraße/badenova,Frelo | Westbad,Fächerrad | Adenauerring / Fasanengarten,Fächerrad | Agentur für Arbeit,Fächerrad | Brauerstr. / Südendstr.,Fächerrad | Bulach - Grünwinkler Straße,Fächerrad | Carl-Metz-Straße,Fächerrad | Daxlanden - Stadtwerke,Fächerrad | Durlach - Bahnhof,Fächerrad | Durlach Schlossplatz,Fächerrad | E-Bike-Station Berliner Platz,Fächerrad | E-Bike-Station Hauptbahnhof,Fächerrad | Erbprinzenstr.,Fächerrad | Event Station,Fächerrad | Fächerbad,Fächerrad | Grünwinkel - Carl-Metz-Straße,Fächerrad | HaDiKo,Fächerrad | Hauptbahnhof / Touristinformation,Fächerrad | KIT Ost,Fächerrad | KIT Süd,Fächerrad | Karl-Wilhelm-Platz,Fächerrad | Karlstor,Fächerrad | Karlstraße / Waldstraße,Fächerrad | Knielingen / Herweghstraße,Fächerrad | Kolpingplatz,Fächerrad | Kreativpark/Alter Schlachthof,Fächerrad | L-Bank,Fächerrad | Marie-Baum-Str. / Luise-Riegger-Str.,Fächerrad | Maxau,Fächerrad | Melitta-Schöpf-Str. / Luisenstr.,Fächerrad | Mühlburg Bahnhof,Fächerrad | Mühlburger Tor / Kaiserplatz,Fächerrad | Neue Mensa,Fächerrad | Neuer Zirkel / Englerstr.,Fächerrad | Neureut - Bärenweg,Fächerrad | Nordweststadt - Kurt-Schumacher-Straße,Fächerrad | Oberreut - Zentrum,Fächerrad | Prinz-Max-Palais,Fächerrad | Rommelstr. / Auerstr.,Fächerrad | Rüppurr – Tulpenstraße,Fächerrad | Waldstadt-Zentrum,Fächerrad | Werderplatz,Fächerrad | ZKM,Föli-fillari | Aapistie,Föli-fillari | Ainolanpuisto,Föli-fillari | Assistentinpolku,Föli-fillari | Brahenkatu,Föli-fillari | Datacity,Föli-fillari | Eden,Föli-fillari | Eerikinkatu,Föli-fillari | Elektroniikkatie,Föli-fillari | Erkki Koiso-Kanttilan katu,Föli-fillari | Forum Marinum,Föli-fillari | Föri,Föli-fillari | Hallituskatu,Föli-fillari | Heinäpään urheilukeskus,Föli-fillari | Heinätorin puisto,Föli-fillari | Hietasaari,Föli-fillari | Hollihaka,Föli-fillari | Humalistonkatu,Föli-fillari | Hämeenkatu,Föli-fillari | Ikituuri,Föli-fillari | Isokatu,Föli-fillari | Kaijonharju,Föli-fillari | Kalliotie,Föli-fillari | Kaskenkatu,Föli-fillari | Kauppatori,Föli-fillari | Kauppurienkatu,Föli-fillari | Kaupungintalo,Föli-fillari | Kaupunginteatteri,Föli-fillari | Kirjastosilta,Föli-fillari | Kirkkokatu,Föli-fillari | Kiviharjuntie AMK,Föli-fillari | Kiviharjuntie OAMK,Föli-fillari | Koskelantie,Föli-fillari | Kristiinankatu,Föli-fillari | Kunnallissairaala,Föli-fillari | Kupittaan asema,Föli-fillari | Kupittaanpuisto,Föli-fillari | Kurjenkaivonkenttä,Föli-fillari | Kävelykatu,Föli-fillari | Lasaretti,Föli-fillari | Limingantulli,Föli-fillari | Linja-autoasema,Föli-fillari | Linna,Föli-fillari | Linnanmaan liikuntahalli,Föli-fillari | Linnansaari,Föli-fillari | Lipporanta,Föli-fillari | Martti,Föli-fillari | Mattaksenaukio,Föli-fillari | Medipolis,Föli-fillari | Merikosken tasku E,Föli-fillari | Merikosken tasku P,Föli-fillari | Merimiehenkatu,Föli-fillari | Myllytullin keskus,Föli-fillari | Nallikari,Föli-fillari | Niittyaro,Föli-fillari | OSAO Kaukovainion yksikkö,Föli-fillari | OYS,Föli-fillari | Orion,Föli-fillari | Oulun normaalikoulu ja lukio,"Föli-fillari | Oulun yliopisto, J-ovi",Föli-fillari | Pakkahuoneenkatu,Föli-fillari | Pesäpallostadion,Föli-fillari | Piispankatu,Föli-fillari | Pikisaari,Föli-fillari | Popup 1,Föli-fillari | Popup 2,Föli-fillari | Portsa,Föli-fillari | Przasnyska 6b - Oulu teststation,Föli-fillari | Przasnyska przystanek - Oulu teststation,Föli-fillari | Puistokatu,Föli-fillari | Puutori,Föli-fillari | Pääkirjasto,Föli-fillari | Päärautatieasema,Föli-fillari | Raatti E,Föli-fillari | Raatti P,Föli-fillari | Raksilan urheilukeskus,Föli-fillari | Raksilanraitti,Föli-fillari | Reelinkiaukio,Föli-fillari | Rolan Oy/Nummi,Föli-fillari | Satama,Föli-fillari | Skanssi,Föli-fillari | T-sairaala,Föli-fillari | Technopolis ydinkeskusta,Föli-fillari | Tietomaa,Föli-fillari | Toppilan Möljä,Föli-fillari | Tuiran tori,Föli-fillari | Tullikirjurinraitti,Föli-fillari | Tuomiokirkko,Föli-fillari | Urheilutalo,Föli-fillari | Ursininkatu,Föli-fillari | Vaakahuone,Föli-fillari | Valkea E,Föli-fillari | Valkea P,Föli-fillari | Varvintori,Föli-fillari | Vesibussi,Föli-fillari | Veturiaukio,Föli-fillari | Vähätori,Föli-fillari | Värtön kasarmialue,Föli-fillari | Värtönranta,Föli-fillari | Ympäristötalo,Föli-fillari | Yrttipellontie,GREENbike | 100S 500E Station,GREENbike | 20 S. West Temple,GREENbike | 200S State Street Station,GREENbike | 3 & 3 Uncommons Station,GREENbike | 349 S. 200 E. Station,GREENbike | 400 W. South Temple @ Gateway,GREENbike | 40E 300S Station,GREENbike | 640W  North Temple Station,GREENbike | Artspace Bridge,GREENbike | Blyncsy Station,GREENbike | City Weekly Station,GREENbike | CityScape Station,GREENbike | Dominion Energy - 100S Main Street,GREENbike | Energy Development Station,GREENbike | Google Fiber Station @ Trolley Square,GREENbike | Harmons Station,GREENbike | JF Capital Station,GREENbike | Key Bank Station,GREENbike | Life Elevated Station @ The Salt Palace,GREENbike | Radisson Station,GREENbike | Rocky Mountain Power Station,GREENbike | SLUG Mag Station,GREENbike | Sheraton Station,GREENbike | Squatters Station @ The Rose,GREENbike | TravelWise Station,GREENbike | Twilight Concert Series Station @ 50 West 300 South,GREENbike | UCAIR Station @ City & County Building,GREENbike | UCAIR Station @ Pioneer Park,GREENbike | UTA FrontLines Station,GREENbike | UTA North Temple FrontRunner Station,GREENbike | UTA Salt Lake Central Station,GREENbike | Union Pacific Station,GREENbike | Vestar Station @ 469 W 100 S,GRM Grodzisk | Centrum Kultury / ul. Spółdzielcza,GRM Grodzisk | Hala Sportowa / ul. Westfala,GRM Grodzisk | PKP Deptak / ul. 1 Maja,GRM Grodzisk | Park im. hr. Skarbków / ul. 3 Maja,GRM Grodzisk | Parking/ ul. Piaskowa,GRM Grodzisk | Parking/ ul. Żydowska,GRM Grodzisk | Plac zabaw/ ul. Okrężna,GRM Grodzisk | Pływalnia WODNIK 2000 / ul. Montwiłła,GRM Grodzisk | Stawy Goliana / ul. Marii Skłodowskiej-Curie,GRM Grodzisk | Stawy Walczewskiego / ul. Nadarzyńska,GRM Grodzisk | Targowisko Miejskie / ul. Radońska,GRM Grodzisk | Zespół Szkół / ul. Zielony Rynek,Gimme Bike | Biblioteca Comunale,Gimme Bike | Bizzozero (asl),Gimme Bike | Campus Universitario,Gimme Bike | Casbeno,Gimme Bike | Ospedale Di Circolo,Gimme Bike | Ospedale F. del Ponte,Gimme Bike | Palazzetto dello Sport,Gimme Bike | Piazza Giovine Italia,Gimme Bike | Sede Ter. Regione Lombardia,Gimme Bike | Stazione FF.SS.,Gimme Bike | Stazione FNM,Gimme Bike | Stazione FNM Casbeno,Gimme Bike | Teatro,Gimme Bike | Tribunale,Gira | 101 - Alameda dos Oceanos / Rua dos Argonautas,Gira | 102 - Porta do Mar,Gira | 103 - Jardim da Água,Gira | 104 - Gare do Oriente,Gira | 105 - CC Vasco da Gama,Gira | 106 - Jardim Garcia da Orta,Gira | 107 - Rotunda dos Vice-Reis,Gira | 108 - Rua do Bojador,Gira | 109 - Alameda dos Oceanos / Rua Ilha dos Amores,Gira | 110 - Rua de Moscavide,Gira | 114 - Via do Oriente,Gira | 115 - Passeio dos Heróis do Mar / Rua Capitão Cook,Gira | 208 - Cais das Pombas,Gira | 212 - Av. Infante Dom Henrique / Terminal de Cruzeiros,Gira | 214 - Largo de Santos,Gira | 216 - Praça D. Luís I,Gira | 218 - Cais do Sodré,Gira | 219 - Praça do Município,Gira | 224 - Martim Moniz,Gira | 225 - Martim Moniz,Gira | 301 - Avenida da Liberdade / Restauradores,Gira | 304 - Avenida da Liberdade / São Jorge,Gira | 305 - Avenida da Liberdade / Rua Barata Salgueiro,Gira | 306 - Avenida da Liberdade / Rua Alexandre Herculano,Gira | 307 - Marquês de Pombal,Gira | 308 - Marquês de Pombal,Gira | 309 - Rua da Palma,Gira | 401 - Rua Martens Ferrão / Av. Fontes Pereira de Melo,Gira | 403 - Av. Fontes Pereira de Melo,Gira | 406 - Praça Duque de Saldanha,Gira | 407 - Praça Duque de Saldanha,Gira | 408 - Praça Duque de Saldanha,Gira | 412 - Av. Ressano Garcia / Av. António Augusto de Aguiar,Gira | 413 - Av. Ressano Garcia / Av. António Augusto de Aguiar,Gira | 414 - Av. Duque de Ávila / Rua Pinheiro Chagas,Gira | 415 - Av. Duque de Ávila / Av. Conde Valbom,Gira | 416 - Av. República / Avenida Duque de Ávila,Gira | 417 - Av. Duque de Ávila / Jardim Arco Do Cego,Gira | 419 - Av. António José de Almeida / Instituto Superior Técnico,Gira | 420 - Av. Rovisco Pais / Av. Manuel da Maia,Gira | 421 - Alameda D. Afonso Henriques,Gira | 423 - Av. Conde Valbom / Rua Marquês Sá da Bandeira,Gira | 426 - Av. Elias Garcia / Av. 5 de Outubro,Gira | 427 - Av. República / Av. Visconde Valmor,Gira | 428 - Av. República / Avenida Barbosa Du Bocage,Gira | 430 - Av. Barbosa Du Bocage / Rua Arco do Cego,Gira | 431 - Rua do Arco Cego / Av. Magalhães Lima,Gira | 432 - Praça de Londres,Gira | 442 - Campo Pequeno,Gira | 443 - Av. de Roma / Fórum Lisboa,Gira | 446 - Av. República / Interface Entrecampos,Gira | 449 - Av. 5 de Outubro / Rua da Cruz Vermelha,Gira | 450 - Rua Alfredo Cortês,Gira | 452 - Rua Teixeira de Pascoais / Rua Dr. Gama Barros,Gira | 453 - Av. Roma / Av. EUA,Gira | 457 - Rua Aboim Ascensão,Gira | 459 - Rua Maria Amália Vaz de Carvalho / ES Rainha D. Leonor,Gira | 460 - Av. Rio de Janeiro / Parque de Jogos 1º de Maio,Gira | 462 - Campo Grande / Biblioteca Nacional,Gira | 463 - Campo Grande / Av. da Igreja,Gira | 464 - Av. da Igreja / Rua Afonso Lopes Vieira,Gira | 468 - Largo Frei Heitor Pinto,Gira | 471 - Rua Lopes de Mendonça / EB São João de Brito,Gira | 472 - Rua Marquês Soveral / ES Padre António Vieira,Gira | 473 - Av. do Brasil / Av. de Roma,Gira | 474 - Av. do Brasil / Av. Rio de Janeiro,Gira | 481 - Campo Grande / Museu da Cidade,Gira | 483 - Rua Professor Francisco Lucas Pires,Gira | 484 - Rua Professor Vieira de Almeida,Gira | 485 - Rua Tomás da Fonseca / Rua António Albino Machado,Gira | 486 - Rua Hermano Neves / Rua José Escada,Gira | 487 - Rua Professor João Barreira,Gira | 488 - Rua Fernando Namora / Rua António Quadros,Gira | 490 - Rua Fernando Namora / Azinhaga da Torre do Fato,Gira | Avenida das Gaivotas - Rua dos Corvos,Gliwicki Rower Miejski (SGRM) | Biblioteka Miejska - ul. Kościuszki,Gliwicki Rower Miejski (SGRM) | Dworzec,Gliwicki Rower Miejski (SGRM) | Hala Gliwice,Gliwicki Rower Miejski (SGRM) | Poniatowskiego,Gliwicki Rower Miejski (SGRM) | Radiostacja,Gliwicki Rower Miejski (SGRM) | Skwer Dessau,Gliwicki Rower Miejski (SGRM) | pl. Inwalidów Wojennych,Gliwicki Rower Miejski (SGRM) | pl. Piłsudskiego,Gliwicki Rower Miejski (SGRM) | pl.Mickiewicza,Gliwicki Rower Miejski (SGRM) | ul. Akademicka,Gliwicki Rower Miejski (SGRM) | ul. Gwiazdy Polarnej,Gliwicki Rower Miejski (SGRM) | ul. Kozielska,Gliwicki Rower Miejski (SGRM) | ul. Sikornik,Gliwicki Rower Miejski (SGRM) | ul. Sikorskiego / ul. Reymonta,Gliwicki Rower Miejski (SGRM) | ul. Żwirki i Wigury,GoodBike | Altinate,GoodBike | Antenore,GoodBike | Cesarotti,GoodBike | Della Valle,GoodBike | Duomo,GoodBike | Facciolati,GoodBike | Falloppio,GoodBike | Fiere,GoodBike | Gasometro,GoodBike | Gattamelata,GoodBike | Giotto,GoodBike | I Colli,GoodBike | La Fenice,GoodBike | Marzolo,GoodBike | Mazzini,GoodBike | Morgagni,GoodBike | Nazareth,GoodBike | Orsini,GoodBike | Park Bembo Est,GoodBike | Piovese,GoodBike | Pontecorvo,GoodBike | Riviera Tito Livio,GoodBike | Sarpi,GoodBike | Stazione,GoodBike | Stazione 2,GoodBike | Tribunale,GoodBike | Venezia / Colombo,GoodBike | Venezia 2,Grad Gospić | Gradska uprava,Grad Gospić | Trg Stjepana Radića,Grad Ivanić-Grad | Naftalan,Grad Ivanić-Grad | Šetnica-Školska ulica,Grad Karlovac | Foginovo,Grad Karlovac | Tržnica,Grad Karlovac | Šetalište dr. Franje Tuđmana 1,Grad Makarska | Hotel Dalmacija,Grad Makarska | Obala kralja Tomislava 12,"Grad Metković | Muzej Narona, Vid","Grad Metković | Trg kralja Tomislava, Metković",Grad Sisak | Frankopanska,Grad Sisak | Trg bana Josipa Jelačića,Grad Slavonski Brod | Bazeni,Grad Slavonski Brod | Korzo,Grad Slavonski Brod | TrÅ¾nica,Grad Velika Gorica | Trg kralja Tomislava,Grad Velika Gorica | VG Goričanka,Grad Velika Gorica | Željeznički kolodvor,Grad Zadar | Autobusni kolodvor,Grad Zadar | Borik,Grad Zadar | Luka GaÅ¾enica,Grad Zadar | Novi kampus,Grad Zadar | Poluotok,Grad Zadar | Stari kampus,Grad Šibenik | Autobusni kolodvor,Grad Šibenik | Baldekin,Grad Šibenik | Dalmare,Grad Šibenik | Gat Krka,Grad Šibenik | Martinska – Velika riva,Grad Šibenik | Plaža Banj,Grad Šibenik | Vanjski,"Grad Šibenik | Šubićevac, Caffe bar Shuby",Great Rides Bike Share | Barry Hall,Great Rides Bike Share | Fercho YMCA,Great Rides Bike Share | Great Northern Bicycle Co.,Great Rides Bike Share | High Rise Complex,Great Rides Bike Share | MATBUS Center Downtown,Great Rides Bike Share | Memorial Union,Great Rides Bike Share | Renaissance Hall,Great Rides Bike Share | Sanford Medical Center,Great Rides Bike Share | T Loft,Great Rides Bike Share | University Village,Great Rides Bike Share | Wallman Wellness Center,Grid Bike Share | 7th St. / Garfield St (hosted by Mother Bunch Brewery),Grid Bike Share | ASU Coor Hall - S Forest Mall (Virtual Hub),Grid Bike Share | ASU Goldwater Ctr. for Science - Tyler Mall (Virtual Hub),Grid Bike Share | ASU Hayden Library - Cady Mall (Virtual Hub),Grid Bike Share | ASU Orange St - S McAllister Mall (Virtual Hub),Grid Bike Share | M100 Main St / Center St (Mesa City Plaza),Grid Bike Share | M101 University Dr / Center St (Mesa Amphitheater),Grid Bike Share | M103 Centennial Way / 1st St (Library),Grid Bike Share | M104 Macdonald / 1st St  (Museum of Natural History),Grid Bike Share | M105 Robson / 1st St (i.d.e.a. Museum),Grid Bike Share | M106 Main St / Country Club Dr,Grid Bike Share | M107 Main St / Sycamore,Grid Bike Share | M108 Main St / Mesa Dr,Grid Bike Share | M109 Main St / Horne,Grid Bike Share | M110 2nd St / Hobson,Grid Bike Share | M112 6th St / Mesa Dr,Grid Bike Share | M113 2nd St. and Morris (Mesa Center for Higher Education),Grid Bike Share | M114 MacDonald and 1st. Ave (Alhambra Hotel),Grid Bike Share | M115 Sloan Park,Grid Bike Share | M116 Dobson Rd / Mesa Riverview Dr (Mesa Riverview Park),Grid Bike Share | M118 MacDonald and 2nd St.,Grid Bike Share | M119 5th St. and Hibbert (Escobedo Park),Grid Bike Share | M120 8th St. and Mesa Dr. (Porter Park),Grid Bike Share | M121 2nd Ave. and Center,Grid Bike Share | M122 462 N. Drew St. (Drew Community Park),Grid Bike Share | M123 1st Place and Date St.,Grid Bike Share | M125 Main St. and Hibbert,Grid Bike Share | P101 5th St / Grant St,Grid Bike Share | P102 1st St / Buchanan,Grid Bike Share | P104 Jackson St / 2nd St (Sponsored by SRP),Grid Bike Share | P106: 1st St / Washington St (Sponsored by SRP),Grid Bike Share | P107 17th Ave. and Jefferson St.,Grid Bike Share | P108 12th Ave. and Washington,Grid Bike Share | P109 Adams St / 1st Ave,Grid Bike Share | P110 Van Buren St & 1st Ave,Grid Bike Share | P112 3rd St / Washington St (Convention Center),Grid Bike Share | P113 11th St. / Washington St,Grid Bike Share | P114 Adams St / 2nd Ave (City Hall),Grid Bike Share | P116 6th St. / Monroe St (Sponsored by SRP),Grid Bike Share | P117 Grand Ave / 10th Ave,Grid Bike Share | P118 Encanto Park (Enchanted Island),Grid Bike Share | P119 Grant St / 3rd St.,Grid Bike Share | P120 Central Ave / Taylor St,Grid Bike Share | P121 5th St / Van Buren St (Sponsored by APS),Grid Bike Share | P122 Grand Ave / McKinley St,Grid Bike Share | P123 5th Ave / Fillmore St,Grid Bike Share | P124 3rd St / Taylor St (Sponsored by APS),Grid Bike Share | P125 Pierce and 1st,Grid Bike Share | P127 Central Ave / Roosevelt St,Grid Bike Share | P128 McKinley St / 2nd St.,Grid Bike Share | P129 5th St / Roosevelt St,Grid Bike Share | P131 Central Ave / Willetta St  (Sponsored by APS),Grid Bike Share | P132 10th St / Roosevelt St,Grid Bike Share | P133 5th Ave / McDowell Rd,Grid Bike Share | P134 Central Ave / McDowell Rd (Phoenix Art Museum),Grid Bike Share | P136 12th St / Palm Ln (Coronado Park),Grid Bike Share | P137 12th St / Oak St,Grid Bike Share | P138 Encanto Park,Grid Bike Share | P139 Central Ave / Vernon Ave,Grid Bike Share | P140 8th St / Sheridan St,Grid Bike Share | P141 Phoenix College,Grid Bike Share | P144 Central Ave / Lexington Ave,Grid Bike Share | P145 5th St / Osborn Rd,Grid Bike Share | P146 4th Ave / Clarendon Ave,Grid Bike Share | P147 7th Ave / Glenrosa Ave,Grid Bike Share | P148 Central Ave / Glenrosa Ave (Sponsored by SRP),Grid Bike Share | P149 Central Ave / Campbell Ave,Grid Bike Share | P150 Central Ave / Camelback Rd (Sponsored by SRP),Grid Bike Share | P154 Central Ave / Thomas Rd,Grid Bike Share | P155 Colter St / Central Ave,Grid Bike Share | P159 Sherman St / 3rd Ave.,Grid Bike Share | P161 5th Ave / Roosevelt St,Grid Bike Share | P168 5th St. and Washington,Grid Bike Share | P172 4th Street / Jackson St,Grid Bike Share | P173 Camelback Rd / 7th Ave,Grid Bike Share | P175 9th St. / Van Buren St,Grid Bike Share | P176 Buckeye Rd / 13th St,Grid Bike Share | P177 Indianola Ave / 3rd Street,Grid Bike Share | P179 15th Ave. and Washington,Grid Bike Share | P180 Adams and 17th Ave.,Grid Bike Share | P196 2nd St. and Roosevelt,Grid Bike Share | P209 18th St. & Villa,Grid Bike Share | P210 18th St. & Washington,Grid Bike Share | P211 10th St / Pierce,Grid Bike Share | P212 Adams and 1st Street,Grid Bike Share | T01 5th St / Forest Ave,Grid Bike Share | T02 3rd St / Mill Ave,Grid Bike Share | T03 Rural Rd / Terrace Rd,Grid Bike Share | T04 Apache Blvd / Dorsey Ln,Grid Bike Share | T05 McClintock Dr / Apache Blvd,Grid Bike Share | T06 McClintock Dr / Rio Salado Pkwy,Grid Bike Share | T07 Smith-Martin / Apache Blvd,Grid Bike Share | T08 Apache Blvd / Price Rd,Grid Bike Share | T09 Washington St / Center Pkwy,Grid Bike Share | T10 Washington St / Priest Dr,Grid Bike Share | T11 University Dr / Mill Ave,Grid Bike Share | T12 Rural Rd / Southern Ave,Grid Bike Share | T13 College Ave / Apache Blvd,Grid Bike Share | T14 College Ave / University Dr,Grid Bike Share | T15 8th St / Dorsey Ln,Grid Bike Share | T16 Apache Blvd / Rural Rd,Grid Bike Share | T17 Tempe Beach Park,Grid Bike Share | T18 Neil Giuliano Park,Grid Bike Share | T19 Kiwanis Park,Grid Bike Share | T20 Tempe Center for the Arts,Grid Bike Share | T21 Forest Ave/ Lemon St. (Gammage),Grid Bike Share | T22 Baseline Rd / Priest Dr,Grid Bike Share | T23 Escalante Center,Grid Bike Share | T24 Westside Center,Grid Bike Share | T25 University Dr. / ASU Student Housing,Grid Bike Share | T26 ASU Memorial Union,Grid Bike Share | T27 McAllister Ave / Apache Blvd,Grid Bike Share | T28 Rio Salado Pkwy / Mill Ave,Grid Bike Share | T29 Tempe Town Lake Marina,Grid Bike Share | T30 Evelyn Hallman Park,Grid Bike Share | T31 6th St / Mill Ave,Grid Bike Share | T32 North Tempe Multigen Center,GynDebike | Areião,GynDebike | Bandeirante,GynDebike | Bosque dos Buritis,GynDebike | Bougainville,GynDebike | Câmara Municipal de Goiânia,GynDebike | IFG - CÂMPUS GOIÂNIA,GynDebike | Lago das Rosas,GynDebike | Marista,GynDebike | Paranaíba,GynDebike | Parque Flamboyant,GynDebike | Parque Flamboyant - Kids,GynDebike | Parque Vaca Brava,GynDebike | Praça Cívica,GynDebike | Praça Tamandaré,GynDebike | Praça Universitária,GynDebike | Praça do Sol,GynDebike | Praça do Sol - Kids,GynDebike | Ricardo Paranhos,GynDebike | T63,GynDebike | UNIMED,Healthy Ride | 10th St & Penn Ave (David L. Lawrence Convention Center),Healthy Ride | 11th St & Penn Ave,Healthy Ride | 12th St & Penn Ave,Healthy Ride | 14th St & Penn Ave,Healthy Ride | 17th St & Penn Ave,Healthy Ride | 21st St & Penn Ave,Healthy Ride | 24th St & Smallman St,Healthy Ride | 33rd St & Penn Ave,Healthy Ride | 42nd & Penn Ave.,Healthy Ride | 42nd St & Butler St,Healthy Ride | 9th St & Penn Ave,Healthy Ride | Alder St & S Highland Ave,Healthy Ride | Arch St & Jacksonia St,Healthy Ride | Atwood St & Bates St,Healthy Ride | Beacon St & Murray Ave,Healthy Ride | Bennett St & Eccrue Way,Healthy Ride | Boulevard of the Allies & Parkview Ave,Healthy Ride | Burns White Center at 3 Crossings,Healthy Ride | Butler St & 36th St,Healthy Ride | Butler St & 48th St,Healthy Ride | Butler St & Stanton Ave,Healthy Ride | Centre Ave & Kirkpatrick St,Healthy Ride | Centre Ave & N Craig St,Healthy Ride | Centre Ave & PPG Paints Arena,Healthy Ride | E Liberty Blvd & Larimer Ave,Healthy Ride | E Liberty Blvd & Negley Ave,Healthy Ride | Ellsworth Ave & N Neville St,Healthy Ride | Federal St & E North Ave,Healthy Ride | Fifth Ave & Miltenberger St,Healthy Ride | Fifth Ave & S Bouquet St,Healthy Ride | Fifth Ave & S Dithridge St,Healthy Ride | First Ave & B St (T Station),Healthy Ride | First Ave & Smithfield St,Healthy Ride | First Ave & Stanwix St,Healthy Ride | Forbes Ave & Grant St,Healthy Ride | Forbes Ave & Jumonville St,Healthy Ride | Forbes Ave & Market Square,Healthy Ride | Forbes Ave & Murray Ave,Healthy Ride | Forbes Ave & S Craig St,Healthy Ride | Fort Duquesne Blvd & 7th St,Healthy Ride | Frankstown Ave & E Liberty Blvd,Healthy Ride | Frankstown Ave & Eastview St,Healthy Ride | Frazier St & Dawson St,Healthy Ride | Frew St & Schenley Dr,Healthy Ride | Friendship Ave & S Pacific Ave,Healthy Ride | Grant St & Strawberry Way,Healthy Ride | Hamilton Ave & N Dallas Ave,Healthy Ride | Hamilton Ave & N Lang Ave,Healthy Ride | Hamilton Ave & Zodiac Way,Healthy Ride | Hobart St & Wightman St,Healthy Ride | Hot Metal St & Tunnel Blvd,Healthy Ride | Isabella St & Federal St (PNC Park),Healthy Ride | Ivy St & Walnut St,Healthy Ride | Liberty Ave & 37th St,Healthy Ride | Liberty Ave & 6th St,Healthy Ride | Liberty Ave & Baum Blvd,Healthy Ride | Liberty Ave & Fisk St,Healthy Ride | Liberty Ave & S Millvale Ave (West Penn Hospital),Healthy Ride | Liberty Ave & Stanwix St,Healthy Ride | Maryland Ave & Ellsworth Ave,Healthy Ride | McNulty Dr & Forbes Ave,Healthy Ride | N Homewood Ave & Finance St (Homewood Station),Healthy Ride | North Shore Trail & Fort Duquesne Bridge,Healthy Ride | O'Hara St & Desoto St,Healthy Ride | O'Hara St and University Place (Soldiers and Sailors Memorial),Healthy Ride | Penn Ave & 29th St,Healthy Ride | Penn Ave & 39th St,Healthy Ride | Penn Ave & N Atlantic Ave,Healthy Ride | Penn Ave & N Fairmount St,Healthy Ride | Penn Ave & Negley Ave,Healthy Ride | Penn Ave & Putnam St (Bakery Square),Healthy Ride | Penn Ave & S Whitfield St,Healthy Ride | Penn Ave at The Village at Eastside,Healthy Ride | Ridge Ave & Brighton Rd (CCAC),Healthy Ride | Ross St & Fourth Ave,Healthy Ride | Ross St & Sixth Ave (Steel Plaza T Station),Healthy Ride | Roup Ave & Friendship Ave,Healthy Ride | Ruskin Ave & Bigelow Blvd,Healthy Ride | S 12th St & E Carson St,Healthy Ride | S 18th St & Sidney St,Healthy Ride | S 22nd St & E Carson St,Healthy Ride | S 25th St & E Carson St,Healthy Ride | S 27th St & Sidney St. (Southside Works),Healthy Ride | S Bellefield Ave & Filmore St,Healthy Ride | S Bouquet Ave & Sennott St,Healthy Ride | S Craig St & 5th Ave,Healthy Ride | S Euclid Ave & Centre Ave,Healthy Ride | S Millvale Ave & Centre Ave,Healthy Ride | S Negley Ave & Baum Blvd,Healthy Ride | S Winebiddle St & Penn Ave,Healthy Ride | Schenley Dr & Forbes Ave,Healthy Ride | Schenley Dr & Forbes Ave (Schenley Plaza),Healthy Ride | Schenley Dr at Schenley Plaza (Carnegie Library Main),Healthy Ride | Semple St & Louisa St,Healthy Ride | Seventh Ave & Liberty Ave,Healthy Ride | Shady Ave & Ellsworth Ave,Healthy Ride | Smallman St & 31st St,Healthy Ride | Smithfield St & Fourth Ave,Healthy Ride | South Side Trail & S 4th St,Healthy Ride | Stanton Ave & N Negley Ave,Healthy Ride | Stevenson St & Forbes Ave,Healthy Ride | Taylor St & Liberty Ave,Healthy Ride | Tennyson Ave & Fifth Ave,Healthy Ride | Third Ave & Stanwix St,Healthy Ride | Third Ave & Wood St,Healthy Ride | W General Robinson St & Chuck Noll Way,Healthy Ride | Walnut St & College St,Healthy Ride | Washington Pl & Centre Ave,Healthy Ride | Wightman St & Forbes Ave,Healthy Ride | Wood St & Sixth Ave,Healthy Ride | Zulema St & Coltart Ave,Heartland B-cycle | 10th & Cass,Heartland B-cycle | 10th & Dodge,Heartland B-cycle | 10th & Fahey,Heartland B-cycle | 10th & Farnam,Heartland B-cycle | 11th & Jackson,Heartland B-cycle | 12th & Davenport,Heartland B-cycle | 12th & Harney,Heartland B-cycle | 12th & Leavenworth,Heartland B-cycle | 13th & Dodge,Heartland B-cycle | 13th & William,Heartland B-cycle | 14th & Douglas,Heartland B-cycle | 14th & Fahey,Heartland B-cycle | 1516 Cuming St,Heartland B-cycle | 15th & Howard,Heartland B-cycle | 16th & Douglas,Heartland B-cycle | 16th & Harney,Heartland B-cycle | 17th & St Mary's,Heartland B-cycle | 1819 Farnam,Heartland B-cycle | 19th & California,Heartland B-cycle | 19th & Vinton,Heartland B-cycle | 1st St and Broadway,Heartland B-cycle | 20th & Dodge,Heartland B-cycle | 22nd & St. Mary,Heartland B-cycle | 23rd & Cuming,Heartland B-cycle | 24th & Farnam,Heartland B-cycle | 24th & J,Heartland B-cycle | 24th & Lake,Heartland B-cycle | 24th & N,Heartland B-cycle | 28th Ave & Q St,Heartland B-cycle | 30th & Patrick,Heartland B-cycle | 33rd & California,Heartland B-cycle | 34th & Farnam,Heartland B-cycle | 36th & Farnam,Heartland B-cycle | 39th & Jackson,Heartland B-cycle | 40th & Farnam,Heartland B-cycle | 40th & Leavenworth,Heartland B-cycle | 42nd & Dewey,Heartland B-cycle | 44th & Farnam,Heartland B-cycle | 45th & Emile,Heartland B-cycle | 50th & Underwood,Heartland B-cycle | 60th & Maple,Heartland B-cycle | 62nd & Dodge,Heartland B-cycle | 63rd & Maple,Heartland B-cycle | 64th & Pine,Heartland B-cycle | 66th & Center,Heartland B-cycle | 67th & Frances,Heartland B-cycle | 67th & Pine,Heartland B-cycle | 711 S Main St,Heartland B-cycle | 7th & Jones,Heartland B-cycle | 808 Conagra Drive,Heartland B-cycle | 9th & Jones,Heartland B-cycle | Aksarben Drive,Heartland B-cycle | Ameristar,Heartland B-cycle | Arts & Sciences Hall,Heartland B-cycle | Bob Kerrey Pedestrian Bridge,Heartland B-cycle | Breakers,Heartland B-cycle | Chalco Hills,Heartland B-cycle | College of Saint Mary,Heartland B-cycle | First Street Plaza 1st & Washington,Heartland B-cycle | Lewis & Clark Landing,Heartland B-cycle | Midtown Crossing: 32nd & Farnam,Heartland B-cycle | N 32nd St,Heartland B-cycle | Park Avenue & Woolworth,Heartland B-cycle | Pearl St & Willow Ave,Heartland B-cycle | The Durham Museum,Heartland B-cycle | University Drive South: Maverick Village,Heartland B-cycle | W. Dale Clark Library: 15th & Farnam,Heartland B-cycle | Wabash Trace,Houston B-cycle | 1919 Runnels,Houston B-cycle | 2222 Smith,Houston B-cycle | 24ELEVEN WASHINGTON,Houston B-cycle | 8th Wonder,Houston B-cycle | Amherst & Kelvin,Houston B-cycle | Baldwin Park,Houston B-cycle | Ben Taub Hospital,Houston B-cycle | BioScience Research Collaborative,Houston B-cycle | Bobcat Teddy's,Houston B-cycle | Brazos & McGowen,Houston B-cycle | Burnett Transit Center,Houston B-cycle | Centennial Gardens,Houston B-cycle | Change Happens!,Houston B-cycle | City Hall,Houston B-cycle | Clay & Smith,Houston B-cycle | Crawford Island,Houston B-cycle | Dunstan & Kelvin,Houston B-cycle | Elgin & Smith,Houston B-cycle | Emancipation Park,Houston B-cycle | Ensemble/HCC Station,Houston B-cycle | Freed Library,Houston B-cycle | Gateway on Cullen,Houston B-cycle | Guadalupe Park Plaza,Houston B-cycle | HCC Central,Houston B-cycle | Health Museum,Houston B-cycle | Heights Central Station,Houston B-cycle | Heights Mercantile,Houston B-cycle | Hermann Park Lake Plaza,Houston B-cycle | Jackson Hill & Memorial Dr.,Houston B-cycle | Jury Assembly,Houston B-cycle | La Branch & Lamar,Houston B-cycle | Lamar & Crawford,Houston B-cycle | Lamar & Milam,Houston B-cycle | Leonel Castillo Community Center/South & Henry,Houston B-cycle | Lost Lake,Houston B-cycle | METRO Transit Center,Houston B-cycle | MFAH/Fannin & Binz,Houston B-cycle | Main & Dallas,Houston B-cycle | Main & Walker,Houston B-cycle | Main & Wichita St,Houston B-cycle | Market Square,Houston B-cycle | Memorial City Club,Houston B-cycle | Memorial Park Picnic Loop,Houston B-cycle | Memorial Park Running Center,Houston B-cycle | Menil Collection/Alabama & Mulberry,Houston B-cycle | Midtown Park,Houston B-cycle | Milam & Webster,Houston B-cycle | Montie Beach Park,Houston B-cycle | Moody Park,Houston B-cycle | Navigation Esplanade,Houston B-cycle | Pearl City Centre,Houston B-cycle | Pearl Washington,Houston B-cycle | Project Row House/Holman & Live Oak,Houston B-cycle | Rice University Cambridge Office Building,Houston B-cycle | Rice University Duncan Hall,Houston B-cycle | Rice University Gibbs Recreation & Wellness Center,Houston B-cycle | Rice University Greenbriar Lot,Houston B-cycle | Rice University South Servery,Houston B-cycle | Rice University West Lot,Houston B-cycle | Rice Village Apartments,Houston B-cycle | Rusk & St. Emanuel,Houston B-cycle | Sabine Bridge,Houston B-cycle | Saint Arnold Brewing Company,Houston B-cycle | Smith & Capitol,Houston B-cycle | Spotts Park,Houston B-cycle | Stude Park,Houston B-cycle | TMC Commons,Houston B-cycle | TMC Fannin & Ross Sterling,Houston B-cycle | TMC Garage 2,Houston B-cycle | TMC Garage 8,Houston B-cycle | TMC Pressler & Bertner,Houston B-cycle | TMC Transit Center,Houston B-cycle | TSU Rec & Wellness Center,Houston B-cycle | TSU Student Center East,Houston B-cycle | TSU Student Center West,Houston B-cycle | TSU University Courtyard Apartments,Houston B-cycle | TSU University Towers,Houston B-cycle | Taft & Fairview,Houston B-cycle | Tellepsen YMCA,Houston B-cycle | The Southmore,Houston B-cycle | UH Blaffer Art Museum/GDH School of Architecture,Houston B-cycle | UH Cougar Village,Houston B-cycle | UH Student Center North,Houston B-cycle | UH Student Garage/METROrail,Houston B-cycle | UH TDECU Cullen & Cougar Place,Houston B-cycle | UH Technology Bridge,Houston B-cycle | UHD Jesse H. Jones Student Life Center,Houston B-cycle | UHD Shea St. Building / Lot B,Houston B-cycle | UHD Soccer Field / White Oak Bayou Trailhead,Houston B-cycle | UHD/Main & Franklin,Houston B-cycle | UT Research Park,Houston B-cycle | UTHSC Housing & Rec Center,Houston B-cycle | UTMDA 1MC Bertner & Braeswood,Houston B-cycle | UTMDA Main Campus MDA BLVD,Houston B-cycle | West Gray & Baldwin,Houston B-cycle | Westheimer & Waugh,Houston B-cycle | Woodland Park,Indego | 10th & Chestnut,Indego | 10th & Federal,Indego | 11th & Market,"Indego | 11th & Pine, Kahn Park","Indego | 11th & Poplar, John F. Street Community Center",Indego | 11th & Reed,Indego | 11th & South,Indego | 11th & Washington,Indego | 12th & Callowhill,Indego | 12th & Chestnut,Indego | 12th & Filbert,Indego | 12th & Normandy,Indego | 12th & Passyunk,Indego | 13th & Locust,Indego | 13th & Montgomery,"Indego | 15th & Castle, DiSilvestro Playground",Indego | 15th & Kitty Hawk,Indego | 15th & Market,Indego | 15th & South,Indego | 15th & Spruce,Indego | 17th & Girard,Indego | 17th & Locust,Indego | 17th & Pine,Indego | 17th & Sansom,"Indego | 17th & Spring Garden, Community College of Philadelphia","Indego | 18th & Fernon, Aquinas Center",Indego | 18th & JFK,Indego | 18th & JFK Curbside,"Indego | 18th & Washington, Chew Playground","Indego | 19th & Girard, PTTI",Indego | 19th & Lombard,Indego | 19th & Market,Indego | 20th & Fairmount,Indego | 20th & Market,Indego | 20th & Race,Indego | 20th & Sansom,Indego | 21st & Catharine,"Indego | 21st & Winter, Franklin Institute",Indego | 22nd & Cecil B. Moore,Indego | 22nd & Federal,Indego | 23rd & Fairmount,Indego | 23rd & Market,Indego | 23rd & South,Indego | 24th & Race SRT,Indego | 24th & Sansom,Indego | 25th & Diamond,Indego | 25th & Locust,Indego | 27th & Girard,Indego | 27th & South,Indego | 29th & Dauphin,Indego | 2nd & Fairmount,Indego | 2nd & Market,Indego | 2nd & Race,Indego | 2nd & South,Indego | 30th Street Station East,Indego | 31st & Girard,"Indego | 32nd & Baring, Drexel Park",Indego | 33rd & Dauphin,Indego | 33rd & Diamond,Indego | 33rd & Market,Indego | 33rd & Reservoir,Indego | 34th & Mantua,Indego | 36th & Sansom,Indego | 38th & Market,Indego | 38th & Powelton,Indego | 38th & Spruce,"Indego | 39th & Mt. Vernon, Mantua Haverford Community Center",Indego | 3rd & Girard,"Indego | 40th & Baltimore, Trolley Portal",Indego | 40th & Spruce,"Indego | 40th Street Station, MFL",Indego | 42nd & Lancaster,"Indego | 43rd & Chester, Clark Park",Indego | 44th & Walnut,"Indego | 46th Street Station, MFL",Indego | 48th & Spruce,Indego | 4th & Bainbridge,Indego | 4th & Christian,"Indego | 4th & Walnut, NPS",Indego | 4th & Washington,Indego | 6th & Berks,Indego | 6th & Fairmount,Indego | 6th & Race,Indego | 7th & Fitzwater,Indego | 8th & Market,"Indego | 8th & Mifflin, Bok Building",Indego | 9th & Arch,Indego | 9th & Locust,Indego | 9th & Spring Garden,Indego | Amtrak 30th Street Station,Indego | Barnes Foundation,"Indego | Berks Station, MFL",Indego | Broad & Christian,Indego | Broad & Federal,Indego | Broad & Girard,Indego | Broad & Oxford,Indego | Broad & Passyunk,"Indego | Broad & Pattison, BSL",Indego | Broad & Ritner,Indego | Crescent Park,Indego | Darien & Catharine,Indego | Del. River Trail & Penn St.,Indego | Dornsife Center,Indego | Fairmount & Ridge,Indego | Foglietta Plaza,Indego | Frankford & Belgrade,Indego | Free Library of Philadelphia - Central Library,Indego | Front & Carpenter,Indego | Girard & Hutchinson,"Indego | Girard Station, MFL",Indego | Grays Ferry & Pemberton,Indego | Health Sciences Drive,"Indego | Independence Mall, NPS",Indego | Moyamensing & Tasker,Indego | Municipal Services Building Plaza,Indego | ParkWest Town Center,"Indego | Parkside & Belmont, Case Building",Indego | Pennsylvania & Fairmount Perelman Building,Indego | Pennsylvania Convention Center,Indego | Philadelphia Museum of Art,Indego | Philadelphia Zoo,Indego | Point Breeze & Tasker,Indego | Race Street Pier,Indego | Ridge & Master,Indego | Rodin Museum,"Indego | Spring Garden Station, BSL","Indego | Spring Garden Station, MFL",Indego | Temple University Station,Indego | The Children's Hospital of Philadelphia (CHOP),"Indego | The Children's Hospital of Philadelphia, East Service Drive","Indego | Thompson & Palmer, Adaire School",Indego | University City Station,"Indego | Welcome Park, NPS",Indiana Pacers Bikeshare | Athenaeum,Indiana Pacers Bikeshare | Bankers Life Fieldhouse,Indiana Pacers Bikeshare | Central Library,Indiana Pacers Bikeshare | City County Building,Indiana Pacers Bikeshare | City Market,Indiana Pacers Bikeshare | Convention Center - Maryland and Capitol,Indiana Pacers Bikeshare | Convention Center at Georgia Street,Indiana Pacers Bikeshare | Eskenazi Health,Indiana Pacers Bikeshare | Fletcher Place - Virginia and Merrill,Indiana Pacers Bikeshare | Fletcher Place - Virginia and Norwood,Indiana Pacers Bikeshare | Fountain Square,Indiana Pacers Bikeshare | Gibson Building,Indiana Pacers Bikeshare | Glick Peace Walk,Indiana Pacers Bikeshare | IUPUI Campus Center,Indiana Pacers Bikeshare | Indiana Government Center,Indiana Pacers Bikeshare | Mass Ave. and Alabama,Indiana Pacers Bikeshare | Mass Ave. and College,Indiana Pacers Bikeshare | Mass Ave. and Park,Indiana Pacers Bikeshare | Michigan and Blackford,Indiana Pacers Bikeshare | Michigan and Senate,Indiana Pacers Bikeshare | Monument Circle,Indiana Pacers Bikeshare | North End of Canal,Indiana Pacers Bikeshare | North End of Mass Ave.,Indiana Pacers Bikeshare | North and Alabama,Indiana Pacers Bikeshare | One America Building,Indiana Pacers Bikeshare | Victory Field,Indiana Pacers Bikeshare | Washington and Illinois,Indiana Pacers Bikeshare | Washington and Meridian,Indiana Pacers Bikeshare | White River State Park,Integrabike | Armando Pannunzio,Integrabike | Avenida Ipanema,Integrabike | Avenida Itavuvu,Integrabike | Biblioteca Municipal,Integrabike | Campolim,Integrabike | Dom Aguirre,Integrabike | Ipiranga,Integrabike | Maria Eugênia,Integrabike | Nogueira Padilha,Integrabike | Parque das Águas,Integrabike | Parque dos Espanhóis,Integrabike | Ponte Pinga Pinga,Integrabike | Ponte da rua XV,Integrabike | Poupatempo,Integrabike | Pq Kasatu Maru,Integrabike | Praça Fernando Prestes,Integrabike | Praça Frei Baraúna,Integrabike | Praça Los Angeles,Integrabike | Pça Adolpho Hanickel,Integrabike | Pça Nove de Julho,Integrabike | Pça da Bandeira,Integrabike | Pça do Relógio,Integrabike | Unitem,Integrabike | Vila Angélica,Integrabike | Wanel Ville,JerseyBike | 10th & Clinton,JerseyBike | 14th St Commercial District - Washington St & 14th St,JerseyBike | 14th St Ferry Terminal,JerseyBike | 1600 Park,JerseyBike | 2nd St HBLR Station - 2nd St & Marshall St,JerseyBike | 400 Park Ave/Town Hall,JerseyBike | 45th Street Light Rail,JerseyBike | 600 Harrison,JerseyBike | 66th & Bergenline,JerseyBike | 69th & Bergenline,JerseyBike | 9th St HBLR Station - 8th St & Jackson St,JerseyBike | Applied Housing,JerseyBike | Bayonne City Hall,JerseyBike | Birthplace of Baseball - Washington St & 11th St,JerseyBike | Braddock Park North,JerseyBike | Braddock Park South,JerseyBike | Bulls Ferry (West NY),JerseyBike | Carepoint Health,JerseyBike | City Hall - 1st St & Washington St,JerseyBike | Columbus Park,JerseyBike | Community Pool,JerseyBike | Days Point,JerseyBike | Donnelly Memorial Park,JerseyBike | Hamilton Park,JerseyBike | Hoboken Terminal - Part 1,JerseyBike | Hoboken Terminal - Part 2,JerseyBike | Hoboken Terminal West - Hudson St & Hudson Pl - PATH,JerseyBike | Liberty State Park North---Central Railroad (Virtual),JerseyBike | Liberty State Park South---Flag Plaza (Virtual),JerseyBike | Library/Church Square Park - 5th St & Park Ave,JerseyBike | Lincoln Harbor,JerseyBike | Little League,JerseyBike | Lower Madison - Madison St & 1st St,JerseyBike | Lower Washington - Washington St & 4th St,JerseyBike | Mama Johnson Field - 4th St & Jackson St,JerseyBike | Marineview Plaza,JerseyBike | Maxwell Place Park - Sinatra Dr & 11th St,JerseyBike | Midtown - Clinton St & 7th St,JerseyBike | Midtown East - 8th St & Garden St,JerseyBike | Midtown West - 6th St & Jefferson,JerseyBike | Monroe & 4th,JerseyBike | Multi-Service Center - Grand St & 2nd St,JerseyBike | NW Park,JerseyBike | Newark Plaza - Newark St & Adams St,JerseyBike | North Bergen Town Hall,JerseyBike | Park Bayonne Residence,JerseyBike | Pershing Park,JerseyBike | Pier A Park,JerseyBike | Pier C Park,JerseyBike | Port Imperial & North Park (West NY),JerseyBike | Port Imperial & Riverbend (West NY),JerseyBike | Port Imperial Ferry,JerseyBike | Riverwalk Circle (West NY),JerseyBike | Sam Sloan Statue,JerseyBike | Southwest Park - Harrison St & Observer Hwy,JerseyBike | St Barnabas,JerseyBike | Stevens North - 8th St & Castle Pt Ter,JerseyBike | Stevens South - River Ter & 6th St,JerseyBike | The Promenade (West NY),JerseyBike | Upper Madison - Madison St & 10th St,JerseyBike | Upper Willow - 12th St & Willow Ave,JerseyBike | Veterans Park,JerseyBike | Viaduct - Grand St & 14th St,JerseyBike | Waterfront Park - Weehawken,JerseyBike | Waterfront Park -River Rd 72nd St,JerseyBike | West New York Town Hall,JerseyBike | park + garden - Garden St & 15th St,JesinBici | Giardini Pubblici-Stadio Comunale,JesinBici | Piazza Pergolesi,JesinBici | Riserva Naturale Ripa Bianca,JesinBici | Stazione Ferroviaria,KARBIS | Bengiler,KARBIS | Dere İstasyonu,KARBIS | Doğanbey,KARBIS | Gençlik Merkezi,KRM Konstanciński | Grapa,KRM Konstanciński | Klarysew,KRM Konstanciński | Mirków,KRM Konstanciński | Park Zdrojowy,KRM Konstanciński | Skolimów,KRM Konstanciński | Stary Ratusz,KVB Rad | Agrippabad,KVB Rad | Bahnhof Mülheim,KVB Rad | Charles-de-Gaulle Platz,KVB Rad | Eifelplatz,KVB Rad | Fröbelplatz,KVB Rad | Geißbockheim,KVB Rad | Hotel Stadtpalais,KVB Rad | Humanwissenschaftliche Fakultät,KVB Rad | KVB Hauptverwaltung,KVB Rad | Leonardo Royal Hotel,KVB Rad | Maritim,KVB Rad | Mobilstation Josephstraße,KVB Rad | Mobilstation Severinswall,KVB Rad | Neusser Straße / Gürtel,KVB Rad | RTL Picassoplatz,KVB Rad | Rheinenergie Parkgürtel,KVB Rad | Stegerwaldsiedlung,KVB Rad | Uni Bibliothek,KVB Rad | Uni Boulevard,KVB Rad | Wilhelm-Sollmann-Straße,Kajteroz - Chorzowski Rower Miejski | 3 maja/Pokoju,Kajteroz - Chorzowski Rower Miejski | AKS,Kajteroz - Chorzowski Rower Miejski | Basen – Hajduki,Kajteroz - Chorzowski Rower Miejski | Batory Dworzec PKP,Kajteroz - Chorzowski Rower Miejski | Batory Pętla,Kajteroz - Chorzowski Rower Miejski | Bałtycka,Kajteroz - Chorzowski Rower Miejski | Brzozowa – Przedszkole,Kajteroz - Chorzowski Rower Miejski | Chorzowskie Centrum Kultury,Kajteroz - Chorzowski Rower Miejski | Dolina Górnika,Kajteroz - Chorzowski Rower Miejski | Gwarecka,Kajteroz - Chorzowski Rower Miejski | Jubileuszowa,Kajteroz - Chorzowski Rower Miejski | Kampus,Kajteroz - Chorzowski Rower Miejski | Klimzowiec Gałeczki,Kajteroz - Chorzowski Rower Miejski | Klimzowiec Ryszki,Kajteroz - Chorzowski Rower Miejski | Klimzowiec Sportowa,Kajteroz - Chorzowski Rower Miejski | Kołłątaja,Kajteroz - Chorzowski Rower Miejski | Krajcok,Kajteroz - Chorzowski Rower Miejski | Krzyżowa,Kajteroz - Chorzowski Rower Miejski | Ligoń,Kajteroz - Chorzowski Rower Miejski | MORiS,Kajteroz - Chorzowski Rower Miejski | Maciejkowice,Kajteroz - Chorzowski Rower Miejski | PUP,Kajteroz - Chorzowski Rower Miejski | Park Pod Kasztanami,Kajteroz - Chorzowski Rower Miejski | Park Róż,Kajteroz - Chorzowski Rower Miejski | Park Śląski - Elka,Kajteroz - Chorzowski Rower Miejski | Park Śląski - Pelikany,Kajteroz - Chorzowski Rower Miejski | Park Śląski Różana,Kajteroz - Chorzowski Rower Miejski | Park Śląski ZOO,Kajteroz - Chorzowski Rower Miejski | Park Śląski Żyrafa,Kajteroz - Chorzowski Rower Miejski | Plac Adama Mickiewicza,Kajteroz - Chorzowski Rower Miejski | Plac Piastowski,Kajteroz - Chorzowski Rower Miejski | Plac Św. Jana,Kajteroz - Chorzowski Rower Miejski | Planty Śląskie,Kajteroz - Chorzowski Rower Miejski | Rynek,Kajteroz - Chorzowski Rower Miejski | Stadion Śląski,Kajteroz - Chorzowski Rower Miejski | Stary Zdrój,Kajteroz - Chorzowski Rower Miejski | Styczyńskiego,Kajteroz - Chorzowski Rower Miejski | Szpitalna,Kajteroz - Chorzowski Rower Miejski | Szyb Prezydent,Kajteroz - Chorzowski Rower Miejski | Trzyniecka/Długa,Kajteroz - Chorzowski Rower Miejski | Wodociągi,Kajteroz - Chorzowski Rower Miejski | Węzłowiec,Kajteroz - Chorzowski Rower Miejski | Święta Jadwiga,Kajteroz - Chorzowski Rower Miejski | Święty Wawrzyniec,Kaliski Rower Miejski | Al. Wojska Polskiego/Ryneczek,Kaliski Rower Miejski | Aquapark,Kaliski Rower Miejski | Arena,Kaliski Rower Miejski | Armii Krajowej/Kaczorowskiego,Kaliski Rower Miejski | Braci Niemojowskich/Szkoła,Kaliski Rower Miejski | Cm. Miejski,Kaliski Rower Miejski | Cmentarz Komunalny,Kaliski Rower Miejski | Cmentarz Tyniecki,Kaliski Rower Miejski | Dobrzecka/Reja,Kaliski Rower Miejski | Dworzec PKP,Kaliski Rower Miejski | Gajowa/Nadleśnictwo,Kaliski Rower Miejski | Główny Rynek,Kaliski Rower Miejski | Kołobrzeska/Okrąglicka,Kaliski Rower Miejski | Ks. Jolanty/Most,Kaliski Rower Miejski | Majkowska/Węzeł,Kaliski Rower Miejski | Majkowskie Wembley,Kaliski Rower Miejski | Młynarska/Wąska,Kaliski Rower Miejski | Park Przyjaźni,Kaliski Rower Miejski | Pl. Jana Pawła II/pomnik A. Asnyka,Kaliski Rower Miejski | Pobożnego/Parking,Kaliski Rower Miejski | Podmiejska/Orlik,Kaliski Rower Miejski | Poznańska/Szpital,Kaliski Rower Miejski | Sadowa/McDonald's,Kaliski Rower Miejski | Skarszewska/Borkowska,Kaliski Rower Miejski | Stawiszyńska/Morelowa,Kaliski Rower Miejski | Tatrzańska/Karpacka,Kaliski Rower Miejski | Teatr,Kaliski Rower Miejski | Ułańska/UAM,Kaliski Rower Miejski | Wrocławska/COSSW,Kaliski Rower Miejski | Złoty Róg,Katowice Bike | Al. Bolesława Krzywoustego,Katowice Bike | Al. Księcia Henryka Pobożnego,Katowice Bike | Al. Księżnej Jadwigi Śląskiej,Katowice Bike | Armii Krajowej/Jankego,Katowice Bike | Bogucice Szpital,Katowice Bike | Bracka – Gliwicka,Katowice Bike | Bukszpanowa - Tunelowa,Katowice Bike | Bytomska - Józefowska,Katowice Bike | Chorzowska Park Budnioka,Katowice Bike | DH Supersam,Katowice Bike | Dolina 3-ch Stawów,Katowice Bike | Dąb Kościół,Katowice Bike | Dębowa - Skwer Pająka,Katowice Bike | GPP Business Park,Katowice Bike | Galeria 3 Stawy,Katowice Bike | Galeria Libero,Katowice Bike | Gawrony,Katowice Bike | Giszowiec - Plac Pod Lipami,Katowice Bike | Giszowiec Kolista,Katowice Bike | Graniczna Targowisko,Katowice Bike | Green Park,Katowice Bike | Grota Roweckiego - Stellera,Katowice Bike | Grzyśki Biblioteka,Katowice Bike | ING Roździeńska,Katowice Bike | ING Sokolska,Katowice Bike | KTBS – Krasińskiego 14,Katowice Bike | KTBS – Osiedle Pod Kasztanami,Katowice Bike | KTBS – Osiedle Sławka,Katowice Bike | KTBS – Saint Etienne 1,Katowice Bike | Katowice Rynek,Katowice Bike | Kokociniec S.P nr 67,Katowice Bike | Korczaka - Andersa,Katowice Bike | Kostuchna – Bażantów,Katowice Bike | Kostuchna – Boże Dary,Katowice Bike | Kostuchna – Rondo Rostworowskiego,Katowice Bike | Kostuchna – Szarych Szeregów,Katowice Bike | Koszutka – Plac Gwarków,Katowice Bike | Ligota Centrum Przesiadkowe,Katowice Bike | Ligota Medyków,Katowice Bike | Ligota Wczasowa,Katowice Bike | Mariacka Kościół,Katowice Bike | Murcki - Rynek Murckowski,Katowice Bike | NOSPR Katowice,Katowice Bike | Nikiszowiec - Skwer Zillmannów,Katowice Bike | Nikiszowiec - Szyb Wilson,Katowice Bike | Orkana - Rolna,Katowice Bike | Os. Kukuczki – Skwer Koszycki,Katowice Bike | Os. Paderewskiego - Sikorskiego,Katowice Bike | Os. Paderewskiego -Szeptyckiego,Katowice Bike | Os. Ptasie - Słowików,Katowice Bike | Os. Ptasie – ul. Gawronów,Katowice Bike | Os. Witosa – ul. Rataja,Katowice Bike | Osiedle Witosa - Plac Herberta,Katowice Bike | Panewnicka Szkoła Podstawowa nr 9,Katowice Bike | Park Kościuszki,Katowice Bike | Piotrowice V L.O.,Katowice Bike | Plac Grunwaldzki,Katowice Bike | Plac Hlonda,Katowice Bike | Plac Miarki,Katowice Bike | Plac Sejmu Śląskiego,Katowice Bike | Plac Wolności,Katowice Bike | Podlesie – Stary Most,Katowice Bike | Politechnika Śląska,Katowice Bike | Silesia Business Park,Katowice Bike | Silesia City Center,Katowice Bike | Skwer Bolesława Szabelskiego,Katowice Bike | Szczecińska - Nowowiejskiego,Katowice Bike | Szopienice - Plac Powstańców Śląskich,Katowice Bike | Techników,Katowice Bike | Ul. Powstańców - Biblioteka Śląska,Katowice Bike | Uniczowska PKP,Katowice Bike | Urząd Miasta Francuska 70,Katowice Bike | Zadole Kościół,Katowice Bike | Załęska Hałda,Katowice Bike | Załęże Skwer S. Barei,Katowice Bike | Łętowskiego S.P. nr 27,Koniński Rower Miejski | Aleja 1 Maja,Koniński Rower Miejski | Bulwar Nadwarciański,Koniński Rower Miejski | Park im. F. Chopina,Koniński Rower Miejski | ul. Dworcowa,Koniński Rower Miejski | ul. Grunwaldzka,Koniński Rower Miejski | ul. Józefa Piłsudskiego,Koniński Rower Miejski | ul. Kard. Stefana Wyszyńskiego,Koniński Rower Miejski | ul. Księdza Jerzego Popiełuszki,Koniński Rower Miejski | ul. Paderewskiego,Koniński Rower Miejski | ul. Poznańska,Koniński Rower Miejski | ul. Zakładowa,Koszaliński Rower Miejski | Budowlanka,Koszaliński Rower Miejski | Dworzec,Koszaliński Rower Miejski | Gnieźnieńska,Koszaliński Rower Miejski | Jamno,Koszaliński Rower Miejski | Politechnika,Koszaliński Rower Miejski | Przemysłowa,Koszaliński Rower Miejski | Ratusz,Koszaliński Rower Miejski | Targowisko,Koszaliński Rower Miejski | Wąwozowa,Koszaliński Rower Miejski | Zielona,Koło Marek | Czarna Struga,Koło Marek | Struga,Koło Marek | Urząd Miasta Marki,Koło Marek | Wspólna,Koło Marek | Węzeł Marki - S8,Kołobrzeski Rower Miejski | Dworzec PKP,Kołobrzeski Rower Miejski | Kamienny Szaniec,Kołobrzeski Rower Miejski | Latarnia Morska,Kołobrzeski Rower Miejski | Ogrody - ul. Fredry,Kołobrzeski Rower Miejski | Park Handlowy Albatros,Kołobrzeski Rower Miejski | Podczele - ul. Brzeska,Kołobrzeski Rower Miejski | Ratusz,Kołobrzeski Rower Miejski | Stadion,Kołobrzeski Rower Miejski | Ul. Słowińców,Kołobrzeski Rower Miejski | ul. 1 Maja,Kołobrzeski Rower Miejski | ul. Arciszewskiego,Kołobrzeski Rower Miejski | ul. Toruńska,Kołobrzeski Rower Miejski | ul. Świętego Wojciecha,LRM Lublin - Orlen | PKN Orlen - Al. Kraśnicka 116A,LRM Lublin - Orlen | PKN Orlen - Głęboka 32,LRM Lublin - Orlen | PKN Orlen - Mełgiewska,LRM Lublin - Orlen | PKN Orlen - Męczenników Majdanka,LRM Lublin - Orlen | PKN Orlen - Spółdzielczości Pracy,LRM Lublin | 8685,LRM Lublin | Atrium Felicity,LRM Lublin | Brzeziny,LRM Lublin | Centrum Kultury,LRM Lublin | Dworzec PKP,"LRM Lublin | Koło IKEA, Blisko SKENDE",LRM Lublin | Lublin Plaza,LRM Lublin | Nowy Świat,LRM Lublin | Pl. Litewski / ul. Kapucyńska,LRM Lublin | Plac Wolności,LRM Lublin | Rondo Gen. Leona Berbeckiego / Lidl,LRM Lublin | VIVO! Lublin,LRM Lublin | al. Kompozytorów Polskich / ul. Paganiniego,LRM Lublin | al. Kraśnicka / Konstantynów,LRM Lublin | al. Racławickie / Rondo Krwiodawców,LRM Lublin | al. Smorawińskiego / Al. Kompozytorów Polskich,LRM Lublin | al. Smorawińskiego / ul. Szeligowskiego,LRM Lublin | al. Tysiąclecia / Plac Zamkowy,LRM Lublin | al. Warszawska / ul. Boh. M. Cassino,LRM Lublin | al. Zygmuntowskie / MOSiR,LRM Lublin | ul. Abramowicka / ul. Sierpińskiego,LRM Lublin | ul. Agronomiczna / Skansen,LRM Lublin | ul. Antoniego Gębali / Szpital,LRM Lublin | ul. Antoniny Grygowej,LRM Lublin | ul. Armii Krajowej / ul.  Jutrzenki,LRM Lublin | ul. Bajkowskiego / Ratusz,LRM Lublin | ul. Braci Wieniawskich / ul. Kaprysowa,LRM Lublin | ul. Chodźki / ul. Hirszfelda,LRM Lublin | ul. Cukrownicza / ZDiM / Arena Lublin,LRM Lublin | ul. Czwartaków / DS Helios UMCS,LRM Lublin | ul. Diamentowa / ul. Medalionów,LRM Lublin | ul. Dobrzańskiego / pętla autobusowa,LRM Lublin | ul. Doświadczalna / ul. Jagiełły,LRM Lublin | ul. Dożynkowa /ul. Cynamonowa,LRM Lublin | ul. Droga Męczenników Majdanka - Muzeum,LRM Lublin | ul. Droga Męczenników Majdanka / ul. Krańcowa,LRM Lublin | ul. Dziewanny 21 / ul. Różana,LRM Lublin | ul. Długa / Poczta,LRM Lublin | ul. Elsnera / WSSP / ul. Choiny,LRM Lublin | ul. Filaretów - pętla autobusowa / ul. Wyżynna,LRM Lublin | ul. Filaretów / ul. Radości,LRM Lublin | ul. Generała Tadeusza Góry,LRM Lublin | ul. Godebskiego / LO im. Staszica,LRM Lublin | ul. Gospodarcza / ul. Hutnicza,LRM Lublin | ul. Głęboka / Uniwersytet Przyrodniczy,LRM Lublin | ul. Hieronima Łopacińskiego / KUL,LRM Lublin | ul. Jana Hempla / ul. Peowiaków,LRM Lublin | ul. Jana Pawła II / Rondo NSZ,LRM Lublin | ul. Jana Pawła II / ul. Gęsia,LRM Lublin | ul. Jantarowa / al. Jana Pawła II,LRM Lublin | ul. Judyma 2a - Dom Kultury,LRM Lublin | ul. Kiepury / Dom Kultury,LRM Lublin | ul. Krakowskie Przedmieście / ul. Krótka,LRM Lublin | ul. Kruczkowskiego / ul. Dunikowskiego,LRM Lublin | ul. Kunickiego / ul. Mickiewicza,LRM Lublin | ul. Kunickiego / ul. Oboźna,LRM Lublin | ul. Leszczyńskiego,LRM Lublin | ul. Mełgiewska / WSEI,LRM Lublin | ul. Nadbystrzycka / Politechnika Lubelska,LRM Lublin | ul. Nadbystrzycka / ul. Pozytywistów,LRM Lublin | ul. Nałkowskich / ul. Fulmana,LRM Lublin | ul. Nałęczowska / ul. Sławin,LRM Lublin | ul. Niepodległości,LRM Lublin | ul. Niepodległości 12,LRM Lublin | ul. Osmolicka / Słoneczny Wrotków,LRM Lublin | ul. Osmolicka/ Słoneczny Wrotków 2,LRM Lublin | ul. Paderewskiego /  ul. Leszetyckiego,LRM Lublin | ul. Piłsudskiego / MPWiK,LRM Lublin | ul. Poniatowskiego / XXIII LO,LRM Lublin | ul. Racławicka / ul. Wyszyńskiego,LRM Lublin | ul. Radości / Gimnazjum,LRM Lublin | ul. Radziszewskiego / ul. Akademicka,LRM Lublin | ul. Romera,LRM Lublin | ul. Roztocze / SP nr 50,LRM Lublin | ul. Ruska / Skarpa,LRM Lublin | ul. Rymwida / ul. Filaretów,LRM Lublin | ul. Spokojna / Urząd Wojewódzki,LRM Lublin | ul. Szaserów 15 / Biblioteka,LRM Lublin | ul. Szczerbowskiego / ul. Muzyczna,LRM Lublin | ul. Walecznych / ul. Unicka,LRM Lublin | ul. Willowa / ul. Mineralna,LRM Lublin | ul. Willowa / ul.Relaksowa,LRM Lublin | ul. Wojciechowska / Szkoła,LRM Lublin | ul. Węglarza / Pętla MPK,LRM Lublin | ul. Zakopiańska 5,LRM Lublin | ul. Zamojska / Stary most,LRM Lublin | ul. Zana / Akademiki UMCS,LRM Lublin | ul. Zana / Policja,LRM Lublin | ul. Zana / ZUS,LRM Lublin | ul. Zbożowa / Pętla autobusowa,LRM Lublin | ul. Związkowa / WSPA,LRM Lublin | ul. Łęczyńska / ul. Przyjaźni,LRM Lublin | ul. Żywnego / ul. Paryska,Le vélo | 02279 - DOCKS LES TERRASSES DU PORT,Le vélo | 06253 - ROME SYLVABELLE,Le vélo | 1001 - CANEBIERE REINE ELISABETH,Le vélo | 1002-HOTEL DE VILLE,Le vélo | 1003-PLACE AUX HUILES,Le vélo | 1004-GENERAL DE GAULLE PARADIS,Le vélo | 1005-CENTRE BOURSE,Le vélo | 1006-COURS JEAN BALLARD,Le vélo | 1130- NATIONAL LONGCHAMP,Le vélo | 1191-CANEBIERE-ST FERREOL,Le vélo | 1213-GRIGNAN - MARCELLE PAUL,Le vélo | 1216-SAINTE - LULLI,Le vélo | 1226-PLAINE-ST PIERRE,Le vélo | 1230-ROOSEVELT - REFORMES,Le vélo | 1245-GAMBETTA - LAFAYETTE,Le vélo | 1264 - CANEBIÈRE DUGOMMIER,Le vélo | 1275- JULIEN - 3 MAGES,Le vélo | 1287- STALINGRAD - RÉFORMÉS,Le vélo | 1297- ST FÉRRÉOL DAVSO,Le vélo | 1299- ST CHARLES VOLTAIRE LIBERTÉ,Le vélo | 1301- ST CHARLES MARSEILLAISES,Le vélo | 1302-COLBERT -SAINTE BARBE,Le vélo | 1316 -ST CHARLES FACULTÉ,Le vélo | 1343 - FLAMMARION GROBET,Le vélo | 1344 - FLAMMARION NATIONAL,Le vélo | 1345 - SAINT CHARLES LECLERC ZATTARA,Le vélo | 1346- REPUBLIQUE COUTELLERIE,Le vélo | 2012-GRAND RUE,Le vélo | 2030-REPUBLIQUE DAMES,Le vélo | 2031 - SCHUMANN LECA,Le vélo | 2032- DAMES  SCHUMANN,Le vélo | 2179-QUAI DU PORT,Le vélo | 2184-REPUBLIQUE-CATHALA,Le vélo | 2200-MUCEM,Le vélo | 2221-91 LIBÉRATION,Le vélo | 2222-151 LIBERATION,Le vélo | 2240-DAMES - TERRAS,Le vélo | 2272- JOLIETTE-DUNKERQUE,Le vélo | 2304 - RÉPUBLIQUE MOISSON,Le vélo | 2323 -FORBIN PARIS,Le vélo | 2327- RÉPUBLIQUE PLUMIER,Le vélo | 2341- JOLIETTE FORBIN,Le vélo | 3228 -TOUR LA MARSEILLAISE,Le vélo | 3320 - BELLE DE MAI CADENAT,Le vélo | 3321 - BELLE DE MAI FRICHE,Le vélo | 3322 - ARENC CHANTERAC,Le vélo | 4022-SAKAKINI FOCH,Le vélo | 4057-PLACE SEBASTOPOL,Le vélo | 4111-FOCH FAYOLLE,Le vélo | 4238-LIBERATION-CHAPE-ESPERANDIEU,Le vélo | 4293- BLANCARDE,Le vélo | 4342 - FLAMMARION MONTRICHET,Le vélo | 5024-BAILLE PAURIOL,Le vélo | 5060-SAKAKINI CHAVE,Le vélo | 5103-RUE GEORGES,Le vélo | 5104-CHAVE EUGÈNE PIERRE,Le vélo | 5107-BAILLE CONCEPTION,Le vélo | 5220-ROOSEVELT - ORAN,Le vélo | 5280-CHAVE CAMAS,Le vélo | 5284 - BAILLE-HOPITAL-CONCEPTION,Le vélo | 6020-PLACE DE LA CORDERIE,Le vélo | 6023- CASTELLANE,Le vélo | 6100-PAUL PEYTRAL,Le vélo | 6113-LODI VILLAGE,Le vélo | 6114-JULIEN BARTHELEMY,Le vélo | 6154-PIERRE PUGET BRETEUIL,Le vélo | 6160-153 PARADIS,Le vélo | 6176-CANTINI ROUET,Le vélo | 6177-BAILLE FRIEDLAND,Le vélo | 6187-DELPUECH CORINTHE,Le vélo | 6206-TOULON - MENPENTI,Le vélo | 6208-ROUET,Le vélo | 6217-ROSTAND - PREFECTURE,Le vélo | 6254-ROME - BERLIOZ - ITALIE,Le vélo | 6348 - ROME- SALVATOR-ITALIE,Le vélo | 7025-LIVON PASTEUR,Le vélo | 7027-PLACE DU 4 SEPTEMBRE,Le vélo | 7062-88 CORNICHE - KENNEDY,Le vélo | 7064-CORNICHE  LE PROPHETE,Le vélo | 7138-CORNICHE  ENDOUME,Le vélo | 7142-CORNICHE RAPATRIES,Le vélo | 7146-LIVON VIEUX PORT,Le vélo | 7151-PASTEUR,Le vélo | 7153-CORSE ST MAURICE,Le vélo | 7212-SAINTE - NOTRE DAME,Le vélo | 7215-ENDOUME - CORDERIE,Le vélo | 7349 - LA CRIEE,Le vélo | 8053-PRADO - PERIER,Le vélo | 8065-PROMENADE POMPIDOU PALM BEACH,Le vélo | 8066-MENDES FRANCE HUVEAUNE,Le vélo | 8067-PRADO GABES,Le vélo | 8068-PRADO BORELY,Le vélo | 8078-VIEILLE CHAPELLE,Le vélo | 8093-HAMBOURG ROND POINT GUERRE,Le vélo | 8131-PROMENADE POMPIDOU DAVID,Le vélo | 8132-PROMENADE POMPIDOU AMIRAL MUSELIER,Le vélo | 8134-ROND POINT DU PRADO,Le vélo | 8144-ESCALE BORELY POINTE ROUGE,Le vélo | 8145-ESCALE BORELY,Le vélo | 8147 - MICHELET HUVEAUNE,Le vélo | 8149-391 MICHELET,Le vélo | 8202-397 PRADO,Le vélo | 8246-PARADIS - LORD DUVEEN,Le vélo | 8255-PRADO - PARADIS,Le vélo | 8257-RABATAU - TEISSEIRE,Le vélo | 8261- 318 MAZARGUES,Le vélo | 8262-MAZARGUES-BARRAL,Le vélo | 8265- NÉGRESKO - PAULET,Le vélo | 8270 - RABATAU ST JOSEPH,Le vélo | 8290- POINTE ROUGE - MONTREDON,Le vélo | 8307-PRADO MICHELET,Le vélo | 8308-PRADO LATIL,Le vélo | 8309- PRADO DUVEEN,Le vélo | 8310- CANTINI REGE,Le vélo | 8313- PARC PASTRE,Le vélo | 9074-MICHELET LUCE,Le vélo | 9085-SCHLOESING TEISSERE,Le vélo | 9087-MAZARGUES,Le vélo | 913 - PLAGE DES DAMES,Le vélo | 9207- TEISSEIRE - ROUBAUD,Le vélo | 9219-PUGETTE - ANDRE,Le vélo | 9259-LANCIER-MARTHELINE,Le vélo | 9260- MAZARGUES - ALMERAS,Li bia velo | 001 - OCTAVE HENRY,Li bia velo | 002 - CROIX DE FEUX,Li bia velo | 003 - GARE DU NORD,Li bia velo | 004 - GARE DE NAMUR,Li bia velo | 006 - HOTEL DE VILLE,Li bia velo | 007 - ANGE,Li bia velo | 010 - ARTHUR MASSON,Li bia velo | 011 - CITE ADMINISTRATIVE,Li bia velo | 012 - PLACE SAINT-NICOLAS,Li bia velo | 013 - PONT DES ARDENNES,Li bia velo | 015 - PONT DE JAMBES,Li bia velo | 016 - PLACE DE WALLONIE,Li bia velo | 017 - GARE DE JAMBES,Li bia velo | 018 - CPAS,Li bia velo | 021 - CASINO,Li bia velo | 022 - GROGNON,Li bia velo | 023 - MAURICE SERVAIS,Li bia velo | 024 - SAINT-AUBAIN,Li bia velo | 025 - AUBERGE DE JEUNESSE,Li bia velo | 026 - ARSENAL,Li bia velo | 027 - OMALIUS,Li bia velo | 028 - EXPO,Li bia velo | 029 - WIERTZ,Li bia velo | 030 - PLACE LOUISE GODIN,Li bia velo | 031-PLACE DE BERCK-SUR-MER,Li bia velo | 032- ECOLE DES CADETS,Li bia velo | 033 - BOSQUETS,Li bia velo | 034 - ROGIER,Libélo | Alpes,Libélo | Basse Ville,Libélo | Bourg Mairie,Libélo | Briffaut,Libélo | Champs de Mars,Libélo | Châteauvert,Libélo | Danton,Libélo | Dunkerque,Libélo | Faventines,Libélo | Gare,Libélo | Gare TGV,Libélo | Hugo,Libélo | Hôpital,Libélo | Jaurès,Libélo | Latour Maubourg,Libélo | Lautagne,Libélo | Marguerite,Libélo | Montalivet,Libélo | Montgolfier,Libélo | Montplaisir,Libélo | Pompidou,Libélo | Pôle Bus,Libélo | Rovaltain,Libélo | République,Libélo | Valence Mairie,Libélo | pbsc_test2,Libélo | Épervière,Link | 2nd Street Market,Link | 600 Longworth @ Greater Dayton RTA,Link | Brown St.,Link | Central Campus,Link | Convention Center,Link | Courthouse Square,Link | Grafton Hill @ Dayton Art Institute,Link | Historic South Park,Link | Job Center,Link | McPherson Town,Link | Miami Valley Hospital,Link | N Main St.,Link | Oregon District E,Link | Oregon District W,Link | Patterson Canal,Link | RecPlex,Link | RiverScape,Link | Roesch Library,Link | St. Anne’s Hill,Link | Stonemill,Link | Tech Town,Link | University Place,Link | W Monument,Link | West Fourth @ Sinclair Building 3,Link | West Third,Link | Wright Dunbar,Link | Wright Stop Plaza,LonganoinBici | Caldera`,LonganoinBici | Stazione Nuova,LonganoinBici | Stazione Vecchia,LonganoinBici | Tribunale,LonganoinBici | Villa Oasi,Lundahoj | ALLHELGONAKYRKAN,Lundahoj | BANTORGET,Lundahoj | BOTANISKA TRÄDGÅRDEN,Lundahoj | FYSIOLOGEN,Lundahoj | GALTEN,Lundahoj | IDEON NORR,Lundahoj | IDEON SÖDER,Lundahoj | LUNDS CENTRAL,Lundahoj | MÅRTENSTORGET,Lundahoj | PROFESSORSGATAN,Lundahoj | RIDHUSET,Lundahoj | SPARTA,Lundahoj | STADSPARKEN NORR,Lundahoj | STORTORGET,Lundahoj | UNIVERSITETSBIBLIOTEKET,MIBICI | (GDL-001) C. Epigmenio Glez./ Av. 16 de Sept.,MIBICI | (GDL-002) C. Colonias  / Av.  Niños héroes,MIBICI | (GDL-003) C. Vidrio / Av. Chapultepec,MIBICI | (GDL-004) C. Ghilardi /C. Miraflores,MIBICI | (GDL-005) C. San Diego /Calzada Independencia,MIBICI | (GDL-006) C. Venustiano Carranza /C. Reforma,MIBICI | (GDL-007)C. Epigmenio Glez./Av. Cristobal C.,MIBICI | (GDL-008) C. J. Angulo / C. González Ortega,MIBICI | (GDL-009) Calz. Federalismo/ C. J. Angulo,MIBICI | (GDL-010) C. Cruz verde / C. Joaquin Angulo,MIBICI | (GDL-011) C. Garibaldi / C. Frías,MIBICI | (GDL-012) C. Joaquín Angulo / C. Ghilardi,MIBICI | (GDL-013) C. Vidrio  / C. Marsella,MIBICI | (GDL-014)C. J. Angulo/C. José Clemente Orozco,MIBICI | (GDL-015) C. Herrera y Cairo /C. Pedro Buzeta,MIBICI | (GDL-016)C. Bernardo de Balbuena/C. J. Angulo,MIBICI | (GDL-017) Av. México /C. Bernardo de Balbuena,MIBICI | (GDL-018) Av. México / C. Manuel M. Diéguez,MIBICI | (GDL-019)  C. Juan Manuel / C. Andrés Terán,MIBICI | (GDL-020) C. General Coronado / C.Juan Manuel,MIBICI | (GDL-021) C. Nicolás Romero / C. Reforma,MIBICI | (GDL-022)C. San Felipe /C. Enrique D. de León,MIBICI | (GDL-023) C. Jesús / C. San Felipe,MIBICI | (GDL-024) Av.  Federalismo / C. Juan Manuel,MIBICI | (GDL-025) C. Reforma / C. González Ortega,MIBICI | (GDL-026) C. Pedro Loza / C. Reforma,MIBICI | (GDL-027) C. Belén / C. San Felipe,MIBICI | (GDL-028) C. Gregorio Dávila /C. Manuel Acuña,MIBICI | (GDL-029)Calz. Indep. /C. Juan Manuel,MIBICI | (GDL-030) C. Pedro Moreno/ C. Progreso,MIBICI | (GDL-031) C. Hospital / C. Andrés Terán,MIBICI | (GDL-032) C. Degollado / Av. Hidalgo,MIBICI | (GDL-033) Av. Hidalgo / C. Pedro Loza,MIBICI | (GDL-034) C. Morelos / C. Donato Guerra,MIBICI | (GDL-035)C. Mezquitán / Av. Hidalgo,MIBICI | (GDL-036) C. Marcos Castellanos/ C. Morelos,MIBICI | (GDL-037) C.Juan N. Cumplido /C. Independenci,MIBICI | (GDL-038) C. Nicolás Romero / Av. Hidalgo,MIBICI | (GDL-039) C. General Coronado / Av. Hidalgo,MIBICI | (GDL-040) C. Morelos / C. Progreso,MIBICI | (GDL-041) C. Manuel M. Diéguez / Av. Hidalgo,MIBICI | (GDL-042) C. Bernardo de Balbuena /Av Hidalgo,MIBICI | (GDL-043) C. Simón Bolivar / C. López Cotilla,MIBICI | (GDL-044)C. Gral. San Martín /Av.  Vallarta,MIBICI | (GDL-045) C. Pedro Moreno / C. Marsella,MIBICI | (GDL-046) C. Emerson / Av. Vallarta,MIBICI | (GDL-047) C. Robles Gil / Av. Vallarta,MIBICI | (GDL-048) C. Constancio Hernández/ Av. Juaréz,MIBICI | (GDL-049) Lopez Cotilla/ Marcos Castellanos,MIBICI | (GDL-050) C. Pedro Moreno / Calz. Federalismo,MIBICI | (GDL-051) C. 8 de Julio / Av. Juárez,MIBICI | (GDL-052) Av. Juárez / Av. 16 de Septiembre,MIBICI | (GDL-053) C. Maestranza / Av. Juárez,MIBICI | (GDL-054) Av. Juárez / Calz. Independencia,MIBICI | (GDL-055) C. Degollado /C.Prisciliano Sánchez,MIBICI | (GDL-056) Av. 16 de Sept. / C. Miguel Blanco,MIBICI | (GDL-057) C. Ocampo / C. Prisciliano Sánchez,MIBICI | (GDL-058) C. Pavo / C. Prisciliano Sánchez,MIBICI | (GDL-059) C. Miguel Blanco / C. Penitenciaria,MIBICI | (GDL-060) C. Madero/ C. Camarena,MIBICI | (GDL-061) C. Libertad /  C. Argentina,MIBICI | (GDL-062) C. Libertad / C. Moscú,MIBICI | (GDL-063) C. Colonias  / C. López Cotilla,MIBICI | (GDL-064) C. Marsella / C. López Cotilla,MIBICI | (GDL-065) C. Simón Bolivar / Av. La Paz,MIBICI | (GDL-066) C Lerdo de Tejada/C Gral. Sn Martín,MIBICI | (GDL-067) Calzada Federalismo / C. Vidrio,MIBICI | (GDL-068) C. Guadalupe Zuno / Av. Chapultepec,MIBICI | (GDL-069) C. Colonias / C. Guadalupe Zuno,MIBICI | (GDL-070) Av. La  Paz / C. Juan de Ojeda,MIBICI | (GDL-071) Av. La Paz /Av.Enrique Díaz de León,MIBICI | (GDL-072) Av. La Paz / C. Camarena,MIBICI | (GDL-073) Av. La Paz / Av. Federalismo,MIBICI | (GDL-074) C. Enrique González / C. Libertad,MIBICI | (GDL-075) C. Pedro Rioseco /C. Nueva Galicia,MIBICI | (GDL-076) C. Ramón Corona / C. Libertad,MIBICI | (GDL-077) C. Argentina / C. Pedro Moreno,MIBICI | (GDL-078) C. Comercio / C. La Paz,MIBICI | (GDL-079)  C. Donato Guerra /Av. La Paz,MIBICI | (GDL-080) C. Manuel Acuña / Av. Américas,MIBICI | (GDL-081) C. Venezuela / Av. Niños Héroes,MIBICI | (GDL-082)C. Gdpe. Montenegro/C.Nuño de Guzman,MIBICI | (GDL-083) C. Vidrio / Av. Enrique Díaz,MIBICI | (GDL-084) C. Montenegro / Av. Chapultepec,MIBICI | (GDL-085)C. Gdpe. Zuno/ Av.  Unión,MIBICI | (GDL-086) C. Simón Bolivar / Av. Niños Héroes,MIBICI | (GDL-087) Av. Américas / Av. López Mateos,MIBICI | (GDL-088) Av.Plan de San Luis/C. Andrés Teran,MIBICI | (GDL-089) C. Juan Álvarez / C. Cruz Verde,MIBICI | (GDL-090) Calz. Federalismo / C. Durango,MIBICI | (GDL-091) C. Magisterio /Av. M. Ávila Camacho,MIBICI | (GDL-092) Calz Federalismo / Av Plan San Luis,MIBICI | (GDL-093) C. H Colegio Militar / Av. Américas,MIBICI | (GDL-094) C. Manuel Cambre / C. Andrés Teran,MIBICI | (GDL-095)  C. Mariano Bárcena / Maestros,MIBICI | (GDL-096) C. Jesús García / C. González Orte,MIBICI | (GDL-097) C. María Vigil / C. Juan N Cumplido,MIBICI | (GDL-098) Calz. Federalismo / Av. Maestros,MIBICI | (GDL-099) C. Eulogio Parra /C.González Ortega,MIBICI | (GDL-100) C. Ayuntamiento/C. A. R. Plasencia,MIBICI | (GDL-101) C. Amado Nervo /C. José María Vigil,MIBICI | (GDL-102) C. María Vigil/C. Manuel M. Dieguez,MIBICI | (GDL-103) J. Clemente Orozco /C. Jesús García,MIBICI | (GDL-104) C. Pedro Loza / Av. Manuel Acuña,MIBICI | (GDL-105) C. Pino Suárez / C. Joaquin Angulo,MIBICI | (GDL-106) C. Juan Álvarez / C. Belén,MIBICI | (GDL-107) Calz. Federalismo/C. J. María Vigil,MIBICI | (GDL-108) C. Hospital / C. Alameda,MIBICI | (GDL-109) C. Eulogio Parra / Av. Américas,MIBICI | (GDL-110) C. Manuel Diéguez/Av. Eulogio Parra,MIBICI | (GDL-111) C. José Palomar / C. Hospital,MIBICI | (GDL-112) C. C. Orozco/C. Gral. Eulogio Parra,MIBICI | (GDL-113) C. Ghilardi / C. Arista,MIBICI | (GDL-114) C. Monte Cáucaso / C. Alameda,MIBICI | (GDL-115) Calz. Federalismo / C. Fco. Zarco,MIBICI | (GDL-116) Av Manuel Acuña/C. Pablo Villaseñor,MIBICI | (GDL-117) Av Manuel Acuña / C Fray Fco Frejes,MIBICI | (GDL-118) C. Antonio de León / C. Garibaldi,MIBICI | (GDL-119) C. Fco Rojas González /C. Garibaldi,MIBICI | (GDL-120) C. Agustín de la Rosa /C. Garibaldi,MIBICI | (GDL-121) C. Tomás V. Gómez / Av. México,MIBICI | (GDL-122) C. Fray Luis DePalacio/ Av. México,MIBICI | (GDL-123) C. Aurelio L. Gallardo / Av. México,MIBICI | (GDL-124) C. Severo Díaz / C. Justo Sierra,MIBICI | (GDL-125) C. Pablo Villaseñor / Av. Hidalgo,MIBICI | (GDL-126) C. Aurelio L. Gallardo / Av Hidalgo,MIBICI | (GDL-127) Av. Vallarta / Av. de Los Arcos,MIBICI | (GDL-128) Av. Morelos / C. Emilio Castelar,MIBICI | (GDL-129) C. Lope de Vega / Av. Vallarta,MIBICI | (GDL-130) C. J. Ruíz de Alarcón / Av Vallarta,MIBICI | (GDL-131) C. Emilio Castelar / Av. La Paz,MIBICI | (GDL-132) C. Lope de Vega / Av. La Paz,MIBICI | (GDL-133) C. J. Ruíz de Alarcón / Av. La Paz,MIBICI | (GDL-134) C. Agustín Yáñez / C. Fco Ugarte,MIBICI | (GDL-135) C. Victoriano Agüeros / Av. Unión,MIBICI | (GDL-136) C. Lope de Vega/C. Efraín Glez Luna,MIBICI | (GDL-137) C. Ruíz de Alarcón/C. Efraín G Luna,MIBICI | (GDL-138) C. de la Nebulosa / C. Placeres,MIBICI | (GDL-139) C. Firmamento / Av. Niños Héroes,MIBICI | (GDL-140) C. Constelación / Av. de los Arcos,MIBICI | (GDL-141) C. Ruíz de Alarcón/C. Agustín Yáñez,MIBICI | (GDL-142) C. De la Nebulosa / C. Firmamento,MIBICI | (GDL-143) C. Eclipse / Av. de Los Arcos,MIBICI | (GDL-144) C. Primo Feliciano / C. San Gabriel,MIBICI | (GDL-145) C. San Miguel / Av. San Francisco,MIBICI | (GDL-146) Av. Guadalupe / C. Boturini,MIBICI | (GDL-147) Calz. Lázaro Cárdenas/Av. Guadalupe,MIBICI | (GDL-148) C. San Rafael / Av. Tepeyac,MIBICI | (GDL-149) Calz. Lázaro Cárdenas/López Mateos,MIBICI | (GDL-150) C. Asunción / Av. Chapalita,MIBICI | (GDL-151) C. Capuchinas / Av. Chapalita,MIBICI | (GDL-152) Parque de las Estrellas/C. Orión,MIBICI | (GDL-153) C. Crepúsculo / Av. Tonantzin,MIBICI | (GDL-154) C. Capuchinas / Av. Las Rosas,MIBICI | (GDL-155) Parque de las Estrellas/Mariano Ote,MIBICI | (GDL-156) C. Duque de Rivas/ C. López Cotilla,MIBICI | (GDL-157) Av. Mariano Otero / Av. Las Rosas,MIBICI | (GDL-158) Av. Faro / Av. Las Rosas,MIBICI | (GDL-159) C. Guadalupe Victoria /Del Ejercito,MIBICI | (GDL-160) C.Silverio Garcia/Blvrd. García Ba*,MIBICI | (GDL-161) C. Rio Usumacinta/Blvrd García Barr,MIBICI | (GDL-162) C. Rio Tuxpan / C. Salvador Lopez C,MIBICI | (GDL-163) C. Corregidora / Blvrd. García B.,MIBICI | (GDL-164) Av. Olímpica /C. José Rolon,MIBICI | (GDL-165) C. Rio Panuco/ Blvrd. García B.,MIBICI | (GDL-166) C. Rio Principal / Blvrd. García B.,MIBICI | (GDL-167) C. Rio San Juan de Dios/Blvrd. Garc,MIBICI | (GDL-168) Av. Rio Nilo / C. Ramón Pacheco,MIBICI | (GDL-169) Blvrd. García Barragán/ C. Rio Zapo,MIBICI | (GDL-170)  C. Relojeros/ C. Chamizal,MIBICI | (GDL-171) C. Maquinistas / C. San Rafael,MIBICI | (GDL-172) C. Chamizal / Av. Rio Nilo,MIBICI | (GDL-173) C. Caballerango / C. Caporales,MIBICI | (GDL-174) C. Juan de Zumárraga / Av. Tepeyac,MIBICI | (GDL-175) C. Ermita / C. San Uriel,MIBICI | (GDL-176) C. San Bonifacio/ Paseo Benedictino,MIBICI | (GDL-177) C. Fray Fco Frejes / C. Fco Zarco,MIBICI | (GDL-178) C Salvador Quevedo/C López Portillo,MIBICI | (GDL-179) C. Monte Cáucaso / C. Sierra Nevada,MIBICI | (GDL-180) C. Montes Pirineos/Salvador Quevedo,MIBICI | (GDL-181) C.Ignacio Rmrz / Av Plan de San Lui,MIBICI | (GDL-182) C. General Coronado / C. Manuel Acu,MIBICI | (GDL-183) Calz. Independencia / Av. Niños Hér,MIBICI | (GDL-184) Ingreso Cucei / Revolución,MIBICI | (GDL-185) Dr. Silverio García /Av. Revolución,MIBICI | (GDL-186) C. Argentina / C. Francia,MIBICI | (GDL-187) Av. 16 de Septiembre / C. Priscilia,MIBICI | (GDL-188) Av. de la Presa / Av. Manuel A. Cam,MIBICI | (GDL-189) C. 5 de Mayo/ Av. Revolución,MIBICI | (GDL-190) C. Anahuac / Av. Revolución,MIBICI | (GDL-191) Plaza de los Mariachis,MIBICI | (GDL-192) Calle A1 / Av. Manuel A. Camacho,MIBICI | (GDL-193) C. Hawai / C. Nicolás Romero,MIBICI | (GDL-194) Av. Revolución / C. Manuel López Ve,MIBICI | (GDL-195) C. Ramón Corona / Av. Juárez,MIBICI | (GDL-196) C. Esmeralda / C. Manuel Acuña,MIBICI | (GDL-197) Av. Río Nilo / Av. Revolución,MIBICI | (GDL-198) Av. Alcalde / C. Hospital,MIBICI | (GDL-199) C. Jesús García/Av. Alcalde,MIBICI | (GDL-200) Av. Alcalde /Av. Manuel A. Camacho,MIBICI | (GDL-201) Av. de los Normalistas / C. M. Guti,MIBICI | (GDL-202) C. Magisterio / C. Durango,MIBICI | (GDL-203) Av. Federalismo / C. Tamaulipas,MIBICI | (GDL-204) C. España/ Av. Chapultepec,MIBICI | (GDL-205) Av. Agustín Yáñez /C. Venezuela,MIBICI | (GDL-206) C. Suiza / Av. Enrique Díaz de león,MIBICI | (GDL-207) C. Lázaro Pérez / C. Escorza,MIBICI | (GDL-208) Av. España / Av. Federalismo,MIBICI | (GDL-209) Calz. del Campesino / Calz. Indepen,MIBICI | (GDL-210) Av. Washington / Calz. Independenci,MIBICI | (GDL-211) Av. Washington / C. Rusia,MIBICI | (GDL-212) C. Nicolás Romero / C. Jaime Nunó,MIBICI | (TLQ-001) BlvrdGarcía Barragán/C. Río Tajo,MIBICI | (TLQ-002) C. Juárez / Av. Niños Héroes,MIBICI | (TLQ-003) C. Contreras Medellín/Donato Guerra,MIBICI | (TLQ-004) C. Donato Guerra / C. Obregón,MIBICI | (TLQ-005) C. Zalatitán / C. Jalisco,MIBICI | (TLQ-006) C. Miguel Hidalgo / Calz. Revolució,MIBICI | (TLQ-007) Blvrd.García Barragán/Donato Guerra,MIBICI | (TLQ-008) C. Juárez / C. Francisco de Miranda,MIBICI | (TLQ-009) C. Progreso / C. Juárez,MIBICI | (TLQ-010) C. Zaragoza / C. Emilio Carranza,MIBICI | (TLQ-011) C. Jalisco / C. Hidalgo,MIBICI | (TLQ-012) C. Paseo Don Bosco / C. Tonalá,MIBICI | (ZPN-001) Emilio Carranza /Carretera Tesistán,MIBICI | (ZPN-002) C. Emilio Carranza /C. Independenci,MIBICI | (ZPN-003) C. Emilio Carranza / Av. Hidalgo,MIBICI | (ZPN-005) C. Del Corral / C. Anáhuac,MIBICI | (ZPN-006) C. Independencia / C. Anáhuac,MIBICI | (ZPN-008) C. Vicente Guerrero / Av. Hidalgo,MIBICI | (ZPN-010) C. Ramón Corona / C. Cuauhtémoc,MIBICI | (ZPN-011) C. Pino Suárez / C. López Cotilla,MIBICI | (ZPN-012) C. Pino Suárez / Av. Juan Pablo II,MIBICI | (ZPN-013) C. Eva Briseño / C. Javier Mina,MIBICI | (ZPN-014) C. Juan Manuel / Pino Suárez,MIBICI | (ZPN-015) C. Sarcófago / C. Panteon,MIBICI | (ZPN-016) Av. Hidalgo/ C. Emiliano Zapata,MIBICI | (ZPN-017) C. Juan Manuel / C. Pedro Moreno,MIBICI | (ZPN-018) Av. Juan Pablo II / C. Santa Lucía,MIBICI | (ZPN-020) Av. Aurelio Ortega / Av. Laureles,MIBICI | (ZPN-021) Blvrd. Panamericano/ C.Santa Mónica,MIBICI | (ZPN-022) Av. Aurelio Ortega / C. Morelos*,MIBICI | (ZPN-023) Blvrd. de la Espuela / C. Silvano B,MIBICI | (ZPN-024) C. López Cotilla / C. del Estribo,MIBICI | (ZPN-025) C. Pedro Moreno / C. Jesus García,MIBICI | (ZPN-027) C. 5 de Mayo / C. Noviembre,MIBICI | (ZPN-028) C. Ejido / C. Sabino Delgado,MIBICI | (ZPN-029) C. La Villa / C. Cuauhtémoc,MIBICI | (ZPN-030) C. Francisco Sarabia / C. Libertad,MIBICI | (ZPN-031) C. Niño Obrero/Calz Lázaro Cárdenas,MIBICI | (ZPN-032) Calz Lázaro Cárdenas / Av San Fco,MIBICI | (ZPN-033) Av Lázaro Cárdenas / Av San Ignacio,MIBICI | (ZPN-034) C. San Demetrio / C. Niño Obrero,MIBICI | (ZPN-035) C. San Juan Bosco / Av. San Ignacio,MIBICI | (ZPN-036) C. Niño Obrero /C José María Robles,MIBICI | (ZPN-037) Av. San Ignacio / Av. Guadalupe,MIBICI | (ZPN-038) C. Santa Rita / Av. Guadalupe,MIBICI | (ZPN-039) Av. Niño Obrero / C. Juan Diego,MIBICI | (ZPN-040) C. Santa María / C. Árbol,MIBICI | (ZPN-041) C. 12 de Diciembre / C. Juan Diego,MIBICI | (ZPN-042) C. Tonatiuh / Av. Netzahualcóyotl,MIBICI | (ZPN-043) C. Ermita / C. Del Árbol,MIBICI | (ZPN-045) Av. Tizoc / C. Iztaccíhuatl,MIBICI | (ZPN-046) Av. Cubilete / Av. López Mateos,MIBICI | (ZPN-047) Av. Tizoc / Av. López Mateos,MIBICI | (ZPN-048) Av. J. Parres Arias / Prol. López C,MIBICI | (ZPN-049) Ávila Camacho/ Lábaro Patrio,MIBICI | (ZPN-050) C. el Mediero / Prol. Laureles,MIBICI | (ZPN-051) Av. Periférico G. Morín / Av. J. Pa,MIBICI | (ZPN-052) C. del Pial / C. del Vigía,MIBICI | (ZPN-053) Prol. Laureles / Av. Periférico G.,MIBICI | (ZPN-054) Av. J. Parres Arias / C. Ignacio Ja,MIBICI | (ZPN-055) Prol. Laureles / Av. J. Parres Aria,MIBICI | (ZPN-056) Av. Manuel A. Camacho / C. San Jorg,MOL Bubi | 0101-Batthyány tér,MOL Bubi | 0102-Szilágyi Dezső tér,MOL Bubi | 0103-Clark Ádám tér,MOL Bubi | 0104-Döbrentei tér,MOL Bubi | 0105-Déli pályaudvar,MOL Bubi | 0106-Krisztina tér,MOL Bubi | 0107-Alkotás utca - Márvány utca,MOL Bubi | 0201-Margit híd - Buda,MOL Bubi | 0202-Horvát utca,MOL Bubi | 0203-Bem József tér,MOL Bubi | 0204-Széna tér,MOL Bubi | 0205-Császár - Komjádi Uszoda,MOL Bubi | 0206-Fény utcai piac,MOL Bubi | 0207-Mechwart liget,MOL Bubi | 0208-Millenáris park - Fény utca,MOL Bubi | 0209-Margit körút - Tölgyfa utca,MOL Bubi | 0210-Széll Kálmán tér,MOL Bubi | 0211-Csalogány utca - Medve utca,MOL Bubi | 0212-Zsigmond tér,MOL Bubi | 0301-Kolosy tér,MOL Bubi | 0302-Szépvölgyi út H,MOL Bubi | 0303-Bécsi út - Óbudai Egyetem,MOL Bubi | 0304-Lajos utca - Nagyszombat utca,MOL Bubi | 0305-Szent Margit Kórház,MOL Bubi | 0306-Kiscelli utca - Zápor utca,MOL Bubi | 0501-Szent István körút - Vígszínház,MOL Bubi | 0502-Szalay utca - Falk Miksa utca,MOL Bubi | 0503-Bajcsy-Zsilinszky út - Kálmán Imre utca,MOL Bubi | 0504-Vécsey utca,MOL Bubi | 0505-Podmaniczky tér,MOL Bubi | 0506-Szabadság tér,MOL Bubi | 0507-Akadémia,MOL Bubi | 0508-Erzsébet tér,MOL Bubi | 0509-Apáczai Csere János utca,MOL Bubi | 0510-Dorottya utca - Wekerle Sándor utca,MOL Bubi | 0511-Vigadó tér,MOL Bubi | 0512-Vitkovics Mihály utca - Városház utca,MOL Bubi | 0513-Március 15. tér,MOL Bubi | 0514-Károlyi utca,MOL Bubi | 0515-Fővám tér,MOL Bubi | 0516-Ferenciek tere,MOL Bubi | 0517-Városháza Park,MOL Bubi | 0518-Deák tér,MOL Bubi | 0601-Teréz körút - Király utca,MOL Bubi | 0602-Hősök tere,MOL Bubi | 0603-Nyugati pályaudvar,MOL Bubi | 0604-Kodály körönd,MOL Bubi | 0605-Teréz körút - Szondi utca,MOL Bubi | 0606-Lövölde tér,MOL Bubi | 0607-Oktogon,MOL Bubi | 0608-Jókai utca - Zichy Jenő utca,MOL Bubi | 0609-Andrássy út - Nagymező utca,MOL Bubi | 0610-Andrássy út - Káldy Gyula utca,MOL Bubi | 0611-Nyugati tér,MOL Bubi | 0612-Városligeti fasor - Dózsa György út,MOL Bubi | 0613-Ferdinánd híd - Podmaniczky utca,MOL Bubi | 0614-Westend,MOL Bubi | 0701-Gozsdu udvar,MOL Bubi | 0702-Dózsa György út - Dembinszky utca,MOL Bubi | 0703-Garay tér,MOL Bubi | 0704-Klauzál tér,MOL Bubi | 0705-Erzsébet körút - Wesselényi utca,MOL Bubi | 0706-Rózsák tere,MOL Bubi | 0707-Kéthly Anna tér,MOL Bubi | 0708-Wesselényi utca - Síp utca,MOL Bubi | 0709-Rumbach Sebestyén utca - BKK,MOL Bubi | 0710-Almássy tér,MOL Bubi | 0711-Bethlen Gábor tér,MOL Bubi | 0712-Károly körút (Astoria M) - Zsinagóga,MOL Bubi | 0801-Gyulai Pál utca - Rákóczi út,MOL Bubi | 0802-Astoria,MOL Bubi | 0803-Kőfaragó utca - Vas utca,MOL Bubi | 0804-Rákóczi tér,MOL Bubi | 0805-Bródy Sándor utca - Múzeum körút,MOL Bubi | 0806-József körút - Baross utca,MOL Bubi | 0807-Mikszáth Kálmán tér,MOL Bubi | 0808-Keleti pályaudvar,MOL Bubi | 0809-Blaha Lujza tér,MOL Bubi | 0810-Horváth Mihály tér,MOL Bubi | 0811-II. János Pál Pápa tér M,MOL Bubi | 0812-Corvin sétány,MOL Bubi | 0901-Markusovszky tér,MOL Bubi | 0902-Üllői út - Ferenc Körút,MOL Bubi | 0903-Corvinus Egyetem,MOL Bubi | 0904-Boráros tér,MOL Bubi | 0905-Kálvin tér,MOL Bubi | 0906-Ferenc tér,MOL Bubi | 0907-SOTE - Vendel utca,MOL Bubi | 0908-Bakáts tér,MOL Bubi | 0909-MÜPA-Nemzeti Színház H,MOL Bubi | 0910-Népliget M (buszpályaudvar),MOL Bubi | 0911-Ráday utca - Kinizsi utca,MOL Bubi | 0912-MILL Park,MOL Bubi | 1101-Szent Gellért tér,MOL Bubi | 1102-Műegyetem,MOL Bubi | 1103-Gárdonyi tér,MOL Bubi | 1104-Petőfi híd - Buda,MOL Bubi | 1105-Kőrösy József utca,MOL Bubi | 1106-Budafoki út - Schönherz Kollégium,MOL Bubi | 1107-Móricz Zsigmond körtér,MOL Bubi | 1108-Pázmány Péter sétány - ELTE,MOL Bubi | 1109-Újbuda-központ M,MOL Bubi | 1110-Villányi út - Tas vezér utca,MOL Bubi | 1111-Kosztolányi Dezső tér,MOL Bubi | 1112-Bertalan Lajos utca - Stoczek utca,MOL Bubi | 1113-Villányi út - Karolina út,MOL Bubi | 1114-Moholy-Nagy Művészeti Egyetem,"MOL Bubi | 1115-Műegyetem, Q épület",MOL Bubi | 1116-Egry József utca,MOL Bubi | 1117-Műegyetem rakpart – R épület,MOL Bubi | 1118-Pázmány Péter sétány - Északi tömb,MOL Bubi | 1119-Infopark - aluljáró,MOL Bubi | 1201-BAH csomópont,MOL Bubi | 1202-MOM Park,MOL Bubi | 1203-Csörsz utca - MOM Kulturális Központ,MOL Bubi | 1204-Városmajor - Nyúl utca,MOL Bubi | 1205-Szilágyi Erzsébet fasor - Fogaskerekű,MOL Bubi | 1206-Szent János Kórház,MOL Bubi | 1301-Jászai Mari tér,MOL Bubi | 1302-Szent István park,MOL Bubi | 1303-Váci út - Victor Hugo utca,MOL Bubi | 1304-Margitsziget,MOL Bubi | 1305-Pannónia utca - Raoul Wallenberg utca,MOL Bubi | 1306-Váci út-Bulcsú utca,MOL Bubi | 1307-Dózsa György út M,MOL Bubi | 1308-Hajós Alfréd Uszoda,MOL Bubi | 1309-Palatinus Strand,MOL Bubi | 1310-Zenélőkút,MOL Bubi | 1311-Duna Aréna,MOL Bubi | 1312-Forgách utca M,MOL Bubi | 1313-Árpád-híd M Észak,MOL Bubi | 1314-Árpád-híd M-József Attila Színház,MOL Bubi | 1315-Párkány utca - Viza utca,MOL Bubi | 1316-Kárpát utca - Tisza utca,MOL Bubi | 1317-Népfürdő utca - Dunavirág utca,MOL Bubi | 1318-Gogol utca - Pozsonyi utca,MOL Bubi | 1319-Nordic Light Offices,MOL Bubi | 1320-Béke tér,MOL Bubi | 1321-Kassák Lajos utca,MOL Bubi | 1322-Rákosrendező vasútállomás,MOL Bubi | 1323-Hajdú utca - Szegedi út,MOL Bubi | 1324-Pap Károly utca,MOL Bubi | 1401-Széchenyi fürdő,MOL Bubi | 1402-Vágány utca-Róbert Károly körút,Malmö by bike | Bagers plats,Malmö by bike | Baltzargatan,Malmö by bike | Celsiusgatan 29,Malmö by bike | Davidhall,Malmö by bike | Engelbrektsgatan 13,Malmö by bike | Flensburgsgatan,Malmö by bike | Folkets park,Malmö by bike | Fridhemstorget,Malmö by bike | Gustav Adolfs Torg,Malmö by bike | Hästhagens Idrottsplats,Malmö by bike | Isbergs gata,Malmö by bike | Jörgen Kocksgatan,Malmö by bike | Klaffbron,Malmö by bike | Kronprinsen,Malmö by bike | Kungsgatan 1.3,Malmö by bike | Kungsgatan 6,Malmö by bike | Lantmannagatan,Malmö by bike | Lilla Varvsgatan 14,Malmö by bike | Malmö C Norra,Malmö by bike | Malmö C Södra,Malmö by bike | Malmö IP,Malmö by bike | Malmöhusvägen,Malmö by bike | Masttorget,Malmö by bike | Mobillia,Malmö by bike | Möllevångstorget,Malmö by bike | Nobeltorget,Malmö by bike | Nordenskiöldsgatan 8,Malmö by bike | Pildammsparken,Malmö by bike | Propellergatan 9,Malmö by bike | Raoul Wallenbergs park,Malmö by bike | Ribersborg Kallbadhus,Malmö by bike | Ribersborgsstigen,Malmö by bike | Rönneholmsparken,Malmö by bike | Sallerupsvägen 1,Malmö by bike | Saltimporten,Malmö by bike | Scaniabadet,Malmö by bike | Sevedsplan,Malmö by bike | Skvadronsgatan,Malmö by bike | Stadsbiblioteket,Malmö by bike | Stadshuset,Malmö by bike | Station Triangeln Norra,Malmö by bike | Station Triangeln Södra,Malmö by bike | Stora Nygatan 5,Malmö by bike | Storgatan 22,Malmö by bike | Stortorget,Malmö by bike | Södervärn Väste,Malmö by bike | Södervärn öster,Malmö by bike | Södra Förstadsgatan 54,Malmö by bike | Östergatan 1,Malmö by bike | Östra Promenaden 3,Malmö by bike | Östra Varvsgatan 9,Manerba in Bici | Aldo Moro,Manerba in Bici | Centro Sportivo,Manerba in Bici | Crociale,Manerba in Bici | Montinelle,Manerba in Bici | Porto Dusano,Manerba in Bici | Porto Torchio,Manerba in Bici | Romantica,Mar e Bici | Impianti Sportivi,Mar e Bici | Vittoria,Meglio in Bici | 25 Aprile - Pioltello,Meglio in Bici | Centro Sportivo - Cernusco,Meglio in Bici | Esselunga - Pioltello,Meglio in Bici | Municipio - Pioltello,Meglio in Bici | Stazione FFSS - Pioltello,Meglio in Bici | Viale Assunta - Cernusco,Meglio in Bici | Villa Fiorita - Cernusco,Meglio in Bici | Zona Industriale - Cernusco,Melbourne Bike Share | ACCA - Sturt St - Southbank,Melbourne Bike Share | ACU - Central Hall - Brunswick St - Fitzroy,Melbourne Bike Share | ANZ - Collins St - Docklands,Melbourne Bike Share | Aquarium - Kings Way / Flinders St - City,Melbourne Bike Share | Argyle Square - Lygon St - Carlton,Melbourne Bike Share | Arts Centre - St Kilda Road - City,Melbourne Bike Share | Beach St - Port Melbourne,Melbourne Bike Share | Bourke Street Mall - 205 Bourke St - City,Melbourne Bike Share | Bridport St / Montague St - Albert Park,Melbourne Bike Share | Cleve Gardens - Fitzroy St - St Kilda,Melbourne Bike Share | Coventry St / Clarendon St - South Melbourne,Melbourne Bike Share | Domain Interchange - Park St / St Kilda Rd - Melbourne,Melbourne Bike Share | Fitzroy Street - St Kilda,Melbourne Bike Share | Fitzroy Town Hall - Moor St - Fitzroy,Melbourne Bike Share | Flagstaff Gardens - Peel St - West Melbourne,Melbourne Bike Share | Gasworks Arts Park - Pickles St - Albert Park,Melbourne Bike Share | Harbour Town - Docklands Dve - Docklands,Melbourne Bike Share | Jolimont Station - Wellington Pde South - East Melbourne,Melbourne Bike Share | Kings Way / St Kilda Rd - Melbourne,Melbourne Bike Share | Luna Park - Lower Esp - St Kilda,Melbourne Bike Share | MSAC - Aughtie Dve - Albert Park,Melbourne Bike Share | Museum - Rathdowne St - Carlton,Melbourne Bike Share | NAB - Harbour Esp / Bourke St - Docklands,Melbourne Bike Share | New Quay Prom / Harbour Esp - Docklands,Melbourne Bike Share | North Melbourne Station - Adderley St - North Melbourne,Melbourne Bike Share | Parliament Station - Nicholson St / Albert St - City,Melbourne Bike Share | Pickles St / Ingles St - Port Melbourne,Melbourne Bike Share | Plum Garland Reserve - Beaconsfield Pde - Albert Park,Melbourne Bike Share | Prince Alfred Hotel - Grattan St - Carlton,Melbourne Bike Share | Queens Rd / Bowen Cres - Melbourne,Melbourne Bike Share | Queensbridge St / Yarra River - Southbank,Melbourne Bike Share | RACV - Bourke St / New Chancery Ln - City,Melbourne Bike Share | RMIT - Swanston St / Franklin St - City,Melbourne Bike Share | Richmond Station - Brunton Ave - East Melbourne,Melbourne Bike Share | Rod Laver Arena - Batman Ave / Swan St - City,Melbourne Bike Share | Sandridge Bridge - Southbank,Melbourne Bike Share | Siddeley St / Seafarers Bridge - Docklands,Melbourne Bike Share | South Melbourne Market - York St / Cecil St - South Melbourne,Melbourne Bike Share | Southern Cross Station - Spencer St - City,Melbourne Bike Share | Spring St / Collins St - City,Melbourne Bike Share | St Paul's Cathedral - Swanston St / Flinders St - City,Melbourne Bike Share | St Paul's Cathedral North - Swanston St - City,Melbourne Bike Share | State Library - Swanston St / Little Lonsdale St - City,Melbourne Bike Share | VCAM - St Kilda Rd / Southbank Blvd - Southbank,Melbourne Bike Share | Vic Barracks - Coventry St / St Kilda Rd - Southbank,Melbourne Bike Share | Victoria Market - Elizabeth St / Victoria St - City,Melbourne Bike Share | West Beach Pavilion - Beaconsfield Pde - St Kilda West,Melbourne Bike Share | Yarra's Edge - River Esp / Yarra River - Docklands,Melbourne Bike Share | Yarra's Point - Lorimer St / Yarra River - Docklands,Melbourne Bike Share | Yorkshire Brewery - Wellington St - Collingwood,Metro Bike Share | 11th & Maple,Metro Bike Share | 12th & Hill,Metro Bike Share | 17th St / SMC Expo Line Station,Metro Bike Share | 18th & Figueroa,Metro Bike Share | 18th & San Pedro,Metro Bike Share | 1st & Central,Metro Bike Share | 1st & Judge John Aiso,Metro Bike Share | 25th & Vermont,Metro Bike Share | 28th & Figueroa,Metro Bike Share | 28th & University,Metro Bike Share | 29th & Ellendale,Metro Bike Share | 2nd & Figueroa,Metro Bike Share | 2nd & Hill,Metro Bike Share | 32nd & Figueroa,Metro Bike Share | 3rd & San Pedro,Metro Bike Share | 3rd & Santa Fe,Metro Bike Share | 4th & Vermont,Metro Bike Share | 5th & Grand,Metro Bike Share | 5th & Hewitt,Metro Bike Share | 7th & Berendo,Metro Bike Share | 7th & Bixel,Metro Bike Share | 7th & Broadway,Metro Bike Share | 7th & Flower,Metro Bike Share | 7th & Park View,Metro Bike Share | 7th & Spring,Metro Bike Share | 7th & Westminster,Metro Bike Share | 8th & Vermont,Metro Bike Share | 8th & Wall,Metro Bike Share | 9th & Los Angeles,Metro Bike Share | Abbot Kinney & Cadiz,Metro Bike Share | Albany & Olympic,Metro Bike Share | Anaheim & Avalon,Metro Bike Share | Bagley & Venice,Metro Bike Share | Banning's Landing,Metro Bike Share | Barrington & National,Metro Bike Share | Berendo & Olympic,Metro Bike Share | Broadway & 3rd,Metro Bike Share | Broadway & 9th,Metro Bike Share | Cabrillo Beach,Metro Bike Share | California & Lincoln,Metro Bike Share | Catalina Express,Metro Bike Share | Centinela & Lucile,Metro Bike Share | Crafted 22nd St Park,Metro Bike Share | DoubleTree Hotel,Metro Bike Share | Downtown Harbor,Metro Bike Share | Downtown Santa Monica Expo Line Station,Metro Bike Share | Durango & Venice,Metro Bike Share | Expo Park/LAFC,Metro Bike Share | Expo/Sepulveda Expo Line Station,Metro Bike Share | Factory Place & Alameda,Metro Bike Share | Fanfare Fountain,Metro Bike Share | Figueroa & 8th,Metro Bike Share | Figueroa & 9th,Metro Bike Share | Figueroa & Cesar Chavez,Metro Bike Share | Figueroa & McCarthy Way,Metro Bike Share | Figueroa & Pico,Metro Bike Share | Grand & 14th,Metro Bike Share | Grand & 3rd,Metro Bike Share | Grand & 7th,Metro Bike Share | Grand & Olympic,Metro Bike Share | Grand & Temple,Metro Bike Share | Grand & Washington,Metro Bike Share | Grand / LATTC,Metro Bike Share | Hill & College,Metro Bike Share | Hill & Washington,Metro Bike Share | Hoover & 29th,Metro Bike Share | Hoover & 32nd,Metro Bike Share | Hope & 11th,Metro Bike Share | Hope & 1st,Metro Bike Share | Hope & 6th,Metro Bike Share | Hope & Olympic,Metro Bike Share | Imperial & 7th,Metro Bike Share | Industrial St & Mateo St,Metro Bike Share | Inglewood & Ballona,Metro Bike Share | Inglewood & Braddock,Metro Bike Share | Kenmore & 3rd,Metro Bike Share | Kenmore & 6th,Metro Bike Share | Los Angeles & Temple,Metro Bike Share | Main & 1st,Metro Bike Share | Main & 4th,Metro Bike Share | Main & 5th,Metro Bike Share | Main & 6th,Metro Bike Share | Main & 9th,Metro Bike Share | Mar Vista Rec Center,Metro Bike Share | Maubert & Vermont,Metro Bike Share | Maxella & Del Ray,Metro Bike Share | McLaughlin & Venice,Metro Bike Share | National & Motor,Metro Bike Share | New High & Ord,Metro Bike Share | Newton & Central,Metro Bike Share | Ocean Front Walk & Navy,Metro Bike Share | Ocean Front Walk & North Venice,Metro Bike Share | Olive & 5th,Metro Bike Share | Olive & 8th,Metro Bike Share | Pacific & North Venice,Metro Bike Share | Palms & Kelton,Metro Bike Share | Palms & Motor,Metro Bike Share | Palms & National,Metro Bike Share | Park & Echo Park,Metro Bike Share | Pico & Flower,Metro Bike Share | Ports O'Call,Metro Bike Share | Public Bike Rack: Culver City Expo Line,Metro Bike Share | Public Bike Rack: Westwood/Rancho Park Expo Line,Metro Bike Share | Rose & 7th,Metro Bike Share | Rose & Main,Metro Bike Share | Rose & Rennie,Metro Bike Share | Row DTLA,Metro Bike Share | Sepulveda & Charnock,Metro Bike Share | Sepulveda & Lucerne,Metro Bike Share | Sepulveda & National,Metro Bike Share | Sepulveda & Palms,Metro Bike Share | Sepulveda & Venice,Metro Bike Share | Severance & Adams,Metro Bike Share | Shatto Pl & Wilshire,Metro Bike Share | Spring & 3rd,Metro Bike Share | Spring & College,Metro Bike Share | Stanford & 12th,Metro Bike Share | Sunset & Virgil,Metro Bike Share | Temple & Vignes,Metro Bike Share | Traction & Rose,Metro Bike Share | USS IOWA,Metro Bike Share | Union & 7th,Metro Bike Share | Union & Olympic,Metro Bike Share | Union Station West Portal,Metro Bike Share | University & Hoover,Metro Bike Share | Venice & Beethoven,Metro Bike Share | Venice & Clarington,Metro Bike Share | Venice & Colonial,Metro Bike Share | Venice & Glendon,Metro Bike Share | Venice & Hughes,Metro Bike Share | Venice & Inglewood,Metro Bike Share | Venice & Lincoln,Metro Bike Share | Venice & Motor,Metro Bike Share | Venice & Sawtelle,Metro Bike Share | Venice & Walgrove,Metro Bike Share | Vermont & Beverly,Metro Bike Share | Vermont Pl & Vermont,Metro Bike Share | Washington & Abbot Kinney,Metro Bike Share | Waterfront Park (East),Metro Bike Share | Waterfront Park (West),Metro Bike Share | Westlake & 3rd,Metro Bike Share | Westlake/Macarthur Park Station,Metro Bike Share | Westlawn & Beatrice,Metro Bike Share | Westwood & National,Metro Bike Share | Willow St & Mateo St,Metro Bike Share | Wilshire & Witmer,Metro Bike Share | Windward & Main,Mi Muovo in Bici | 01. Duc,Mi Muovo in Bici | 01. Parcheggio Cecati,Mi Muovo in Bici | 01. Stazione FF.SS.,Mi Muovo in Bici | 01. Stazione FS,Mi Muovo in Bici | 02. Arco d'Augusto,Mi Muovo in Bici | 02. Ospedale Maggiore,Mi Muovo in Bici | 02. Parcheggio Gasometro,Mi Muovo in Bici | 02. Parcheggio viale Malta,Mi Muovo in Bici | 02. Vittoria,Mi Muovo in Bici | 03. Domus del chirurgo,Mi Muovo in Bici | 03. Stazione Trenitalia,Mi Muovo in Bici | 03. Traversetolo,Mi Muovo in Bici | 03. Universita` Cattolica,Mi Muovo in Bici | 03. Vittorio Veneto,Mi Muovo in Bici | 04. Campus Chimica,Mi Muovo in Bici | 04. Don Andreoli,Mi Muovo in Bici | 04. Mercato coperto,Mi Muovo in Bici | 04. Piazza Cavalli,Mi Muovo in Bici | 04. Piazza Saffi,Mi Muovo in Bici | 05. Municipio,Mi Muovo in Bici | 05. San Domenico,Mi Muovo in Bici | 05. Stazione FF.SS.,Mi Muovo in Bici | 06. Park dell'Argine,Mi Muovo in Bici | 06. Piazzale Kennedy,Mi Muovo in Bici | 06. Ponte di Mezzo,Mi Muovo in Bici | 06. Roversi,Mi Muovo in Bici | 07. Fontana dei quattro cavalli,Mi Muovo in Bici | 07. Gioberti,Mi Muovo in Bici | 07. Park Schiavonia,Mi Muovo in Bici | 07. Santa Croce,Mi Muovo in Bici | 08. Bixio,Mi Muovo in Bici | 08. Ospedale Morgagni Pierantoni,Mi Muovo in Bici | 08. Parcheggio Caserma Zucchi,Mi Muovo in Bici | 08. Piazzale Boscovich,Mi Muovo in Bici | 09. Campus Universitario I,Mi Muovo in Bici | 09. Castello Malatestiano,Mi Muovo in Bici | 09. Farini,Mi Muovo in Bici | 09. Vittoria,Mi Muovo in Bici | 1. Stazione  FF.SS.,Mi Muovo in Bici | 10. Barilla Center,Mi Muovo in Bici | 10. Park Oriani,Mi Muovo in Bici | 10. San Pietro,Mi Muovo in Bici | 11. Campus Universitario II,Mi Muovo in Bici | 11. Dus,Mi Muovo in Bici | 11. Parcheggio Polveriera,Mi Muovo in Bici | 12. Barezzi,Mi Muovo in Bici | 12. Parcheggio Ex Foro Boario,Mi Muovo in Bici | 13. Borgo XX Marzo,Mi Muovo in Bici | 13. Ospedale S. M. Nuova,Mi Muovo in Bici | 14. Garibaldi,Mi Muovo in Bici | 14. Guidelli,Mi Muovo in Bici | 15. CIM - Centro Interscambio Mobilita`,Mi Muovo in Bici | 15. Repubblica,Mi Muovo in Bici | 16. Parcheggio Funakoshi,Mi Muovo in Bici | 16. Toschi,Mi Muovo in Bici | 17. Rondani,Mi Muovo in Bici | 18. Crocetta,Mi Muovo in Bici | 19. Boito,Mi Muovo in Bici | 2. Poste Centrali,Mi Muovo in Bici | 20. Efsa,Mi Muovo in Bici | 21. Kennedy,Mi Muovo in Bici | 22. Cittadella,Mi Muovo in Bici | 23. Vittoria,Mi Muovo in Bici | 24. Campus,Mi Muovo in Bici | 25. Ospedale - viale Osacca,Mi Muovo in Bici | 26. Palasport,Mi Muovo in Bici | 27. Ostello Gioventu`,Mi Muovo in Bici | 28. Bizzozero,Mi Muovo in Bici | 29. Villetta,Mi Muovo in Bici | 3. Cinema Boldini,Mi Muovo in Bici | 30. Auditorium Paganini,Mi Muovo in Bici | 31. Lauro Grossi,Mi Muovo in Bici | 32. Stadio,Mi Muovo in Bici | 33. Cavagnari,Mi Muovo in Bici | 4.Rettorato Universita`,Mi Muovo in Bici | 5. Castello Estense,Mi Muovo in Bici | 6. Polo Chimico Bio Medico,Mi Muovo in Bici | 7. Dipartimento di Architettura,Mi Muovo in Bici | 8. Polo Scientifico-Tecnologico,Mi Muovo in Bici | Arceto,Mi Muovo in Bici | Biagi,Mi Muovo in Bici | Biblioteca Comunale,Mi Muovo in Bici | Cinema,Mi Muovo in Bici | Istituto Gobetti,Mi Muovo in Bici | Pratissolo,Mi Muovo in Bici | Stazione FF.SS.,Mi Muovo in Bici | Stazione FFSS,Mi Muovo in Bici | Stazione Ferroviaria,Mi Muovo in bici | 01. Stazione FF.SS.,Mi Muovo in bici | 01. Stazione FF.SS. Imola,Mi Muovo in bici | 02. Area Blu,Mi Muovo in bici | 02. Matteotti,Mi Muovo in bici | 03. Emilia Est,Mi Muovo in bici | 03. Terminal Bus,Mi Muovo in bici | 04. Campanella,Mi Muovo in bici | 05. Ospedale Vecchio,Mi Muovo in bici | 06. Zolino,Mi Muovo in bici | 07. Pedagna Ovest,Mi Muovo in bici | 08. Guicciardini,Mi Muovo in bici | 09. Santa Maria della Scaletta,Mi Muovo in bici | 1. Stazione FS,Mi Muovo in bici | 10. Cogne,Mi Muovo in bici | 2. Karl Marx,Mi Muovo in bici | 3. Bufalini,Mi Muovo in bici | 4. IX Febbraio,Mi Muovo in bici | 5. Sanguinetti,MoBike | 1. Matitone,MoBike | 10. Vittorio Veneto,MoBike | 11. Stadio,MoBike | 12. Fiumara,MoBike | 13. Di Negro,MoBike | 14. Darsena,MoBike | 15. Marina,MoBike | 16. Rossetti,MoBike | 17. Raggi,MoBike | 2. Principe,MoBike | 3. Caricamento,MoBike | 4. De Ferrari,MoBike | 5. San Vincenzo,MoBike | 6. Brignole,MoBike | 7. Zecca,MoBike | 8. Questura,MoBike | 9. San Benigno,Mobi | 0001 10th & Cambie,Mobi | 0002 Burrard Station,Mobi | 0004 Yaletown-Roundhouse Station,Mobi | 0005 Dunsmuir & Beatty,Mobi | 0006 Olympic Village Station,Mobi | 0007 12th & Yukon,Mobi | 0008 8th & Ash,Mobi | 0009 Spyglass & Seawall,Mobi | 0010 Stamp's Landing,Mobi | 0011 Ontario & Seawall,Mobi | 0012 Dunsmuir & Richards,Mobi | 0014 Canada Place,Mobi | 0015 Granville & Georgia,Mobi | 0016 Pender & Burrard,Mobi | 0017 Marinaside & Davie,Mobi | 0019 Robson & Hornby,Mobi | 0021 Cordova & Granville,Mobi | 0024 Hornby & Pender,Mobi | 0025 Homer & Robson,Mobi | 0026 Beatty & Robson,Mobi | 0027 Beatty & Nelson,Mobi | 0030 Abbott & Cordova,Mobi | 0032 Comox & Denman,Mobi | 0033 Robson & Denman,Mobi | 0034 Cordova & Bute,Mobi | 0035 Coal Harbour Community Centre,Mobi | 0036 Bute & Robson,Mobi | 0037 Hornby & Nelson,Mobi | 0039 Helmcken & Burrard,Mobi | 0040 Cardero & Pendrell,Mobi | 0041 Cardero & Robson,Mobi | 0044 Pacific & Richards,Mobi | 0047 Chilco & Beach,Mobi | 0048 Comox & Broughton,Mobi | 0050 Bute & Comox,Mobi | 0052 Cambie & Water,Mobi | 0053 Keefer & Abbott,Mobi | 0054 Expo & Carrall,Mobi | 0055 Keefer & Columbia,Mobi | 0057 Marinaside & Cooperage,Mobi | 0058 Homer & Smithe,Mobi | 0060 Bidwell & Burnaby,Mobi | 0063 Robson & Granville,Mobi | 0064 Expo & Smithe,Mobi | 0065 Cypress & Cornwall,Mobi | 0066 Anderson & 2nd,Mobi | 0068 Cypress & Broadway,Mobi | 0069 7th & Granville,Mobi | 0070 10th & Granville,Mobi | 0071 14th & Granville,Mobi | 0072 14th & Cambie,Mobi | 0073 Ontario & 5th,Mobi | 0074 10th & Main,Mobi | 0076 Cypress & 4th,Mobi | 0077 Vanier Park,Mobi | 0078 Nelson & Mainland,Mobi | 0079 Nelson & Richards,Mobi | 0080 Laurel & Broadway,Mobi | 0081 7th & Heather,Mobi | 0082 Richards & Davie,Mobi | 0083 Aquatic Centre,Mobi | 0084 Sunset Beach West,Mobi | 0087 Broughton & Burnaby,Mobi | 0088 Harwood & Bute,Mobi | 0089 Burrard & Drake,Mobi | 0092 Chilco & Barclay,Mobi | 0093 Chilco & Robson,Mobi | 0096 Nicola & Robson,Mobi | 0098 Carrall & Hastings,Mobi | 0099 Vancouver Art Gallery - North Plaza,Mobi | 0101 Stanley Park - Vancouver Aquarium,Mobi | 0102 Stanley Park - Second Beach North,Mobi | 0103 Stanley Park - Third Beach Parking Lot,Mobi | 0104 Stanley Park - Second Beach South,Mobi | 0105 Stanley Park - Totem Poles,Mobi | 0106 Heather & 14th,Mobi | 0107 8th & Ontario,Mobi | 0108 1st & Chestnut,Mobi | 0109 7th & Arbutus,Mobi | 0110 5th & Arbutus,Mobi | 0112 10th & Oak,Mobi | 0113 Arbutus & 16th,Mobi | 0114 Cypress & 14th,Mobi | 0115 Cypress & 16th,Mobi | 0119 3rd & Quebec,Mobi | 0123 Georgia & Thurlow,Mobi | 0125 Hamilton & Robson,Mobi | 0126 Thurlow & Pendrell,Mobi | 0129 Richards & Robson,Mobi | 0130 Heather & 16th,Mobi | 0132 14th & Ontario,Mobi | 0133 Ontario & 16th,Mobi | 0134 14th & Main,Mobi | 0136 David Lam Park - West,Mobi | 0137 Beach & Seymour,Mobi | 0138 Richards & Helmcken,Mobi | 0139 Burrard & 4th,Mobi | 0140 Burrard & 7th,Mobi | 0143 South False Creek Seawall,Mobi | 0147 Chestnut & McNicoll,Mobi | 0148 Creekside Park North,Mobi | 0150 Alexander & Main,Mobi | 0152 Arbutus Greenway & 14th,Mobi | 0153 Arbutus Greenway & Fir,Mobi | 0154 Kitsilano Beach Park,Mobi | 0155 Arbutus & McNicoll,Mobi | 0159 Vine & 4th,Mobi | 0161 Alexander & Dunlevy,Mobi | 0165 Columbia & 4th,Mobi | 0166 Alder & 11th,Mobi | 0167 Cordova & Columbia,Mobi | 0171 5th & Yukon,Mobi | 0172 10th & Columbia,Mobi | 0173 1st & Columbia,Mobi | 0174 1st & Manitoba,Mobi | 0176 10th & Ontario,Mobi | 0177 Quebec & 1st,Mobi | 0179 11th & Kingsway,Mobi | 0180 Columbia & 14th,Mobi | 0187 Bute & Davie,Mobi | 0190 Melville & Bute,Mobi | 0191 7th & Laurel,Mobi | 0192 7th &  Alder,Mobi | 0193 Science World,Mobi | 0196 Drake & Hornby,Mobi | 0197 1st & Scotia,Mobi | 0198 6th & Main,Mobi | 0199 Georgia & Main,Mobi | 0201 Shaw Tower,Mobi | 0202 14th & Oak,Mobi | 0203 Pine & 14th,Mobi | 0204 York & Yew,Mobi | 0205 Pine & 10th,Mobi | 0206 8th & Scotia,Mobi | 0207 Alberni & Jervis,Mobi | 0208 Arbutus Greenway & Broadway,Mobi | 0209 Stanley Park - Information Booth,Mobi | 0211 14th & Alder,Mobi | 0213 Pender & Gore,Mobi | 0218 Carrall & Seawall,Mobi | 0221 Glen & Union,Mobi | 0222 Adanac & McLean,Mobi | 0223 Commercial & Adanac,Mobi | 0224 Pender & Commercial,Mobi | 0225 McLean & Pender,Mobi | 0227 Campbell & Hastings,Mobi | 0229 Keefer & Princess,Mobi | 0230 Alexander & Railway,Mobi | 0231 Napier & Commercial,Mobi | 0232 Britannia Parking Lot,Mobi | 0233 Thornton & National,Mobi | 0234 Station & National,Mobi | 0235 Charles & Commercial,Mobi | 0236 Keith & 6th,Mobi | 0237 Glen & 6th,Mobi | 0238 Thornton & 1st,Mobi | 0239 Grant & Commercial,Mobi | 0240 2nd & Commercial,Mobi | 0241 4th & Commercial,Mobi | 0242 8th & Commercial,Mobi | 0244 10th & Commercial,Mobi | 0245 Woodland & 10th,Mobi | 0246 Glen & Broadway,Mobi | 0248 St George & Broadway,Mobi | 0249 7th & Woodland,Mobi | 0250 Woodland & 4th,Mobi | 0252 Woodland & Graveley,Mobi | 0253 Charles & Woodland,Mobi | 0254 Grandview Bike Lane & Commercial,Mobi | 0255 18th & Main,Mobi | 0256 Prince Edward & 16th,Mobi | 0257 Prince Edward & 14th,Mobi | 0258 13th & St George,Mobi | 0260 10th & Fraser,Mobi | 0261 8th & Fraser,Mobi | 0262 8th & Prince Edward,Mobi | 0265 St Catherines & 10th,Mobi | 0266 St Catherines & 7th,Mobi | 0272 Pender & Victoria,Mobi | 0273 Victoria & 4th,Mobi | 0274 Victoria & 10th,Mobi | 0278 15th & Victoria,Mobi | 0280 Triumph & Victoria,Mobi | 0281 Windsor & 14th,Mobi | 0282 14th & Fraser,Mobi | 0283 15th & Knight,Mobi | 0285 Commercial & Pandora,Mobi | 0287 Carolina & Great Northern Way,Mobi | 0297 6th & Prince Edward,Mobi | 0298 6th & Carolina,Monash BikeShare | 16 Rainforest Walk,Monash BikeShare | 211 Wellington Rd,Monash BikeShare | 24 Research Way,Monash BikeShare | 25 Rainforest Walk,Monash BikeShare | 321 Ferntree Gully,Monash BikeShare | 35 Rainforest Walk,Monash BikeShare | 5 Rainforest Walk - Car Park N1,Monash BikeShare | 700 Blackburn Rd,Monash BikeShare | 738 Blackburn Rd,Monash BikeShare | 738 Blackburn Rd - Car Park,Monash BikeShare | Biomedical Sciences,Monash BikeShare | Biotechnology E,Monash BikeShare | Biotechnology W,Monash BikeShare | Briggs Hall,Monash BikeShare | Bus Loop W,Monash BikeShare | Campbell Hall E,Monash BikeShare | Campbell Hall S,Monash BikeShare | Campbell Hall W,Monash BikeShare | Campus Centre N,Monash BikeShare | Campus Centre S,Monash BikeShare | Campus Centre W,Monash BikeShare | Car Park OC1 West at 800 Blackburn Rd,Monash BikeShare | Car Park OC1 at 800 Blackburn Rd,Monash BikeShare | Childcare,Monash BikeShare | Deakin Hall,Monash BikeShare | Earth Sciences,Monash BikeShare | Education,Monash BikeShare | Engineering N,Monash BikeShare | Engineering NE,Monash BikeShare | Engineering S,Monash BikeShare | Engineering SE,Monash BikeShare | Engineering W,Monash BikeShare | Farrer Hall,Monash BikeShare | Green Chemical Futures,Monash BikeShare | Halls,Monash BikeShare | Hargrave-Andrew Library,Monash BikeShare | Information Technology N,Monash BikeShare | Information Technology S,Monash BikeShare | Innovation Walk S,Monash BikeShare | MSI,Monash BikeShare | Mannix College,Monash BikeShare | Medicine Offices - East,Monash BikeShare | Medicine Offices - North,Monash BikeShare | Menzies E,Monash BikeShare | Menzies W,Monash BikeShare | Monash Biomedical Imaging,Monash BikeShare | Monash College W,Monash BikeShare | Monash Nanofabrication,Monash BikeShare | Monash Sport,Monash BikeShare | Normanby House,Monash BikeShare | Normanby House W,Monash BikeShare | Physics,Monash BikeShare | Richardson Hall,Monash BikeShare | Robert Blackwood,Monash BikeShare | Roberts Hall,Monash BikeShare | Scenic Blvd S,Monash BikeShare | South East Flats,Monash BikeShare | Sports Walk E,Monash BikeShare | Teaching and Learning S,Monash BikeShare | Turner Hall,Monash BikeShare | Youlendj Hub,Monopoli BIKE | Area Fitness,Monopoli BIKE | Capitolo,Monopoli BIKE | Polo Liceale,Monopoli BIKE | Stazione Ferroviaria,Monopoli BIKE | Vittorio Emanuele,Monopoli BIKE | Vittorio Veneto,Nextbike | (inoff) Rembrandtstraße & Berliner Straße,Nextbike | 1,Nextbike | 1 Hastings st,Nextbike | 10,Nextbike | 10vorWien / Strebersdorferhof,Nextbike | 11,Nextbike | 12,Nextbike | 14,Nextbike | 15,Nextbike | 16,Nextbike | 18,Nextbike | 19,Nextbike | 2,Nextbike | 20,Nextbike | 21,Nextbike | 22,Nextbike | 23,Nextbike | 24,Nextbike | 26,Nextbike | 27,Nextbike | 29,Nextbike | 3,Nextbike | 31,Nextbike | 32,Nextbike | 33,Nextbike | 34,Nextbike | 35,Nextbike | 36,Nextbike | 37,Nextbike | 38,Nextbike | 39,Nextbike | 4,Nextbike | 40,Nextbike | 41,Nextbike | 42,Nextbike | 43,Nextbike | 44,Nextbike | 45,Nextbike | 46,Nextbike | 47,Nextbike | 48,Nextbike | 5,Nextbike | 5181 Bertramstraße (Campus),Nextbike | 6,Nextbike | 7,Nextbike | 750 Pandora,Nextbike | 8,Nextbike | 9,Nextbike | A Themistokleous,Nextbike | A.ÖZCAN CAD.ZAFER İ.Ö.O.ÖNÜ,Nextbike | A1 kampus (SAMO ZA ZAPOSLENIKE),Nextbike | ALAADDİN BULVARI İŞ BANKASI ÖNÜ,Nextbike | ALAADDİN KAP CAD.K.T.O. ONU,Nextbike | ALSO,Nextbike | ALTA Shopping Centar,Nextbike | ASTO Park,Nextbike | Abraham-Lincoln-Park,Nextbike | Achermann Sport / Engelbergstrasse 37A,Nextbike | Ackerstr.,Nextbike | Adamsdown - Clifton Street,Nextbike | Adina Apartment Hotel Hamburg Michel,Nextbike | Agentur für Arbeit Kassel,Nextbike | Aggsbach Dorf/ Parkplatz - Info,Nextbike | Aggsbach Markt/ Freizeitzentrum,Nextbike | Airport Terminal One,Nextbike | Albrecht-Achilles-Straße,"Nextbike | Alexander Court Residences, University of Stirling",Nextbike | Alexandra Parade (West),Nextbike | Alexandra Park (south entrance) Alexandra Parade Railway Station,Nextbike | Allmend / Horwerstrasse 85,Nextbike | Alp Betagtenzentrum,Nextbike | Alpenquai 42,Nextbike | Alsterufer / Cliff Restaurant,Nextbike | Alsterufer / Ecke Alte Rabenstraße,Nextbike | Alt Waldau,Nextbike | Alte Kasseler Straße/Jägertunnel,Nextbike | Alte Mainbrücke,Nextbike | Alter Domus,Nextbike | Alter Friedhof,Nextbike | Altes Rathaus,Nextbike | Am Friedrichshain,Nextbike | Am Heimbach,Nextbike | Am Krekel/Stadtwerke Marburg,Nextbike | Am Köllnischen Park,Nextbike | Am Plan/Wirtschaftswissenschaften,Nextbike | Am Schülerpark,Nextbike | Am Stadtgarten,Nextbike | Am Tempelhofer Feld,Nextbike | Am Wasserturm,Nextbike | Amathus,Nextbike | Amstetten / BHF Greinsfurth,Nextbike | Amstetten / BHF Mauer,Nextbike | Amstetten / Bahnhof,Nextbike | Amstetten / Hauptplatz,Nextbike | Amstetten / Landesberufsschule WkNÖ,Nextbike | Amstetten / Landesklinikum,Nextbike | Amstetten / Landesklinikum Mauer,Nextbike | An den Siechengärten,Nextbike | Anatomie,Nextbike | Andreasstraße,Nextbike | Anklamerstr./Fehrberllinerstr.,Nextbike | Annastraße,Nextbike | Ansbacher Straße,Nextbike | Anton-Saefkow-Platz,Nextbike | Antwerpener Straße,Nextbike | Aphrodite hills Village Square,Nextbike | Aquamar,Nextbike | Aquarium,Nextbike | Ara City Campus,Nextbike | Ara Woolston Campus,Nextbike | Arena Centar,Nextbike | Argent Court,Nextbike | Argyle Street Railway Station,Nextbike | Arkadiia (main entrance),Nextbike | Arkonaplatz,Nextbike | Armonia,Nextbike | Arndtstraße / Platenstraße,Nextbike | Arriba Erlebnisbad,Nextbike | Arriva Limburg,Nextbike | Arthur Vick 1,Nextbike | Arthur Vick 2,Nextbike | Athinon 1,Nextbike | Atlantic / Holzdamm,Nextbike | Atrium 2,Nextbike | Atrium 3,Nextbike | Audimax,Nextbike | Auebad,Nextbike | Auestadion,Nextbike | August 23 str/Nauky ave.,Nextbike | Avaz Twist Tower,Nextbike | Avenue Mall,Nextbike | Axetris AG,Nextbike | B&B Hotel Hamburg Altona,Nextbike | B&B Hotel Hamburg Nord,Nextbike | BBI centar,Nextbike | BEYŞEHİR CAD.BAŞKENT HASTANESİ KARŞISI,Nextbike | BEYŞEHİR CAD.DEDEMAN OTEL ÖNÜ,Nextbike | BKS Bank St.VeiterRing,Nextbike | BTC Merkur Otoka,Nextbike | Bad Deutschaltenburg / Bahnhof,Nextbike | Bad Deutschaltenburg / Museum Carnuntinum,Nextbike | Bad Vöslau / Bahnhof,Nextbike | Bad Vöslau / Schlossplatz,Nextbike | Baden / BH,Nextbike | Baden / Bahnhof,Nextbike | Baden / Tourismusinfo Römertherme,Nextbike | Baerwaldstraße,Nextbike | Bahnhof,Nextbike | Bahnhof / Gleis 1,Nextbike | Bahnhof / Osteingang,Nextbike | Bahnhof / Stadtverwaltung,Nextbike | Bahnhof / ZOB,Nextbike | Bahnhof Alpnach Dorf/Bahnhofplatz,Nextbike | Bahnhof Alpnachstad/Bahnhofplatz,Nextbike | Bahnhof Altona / Ausgang Hauptstraße,Nextbike | Bahnhof Altona / Reisezentrum,Nextbike | Bahnhof BWZ/Grundacherweg 6,Nextbike | Bahnhof Beuel,Nextbike | Bahnhof Charlottenhof,Nextbike | Bahnhof Dallenwil,Nextbike | Bahnhof Dammtor / Ausgang Dag-Hammarskjoeld-Platz,Nextbike | Bahnhof Dorf,Nextbike | Bahnhof Duisdorf,Nextbike | Bahnhof Godesberg,Nextbike | Bahnhof Golm,Nextbike | Bahnhof Griebnitzsee,Nextbike | Bahnhof Lienewitz,Nextbike | Bahnhof Medienstadt,Nextbike | Bahnhof Mehlem,Nextbike | Bahnhof Michendorf,Nextbike | Bahnhof Nord / Bahnhofstrasse,Nextbike | Bahnhof Nordseite,Nextbike | Bahnhof Oberkassel,Nextbike | Bahnhof Pirschheide,Nextbike | Bahnhof Sanssouci,Nextbike | Bahnhof Sarnen Nord,Nextbike | Bahnhof Süd / Bahnhofstrasse,Nextbike | Bahnhof Süd / Seerosenstrasse,Nextbike | Bahnhof Südseite,Nextbike | Bahnhof Werder,Nextbike | Bahnhof West,Nextbike | Bahnhof Wilhelmshorst,Nextbike | Bahnhof/ Bahnhofstr.,Nextbike | Bahnhofplatz,Nextbike | Bahnhofstr. / Erlengang,Nextbike | Bahnhofstr./ Priestergasse,Nextbike | Ballindamm / Kunsthalle,Nextbike | Bannockburn Town Centre,Nextbike | Barbarossaplatz / Theaterstraße,Nextbike | Barbarossastraße/ Speyerer Straße,Nextbike | Bargoed Street -Corporation Road,Nextbike | Barrowlands,Nextbike | Battlefield,Nextbike | Bayernring,Nextbike | Bayreuther Straße,Nextbike | Bellgrove Railway Station (North),Nextbike | Bergstraße,Nextbike | Berliner Str. / Ecke Münsterstr.,Nextbike | Bertelsmann,Nextbike | Besucherzentrum,Nextbike | Betriebshof Wilhelmshöhe,Nextbike | Beuel Krankenhaus,Nextbike | Biedermannsdorf / Jubiläumshalle,Nextbike | Biedermannsdorf / Laxenburgerstraße /Ortstraße,Nextbike | Biegenstraße/Cineplex,Nextbike | Biegenstraße/Volkshochschule,Nextbike | Bielen/ Geissmattli 2,Nextbike | Biesbosch / Baanhoekweg,Nextbike | Biesboschcentrum,Nextbike | Birkirkara Road,Nextbike | Bisazza,Nextbike | Bitzighofen/ Bitzighofenstr.9,Nextbike | Bleicherstrasse 10,Nextbike | Blue Sisters,Nextbike | Bluebell Residences,Nextbike | Blücherplatz,Nextbike | Bonn Information,Nextbike | Bonner Bogen,Nextbike | Borestone Roundabout,Nextbike | Boschstraat,Nextbike | Botanic Gardens,Nextbike | Boutique-Hotel Schlüssel,Nextbike | Brachdy Road Rumney,Nextbike | Brachvogelstraße,Nextbike | Brandgasse,Nextbike | Breite Straße,Nextbike | Breitenhaus / Buochserstrasse 1,Nextbike | Bridge Street Subway,Nextbike | Bridge of Allan,Nextbike | Bridge of Allan Train Station,Nextbike | Bridgeton,Nextbike | Broomielaw,Nextbike | Bruchstr. / Schützenstr.,Nextbike | Bruchstrasse/Bruchstrasse 4,Nextbike | Brunn / Bahnhof,Nextbike | Brunnenstraße,Nextbike | Brünigstr. / Industriestr.,Nextbike | Buchanan Street Bus Station,Nextbike | Bugibba Square,Nextbike | Bundesallee,Nextbike | Bundeshaus,Nextbike | Bundesplatz / Zentralstr.,Nextbike | Bundesrechnungshof,Nextbike | Bundeswehrkrankenhaus,Nextbike | Bus Interchange,Nextbike | Buschdorf,Nextbike | Bürgenstock-Bahn,Nextbike | BürgerBüroBauen / Technisches Rathaus,Nextbike | Bürgerpark,Nextbike | CKW / Rathausen,Nextbike | CKW /Reussbühl,Nextbike | Café Trauma/Afföllerwiesen,Nextbike | Campus Am Brückweg,Nextbike | Campus Jungfernsee,Nextbike | Campus Poppelsdorf I,Nextbike | Campus Unigelände,Nextbike | Cantianstr.,Nextbike | Canton Shopping Centre,Nextbike | Canton Victoria Park,Nextbike | Capital Park 1,Nextbike | Cappel August-Bebel-Platz,"Nextbike | Caputh, Schloss",Nextbike | Cardiff Bay,Nextbike | Cardiff Bay - International Sports Village,Nextbike | Cardiff Bay - The Barrage,Nextbike | Cardiff Bay Millenium Centre,Nextbike | Cardiff Central South,Nextbike | Cardiff County Hall,Nextbike | Cardiff Met Cyncoed Campus,Nextbike | Cardiff Met Plas Gwyn Campus,Nextbike | Cardiff University - Aberconway Hall (Colum Road),Nextbike | Cardiff University - Cartwright Court (Daviot Street),Nextbike | Cardiff University - Cochrane Building,Nextbike | Cardiff University - Hadyn Ellis (Maindy Road),Nextbike | Cardiff University - Heath Park Campus (University Hospital of Wales),Nextbike | Cardiff University - McKenzie House (Howard Place),Nextbike | Cardiff University - Roy Jenkins Hall (Crwys Road),Nextbike | Cardiff University - Sir Martin Evans (Park Place),"Nextbike | Cardiff University - Talybont, (Llys Tal-y-Bont Road)",Nextbike | Cardiff University - The Queen's Buildings (The Parade),Nextbike | Cardiff University – Bute,Nextbike | Caritas Schweiz,Nextbike | Caritas Wohnen,Nextbike | Carolinenhaus/Elisabethkirche,Nextbike | Castle Business Park / Lomond Court,Nextbike | Castleview Park & Ride,Nextbike | Cathays Library,Nextbike | Cathays Park - National Museum of Wales,Nextbike | Causewayhead Roundabout,Nextbike | Celsiusstraße,Nextbike | Centar Safet Zajko,"Nextbike | Centar, Drniš","Nextbike | Centar, Jastrebarsko",Nextbike | Central Station,Nextbike | Cessnock Subway Station,Nextbike | Chalet,Nextbike | Charing Cross Railway Station,"Nextbike | Chervonoi Kalyny Ave, 49 (Shuvar trade zone)",Nextbike | Chervonoi Kalyny ave. 109 (Santa Barbara shopping mall),Nextbike | Chervonoi Kalyny ave. 81 (O.Dovhenko cinema hall),Nextbike | Chlodwigplatz,Nextbike | Chornovola / Lypyns'koho,"Nextbike | Chornovola, 67",Nextbike | Churchill Quai,Nextbike | Ciglane,Nextbike | City Centre - Churchill Way,Nextbike | City Centre - Fitzhamon Embankment,Nextbike | City Centre - St John Street,Nextbike | City Centre - St Mary Street,Nextbike | City Hall,Nextbike | City Plaza,Nextbike | City Road,Nextbike | City Road – Northcote Street,Nextbike | City of Glasgow College (Riverside Campus),Nextbike | Claycroft Residence,Nextbike | Coach Station - Sophia Close,Nextbike | Columbiadamm,Nextbike | Community Hospital,Nextbike | Congresszentrum Turmgasse,Nextbike | Coop,Nextbike | Corinthia,"Nextbike | Cottrell Building (Logie Entrance), University of Stirling",Nextbike | Crowne Plaza,Nextbike | CÃ©ramique,Nextbike | Dalmarnock Railway Station,Nextbike | Danescourt Railway Station,Nextbike | Danziger Straße / Lychener Straße,Nextbike | Danziger Straße / Prenzlauer Allee,Nextbike | Danziger Straße/Winsstraße,Nextbike | Dasoudi,Nextbike | Dehtyrivs'ka 51B (shop.veliki.ua),"Nextbike | Dendropark ""Peremohy"" from Marshala Hovorova Str.","Nextbike | Dendropark ""Peremohy"" from Shevchenko ave.",Nextbike | Dennhäuser Straße,Nextbike | Dern’sches Gelände,Nextbike | Diakonie-Kliniken,Nextbike | Diegisbalm,Nextbike | Dingli Circus,Nextbike | Dobrinja,Nextbike | Dominion Business Park (Ushyns'kogo 40),Nextbike | Domplatz,Nextbike | Donaustraße,Nextbike | Dordrecht Station,Nextbike | Dordtse Kil III,Nextbike | Dorfplatz/Rathhausgasse,Nextbike | Dortusstraße / Charlottenstraße,Nextbike | Druseltalstraße,Nextbike | Duke Street Railway Station,Nextbike | Duke of Kent Building,Nextbike | Dumballs Road - Clarence Road,Nextbike | Dunleavy Drive - Willcox House,Nextbike | Durstexpress,Nextbike | Dörfli/ Dörfli 4,Nextbike | Dürerplatz,Nextbike | Dürnstein / BRANDNER Schiffahrt,Nextbike | Dürnstein / Donaustation 21 - Busparkplatz,Nextbike | Dürnstein / P2 BHF,Nextbike | E-Bike-Station Messe,Nextbike | E-Center,Nextbike | E.-Zeigner-Allee/nextbike HQ,Nextbike | EDEKA / Sparkasse,Nextbike | East Tyndall Street - Splott,Nextbike | Eastern Leisure Centre,Nextbike | Ebenthal,"Nextbike | Ebikon, Rotsee-Badi",Nextbike | Eglinton Toll,Nextbike | Eisfeldstrasse 3,Nextbike | Elbphilharmonie,Nextbike | Elisabeth-Blochmann-Platz,Nextbike | Eltviller Straße,Nextbike | Ely and Caerau Hub,Nextbike | Emirates Arena,Nextbike | Emmen Center,"Nextbike | Emmen, Bahnhofstrasse 11",Nextbike | Emmenbrücke / Bahnhof Süd,Nextbike | Emmenfeld Betagtenzentrum,Nextbike | Emmersdorf / Tourismusinfo,Nextbike | Empire Stadium,Nextbike | Enaerios,Nextbike | Endenich Nord/ Auf dem Hügel,Nextbike | Engelhardstraße,Nextbike | Engelhartstetten / Schloss Hof,Nextbike | Ennethorw / Bushaltestelle,Nextbike | Ernst-Reuter-Platz,"Nextbike | Etnoland, Pakovo Selo",Nextbike | Eutritzscher Markt (LVB Mobilitätsstation 19),Nextbike | Ev. Diakonissenkrankenhaus Leipzig,Nextbike | Exiles,Nextbike | FERİTPAŞA CAD.D.S.İ.ÖNÜ,Nextbike | FH Hauptcampus,Nextbike | FH Klinikum St. Veiter Straße,Nextbike | FH Kärnten Primoschgasse,Nextbike | FH LGF,Nextbike | FH Schlüterstraße,"Nextbike | FSB, Ul. Ivana Lučića 5",Nextbike | Fachhochschule Potsdam,Nextbike | Faina Town (Salutna 2),Nextbike | Fairwater - Fairwater Green,Nextbike | Fairwater - Waungron Park,Nextbike | Fasanenstraße,Nextbike | Felmis / Kastanienbaumstrasse 90,"Nextbike | Ferch, Rathaus",Nextbike | Fernsicht / Ecke Agnesstraße,Nextbike | Ferries,Nextbike | Filmmuseum,Nextbike | Filmuniversität Babelsberg,Nextbike | Finnieston Street,Nextbike | Firhill Road,Nextbike | Fischamend / BHF,Nextbike | Fischereihafen (Ostseite),Nextbike | Fischmarkt,Nextbike | Fond Ghadir,Nextbike | Foribach,Nextbike | Forth Valley College,Nextbike | Forum Lviv shoppingmall,Nextbike | Fraenkelufer,Nextbike | Frankenbad/Vorgebirgsstraße,Nextbike | Frankfurter Allee/Gürtelstraße,Nextbike | Frankfurter Straße,Nextbike | Frankfurter Straße/Psychologie,Nextbike | Frankfurter Straße/Theater,Nextbike | Franziskanerplatz,Nextbike | Frauen Museum,Nextbike | Freibad Harleshausen,Nextbike | Freibad Wilhelmshöhe,Nextbike | Frey-Naepflin-Stiftung / Hansmatt 30,Nextbike | Friedenskirche,Nextbike | Friedensplatz/Budapester Straße,Nextbike | Friedrich Ebert Str. / Volksbank,Nextbike | Friedrich-Ebert-Straße / Mittelstraße,Nextbike | Friedrich-Ebert-Straße/ Christian-Wolff-Häuser,Nextbike | Friedrich-Naumann-Straße (Studierendenwohnheim),Nextbike | Friedrichplatz,Nextbike | Friedrichsplatz,Nextbike | Friedrichstadtpalast,Nextbike | Friedrichstr./Besselstr.,Nextbike | Friedrichstraße,Nextbike | Friesdorf Klufterplatz,Nextbike | GWEFAN DIGWYDDIADAU CAERDYDD - CARDIFF EVENTS,Nextbike | Gablitz / Park & Ride,Nextbike | Gagarina ave. station,Nextbike | Gallery of Modern Art,Nextbike | Galopprennbahn (Vorplatz/Zufahrtsstraße),Nextbike | Garage Heller,Nextbike | Gartenstadt Drewitz,Nextbike | Gartenstrasse/Bahnhof Nord,Nextbike | Gartnavel General Hospital,Nextbike | Gasthaus Schlüssel,Nextbike | Gebäude Sust / Dorfplatz 1,"Nextbike | Geltow, Wimmerplatz",Nextbike | Gemeindehaus,Nextbike | Gemeindehaus/Brünigstr.160,Nextbike | Gemeindehaus/Schulhaustr. 19,Nextbike | Gemeindehaus/Stanserstr. 2,Nextbike | Gemeindehausplatz,Nextbike | Gendarmenmarkt,Nextbike | General-Guisan-Quai,Nextbike | Georg-Gaßmann-Stadion,Nextbike | Georg-Stock-Platz,Nextbike | George Edwards Building,Nextbike | George Square,Nextbike | Geschwister Scholl Str.,Nextbike | Gewobag,Nextbike | Gibbet Hill Campus,Nextbike | Gimnasium riverwalk/Administrative services center,Nextbike | Ginseldorfer Weg,Nextbike | Glasgow Caledonian University,Nextbike | Glasgow Cathedral,Nextbike | Glasgow Green,Nextbike | Glasgow Green - Saltmarket / Clyde Place,Nextbike | Glasgow Science Centre,"Nextbike | Glashütte, Markt",Nextbike | Glasi-Restaurant Adler,Nextbike | Gneisenaustraße,Nextbike | Gnien F X Ebejer,Nextbike | Gnien Pembroke,Nextbike | Goethestr./Knesebeckstr.,Nextbike | Goethestraße,Nextbike | Gorkyy Park,Nextbike | Gormannstraße,Nextbike | Govan Cross,Nextbike | Grafenstein,Nextbike | Grand Harbour Marina,Nextbike | Grangetown - Corporation Road,Nextbike | Grangetown - Merches Gardens (Taff's Mead Embankment),Nextbike | Green Gold,Nextbike | Greifswalder Straße/ Danziger Straße,Nextbike | Grellebucht,Nextbike | Grendel,Nextbike | Grimmstraße,Nextbike | Groß Enzersdorf / Auvorstadt,Nextbike | Groß Enzersdorf / Busbahnhof,Nextbike | Groß Enzersdorf / Sachsengang,Nextbike | Große Hamburger Str.,Nextbike | Guildford Business Park,Nextbike | Gumpoldskirchen / Bahnhof,Nextbike | Gundulićeva,Nextbike | Guntramsdorf / Hst. Lokalbahn,Nextbike | Guntramsdorf / Hst. Neu Guntramsdorf,Nextbike | Gurlittstr. / Lange Reihe,Nextbike | Gustav-Rée-Anlage,Nextbike | Gutenbergring / Rudolf Dankwardt,Nextbike | Gänsemarkt,Nextbike | HSHL Campus Lippstadt,Nextbike | HSLU - Technik & Architektur,Nextbike | HTL Moessingerstraße,Nextbike | HTL1 Lastenstraße,Nextbike | Habsburgerstr. 1a / Zentralstr.,Nextbike | Habsburgerstrasse 26,Nextbike | Hafen/ Seestr.4,Nextbike | HafenCity / Marco-Polo-Terrassen,Nextbike | Hainburg / Hauptplatz,Nextbike | Haldenstr. 1 / Kurplatz,Nextbike | Hallenbad Allmend / Zihlmattweg 46,Nextbike | Haltepunkt Bonn-West,Nextbike | Hans-Steger-Ufer,Nextbike | Harksheider Markt,Nextbike | Hartmannstraße / Sedanstraße,Nextbike | Haselmatte 2C,Nextbike | Haugerkirchplatz,Nextbike | Hauptbahnhof,Nextbike | Hauptbahnhof - Vorplatz,Nextbike | Hauptbahnhof / Ausgang Glockengießerwall,Nextbike | Hauptbahnhof / Bahnhofsvorplatz,Nextbike | Hauptbahnhof Nord,Nextbike | Hauptbahnhof Nord / Ecke Kirchenallee,Nextbike | Hauptbahnhof Süd / SATURN,Nextbike | Hauptbahnhof Süd / Taxistand,Nextbike | Hauptbahnhof ZOB,Nextbike | Hauptbahnhof/Europaplatz,Nextbike | Hauptbahnhof/LVB-Mobilitätszentrale,Nextbike | Hauptbahnhof/Osthalle,Nextbike | Hauptbahnhof/Ostseite,Nextbike | Hauptbahnhof/Westhalle (LVB Mobilitätsstation 4),Nextbike | Hauptbahnhof/Westseite,Nextbike | Hauptpost / Bahnhofstr. 1,Nextbike | Hauptstraße/Emma-Ihrer-Straße,Nextbike | Haus der Geschichte,Nextbike | Haus der Kulturen,Nextbike | Hbf. Nord,Nextbike | Hbf. Süd,Nextbike | Heath - Birchgrove Crossroads (Caerphilly Road),Nextbike | Heath – High and Low Level Railway Stations,Nextbike | Hegelsbergstraße,Nextbike | Heiligengeistplatz,Nextbike | Heinrich-Plett-Str./Uni,Nextbike | Helmholtzplatz,Nextbike | Helsingforser Platz,Nextbike | Hennersdorf / Bahnhof,Nextbike | Hennersdorf / Gemeindeamt,Nextbike | Herderstraße,Nextbike | Hermannstraße/Briesestraße,Nextbike | Herold Center,Nextbike | Herrfurthplatz,Nextbike | Herzogenburg / Bahnhof,Nextbike | Herzogenburg / Rathausplatz,Nextbike | Herzzentrum,Nextbike | Heuplatz,Nextbike | Hilton Malta,Nextbike | Hinterbrühl / Hst. Höldrichsmühle,Nextbike | Hinterbrühl / Parkstraße - Seegrotte,Nextbike | Hirschgarten,Nextbike | Hirschlachufer / Mühlgasse,Nextbike | Hobrechtstraße,Nextbike | Hochkreuz,Nextbike | Hogenfelde / Ochsenzoller Straße,Nextbike | Hollabrunn / Bahnhof,Nextbike | Hollabrunn / KAUF ein- Fachzentrum,Nextbike | Holländische Straße,"Nextbike | Horw, Kantonsstr. / Kastanienbaumstr.","Nextbike | Horw, Kantonsstr. / Winkelstr.","Nextbike | Horw, Station Zentrum",Nextbike | Horwerhalle / Schulhausweg,Nextbike | Hosenmatten,Nextbike | Hotel Engel / Dorfplatz 1,Nextbike | Hotel Krone/Sternen,Nextbike | Hotel Nidwaldnerhof,Nextbike | Hotel Radisson / Inseliquai 12,Nextbike | Hotel Radon Plaza,Nextbike | Hotel Roggerli,Nextbike | Hotel Seerausch,Nextbike | Hotel Stans Süd / Rieden 4,Nextbike | Hufelandstraße,Nextbike | Humboldtring / Zentrum Ost,Nextbike | ICE-Bahnhof,Nextbike | IRVA Business Park (Radysheva 10/14),Nextbike | Ibragg,Nextbike | Ihringshäuser Straße,Nextbike | Importanne Centar,Nextbike | Inseliquai 1 / Frohburgstrasse,Nextbike | Interkulturelle Gärten/ Am Richtsberg,Nextbike | Ippendorf,Nextbike | Ivan Franko University,Nextbike | Ivy Arts Centre,"Nextbike | J.J Strossmayera 4, Vukovar",Nextbike | JLU Innenstadt / Universitätszentrum,Nextbike | JLU Medizin / BFS,Nextbike | JLU Phil. I / GCSC,Nextbike | JLU Phil. I / Haus A,Nextbike | JLU Phil. I / Haus F,Nextbike | JLU Phil. II / Haus F,Nextbike | JLU Phil. II / Karl-Glöckner Str.,Nextbike | JLU Recht und Wirtschaft,Nextbike | JLU Seltersberg / HRZ,Nextbike | JLU Seltersberg / Leihgesterner Weg,Nextbike | JLU Seltersberg / Veterinärmedizin,Nextbike | JLU Sport / Kugelberg,Nextbike | JUKO Pavillion/Militärstr.3,Nextbike | Jelbi-Station S+U Schönhauser Allee,Nextbike | Jelbi-Station U Prinzenstr,Nextbike | Joachim-Friedrich-Str. / KuDamm,Nextbike | Johannes-Kepler-Platz,Nextbike | Jugendherberge,Nextbike | Jugendherberge / Sedelstrasse 12,Nextbike | Jugendherberge Fred-Joseph-Platz,Nextbike | Jugendherberge Stintfang,Nextbike | Jungfernkopf,Nextbike | Jungfernstieg / Ecke Reesendamm,Nextbike | Jungstraße/Scharnweberstraße,Nextbike | Juridicum,Nextbike | Jägertor / Lindenstr.,Nextbike | KARATAY MEDRESE ÖNÜ,Nextbike | KAZIM KARABEKİR CAD.1 CAMLIKÖŞK ÖNÜ,Nextbike | KEMERLİ CAD.MALİYE KARŞISI,Nextbike | KKL / Bahnhofplatz,Nextbike | KMDA Kyiv city counsil,Nextbike | KONYA BÜYÜKŞEHİR BELEDİYESİ ÖNÜ,Nextbike | KULE SİTE A.V.M. YANI,Nextbike | Kantonalbank / Pilatusstr. 12,Nextbike | Kantonalbank / Stansstaderstrasse 54,Nextbike | Kantonspital Personalhaus 2 / Spitalstr.,Nextbike | Kantonsspital,Nextbike | Kantonsspital / Ennetmooserstrasse 19,Nextbike | Kantonsspital/ Spitalstr.,Nextbike | Kantstraße,Nextbike | Kardinalplatz,Nextbike | Karl-Kunger-Straße/Plesserstraße,Nextbike | Karl-Marx-Straße/Delbrückstraße,Nextbike | Karlshafener Straße,Nextbike | Karlsruher Str. / Aspria,Nextbike | Karlstraße,Nextbike | Karthäuserstraße,Nextbike | Kaserne/Kasernenstr. 2,Nextbike | Kasernenplatz / Naturmuseum,"Nextbike | Katerynynska sq., 1",Nextbike | Katholische Kirche / Dorfstrasse 19,Nextbike | Katzbachstraße,Nextbike | Katzelsdorf / Bahnhof,Nextbike | Katzelsdorf / Zinnfigurenwelt,Nextbike | Keizer Karelplein / Vrijthof,Nextbike | Kelvinbridge Subway,Nextbike | Kelvingrove Art Gallery,Nextbike | Kelvinhaugh Street / Argyle Street,Nextbike | Ketzerbach/Zwischenhausen,Nextbike | Khreschatyk/ Gorodetskogo,Nextbike | Kindred,Nextbike | Kinemastik Short Film Festival,Nextbike | King Cross Jankomir,Nextbike | King Cross Leopolis,Nextbike | Kirchditmold,Nextbike | Kirche / Dorfplatz,Nextbike | Kirchhofen/ Pfarrgässli 1,Nextbike | Kirchweg,Nextbike | Kirschallee / Pappelallee,Nextbike | Klausener Platz,Nextbike | Klingelhöferstr.,Nextbike | Klinikum,Nextbike | Klinikum Kassel,Nextbike | Klosterneuburg / IST Austria,Nextbike | Klosterneuburg / Kierling / Bahnhof,Nextbike | Klosterneuburg / Weidling / Bahnhof,Nextbike | Klosterstrasse 12A,Nextbike | Knesebeckstraße,Nextbike | Kniprodestraße/Storkower Straße,Nextbike | Knyahyni Olhy Akvapark,Nextbike | Koblenzer Straße,"Nextbike | Kod Orača, Drniš",Nextbike | Kohlkauer Platz,Nextbike | Kollegium St. Fidelis / Mürgstrasse 20,Nextbike | Konrad-Adenauer-Platz,Nextbike | Konstitution square,Nextbike | Kontraktova Pamyatnyk Skovorody,Nextbike | Kontraktova Verhniy Val,Nextbike | Kopernikusstraße,Nextbike | Koppenstraße,Nextbike | Koppenstraße/Münchebergerstraße,Nextbike | Korneuburg / BH Korneuburg,Nextbike | Korneuburg / BP K01 - Halle A,Nextbike | Korneuburg / BP K01 - Halle G,Nextbike | Korneuburg / BP K01 - Halle I,Nextbike | Korneuburg / Bahnhof,Nextbike | Korneuburg / Dabschkaserne,Nextbike | Korneuburg / Florian Berndl Bad,Nextbike | Korneuburg / Hauptplatz,Nextbike | Korneuburg / Rollfähre,Nextbike | Kottingbrunn / Raiba - EKZ,Nextbike | Kottingbrunn / Volkschule,Nextbike | Kottingbrunn / Weingut Rathbauer,Nextbike | Krems / Bahnhof,Nextbike | Krems / Campus Donau Uni Krems,Nextbike | Krems / Donaustation 24,Nextbike | Krems / Kunstmeile Krems,Nextbike | Krems / Landstraße,Nextbike | Krems / Nachtwächter Kreisverkehr,Nextbike | Krems / Südtiroler Platz,Nextbike | Kriens / Mattenhof SBB,"Nextbike | Kriens, Bellpark / Luzernerstr.","Nextbike | Kriens, Gallusstr. / Luzernerstr.","Nextbike | Kriens, Luzernerstr. / St. Kupferhammer","Nextbike | Kriens, Parkbad / Horwerstr.",Nextbike | Krämpfertor,Nextbike | Kuhbach Rathaus,Nextbike | Kulturforum,Nextbike | Kurfürstendamm,Nextbike | Kurt-Schumacher-Ring (Campus Mitte),Nextbike | Kurt-Schumacher-Ring (Campus Ost),Nextbike | Kvaternikov trg,Nextbike | KÜLTÜR PARK A GİRİŞİ ÖNÜ,Nextbike | Kägiswil/Dörflistr.,Nextbike | Königsplatz Ost,Nextbike | Königsplatz West,Nextbike | Königstor,Nextbike | LARENDE CAD.BALIK HALİ ÖNÜ,Nextbike | Laa / Bahnhof,Nextbike | Laa / Stadtplatz - Rathaus,Nextbike | Laan van Europa,Nextbike | Ladas/parking,Nextbike | Lager,Nextbike | Lager Maigen,Nextbike | Lager Melk Bad,Nextbike | Lakeside Residences,Nextbike | Landenbergstrasse 36,Nextbike | Landesregierung Mießtalerstraße,Nextbike | Landratsamt / Medienpark,Nextbike | Landsberger Allee,Nextbike | Landungsbrücken,Nextbike | Landungsbrücken / Eingang Hafentor,Nextbike | Langenzersdorf / Bahnhof,Nextbike | Langside Hall,Nextbike | Lannesdorf Mitte,Nextbike | Lanzheron beach,Nextbike | Laxenburg / Franz-Josephs-Platz,Nextbike | Laxenburg / Schlosspark Haupteingang,Nextbike | Leipziger Platz,Nextbike | Leister AG / Cockpit,Nextbike | Leister Technologies AG,Nextbike | Lemongrass Hostel,Nextbike | Lennéstraße,Nextbike | Leobendorf / Bahnhof,Nextbike | Leobendorf / Zentrum,Nextbike | Leobersdorf / Ared Park,Nextbike | Leobersdorf / Bahnhof,Nextbike | Leobersdorf / Rathausplatz,"Nextbike | Leontiou, CHS Fitness Club",Nextbike | Leopoldsdorf / Gemeindeamt,Nextbike | Leopoldsdorf / Rustenfeld,Nextbike | Leopoldsdorf / ZIAG,Nextbike | Leuschnerstraße/DEZ,Nextbike | Liberdastraße / Maybachufer,Nextbike | Library Road,Nextbike | Lido Strandbad,Nextbike | Liesing / Bahnhof,Nextbike | Liesing / Perfektastraße U6,Nextbike | Lietzenburger Str. / Rankestr.,Nextbike | Limani/port,Nextbike | Lindenhof,Nextbike | Lindenstrasse,Nextbike | Livoberezhna-Trade Center,Nextbike | Llandaff - Western Avenue (Cardiff Met),Nextbike | Llandaff City - High Street,Nextbike | Llandaff North - Gabalfa Avenue,Nextbike | Llanishen Street,Nextbike | Llanishen Village,Nextbike | Llantrisant Road,Nextbike | Loreleiring,Nextbike | Ludwigkirchplatz/Pfalzburger Straße,Nextbike | Luisenplatz Süd / Sparkasse,Nextbike | Luisenstraße,Nextbike | Lunz / Bootsvermietung Seepromenade,Nextbike | Lunz / Kasten - Töpperbrücke,Nextbike | Lunz / Seehof / Parkplatz,Nextbike | Luzerner Theater / Hirschengraben,Nextbike | Lviv bus station,Nextbike | Lvivs'ka Politekhnika,Nextbike | Lyubinska str.89,Nextbike | Länderpark / Bitzistrasse 2,Nextbike | Löwenplatz / Bourbaki-Panorama,Nextbike | Löwenplatz/Zürichstrasse,Nextbike | Lübeckerstr. / Perlebergerstr.,Nextbike | Lützowplatz,Nextbike | M.HULUSİ BAYBAL CAD.BERA OTEL KARŞISI,Nextbike | MEVLANA CAD. HÜKÜMET MEYDANI ŞERAFETTİN CAMİİ ÖNÜ,Nextbike | MEVLANA CAD.KAYALIPARK YANI,"Nextbike | MOZ (Ministry of Health, Hrushevs'kogo 7)",Nextbike | MZA Ei,Nextbike | Ma. Enzersdorf / Franziskanerplatz,Nextbike | Ma. Enzersdorf / Friedhof,Nextbike | Ma. Enzersdorf / Gemeindeamt,Nextbike | Ma. Enzersdorf / Haltestelle,Nextbike | Ma. Enzersdorf / Theissplatz,Nextbike | Maastricht CS Oostzijde,Nextbike | Maastricht Noord,Nextbike | Maastricht Randwyck,Nextbike | Maes y Coed Rd (Woodfield House),Nextbike | Magdalenenplatz,Nextbike | MaiHof,Nextbike | Maidan Center,Nextbike | Maihofstr. / Vallasterstr.,Nextbike | Maihofstrasse / Maihofmatte,Nextbike | Makariou,Nextbike | Makariou/Petrou Tsirou,Nextbike | Maksimir,Nextbike | Malta Independent,Nextbike | Malteser Krankenhaus,Nextbike | Manoel Island,Nextbike | Manor Park Residences,Nextbike | Marazliivska (main entrance to Shevchenko park),Nextbike | Marbachshöhe,Nextbike | Marchegg / Bahnhof,Nextbike | Marchegg / Hauptplatz,Nextbike | Marheinekeplatz,Nextbike | Maria Saal,Nextbike | Mariannenplatz,Nextbike | Mariazell,Nextbike | Marie-Jonas-Platz,Nextbike | Markgrafenstraße/Lindenstraße,Nextbike | Markthalle,Nextbike | Marktplatz,Nextbike | Marktplatz/Marktstr.,Nextbike | Martin-Gropius-Bau,Nextbike | Martin-Luther-Straße,Nextbike | Mater Dei Hospital,Nextbike | Mauerpark,Nextbike | Mautern a. d. Donau Römerhalle / Tourismus Information,Nextbike | Max-Schmeling-Halle,Nextbike | Maybachufer,Nextbike | Mehringdamm,Nextbike | Mehringdamm/Barutherstr.,"Nextbike | Melk / BH, Abt Karlstraße",Nextbike | Melk / BRANDNER Schiffahrt Melk/ Altarm,Nextbike | Melk / Bahnhof,Nextbike | Melk / Gasthof Fährhaus - Camping,Nextbike | Melk / Hubbrücke Wachauarena,Nextbike | Melk / Konditorei Mistlbacher / Fußgängerzone,Nextbike | Melk / Sparkassengasse,Nextbike | Memhardstraße,Nextbike | Menzelstraße/Uni,Nextbike | Merchant Square,Nextbike | Mercure Hotel,Nextbike | Merseburger Straße,Nextbike | Merwekade (waterbus),Nextbike | Messe,Nextbike | Messe Allmend / Horwerstrasse,Nextbike | Messe Klagenfurt,Nextbike | Messe Parkhaus,Nextbike | Metzer Straße/Prenzlauer Allee,Nextbike | Michelhausen / Bahnhof Tullnerfeld,Nextbike | Mikropole Mattenhof,Nextbike | Millburn House,Nextbike | Miniaturwunderland / Hamburg Dungeon,Nextbike | Mitchell Library,Nextbike | Mitte ZOB,Nextbike | Mittelweg / Ecke Milchstraße,Nextbike | Molki / Reussbühl,Nextbike | Molos,Nextbike | Mombachstraße,Nextbike | Mommsenstr./Bleibtreustr.,Nextbike | Moosstr. / Bundesstr.,Nextbike | Moosstr. / Obergrundstr.,Nextbike | Morsestr./Carnotstr.,Nextbike | Mosae Forum,Nextbike | Motel One / St. Pauli,Nextbike | Mount Florida Railway Station,Nextbike | Msida Central,Nextbike | Msida Skatepark,Nextbike | Muffendorf Kommende,Nextbike | Murhardstraße/Uni,Nextbike | Murray Place,Nextbike | Museum König,Nextbike | Museumshafen,Nextbike | Musikpavillon,Nextbike | My Mall,Nextbike | Märtplatz,Nextbike | Mödling / BH Mödling,Nextbike | Mödling / Babenbergerhof,Nextbike | Mödling / Bahnhof,Nextbike | Mödling / Bike+Ride (Bach),Nextbike | Mödling / Jordanfelsen,Nextbike | Mödling / Josef-Deutsch-Platz,Nextbike | Mödling / Schrannenplatz,Nextbike | Mödling / Stadtbad,Nextbike | Mödling / WIFI,Nextbike | Möllendorffstr./Rathaus,Nextbike | Mönckebergstraße / Gerhard Hauptmann Platz,Nextbike | Mühldorf / Feuerwehr,Nextbike | Mühlenbergcenter,Nextbike | Mühlenkamp / Preystraße,Nextbike | Mühlenstraße/Edith-Kiss-Straße,Nextbike | Mühleplatz,Nextbike | Mühlgasse,Nextbike | Müliplatz,Nextbike | Münsterlandplatz,Nextbike | Münsterplatz,Nextbike | NMS St.Ruprecht,Nextbike | Nacionalna,Nextbike | Nassestr./Riesstr.,Nextbike | Nationalquai / Seebad (Badesaison),Nextbike | Naukova stantion,Nextbike | Nauky ave./ Lyapunova str.,Nextbike | Naxxar Central,Nextbike | Naxxar Mithna,Nextbike | Naxxar Road,Nextbike | Neptunes,Nextbike | Nettelbeckplatz,Nextbike | Neubad,Nextbike | Neubaustraße (Gotengasse),Nextbike | Neue Hochstraße,Nextbike | Neue Universitätsbibliothek,Nextbike | Neuer Jungfernstieg,Nextbike | Neuer Platz,Nextbike | Neues Palais / Universität,Nextbike | Neustadtstrasse 10,Nextbike | Neustadtstrasse 44,Nextbike | New George Street,Nextbike | New Road Rumney,Nextbike | Newport Road,Nextbike | Niendorf Nord,Nextbike | Ninian Park Station - Jubilee Gardens,Nextbike | Nollendorfplatz,Nextbike | Nordertorplatz / Phänomenta,Nextbike | Nordpol/Reusszopfweg,Nextbike | North Road,Nextbike | North wharf,Nextbike | Nr. 1 / Eberhardsbrücke / Tourismusinformation,Nextbike | Nr. 10 / Bei den Pferdeställen 11 / Französisches Viertel,Nextbike | Nr. 11 / Parkhaus Lorettoplatz / Katharinenstraße 14,Nextbike | Nr. 2 / Europaplatz / Hauptbahnhof,Nextbike | Nr. 3 / Österbergstraße / Lustnauertor,Nextbike | Nr. 4 / Schnarrenbergstraße / Parkhaus König,Nextbike | Nr. 5 / Nauklerstraße / Universität,Nextbike | Nr. 6 / Silcherstraße / Universität / Alter Botanischer Garten,Nextbike | Nr. 8 / Haagtorplatz,Nextbike | Nr. 9 / Rappenberghalde / Campingplatz,Nextbike | Nursery Car Park,Nextbike | Nägeligasse 29,Nextbike | OLD PORT,Nextbike | OVAL ÇARŞI BOSNA,Nextbike | Obentrautstraße,Nextbike | Oberrheinhalle,Nextbike | Old Stirling Bridge,Nextbike | Ollenhauerstraße,Nextbike | Općina Novi Grad,Nextbike | Oranienplatz,Nextbike | Ortenau Klinikum,Nextbike | Ortenbergplatz,Nextbike | Osram-Höfe,Nextbike | Oststadt-Schulen,Nextbike | Oswaldsgarten,Nextbike | P&R Sirius,Nextbike | P+R Energiehuis,Nextbike | P+R Ortseingang,Nextbike | P+R Parkplatz (Tanneneck),Nextbike | P+R Weeskinderendijk,Nextbike | Paceville,Nextbike | Paisley Road Toll,Nextbike | Pankstr. / Böttgerstr.,Nextbike | Pannierstraße,Nextbike | Pannierstraße/Pflügerstraße,Nextbike | Parallelweg,Nextbike | Pareklisia Grand Resort,Nextbike | Pariser Straße,Nextbike | Park & Ride Fernheizkraftwerk,Nextbike | Park Drive,Nextbike | Park to Park 1,Nextbike | Park to Park 2,Nextbike | Parkplatz Wildenbruch,Nextbike | Parkplatz Winkel / Winkelstrasse 30,Nextbike | Parmer Pierhead Street,Nextbike | Partick Interchange,Nextbike | Pascalkehre,Nextbike | Patrol Police Department(Narodnogo Opolchenya 9),Nextbike | Paul-Lincke-Ufer/Liegnitzer Straße,Nextbike | Paulstr. / Alt-Moabit,Nextbike | Pauluskirche / Moosmattstrasse 4,Nextbike | Pavlivska square,Nextbike | Pefkos City hotel,Nextbike | Pembroke,Nextbike | Penylan - Waterloo Gardens,Nextbike | Perchtoldsdorf / Bahnhof,Nextbike | Perchtoldsdorf / Freizeitzentrum,Nextbike | Perchtoldsdorf / Kulturzentrum,Nextbike | Perchtoldsdorf / Marktplatz,Nextbike | Perchtoldsdorf / Rodaun,Nextbike | Pestalozzistraße,Nextbike | Petersburger Straße,Nextbike | Petrinjska,Nextbike | Petronell - Carnuntum / Archäologischer Park Carnuntum,Nextbike | Petronell - Carnuntum / Bahnhof,Nextbike | Petrushevycha sq.1,Nextbike | Pfaffstätten / Bahnhof,Nextbike | Pfarrplatz,Nextbike | Philosophische Fakultät,Nextbike | Pier beach hotel,Nextbike | Pilatusmarkt,Nextbike | Pilatusplatz / Hallwilerweg,Nextbike | Pilatusstr. 1,Nextbike | Pilatusstr. 8 / Seidenhofstr.,Nextbike | Plantagenplatz,Nextbike | Plateia Iron,Nextbike | Platz der Deutschen Einheit,Nextbike | Platz der Einheit,Nextbike | Platz der Luftbrücke,Nextbike | Platz der Vereinten Nationen,Nextbike | Platz vor dem Neuen Tor,Nextbike | Plosha Mykhaylivs'ka/ Troh'svyatytel'ska,Nextbike | Plosha Sofiyvs'ka,Nextbike | Pohlstraße,Nextbike | Point centar Vrbani,Nextbike | Politie Limburg,"Nextbike | Poljana, Drniš",Nextbike | Pontcanna - Llandaff Fields,Nextbike | Poppelsdorfer Schloss,Nextbike | Port Dundas,Nextbike | Port Street,Nextbike | Poshtova Plosha,Nextbike | Potamos Yermasoyias,Nextbike | Potsdamer Platz,Nextbike | Potsdamer Str. / Eichhornstr.,Nextbike | Potsdamer Straße,Nextbike | Prenzlauer Allee,Nextbike | President's Residence (Bankova 10),Nextbike | Pressbaum / Rathaus,Nextbike | Promyslova str. 50/52,Nextbike | Provincie Limburg,"Nextbike | Prymorskyi boulevard, 15","Nextbike | Pryvokzalna sq., 2",Nextbike | Pryvokzalna squre/ Central Railway Station,Nextbike | Purkersdorf / BHF Unterpurkersdorf,Nextbike | Purkersdorf / Bahnhof Hütteldorf,Nextbike | Purkersdorf / Sanatorium Hst.,Nextbike | Purkersdorf / Zentrum Hst.,Nextbike | Pushkinska str / Yaroslava Mudroho str,Nextbike | PİRİESAT CAD.KARATAY BELEDİYE ÖNÜ,Nextbike | Qawra Terminus,Nextbike | Queens Park Railway Station,Nextbike | Queens Park West,Nextbike | Queens wharf,Nextbike | Quickborner Str.,Nextbike | Quirinusplatz,Nextbike | Quisisana,Nextbike | Quitzowstr.,Nextbike | RAUF DENKTAŞ CAD. NENE HATUN PARKI ÖNÜ,Nextbike | RBB,Nextbike | Raiffeisenplatz,Nextbike | Ramada Hotel Hamburg,Nextbike | Ramersdorf,Nextbike | Raploch Community Campus,Nextbike | Rathaus,Nextbike | Rathaus (Glockengasse),Nextbike | Rathaus Babelsberg,Nextbike | Rathaus Friedrichshain-Kreuzberg,Nextbike | Rathaus Schöneberg,Nextbike | Rathaus Tiergarten,Nextbike | Rathausplatz,Nextbike | Rathenower Str. / Turmstr.,"Nextbike | Ratusha, Rynok Square",Nextbike | Reformierte Kirche,Nextbike | Reichenbach West,Nextbike | Restaurant Schlüssel,Nextbike | Reussfähre/Sentimattstr. 10,Nextbike | Reuterplatz,Nextbike | Rheindorfer Straße,Nextbike | Rhiwbina Village,Nextbike | Rhyd - Y - Penau Rd,Nextbike | Rhönplatz,Nextbike | Richardplatz,Nextbike | Richtweg,Nextbike | Riedenmatt 1,Nextbike | Rigiblick / Schiffstation,Nextbike | Rigimärt / Siegwartstrasse,Nextbike | Rijksstraatweg,Nextbike | Ringallee/Gutfleischstr.,"Nextbike | Rishelievska Str., 11",Nextbike | Riverside - Green Street,Nextbike | Riverside Hotel,Nextbike | Riverside Museum,Nextbike | Roath - Wellfield Road,Nextbike | Robert Schumann Platz,Nextbike | Rochowstr. / Corinthstr.,Nextbike | Rochusstraße,Nextbike | Rootes Grocery Store,Nextbike | Rosental/Am Johanneskreuz,Nextbike | Rossatz - Arnsdorf / Winzerstüberl Essl Rührsdorf,Nextbike | Rossatz -Arnsdorf / Feuerwehr Hofarnsdorf,Nextbike | Rossatz-Arnsdorf/ Camping - Fähre Rossatzbach,Nextbike | Rotes Kreuz,Nextbike | Rudi-Dutschke-Straße,Nextbike | Rudolf-Seiffert-Straße,Nextbike | Rugisbalm/ Otteneny-Mettlen,Nextbike | Rumney Police Station (Newport Road),Nextbike | Ruopigenplatz 1,Nextbike | Rusanivka Kulturny Center Kyiv,Nextbike | Ruschestraße,Nextbike | Rykestr.,Nextbike | Rösslimattstr. / Werkhofstr.,Nextbike | Röttgen,Nextbike | Rüdigerstraße/Volkerstraße,Nextbike | S Anhalter Bahnhof,Nextbike | S Charlottenburg,Nextbike | S Friedrichsfelde Ost,Nextbike | S Gesundbrunnen,Nextbike | S Greifswalder Straße,Nextbike | S Hackescher Markt,Nextbike | S Halensee,Nextbike | S Köllnische Heide,Nextbike | S Landsberger Allee,Nextbike | S Messe Nord/ICC,Nextbike | S Neukölln,Nextbike | S Nordbahnhof,Nextbike | S Nöldnerplatz,Nextbike | S Ostkreuz,Nextbike | S Prenzlauer Allee,Nextbike | S Rummelsburg,Nextbike | S Sonnenallee,Nextbike | S Tiergarten,Nextbike | S Treptower Park,Nextbike | S Wedding,Nextbike | S+U Alexanderplatz (Dircksenstraße),Nextbike | S+U Alexanderplatz (Ecke Alexanderstraße),Nextbike | S+U Brandenburger Tor,Nextbike | S+U Friedrichstraße,Nextbike | S+U Heidelberger Platz,Nextbike | S+U Hermannstraße,Nextbike | S+U Jannowitzbrücke,Nextbike | S+U Lichtenberg,Nextbike | S+U Zoologischer Garten,Nextbike | S-Bahn Annabichl,Nextbike | S-Bahn Haltestelle Klagenfurt Ost/Rudolfsbahnguertel,Nextbike | S-Bahn Klgf.West,Nextbike | S-Bahn-Station Königsstraße,Nextbike | S-Bahn-Station Stadthausbrücke,Nextbike | S-Bahn-Station Sternschanze,Nextbike | S-Bhf. Leutzsch,Nextbike | S-Bhf. MDR,Nextbike | S-Ostbahnhof,Nextbike | S-Savignyplatz,Nextbike | S.D. Cvjetno naselje,Nextbike | S.D. Stjepan Radić,Nextbike | SELGROS Markt / Gutenbergring,Nextbike | SELÇUK ÜNİVERSİTESİ KAMPÜS,Nextbike | SELÇUKLU BELEDİYESİ ÖNÜ,Nextbike | SSBL / Rathausen,Nextbike | STW Kundencenter,Nextbike | SWB Haupteingang,Nextbike | Saalgasse,Nextbike | Sadova str. 2a (SoftServe office),Nextbike | Saint Nikolas RoundAbout,Nextbike | Salini Resort,Nextbike | Salzmannshausen,Nextbike | Samariterstraße,Nextbike | San Gwann Centre,Nextbike | Sanderring,Nextbike | Sandershäuser Str.-kVG,Nextbike | Sandgruebestrasse,Nextbike | Sasarsteig,Nextbike | Sauchiehall Street,Nextbike | Schauspielhalle,Nextbike | Schiffbauergasse,Nextbike | Schiffsanlegestelle Bundeshaus,Nextbike | Schiffsanlegestelle Krumpendorf,Nextbike | Schiffsanlegestelle Poertschach,Nextbike | Schiffsanlegestelle Velden,Nextbike | Schiffsanlegestelle Willy-Brand-Kai,Nextbike | Schiffsanlegestelle „Alter Zoll“,Nextbike | Schiffstation,Nextbike | Schiffstation Beckenried,Nextbike | Schiffstation Kastanienbaum / St. Niklausenstrasse 104,Nextbike | Schiffstation Kehrsiten,Nextbike | Schiffstation Küssnacht,Nextbike | Schiffstation Merlischachen,Nextbike | Schiller Theater,Nextbike | Schillerplatz,Nextbike | Schillerstraße,Nextbike | Schinkestraße,Nextbike | Schleidenplatz,Nextbike | Schleiermacherstr./Blücherstr,Nextbike | Schleppeplatz,Nextbike | Schlüterstraße,Nextbike | Schmollerplatz,Nextbike | Schmuggelstieg,Nextbike | Schulhaus Amlehn,Nextbike | Schulhaus Dorf,Nextbike | Schulhaus Grossmatt,Nextbike | Schulhaus Immensee / Rötelweg,Nextbike | Schulhaus Matt,Nextbike | Schulhaus Spitz / Bodenmattstrasse 8,Nextbike | Schulhaus Säli/Pilatusstr. 59,Nextbike | Schulterblatt / Rote Flora,Nextbike | Schulzentrum Tellenmatt / Tellenmattstrasse 5,Nextbike | Schulzentrum Turmatt / Bluemattstrasse 1,Nextbike | Schwanenplatz,Nextbike | Schwechat / Bahnhof,Nextbike | Schwechat / Concorde Businesspark,Nextbike | Schwechat / HCW Handling Center West,Nextbike | Schwechat / Office Park 1,Nextbike | Schwedterstraße,Nextbike | Schädrütistrasse / Würzenbach,Nextbike | Schönauer Str./Lützner Str. (LVB Mobilitätsstation 25),Nextbike | Schönbühlcenter,Nextbike | Schöngrabern/ Kirche,Nextbike | Schönleinstraße,Nextbike | Schönstedtstraße,Nextbike | Schüür / Güterstrasse,Nextbike | Scottish Event Campus (formerly S.E.C.C),Nextbike | Seabank Resort,Nextbike | Sedanplatz,Nextbike | Seefeld,Nextbike | Seefeldpark/Seestr.20,Nextbike | Seehofstr. / Matthäuskirche,Nextbike | Seepark Hotel,Nextbike | Segeberger Chaussee,Nextbike | Seilbahn,Nextbike | Selkestraße/Schierker Straße,Nextbike | Selkirk Waterfront,Nextbike | Seminarstraße,Nextbike | Sentimatt / Dammstrasse,Nextbike | Shareplace -bike sharing tour,Nextbike | Shawlands Railway Station,Nextbike | Shawlands Shopping Centre (Kilmarnock Road),Nextbike | Shchyrecka str. 36 (Pivdennyy shopping center),Nextbike | Sherbourne Village,Nextbike | Shevchenko Univercity Red Building,Nextbike | Shields Road,Nextbike | Sickingenstr.,Nextbike | Siegessäule,Nextbike | Siemens AG,Nextbike | Sigečica Bistro RougeMarin,Nextbike | Sika/Industriestr. 26,Nextbike | Skyparks Business Centre,Nextbike | Sliema Road,Nextbike | Soborna sq. (from Sadova Str.),Nextbike | Sonnenallee,Nextbike | Sonnenallee/Innstraße,Nextbike | Sonnenallee/Reuterstraße,Nextbike | Sonnenallee/Treptower Straße,"Nextbike | Sonnenplatz, Emmenbrücke",Nextbike | Spazio Gourmet,Nextbike | Speirs Wharf,Nextbike | Spillern / Bahnhof,Nextbike | Spillern / Jugendtreff,Nextbike | Spinola,Nextbike | Spinola Car Park,Nextbike | Spitalstrasse 93,Nextbike | Spitz / Bahnhof,Nextbike | Spitz / Donaustation 15 - Tourismusinfo,Nextbike | Splott Rd,Nextbike | Sporthalle Eichli,Nextbike | Sportpark Klagenfurt,Nextbike | Sports Hub,Nextbike | Springfield Quay 1,Nextbike | Springfield Quay 2,Nextbike | Springkerse Park & Ride,Nextbike | St Enoch Square,Nextbike | St George's Cross,Nextbike | St. Andrä Wördern / BHF Greifenstein - Altenberg,Nextbike | St. Andrä Wördern / Bahnhof,Nextbike | St. Andrä Wördern / Marienhof,Nextbike | St. George's Bay,Nextbike | St. George's Beach,Nextbike | St. Jakob/Stanserstr.,Nextbike | St. Josefsklinik,Nextbike | St. Marien Hospital,Nextbike | St. Paul's Bay,Nextbike | St. Pölten / AK Platz,Nextbike | St. Pölten / Alpenbahnhof NÖVOG,Nextbike | St. Pölten / Campus Domus,Nextbike | St. Pölten / Emmausgemeinschaft Viehofen,Nextbike | St. Pölten / Fachhochschule,Nextbike | St. Pölten / Gugler* / Josefskirche,Nextbike | St. Pölten / Gästehaus Aquilin,Nextbike | St. Pölten / Hauptbahnhof Ostportal,Nextbike | St. Pölten / Hauptbahnhof Vorplatz,Nextbike | St. Pölten / Haus 12 - Landhaus,Nextbike | St. Pölten / Haus 14 - Landhaus,Nextbike | St. Pölten / Haus 16 - Landhaus,Nextbike | St. Pölten / Haus 1a - Landhaus,Nextbike | St. Pölten / Haus 2 - Landhaus,Nextbike | St. Pölten / Haus 7 - Landhaus,Nextbike | St. Pölten / Klostergasse,Nextbike | St. Pölten / Landeskliniken-Holding,Nextbike | St. Pölten / Landesklinikum,Nextbike | St. Pölten / Landesmuseum - Festspielhaus,Nextbike | St. Pölten / Rathausplatz,Nextbike | St. Pölten / SPORT.ZENTRUM.Niederösterreich,Nextbike | St. Pölten / Seenerlebnis Viehofen,Nextbike | St. Pölten / Tor zum Landhaus,Nextbike | St. Pölten / WIFI - NDU,Nextbike | St. Pölten / Werk 3100 - Haus 56,Nextbike | St. Pölten / Wirtschaftszentrum NÖ,Nextbike | St.Karlistrasse 3,Nextbike | Staatstheater,Nextbike | Stacey Road,Nextbike | Stadskantoor Dordrecht,Nextbike | Stadtbuckel,Nextbike | Stadtbüro,Nextbike | Stadthalle,Nextbike | Stadthaus Potsdam,Nextbike | Stadtpark,Nextbike | Stadtverwaltung,Nextbike | Stadtverwaltung / Winkelriedstrasse 14,Nextbike | Stammersdorf / Bahnhofsplatz Erlebnisstop 2,Nextbike | Stanserhornbahn / Stansstaderstrasse 19,Nextbike | Star Hub - Splott,Nextbike | Steinerne Brücke,Nextbike | Steinstraße,Nextbike | Stella Maris,Nextbike | Sternbergstraße,Nextbike | Stiftung Weidli / Weidlistrasse 4,Nextbike | Stirling Council â€“ Old Viewforth,Nextbike | Stockerau / Bahnhof,Nextbike | Stockerau / Kaiserrast,Nextbike | Stockerau / Rathausplatz,Nextbike | Storkower Straße/Paul-Junius-Straße,Nextbike | Str. des 17. Juni,Nextbike | Stralauer Allee/Coca Cola,Nextbike | Strandbad,Nextbike | Strandbad Klagenfurt,Nextbike | Strandbad Loretto,Nextbike | Strandbad Maiernigg,Nextbike | Strandbad Seeburg,Nextbike | Straßburger Straße/Belforter Straße,Nextbike | Straßmannstraße,Nextbike | Strengerstr. / Sparkasse,Nextbike | Stryyska - Naukova str. intersection,Nextbike | Stryyska str. 35 (State tax office),Nextbike | Studierendenwohnheim An der Feuerwache,Nextbike | Studierendenwohnheim Auf dem Steinweg,Nextbike | Studierendenwohnheim August-Bebel-Straße,Nextbike | Studio Babelsberg / Guido-Seeber-Haus,Nextbike | Surrey Sports Park,Nextbike | Surrey Technology Centre,Nextbike | Svobody square/ Sumska str.,Nextbike | Svobody square/ station Derzprom,Nextbike | Swatar,Nextbike | Swieqi Road,Nextbike | Swieqi Tennis Courts,Nextbike | Swinemünderstr.,Nextbike | Südbahnhof,Nextbike | Südbahnhof Westseite,Nextbike | Südpark,Nextbike | Südpol/Arsenalstrasse 28,Nextbike | SİVASLI ALİ KEMAL CAD.MELİKŞAH PARKI ÖNÜ,"Nextbike | T-Mobile, Landgrabenweg",Nextbike | TCS Camping,Nextbike | THM A / Wiesenstraße,Nextbike | THM C / Moltkestraße,Nextbike | THM D / Gutfleischstraße,Nextbike | THM E / Bismarckstraße,Nextbike | TIP FAKÜLTESİ ÖNÜ MERAM,Nextbike | TREN GARI ÖNÜ,Nextbike | Ta Xbiex Yacht Marina,Nextbike | Ta' Xbiex Gardens,Nextbike | Talavera / Luitpoldstr. / Zugang zum LGS 90,Nextbike | Talstation LDN / Talstation LDN 1,Nextbike | Talstation Luftseilbahn Beckenried-Klewenalp,Nextbike | Tannenbusch Mitte,Nextbike | TechnoPark,Nextbike | Tehnički muzej,Nextbike | Teith House,Nextbike | The Back Walk,Nextbike | The Hub,Nextbike | The Lightbulb,Nextbike | The Market Fair,Nextbike | The Movies,Nextbike | The Peak,Nextbike | The Strand,Nextbike | The landing,Nextbike | Theater Bonn,Nextbike | Thornhill roundabout-Rhiwbina,Nextbike | Tieckstraße,Nextbike | Torgauer Straße/Cherusker Straße,Nextbike | Tourist-Information / Zentralstr. 5,Nextbike | Trafostation Rotzberg / Rotzhalde 1,Nextbike | Train Station,"Nextbike | Trešnjevka, HUB385","Nextbike | Trg Dražena Petrovića 2, Vukovar",Nextbike | Trg Oslobođenja,Nextbike | Trg kralja Tomislava,Nextbike | Tribschenstrasse / Werkhofstrasse,Nextbike | Trongate,Nextbike | Trychlepark / Bahnhofstrasse 8,Nextbike | Tucholskystraße,Nextbike | Tulln / BH - Marc Aurel Park,Nextbike | Tulln / Campus Fachhochschule,Nextbike | Tulln / Campus UFT,Nextbike | Tulln / Die Garten Tulln,Nextbike | Tulln / Donaulände - Nibelungenplatz,Nextbike | Tulln / Hauptbahnhof Nord,Nextbike | Tulln / Hauptbahnhof Park & Ride,Nextbike | Tulln / Hauptplatz - Rosenarcade,Nextbike | Tulln / Stadtbahnhof,Nextbike | Tullnerbach / BHF Tullnerbach - Pressbaum,Nextbike | Turnhalle Ebnet,Nextbike | Twedter Plack,Nextbike | U Bahn Berliner Tor,Nextbike | U Berliner Straße,Nextbike | U Bernauer Straße,Nextbike | U Blissestraße,Nextbike | U Fehrbelliner Platz,Nextbike | U Frankfurter Tor,Nextbike | U Gleisdreieck,Nextbike | U Gneisenaustraße,Nextbike | U Görlitzer Bahnhof,Nextbike | U Güntzelstraße,Nextbike | U Hallesches Tor,Nextbike | U Hausvogteiplatz,Nextbike | U Hermannplatz/Hasenheide,Nextbike | U Hohenzollernplatz,Nextbike | U Karl-Marx-Straße,Nextbike | U Klosterstraße,Nextbike | U Kochstraße,Nextbike | U Konstanzer Straße,Nextbike | U Kurfürstendamm,Nextbike | U Leinestraße,Nextbike | U Magdalenenstraße,Nextbike | U Mohrenstraße,Nextbike | U Moritzplatz,Nextbike | U Märkisches Museum,Nextbike | U Potsdamer Platz,Nextbike | U Potsdamer Platz / Linkstraße,Nextbike | U Prinzenstraße,Nextbike | U Reinickendorfer Str.,Nextbike | U Schillingstraße,Nextbike | U Schlesiches Tor,Nextbike | U Schönleinstraße,Nextbike | U Senefelder Platz,Nextbike | U Südstern,Nextbike | U Tierpark,Nextbike | U Wilmersdorfer Straße,Nextbike | U- Boddinstr.,Nextbike | U- Weberwiese,Nextbike | U-Bahn Emilienstrasse,Nextbike | U-Bahn Feldstrasse,Nextbike | U-Bahn Lohmühlenstraße / Motel One,Nextbike | U-Bahn Lutterothstraße / Else Rauch Platz,Nextbike | U-Bahn Messehalle,Nextbike | U-Bahn-Station Baumwall,Nextbike | U-Bahn-Station Hallerstraße,Nextbike | U-Bahn-Station St.Pauli,Nextbike | U-Samariterstr.,Nextbike | U-Stadtmitte,Nextbike | UFZ Leipzig/Permoserstr.,Nextbike | UKBonn,Nextbike | UN-Campus,Nextbike | Uhlandstraße,Nextbike | Uhorska str. 14 (Bisiness center Dominant Plaza),Nextbike | Ukrainian Defenders square,Nextbike | Ulmer Hof (Juliuspromenade),Nextbike | Ulzburger Str. / Glashütter Weg,Nextbike | Ulzburger Straße,Nextbike | Uni Hamburg / Grindel,Nextbike | Uni/Diagonale,Nextbike | Uni/Holländischer Platz,Nextbike | University - Students' House,Nextbike | University Bus Terminus,Nextbike | University Hospital,Nextbike | University House,Nextbike | University Sports Complex,Nextbike | University of Glasgow (East),Nextbike | University of Glasgow (West),Nextbike | University of Strathclyde (North),Nextbike | University of Strathclyde (South),Nextbike | Universität Klagenfurt,Nextbike | Universitätsstadion,Nextbike | Universitätsstraße/Bibliothek Jura,Nextbike | Unstrutstraße,Nextbike | Unter den Eichen (Campus),Nextbike | Unterloiben / Zentrum,Nextbike | Unterneustadt,Nextbike | Urban Valley Resort & Spa,Nextbike | V.Velykoho str. 113,Nextbike | VSM Building,Nextbike | VVV Dordrecht,Nextbike | VXV plaza,Nextbike | Valletta Central,Nextbike | Velostation Bhf Luzern,Nextbike | Velotrek,Nextbike | Velowerkstatt Kerns,Nextbike | Verkehrshaus / Lidostrasse,Nextbike | Verkehrssicherheitszentrum / Kreuzstrasse 2,Nextbike | Verwaltungsstandort Lichtenberg,Nextbike | Vijecnica,Nextbike | Vilich Müldorf,Nextbike | Virchowstr. (LVB Mobilitätsstation 23),Nextbike | Virchowstraße,Nextbike | Volksbühne,Nextbike | Volkshochschule,Nextbike | Volkspark Süd,"Nextbike | Volodymyra Velykoho Str, 1",Nextbike | Vögeligärtli / Morgartenstrasse,Nextbike | Vösendorf / Schloss,Nextbike | Vösendorf / Schönbrunner Allee,Nextbike | Vösendorf / Siebenhirten HST,Nextbike | Vösendorf / Spitz,Nextbike | Wagnerplatz,Nextbike | Waldbad Templin,Nextbike | Waldstadt / Heinrich-Mann-Allee,Nextbike | Warschauer Str.,Nextbike | Warteggstrasse/Warteggstr. 5,Nextbike | Warwick Business School,Nextbike | Warwick Sports Centre,Nextbike | Wassersleben,Nextbike | Wasteserv,Nextbike | Waterloo Street,Nextbike | Webergasse,Nextbike | Wehrda Bürgerhaus,Nextbike | Weinberglistr. 4,Nextbike | Weinbergspark,Nextbike | Weißenkirchen / Bahnhof,Nextbike | Weißenkirchen / Rollfährestraße,Nextbike | Weißenseer Weg/Landsberger Allee,Nextbike | Welzeneggerstraße,Nextbike | Werbellinstraße/Falkstraße,Nextbike | Werftestr. / Ufschötti,Nextbike | Weserspitze,Nextbike | Western Leisure Centre - Caerau Lane,Nextbike | Westfälische Straße,Nextbike | Westin,Nextbike | Westwood Residences,Nextbike | Whitchurch - Merthyr Road,Nextbike | Whitchurch Library - Park Road,Nextbike | Wiener Neudorf / C.-Migazzi-Haus,Nextbike | Wiener Neudorf / HST Griesfeld,Nextbike | Wiener Neudorf / Haltestelle,Nextbike | Wiener Neudorf / Reisenbauer Ring,Nextbike | Wiener Straße,Nextbike | Wienerstr./ Glogauer Str.,Nextbike | Wiesenweg,Nextbike | Wildenbruchplatz,Nextbike | Wildenbruchstraße,Nextbike | Wilen Dorf/Wilerstr.65,Nextbike | Wilhelmshöhe (Park),Nextbike | Wilhelmsplatz,Nextbike | Wilhelmsstraße,Nextbike | Wilhelmstraße/Robinenwäldchen,"Nextbike | Willow Court Residences, University of Stirling",Nextbike | Willy-Brandt-Platz,Nextbike | Wilmersdorfer Straße,Nextbike | Winterfeldtstraße/Frobenstraße,Nextbike | Wisbyer Str./Lewaldstr.,Nextbike | Wissenschaftspark Potsdam-Golm,Nextbike | Wolfsgraben,Nextbike | Woodside (North),Nextbike | Wr. Neustadt / Bootsverleih Wr. Neustädter Kanal,Nextbike | Wr. Neustadt / Fachhochschule,Nextbike | Wr. Neustadt / Fischapark Dreipappelstrasse,Nextbike | Wr. Neustadt / Hauptbahnhof,Nextbike | Wr. Neustadt / Hauptplatz,Nextbike | Wr. Neustadt / Hst. Nord,Nextbike | Wr. Neustadt / Hst.Civitas Nova,Nextbike | Wr. Neustadt / Kasematten,Nextbike | Wr. Neustadt / Landesklinikum,Nextbike | Wr. Neustadt / Merkurcity,Nextbike | Wr. Neustadt / Museum St. Peter an der Sperr,Nextbike | Wr. Neustadt / Studentenwohnheim,Nextbike | Wr. Neustadt / Theatergarage / Fußgängerzone,Nextbike | Wrangelstraße,Nextbike | Wurzer Straße,Nextbike | Wörthersee Schifffahrt,Nextbike | Wühlischstraße,Nextbike | Wühlischstraße/Holteistraße,Nextbike | Xwieki,Nextbike | YENİ MERAM CAD.MERAM EĞİTİM ARAŞTIRMA HASTANESİ ÖNÜ,Nextbike | YENİ MERAM CAD.ÇINARALTI RESTAURANT KARŞISI,Nextbike | ZHK Nyvky Park (pr.Peremogy 67),Nextbike | ZOB,Nextbike | Zentrum Nordweststadt,Nextbike | Zeppelinstraße / Feuerbachstr. / Breite Straße,Nextbike | Zeppelinstraße/Kastanienallee,Nextbike | Zeughofstraße (Lausitzer Park),Nextbike | Zihlmattweg 29,Nextbike | Zivilstandsamt/Brünigstr. 180,Nextbike | Zmaja od Bosne,Nextbike | Zoloty Vorota Exit,Nextbike | corner Panteleimonivska Str./Leontovycha Str.,Nextbike | corner Uspenska Str./Lidersovsky boulevard,Nextbike | eawag / Seestrasse 79,Nextbike | ewl / Industriestrasse 6,Nextbike | job-vision / Am Bergli 41,Nextbike | m. Arsenalna,Nextbike | m. Heroyv Dnipra (zakhid),Nextbike | m. Luk'yanivska (vodafone),Nextbike | m. Mins'ka (zakhid),Nextbike | m. Obolon (zakhid),Nextbike | m. Osokorki (pivnich),Nextbike | m. Pochaina (pivden),Nextbike | m. Pochaina Gorodok shoppingmall (pivnich),Nextbike | m.Kharkivs'ka (pivden),Nextbike | m.Mins'ka (skhid),Nextbike | m.Poznyaki (pivden),Nextbike | m.Poznyaki (pivnich),Nextbike | nidair Flugfeld,"Nextbike | str. Dorohozhytska, 3 (UNIT.City)","Nextbike | Ð�. Mazepy Str. 1B, Spartak",Nextbike | Überbauung Feld / Feld 6,Nextbike | Überbauung Seehof / Rotzbergstrasse 14,Nextbike | Ückesdorf,Nextbike | İSTANBUL YOLU AYDİNLİK EVLER KAVSAGİ,Nextbike | İSTANBUL YOLU FARABİ HASTANESİ KAVŞAĞI,"Nextbike | ДОМ ПАМЕТНИК ""ЙОРДАН ЙОВКОВ"" HOUSE MEMORIAL 'YORDAN YOVKOV'",Nextbike | ОБЩИНА ДОБРИЧ DOBRICH MUNICIPALITY,Nextbike | ПЛОЩАД СВОБОДА 'SVOBODA' SQUARE,"Nextbike | СПОРТЕН КОМПЛЕКС ""ИЗИДА"" ''IZIDA' SPORT COMPLEX","Nextbike | ЦЪРКВА ""СВ. ГЕОРГИ"" 'ST. GEORGE' CHURCH",NomagoBikes | Avtobusna postaja,NomagoBikes | Bolnica Celje,NomagoBikes | Citycenter,NomagoBikes | Dečkova cesta,NomagoBikes | Dvorana Tri Lilije,NomagoBikes | Dvorana Zlatorog Celje,NomagoBikes | Hudinja,NomagoBikes | Krekov trg,NomagoBikes | Lava,NomagoBikes | Levstikova ulica,NomagoBikes | Ljubljanska cesta,NomagoBikes | Mariborska cesta – Tuš,NomagoBikes | Muzejski trg,NomagoBikes | Na zelenici TUŠ,NomagoBikes | Nova vas,NomagoBikes | Ostrožno,NomagoBikes | Prešernova ulica,NomagoBikes | TIC Rimske Toplice,NomagoBikes | Thermana Laško,NomagoBikes | Tkalska ulica,NomagoBikes | Trubarjevo nabrežje,NomagoBikes | Železniška postaja,NotoinBici | Lido di Noto,NotoinBici | Nazionale,NotoinBici | Pantheon,NotoinBici | XVI Maggio,Novara | Alpini,Novara | Autostazione,Novara | Cimitero,Novara | Cittadella,Novara | Costituente,Novara | Mercato,Novara | Municipio,Novara | Ospedale,Novara | Polo Scolastico,Novara | Questura,Novara | San Rocco,Novara | Stazione FF.SS.,Novara | Verdi,Novara | Vignale,OK Bike | Bolesława Krzywoustego,OK Bike | Hala Sportowa Azoty,OK Bike | Hala Sportowa Śródmieście,OK Bike | Kędzierzyn Stacja Kolejowa,OK Bike | Mieszka I,OK Bike | Odrzańskie Ogrody,OK Bike | Osiedle Blachownia,OK Bike | Osiedle Cisowa,OK Bike | Osiedle Kłodnica,OK Bike | Osiedle Sławięcice,OK Bike | Osiedle Zachód,OK Bike | Plac Raciborski,OK Bike | Plac Rodła,OK Bike | Wojska Polskiego,Olbia Bike | Aeroporto Costa Smeralda,Olbia Bike | Necropoli San Simplicio,Olbia Bike | Sede Comunale,Onroll Via Verde | Biblioteca Municipal Xerardo Dýaz - Porto Do Son,Onroll Via Verde | Casa Da Cultura - Portosin,Onroll Via Verde | Casa Do Concello - Lousame,Onroll Via Verde | Polideportivo Municipal - Lousame,Onroll Via Verde | Praza Das Américas - Noia,Onroll Via Verde | Rúa Besteiros - Noia,Onroll | 1_ayuntamiento,Onroll | 2_plaza de la Constitución,Onroll | 3_instituto Lloixa,Onroll | 4_polideportivo,Onroll | 5_instituto García Berlanga,Onroll | 6_hospital,Onroll | Acceso a Biblioteca Pública del Estado,Onroll | Acueducto,Onroll | Alcýzar,Onroll | Alfa,Onroll | Alfonso X el Sabio,Onroll | Alto de Bayna,Onroll | Ambulatorio San Fermýn,Onroll | Antonio Mena/fray Jaime Torres,Onroll | Aparcamiento de la Facultad de Geografýa E História,Onroll | Aparcamiento del Mercado de Vegueta,Onroll | Apeadero Villaquilambre,Onroll | Auditorio Ceu,Onroll | Auditorio Parque Almansa,Onroll | Aulario Universidad,Onroll | Av. Ametllý de Mar,Onroll | Avda. Libertad - Aljub,Onroll | Avda. Libertad/reina Victoria,Onroll | Avda. Llauradors / Eslava,Onroll | Avenida Castilla,Onroll | Avenida Europa,Onroll | Avenida María Auxiliadora,Onroll | Avenida de Burgos,Onroll | Avenida de España,Onroll | Avenida del Prýncipe,Onroll | Avenida del Rio,Onroll | Ayto. Alhama Murcia,Onroll | Ayuntamiento,Onroll | Ayuntamiento de Benidorm,Onroll | Ayuntamiento de las Palmas de Gran Canaria,Onroll | Barrio de Andalucia,Onroll | Barrio de la Estación,Onroll | Biblioteca,Onroll | Biblioteca San José,Onroll | Bienestar Social,Onroll | C. P. Mariano Benlliure,Onroll | Calle Infante,Onroll | Calle Mercado,Onroll | Calle San Francisco,Onroll | Campo de Fútbol,Onroll | Campo de Fútbol Cesped Artificial,Onroll | Campus Ciencias,Onroll | Campus Claretianos,Onroll | Campus Fuentenueva - Arquitectura T?cnica,Onroll | Campus Unamuno,Onroll | Casa de Cultura - Robledo,Onroll | Casa de Cultura - Villamoros de las Regueras,Onroll | Casa de Cultura - Villanueva del ?rbol,Onroll | Casa de Cultura - Villarrodrigo de las Regueras,Onroll | Casa de la Cultura,Onroll | Casablanca,Onroll | Castillo,Onroll | Catalinetes,Onroll | Cañada Real de la Mesa,Onroll | Centro Aguas Vivas,Onroll | Centro Comercial Eroski,Onroll | Centro Comercial las Arenas,Onroll | Centro Educativo,Onroll | Centro Juventud - Escuela Danza,Onroll | Centro Salud Altabix,Onroll | Centro Social,Onroll | Centro Virtus,Onroll | Centro de Congresos,Onroll | Centro de Convenciones,Onroll | Centro de Salud,Onroll | Centro las Salinas,Onroll | Chimenea Colonial,Onroll | Ciudad Deportiva de Gran Canaria,Onroll | Colegio Jorge Juan,Onroll | Comisarýa,Onroll | Complejo Deportivo,Onroll | Complejo Triunfo,Onroll | Conrado del Campo / Trinquete,Onroll | Corazón de Jesús,Onroll | Correos,Onroll | Cruz del Rio,Onroll | Edificio Woerman,Onroll | Egido de la Fuente,Onroll | El Niño de Mula,Onroll | El Pozo,Onroll | Escorxador,Onroll | Espacio J?ven,Onroll | Espacio M (centro Joven),Onroll | Esquina el Convento,Onroll | Estaci?n Autobuses,Onroll | Estacion de Autobuses,Onroll | Estación,Onroll | Estación Autobuses,Onroll | Estación Autobuses/renfe,Onroll | Estación de Autobuses,Onroll | Estación de Autobuses / Policía Local,Onroll | Estación de Tren,Onroll | Estación de Trenes (vialia),Onroll | Estadio Municipal Sýnchez Menor,Onroll | Explanada de lo Pagan,Onroll | Facultad de Medicina,Onroll | Federico Anaya - los Tilos,Onroll | Fgv,Onroll | Fuente del Rey,Onroll | Glorieta Alto del Rollo,Onroll | Glorieta Antonio Machado,Onroll | Glorieta Castilla Y León,Onroll | Glorieta de la Base Naval,Onroll | Granadilla I,Onroll | Granadilla Ii,Onroll | Hilario Goyenechea (barrio San José),Onroll | Hospital,Onroll | Hospital General,Onroll | Hospital del Vinalopó,Onroll | Huerta Otea,Onroll | I. Municipal de Deportes,Onroll | Inform?tica Y Telecomunicaciones,Onroll | Instalaciones Deportivas Campo la Cartuja,Onroll | Instituo Luis Chamizo,Onroll | Institut-renfe,Onroll | Instituto Doménico Scarlatti,Onroll | Isaac Peral,Onroll | Jardines del Triunfo,Onroll | Jardín Miguel Cervantes,Onroll | Jardýn de Aspe,Onroll | Jesuitinas,Onroll | Juan Herrera,Onroll | Juan Xxiii,Onroll | Juzgados,Onroll | La Albuera,Onroll | La Manga,Onroll | La Marina (parque Jesuitas),Onroll | La Mota,Onroll | La Pulgosa,Onroll | La Redonda,Onroll | La Roda,Onroll | Los Pajaritos,Onroll | Los Pinos,Onroll | Marýa Auxiliadora (corte Inglés),Onroll | Mercado Municipal,Onroll | Muelle Deportivo,Onroll | Nizeto Alcalá Zamora,Onroll | Nueva Segovia,Onroll | O Aguillón,Onroll | Oficina de Turismo,Onroll | P. Jose Angel de Jesus Encinas,Onroll | P. Puerta de Cuartos,Onroll | Pabellón Municipal,Onroll | Pabellón Polideportivo,Onroll | Pabellón de Deportes,Onroll | Palacio de Congresos,Onroll | Palacio del Infantado,Onroll | Palau D'esports L'illa Benidorm,Onroll | Parking Hospital,Onroll | Parque Abelardo Sánchez,Onroll | Parque Atalaya Gandia,Onroll | Parque Don Bosco,Onroll | Parque Feria,Onroll | Parque Fiesta del Árbol,Onroll | Parque Fuster,Onroll | Parque Juan Carlos I,Onroll | Parque Leocadio Marín,Onroll | Parque Medina Siyasa,Onroll | Parque Norte,Onroll | Parque Santa Catalina,Onroll | Parque Zona Carrefour (c/ la Ba?eza),Onroll | Parque de Bomberos,Onroll | Parque de Elche,Onroll | Parque de la Música,Onroll | Parque de la Victoria,Onroll | Parque la Alamedilla,Onroll | Paseo Canalejas,Onroll | Paseo García del Olmo,Onroll | Paseo Real,Onroll | Paseo de la Cuba,Onroll | Passeig Fora Forat,Onroll | Passeig de Germanies,Onroll | Patrimonio Humanidad,Onroll | Patronato,Onroll | Piscina Climatizada,Onroll | Piscina Cubierta,Onroll | Piscina Magdalena,Onroll | Piscina Municipal,Onroll | Piscina Municipal Sonia Reyes,Onroll | Piscinas Cubiertas,Onroll | Pista Deportiva,Onroll | Pista de Atletismo,Onroll | Playa 1,Onroll | Playa 2,Onroll | Playa Cesantes Punta,Onroll | Plaza,Onroll | Plaza 1 de Mayo,Onroll | Plaza Altozano,Onroll | Plaza Ayuntamiento,Onroll | Plaza Bejanque,Onroll | Plaza Castilla,Onroll | Plaza Conquistadores,Onroll | Plaza Constitución,Onroll | Plaza David Martýn,Onroll | Plaza Gabriel Y Galýn,Onroll | Plaza Iglesia Pizarrales,Onroll | Plaza Ingeniero Manuel Becerra,Onroll | Plaza Luis Braille,Onroll | Plaza Mayor,Onroll | Plaza Palenque,Onroll | Plaza Pio Xii,Onroll | Plaza Poeta Iglesias,Onroll | Plaza San Francisco,Onroll | Plaza San Juliýn,Onroll | Plaza Torrejó,Onroll | Plaza Xúquer,Onroll | Plaza de Crevillente,Onroll | Plaza de España,Onroll | Plaza de Granados,Onroll | Plaza de Isabel la Católica,Onroll | Plaza de Leon,Onroll | Plaza de San Pedro,Onroll | Plaza de San Pedro Ii,Onroll | Plaza de Toros,Onroll | Plaza de Vázquez de Molina,Onroll | Plaza de la Concordia,Onroll | Plaza de la Constitución,Onroll | Plaza de la Lonja,Onroll | Plaza de la Magdalena,Onroll | Plaza de las Canteras,Onroll | Plaza de las Pipas,Onroll | Plaza de las Provincias,Onroll | Plaza de los Bandos,Onroll | Plaza del Ayuntamiento,Onroll | Plaza del Coso Viejo,Onroll | Plaza del Oeste,Onroll | Plaza del Raval,Onroll | Plaza la Rosa,Onroll | Plaça de Bous,Onroll | Policýa Local,Onroll | Polideportivo,Onroll | Polideportivo Altabix,Onroll | Polideportivo Foietes,Onroll | Polideportivo Mauli,Onroll | Polideportivo Municipal,Onroll | Polideportivo Municipal 1º de Mayo,Onroll | Polideportivo de Calabagueiros,Onroll | Polivalente Carrús,Onroll | Polýgono,Onroll | Posada del Rosario,Onroll | Praza Andrés de Prada,Onroll | Praza José A. Mýguez,Onroll | Prosperidad,Onroll | Puente Romano,Onroll | Puerta Real,Onroll | Rambla de San Roque,Onroll | Rectorado I,Onroll | Rectorado Ii,Onroll | Renfe,Onroll | Salas Bajas,Onroll | Salines,Onroll | San Cristobal,Onroll | San Lorenzo,Onroll | San Roque,Onroll | Santa Ana,Onroll | Santa Teresa de Jornet,Onroll | Santiago de la Ribera,Onroll | Santo Domingo,Onroll | Sembrador,Onroll | Sinforiano Madroñero I,Onroll | Sinforiano Madroñero Ii,Onroll | Sinforiano Madroñero Iii,Onroll | Squash,Onroll | Tejares (caja Duero),Onroll | Teneria I Antonio Lopez,Onroll | Turismo,Onroll | Umh - Escuela Oficial de Idiomas,Onroll | Umh - Pabellón Deportes,Onroll | Universidad,Onroll | Universidad de Jaen,Onroll | Universidad del Deporte,Onroll | Victimas del Terrorismo,Onroll | Viloira,Onroll | Virgen de las Cruces,Onroll | Zona Deportiva Escolar,Onroll | Zurguén,Općina Brinje | Brinje,Općina Brinje | Hotel Lika,Ordu Bisikletli | Ordu - Altınordu İstasyonu-1,Ordu Bisikletli | Ordu - Altınordu İstasyonu-10,Ordu Bisikletli | Ordu - Altınordu İstasyonu-2,Ordu Bisikletli | Ordu - Altınordu İstasyonu-3,Ordu Bisikletli | Ordu - Altınordu İstasyonu-4,Ordu Bisikletli | Ordu - Altınordu İstasyonu-5,Ordu Bisikletli | Ordu - Altınordu İstasyonu-6,Ordu Bisikletli | Ordu - Altınordu İstasyonu-7,Ordu Bisikletli | Ordu - Altınordu İstasyonu-8,Ordu Bisikletli | Ordu - Altınordu İstasyonu-9,Ordu Bisikletli | Ordu - Fatsa İstasyonu - 1,Ordu Bisikletli | Ordu - Fatsa İstasyonu - 2,Ordu Bisikletli | Ordu - Fatsa İstasyonu - 3,Ordu Bisikletli | Ordu - Fatsa İstasyonu - 4,Ordu Bisikletli | Ordu - Ünye Istasyonu - 1,Ordu Bisikletli | Ordu - Ünye Istasyonu - 4,Ordu Bisikletli | Ordu - Ünye İstasyonu - 2,Ordu Bisikletli | Ordu - Ünye İstasyonu - 3,Ordu Bisikletli | Transport (Taşıma Depo),PRM | AWF,PRM | Aleje Marcinkowskiego,PRM | Aleje Solidarności,PRM | Bałtycka/Gdyńska,PRM | Bohaterów Westerplatte,PRM | Bonin,PRM | Boranta,PRM | Brama Poznania,PRM | Brzask / Międzychodzka,PRM | Brzechwy / Maklakiewicza,PRM | Buczka/Kołłątaja,PRM | Bukowska / Przybyszewskiego,PRM | Bukowska/Polna,PRM | Bułgarska,PRM | Bułgarska / Marcelińska,PRM | Centrum Podolany,PRM | Dmowskiego/Bosa,PRM | Dmowskiego/Stablewskiego,PRM | Dożynkowa,PRM | Dworzec Autobusowy,PRM | Dworzec Zachodni,PRM | Dębiec,PRM | Ewangelicka,PRM | Garbary,PRM | Grunwaldzka / Grochowska,PRM | Górczyn,PRM | Głogowska / Hetmańska,PRM | Głogowska / ul. Krauthofera,PRM | Inflancka,PRM | Jarochowskiego / Palacza,PRM | Jarochowskiego / Potworowskiego,PRM | Jasna Rola,PRM | Jeleniogórska,PRM | Junikowo,PRM | Karpia,PRM | Keplera,PRM | Koronkarska,PRM | Kościelna,PRM | Kościuszki,PRM | Kraszewskiego,PRM | Krańcowa,PRM | Kukułcza,PRM | Kurpińskiego,PRM | Kórnicka,PRM | Leszczyńska/Kocha,PRM | Libelta,PRM | Literacka,PRM | Maczka,PRM | Malta SKI,PRM | Malwowa/Złotowska,PRM | Marcelińska / Grochowska,PRM | Marcinkowskiego/Podgórna,PRM | Masztalarska,PRM | Matejki,PRM | Małe Garbary,PRM | Miłostowo,PRM | Mogileńska,PRM | Most Teatralny,PRM | Mostowa,PRM | Murawa / Słowiańska,PRM | Nasienna,PRM | Niestachowska/Wojska Polskiego,PRM | Ogrody,PRM | Opalenicka/Przybyszewskiego,PRM | Opieńskiego,PRM | Opolska/Jesionowa,PRM | Os. Batorego/Atlantis,PRM | Os. Dębina,PRM | Os. Lecha,PRM | Os. Marysieńki,PRM | Os. Oświecenia,PRM | Os. Przyjaźni,PRM | Os. Sobieskiego,PRM | Os. Wichrowe Wzgórze,PRM | Os. Winiary,PRM | Os. Łokietka,PRM | Park Rataje,PRM | Park Sołacki,PRM | Park Wilsona,PRM | Piaśnicka Rynek,PRM | Pl. Wolności,PRM | Plac Wiosny Ludów,PRM | Polanka,PRM | Politechnika Centrum Wykładowe,PRM | Poznań Główny,PRM | Poznańska / Jeżycka,PRM | Połabska,PRM | Połabska Pętla,PRM | Promienista/Jawornicka,PRM | Promienista/Ściegiennego,PRM | Przemysłowa/Św. Czesława,PRM | Prądzyńskiego / Kosińskiego,PRM | Puszkina,PRM | Półwiejska,PRM | Rolna,PRM | Rondo Jana Nowaka Jeziorańskiego,PRM | Rondo Kaponiera,PRM | Rondo Rataje,PRM | Rondo Solidarności,PRM | Rondo Starołęka,PRM | Rondo Śródka,PRM | Rynek Jeżycki,PRM | Rynek Wildecki,PRM | Rynek Wschodni,PRM | Rynek Łazarski,PRM | Sczanieckiej,PRM | Sieroca,PRM | Spadzista,PRM | Starołęka,PRM | Strzegomska / Gałczyńskiego,PRM | Szamarzewskiego / Długosza,PRM | Szamarzewskiego / Wawrzyniaka,PRM | Szamotulska / Szamarzewskiego,PRM | Szarych Szeregów,PRM | Szpitalna,PRM | Słowiańska,PRM | Targi,PRM | Termy Maltańskie,PRM | Towarowa,PRM | Traugutta,PRM | UAM Pływalnia,PRM | UAM Wydział Nauk Politycznych i Dziennikarstwa,PRM | Uniwersytet Przyrodniczy,PRM | Wierzbięcice,PRM | Wilczak,PRM | Wspólna,PRM | Wyspiańskiego / Jarochowskiego,PRM | Węgorka,PRM | Włodarska,PRM | Zamek,PRM | Zielona,PRM | Złotowska,PRM | os. Jagiełły,PRM | os. Orła Białego,PRM | os. Piastowskie,PRM | os. Rusa/Chartowo,PRM | os. Stare Żegrze,PRM | Św. Barbary,Parkinbici | Calenella (Fraz. di Vico Garganico),Parkinbici | Foce Varano (Fraz. di Ischitella),Parkinbici | Lido del Sole (Fraz. Rodi Garganico),Parkinbici | Mattinata,Parkinbici | Peschici,Parkinbici | Rignano Garganico,Parkinbici | Rodi Garganico,Parkinbici | San Marco in Lamis,Parkinbici | San Menaio (Fraz. di Vico Garganico),Pavia in bici | Da Vinci,Pavia in bici | Ghinaglia,Pavia in bici | Indipendenza,Pavia in bici | Policlinico,Pavia in bici | Stazione FF.SS.,Pavia in bici | Universita`,Pavia in bici | Vittoria,Piaseczyński Rower Miejski | Centrum,Piaseczyński Rower Miejski | Józefosław,Piaseczyński Rower Miejski | PKP Piaseczno,Piaseczyński Rower Miejski | Stadion,Pinerolo | Abbadia,Pinerolo | Avis,Pinerolo | Cavour,Pinerolo | Municipio,Pinerolo | Ospedale,Pinerolo | Stazione FF.SS.,Pinerolo | Stazione Olimpica,Pinerolo | Stazione di test - non operativa,Pinerolo | Tabona,Piotrkowski Rower Miejski | Belzacka - Basen,Piotrkowski Rower Miejski | Dmowskiego - Poprzeczna,Piotrkowski Rower Miejski | Dworzec Kolejowy,Piotrkowski Rower Miejski | Kąpielisko Słoneczko,Piotrkowski Rower Miejski | Osiedle Słowackiego,Piotrkowski Rower Miejski | Osiedle Wyzwolenia,Piotrkowski Rower Miejski | Osiedle Łódzka,Piotrkowski Rower Miejski | Park im. ks. J. Poniatowskiego,Piotrkowski Rower Miejski | Stare Miasto - Mediateka,Pobiedziski Rower Gminny | Biskupice,Pobiedziski Rower Gminny | Pobiedziska,Pobiedziski Rower Gminny | Pobiedziska Letnisko,Pordenone | Stazione FF.SS.,Pordenone | Universita`,Porec bike share | Borik,Porec bike share | Brulo,Porec bike share | Centar Lungomare,Porec bike share | Centar Riva,Porec bike share | Centar Riva 2,Porec bike share | Špadići,Portofino Park and Bike | 10. S. Margherita Campo Sportivo,Portofino Park and Bike | 3. S. Margherita San Siro,Portofino Park and Bike | 4. S. Margherita Municipio,Portofino Park and Bike | 5. S. Margherita Centro,Portofino Park and Bike | 6. S. Margherita FS,Portofino Park and Bike | 7. S. Margherita Porto,Portofino Park and Bike | 9. Paraggi,Prata Camportaccio | Stazione di Prata Camportaccio,Pruszkowski Rower Miejski | Centrum Kultury i Sportu,Pruszkowski Rower Miejski | Gałczyńskiego,Pruszkowski Rower Miejski | MLP Pruszków I,Pruszkowski Rower Miejski | MLP Pruszków II,Pruszkowski Rower Miejski | Ostoja,Pruszkowski Rower Miejski | PKP,Pruszkowski Rower Miejski | Park Mazowsze,Pruszkowski Rower Miejski | Park Żwirowisko,Pruszkowski Rower Miejski | Parking Waryńskiego,Pruszkowski Rower Miejski | Plantowa,Pruszkowski Rower Miejski | Robotnicza,Pruszkowski Rower Miejski | Spacerowa,Pruszkowski Rower Miejski | WKD Pruszków,Płocki Rower Miejski | 1 Maja - Królewiecka,Płocki Rower Miejski | Armii Krajowej - Kutrzeby,Płocki Rower Miejski | Armii Krajowej - Walecznych,Płocki Rower Miejski | Chopina - Dworcowa,Płocki Rower Miejski | Decathlon Płock,Płocki Rower Miejski | Dobrzyńska - Gałczyńskiego,Płocki Rower Miejski | Górna,Płocki Rower Miejski | Harcerska - Żelazna,Płocki Rower Miejski | Jachowicza - Sportowa,Płocki Rower Miejski | Jana Pawła II - CM Rodzina,Płocki Rower Miejski | Jana Pawła II - Paderewskiego,Płocki Rower Miejski | K. Wielkiego - Dobrzyńska,Płocki Rower Miejski | Kilińskiego - Warszawska,Płocki Rower Miejski | Kobylińskiego - Bielska,Płocki Rower Miejski | Kolegialna - Pl. Obr. Warszawy,Płocki Rower Miejski | Medyczna - Szpital,Płocki Rower Miejski | Nowe Gulczewo – Gmina Słupno,Płocki Rower Miejski | Piłsudskiego - Chopina,Płocki Rower Miejski | Piłsudskiego - Jeziorowskich,Płocki Rower Miejski | Piłsudskiego - Otolińska,Płocki Rower Miejski | Pl. Narutowicza,Płocki Rower Miejski | Przemysłowa - NSZ,Płocki Rower Miejski | Rembielińskiego - Gawareckiego,Płocki Rower Miejski | Sienkiewicza - Tumska,Płocki Rower Miejski | Spółdzielcza - Wyszogrodzka,Płocki Rower Miejski | Stary Rynek,Płocki Rower Miejski | Tysiąclecia - Nowaka,Płocki Rower Miejski | Zalew Sobótka,Płocki Rower Miejski | Łukasiewicza - Miodowa,Płocki Rower Miejski | Łukasiewicza - Orlen Arena,Radomski Rower Miejski | Armii Krajowej - pętla autobusowa,Radomski Rower Miejski | Chrobrego/Uniwersytet,Radomski Rower Miejski | Czarnoleska/Sycyńska,Radomski Rower Miejski | Grzecznarowskiego/Gagarina,Radomski Rower Miejski | Jana Pawła II/Sandomierska,Radomski Rower Miejski | Kilińskiego/Urząd Miasta,Radomski Rower Miejski | Krasickiego-Zalew Borki,Radomski Rower Miejski | Królowej Jadwigi,Radomski Rower Miejski | Kusocińskiego/Bema (Biblioteka),Radomski Rower Miejski | Limanowskiego/Okulickiego,Radomski Rower Miejski | Limanowskiego/Pawia,Radomski Rower Miejski | Malczewskiego/Wernera (Mauzoleum D. Czachowskiego),Radomski Rower Miejski | Narutowicza/Kościuszki,Radomski Rower Miejski | Okulickiego/Główna,Radomski Rower Miejski | Paderewskiego - pętla autobusowa,Radomski Rower Miejski | Radomskiego/Wyścigowa (Pływalnia „Neptun”),Radomski Rower Miejski | Struga/11 Listopada,Radomski Rower Miejski | Struga/25 Czerwca,Radomski Rower Miejski | Sycyńska - pętla autobusowa,Radomski Rower Miejski | Słowackiego- Kalińska,Radomski Rower Miejski | Tochtermana/Lekarska,Radomski Rower Miejski | Traugutta/Dworzec PKP,Radomski Rower Miejski | Wośnicka/Bulwarowa,Radomski Rower Miejski | Żeromskiego/Pl. Konstytucji 3 Maja,Radomski Rower Miejski | Żeromskiego/Zbrowskiego,Rapid City B-cycle | Main Street Square,Rapid City B-cycle | South Dakota School of Mines and Technology,Reddy Bike Share | Allen - Delaware to Franklin (Free),Reddy Bike Share | Allen - Elmwood to Park (Free),Reddy Bike Share | Allen - Wadsworth to Elmwood (Free),Reddy Bike Share | Alumni,Reddy Bike Share | Amherst St.,Reddy Bike Share | BNMC 1,Reddy Bike Share | BNMC 2,Reddy Bike Share | Bidwell Parkway at Elmwood (Free),Reddy Bike Share | Broadway Market Free Parking,Reddy Bike Share | Buffalo State #2,Reddy Bike Share | Buffalo State College (Free),Reddy Bike Share | Buffalo and Erie County Public Library (Free),Reddy Bike Share | Canalside at Naval Park,Reddy Bike Share | Canisius 2,Reddy Bike Share | Canisius College (Free),Reddy Bike Share | City Hall (Free),Reddy Bike Share | Clement/Goodyear,Reddy Bike Share | Connecticut and Normal,Reddy Bike Share | Creekside,Reddy Bike Share | Crofts Hall,Reddy Bike Share | D'youville College,Reddy Bike Share | Delaware Park,Reddy Bike Share | Elmwood - Auburn to Ferry (Free),Reddy Bike Share | Elmwood - Bryant to Summer (Free),Reddy Bike Share | Elmwood - Forest to Bidwell (free),Reddy Bike Share | Fargo,Reddy Bike Share | Fillmore & Glenwood,Reddy Bike Share | Five Points - Utica and Rhode Island,Reddy Bike Share | Flickinger Court,Reddy Bike Share | Flint,Reddy Bike Share | Governor's,Reddy Bike Share | Hadley,Reddy Bike Share | Hertel - Parkside to Starin,Reddy Bike Share | Hertel - Winston to Shoshone,Reddy Bike Share | Hertel and N Park,Reddy Bike Share | LaSalle Station,Reddy Bike Share | Lafayette and Grant,Reddy Bike Share | Larkinville,Reddy Bike Share | Left Bank,Reddy Bike Share | M&T Plaza,Reddy Bike Share | Main St - Tupper to Chippewa,Reddy Bike Share | Military & Amherst St.,Reddy Bike Share | Moody Terrace,Reddy Bike Share | NFTA Bus Station,Reddy Bike Share | Norton Hall,Reddy Bike Share | Porter and Normal (Free),Reddy Bike Share | Riverworks,Reddy Bike Share | Roosevelt Plaza,Reddy Bike Share | Rotary and Hayes,Reddy Bike Share | Sahlen Field,Reddy Bike Share | Science Museum Free Parking,Reddy Bike Share | South Lake,Reddy Bike Share | Spaulding,Reddy Bike Share | Student Union,Reddy Bike Share | The Westin Hotel on Delaware (Free),Reddy Bike Share | Turner Lofts,Reddy Bike Share | University Station,Reddy Bike Share | West Side Community Services,Relay Bike Share | 14TH & HOWELL MILL,Relay Bike Share | 5TH & ARGONNE,Relay Bike Share | ALTITUDE,Relay Bike Share | ATKINS PARK,Relay Bike Share | ATLANTIC STATION,Relay Bike Share | AUC - WOODRUFF LIBRARY,Relay Bike Share | BROAD & MITCHELL,Relay Bike Share | BUCKHEAD - PIEDMONT CENTER,Relay Bike Share | BUCKHEAD - TOWER PLACE,Relay Bike Share | CASTLEBERRY HILL,Relay Bike Share | CENTENNIAL OLYMPIC PARK,Relay Bike Share | CENTRAL PARK,Relay Bike Share | CHEROKEE & WOODWARD,Relay Bike Share | CITY HALL,Relay Bike Share | EDGEWOOD & EASTSIDE BELTLINE,Relay Bike Share | FAIRLIE-POPLAR DISTRICT,Relay Bike Share | FEDERAL RESERVE BANK OF ATLANTA,Relay Bike Share | GEORGIA TECH - BOBBY DODD STADIUM,Relay Bike Share | GEORGIA TECH - CLOUGH BUILDING,Relay Bike Share | GEORGIA TECH - CRC,Relay Bike Share | GEORGIA TECH - TRANSIT HUB,Relay Bike Share | GEORGIA TECH - WEST CAMPUS HOUSING,Relay Bike Share | GORDON-WHITE PARK,Relay Bike Share | GRANT PARK,Relay Bike Share | GREENWOOD AVE BELTLINE,Relay Bike Share | GSU ARTS & HUMANITIES BLDG,Relay Bike Share | GSU MARTA,Relay Bike Share | HARDY IVY PARK,Relay Bike Share | HIGHLAND - FREEDOM TRAIL,Relay Bike Share | HISTORIC FOURTH WARD PARK,Relay Bike Share | HISTORIC WESTSIDE VILLAGE,Relay Bike Share | HOME PARK,Relay Bike Share | INMAN PARK,Relay Bike Share | INMAN PARK VILLAGE,Relay Bike Share | IRWIN & EASTSIDE BELTLINE,Relay Bike Share | JACKSON & CHAMBERLAIN,Relay Bike Share | JACKSON STREET BRIDGE,Relay Bike Share | JUNIPER & 14TH ST,Relay Bike Share | KING OF POPS,Relay Bike Share | LITTLE FIVE POINTS,Relay Bike Share | MARTA - ARTS CENTER,Relay Bike Share | MARTA - CIVIC CENTER,Relay Bike Share | MARTA - EDGEWOOD/CANDLER PARK,Relay Bike Share | MARTA - FIVE POINTS,Relay Bike Share | MARTA - GARNETT,Relay Bike Share | MARTA - INMAN PARK,Relay Bike Share | MARTA - KING MEMORIAL,Relay Bike Share | MARTA - LENOX SQUARE,Relay Bike Share | MARTA - MIDTOWN  (NORTH),Relay Bike Share | MARTA - NORTH AVE,Relay Bike Share | MARTA - PEACHTREE CENTER,Relay Bike Share | MARTA - WEST END,Relay Bike Share | NELSON ST BRIDGE,Relay Bike Share | OUTWRIGHT STATION,Relay Bike Share | PARK & MEMORIAL,Relay Bike Share | PEACHTREE CENTER MALL,Relay Bike Share | PIEDMONT &  AUBURN,Relay Bike Share | PIEDMONT PARK & EASTSIDE BELTLINE,Relay Bike Share | PIEDMONT PARK EAST,Relay Bike Share | PIEDMONT PARK WEST,Relay Bike Share | RANDOLPH & EDGEWOOD,Relay Bike Share | SPELMAN COLLEGE AT WESTVIEW,Relay Bike Share | STATE & 11TH,Relay Bike Share | STUDIOPLEX,Relay Bike Share | SWEET AUBURN MARKET,Relay Bike Share | TECH PARKWAY,Relay Bike Share | TECH SQUARE,Relay Bike Share | THE COCA-COLA COMPANY,Relay Bike Share | VIRGINIA-HIGHLAND,Relay Bike Share | VIRTUAL HUB -  FOX THEATER (PONCE DE LEON AND PEACHTREE STREET),Relay Bike Share | VIRTUAL HUB - 17TH AND PEACHTREE STREET,Relay Bike Share | VIRTUAL HUB - ATLANTA BICYCLE COALITION,Relay Bike Share | VIRTUAL HUB - BROWNWOOD PARK RECREATION CENTER,Relay Bike Share | VIRTUAL HUB - CABBAGETOWN PARK,Relay Bike Share | VIRTUAL HUB - CANDLER PARK,Relay Bike Share | VIRTUAL HUB - CANDLER PARK MARKET,Relay Bike Share | VIRTUAL HUB - CARVER MARKET,Relay Bike Share | VIRTUAL HUB - COAN PARK RECREATION CENTER,Relay Bike Share | VIRTUAL HUB - CURRAN PARKING DECK,Relay Bike Share | VIRTUAL HUB - DUNBAR REC CENTER,Relay Bike Share | VIRTUAL HUB - EAST ATLANTA LIBRARY,Relay Bike Share | VIRTUAL HUB - EAST ATLANTA VILLAGE,Relay Bike Share | VIRTUAL HUB - GEORGIA HILL CENTER,Relay Bike Share | VIRTUAL HUB - GLENWOOD PARK,Relay Bike Share | VIRTUAL HUB - GOLDSBORO PARK,Relay Bike Share | VIRTUAL HUB - GRADUATE LIVING CENTER,Relay Bike Share | VIRTUAL HUB - GRANT PARK EAST,Relay Bike Share | VIRTUAL HUB - HIGH MUSEUM,Relay Bike Share | VIRTUAL HUB - HODGEPODGE COFFEE,Relay Bike Share | VIRTUAL HUB - HOSEA WILLIAMS AND WOODBINE,Relay Bike Share | VIRTUAL HUB - HYATT HOUSE ATLANTA,Relay Bike Share | VIRTUAL HUB - KIRKWOOD STATION,Relay Bike Share | VIRTUAL HUB - KIRKWOOD TRIANGLE,Relay Bike Share | VIRTUAL HUB - KROGER/GLEENWOOD HUB,Relay Bike Share | VIRTUAL HUB - M. RICH CENTER,Relay Bike Share | VIRTUAL HUB - MARIETTA AND BOSS STREET NW,Relay Bike Share | VIRTUAL HUB - MECHANICSVILLE LIBRARY,Relay Bike Share | VIRTUAL HUB - METROPOLITAN LIBRARY,Relay Bike Share | VIRTUAL HUB - MILLTOWN,Relay Bike Share | VIRTUAL HUB - NCR,Relay Bike Share | VIRTUAL HUB - ORMEWOOD PARK,Relay Bike Share | VIRTUAL HUB - PITTMAN REC CENTER,Relay Bike Share | VIRTUAL HUB - PONCE CITY MARKET 3RD FLOOR ACCESS TO BELTLINE,Relay Bike Share | VIRTUAL HUB - PONCE CITY MARKET SURFACE PARKING LOT,Relay Bike Share | VIRTUAL HUB - RDA SQUARE,Relay Bike Share | VIRTUAL HUB - TEMPORARY PONCE HIGHLAND,Relay Bike Share | VIRTUAL HUB - VORTEX MIDTOWN,Relay Bike Share | VIRTUAL HUB - WASHINGTON PARK,Relay Bike Share | VIRTUAL HUB - WASHINGTON PARK LIBRARY,Relay Bike Share | VIRTUAL HUB - WEST END PARK,Relay Bike Share | VIRTUAL HUB - WHITEFORD AND WOODBINE,Relay Bike Share | WALTON SPRING PARK,Relay Bike Share | WEST END STATION,Relay Bike Share | WOODRUFF PARK,Rietinbici | Comune,Rietinbici | Ponte Romano,Rietinbici | Stazione,Rietinbici | Tribunale,Rower Gminny Michałowice | Komorów WKD,Rower Gminny Michałowice | Opacz WKD,Rower Gminny Michałowice | Urząd Gminy Michałowice,Rower Gminny Michałowice | WKD Michałowice,Rower Gminny Michałowice | WKD Nowa Wieś Warszawska,Rower Gminny Michałowice | Zalew Komorowski,Rower Gminny Michałowice | ul. Szkolna,Rower Miejski Szamotuły | Gałowo,Rower Miejski Szamotuły | Ostrorogska,Rower Miejski Szamotuły | Rynek,Rower Miejski Szamotuły | ul. Adama Mickiewicza – Zespół Szkół,Rower Miejski Szamotuły | ul. Dworcowa – Dworzec PKP,Rower Miejski Szamotuły | ul. Ignacego Łukasiewicza – Osiedle Kopernika,Rower Miejski Szamotuły | ul. Sportowa – Centrum Sportu,Rower Miejski w Ostrowie Wielkopolskim | Centrum Przesiadkowe,Rower Miejski w Ostrowie Wielkopolskim | Dworzec PKP,Rower Miejski w Ostrowie Wielkopolskim | Galeria Ostrovia,Rower Miejski w Ostrowie Wielkopolskim | Kozi Borek,Rower Miejski w Ostrowie Wielkopolskim | MAHLE,Rower Miejski w Ostrowie Wielkopolskim | Olimpijska,Rower Miejski w Ostrowie Wielkopolskim | Piaski Szczygliczka,Rower Miejski w Ostrowie Wielkopolskim | Pruślin szkoła,Rower Miejski w Ostrowie Wielkopolskim | Rynek,Rower Miejski w Ostrowie Wielkopolskim | Targowisko,Rower Miejski w Ostrowie Wielkopolskim | Urząd Miejski,Rower Miejski w Ostrowie Wielkopolskim | Urząd Skarbowy,Rowerowe Łódzkie | Al. ZHP / Parking,Rowerowe Łódzkie | Andersa,Rowerowe Łódzkie | Aquapark Kutno,Rowerowe Łódzkie | Armii Krajowej,Rowerowe Łódzkie | Biblioteka,Rowerowe Łódzkie | Bohaterów Września,Rowerowe Łódzkie | Brzezińska,Rowerowe Łódzkie | Dworcowa - Łowicz Główny,Rowerowe Łódzkie | Dworzec PKP,Rowerowe Łódzkie | Dworzec PKP Koluszki,Rowerowe Łódzkie | Dworzec PKS,Rowerowe Łódzkie | Fijałkowskiego/ Dworzec Zgierz Jaracza,Rowerowe Łódzkie | Grunwaldzka - SP 3,Rowerowe Łódzkie | Hala Sportowa,Rowerowe Łódzkie | Kaliska - pływalnia,Rowerowe Łódzkie | Karsznice – Leśmiana,Rowerowe Łódzkie | Karsznice – Plac Zwycięstwa,Rowerowe Łódzkie | Kasztanowa / Zamoyskiego,Rowerowe Łódzkie | Kobusiewicza – MOSiR,Rowerowe Łódzkie | Kolejowa / Dworzec PKP,Rowerowe Łódzkie | Kutnowski Dom Kultury,Rowerowe Łódzkie | Lipowa / Os. Chełmy,Rowerowe Łódzkie | Lisowice,Rowerowe Łódzkie | MOSiR,Rowerowe Łódzkie | MOSiR - stadion,Rowerowe Łódzkie | Malinka / Os. Podleśna,Rowerowe Łódzkie | Medyczna,Rowerowe Łódzkie | Muzeum w Gałkowie Dużym,Rowerowe Łódzkie | Nowy Rynek,Rowerowe Łódzkie | Odlewnicza/ Budowlanych,Rowerowe Łódzkie | Orlik,Rowerowe Łódzkie | Orlik SP10,Rowerowe Łódzkie | Osiedle Dybów/ plac zabaw,Rowerowe Łódzkie | Osiedle za Szpitalem,Rowerowe Łódzkie | Osiedle Łąkoszyn,Rowerowe Łódzkie | PKP Gałkówek,Rowerowe Łódzkie | PKP Słotwiny,Rowerowe Łódzkie | Park Broniewskiego,Rowerowe Łódzkie | Park Miejski,Rowerowe Łódzkie | Parkowa - Browar,Rowerowe Łódzkie | Parzęczewska / Dworzec Zgierz Północ,Rowerowe Łódzkie | Plac Dworcowy,Rowerowe Łódzkie | Plac Kilińskiego,Rowerowe Łódzkie | Plac Wolności – Ratusz,Rowerowe Łódzkie | Plac Zabaw- Gałkówek,Rowerowe Łódzkie | Plac Żelazny – Dworzec,Rowerowe Łódzkie | Podleśna,Rowerowe Łódzkie | Powstańców Śląskich / Kurak,Rowerowe Łódzkie | Południe – Gierymskiego,Rowerowe Łódzkie | Przychodnia,Rowerowe Łódzkie | Rondo Wyszyńskiego,Rowerowe Łódzkie | Rynek,Rowerowe Łódzkie | Rzeka Warta,Rowerowe Łódzkie | SP 9,Rowerowe Łódzkie | Sadowa -os. Górki,Rowerowe Łódzkie | Sieradz Warta PKP,Rowerowe Łódzkie | Srebrna – Przychodnia,Rowerowe Łódzkie | Staffa / Os. 650-lecia,Rowerowe Łódzkie | Starościńska,Rowerowe Łódzkie | Stary Rynek,Rowerowe Łódzkie | Stary Rynek 22,Rowerowe Łódzkie | Starzyńskiego - targowisko,Rowerowe Łódzkie | Strefa,Rowerowe Łódzkie | Szkoła Różyca,Rowerowe Łódzkie | Szymanowskiego / Rondo,Rowerowe Łódzkie | Targowisko,Rowerowe Łódzkie | Urząd Miasta,Rowerowe Łódzkie | Urząd Miejski,Rowerowe Łódzkie | Wiewiórskiej / Os. Krzywie,Rowerowe Łódzkie | Witkacego / Os. 650-lecia,Rowerowe Łódzkie | Wyszyńskiego/ SP nr 7,Rowerowe Łódzkie | Wzgórze Zamkowe,Rowerowe Łódzkie | Zduńska – Kępina,Rowerowe Łódzkie | Zieleń,Rowerowe Łódzkie | Złota – SP 6,Rowerowe Łódzkie | pl. marsz. J. Piłsudskiego,Rowerowe Łódzkie | ul. 20 Stycznia 62,Rowerowe Łódzkie | ul. Grota - Roweckiego 3,Rowerowe Łódzkie | ul. Grota - Roweckiego/ ul. Nawrockiego,Rowerowe Łódzkie | ul. Jana Pawła II 68,Rowerowe Łódzkie | ul. Kilińskiego/ ul. Zamkowa,Rowerowe Łódzkie | ul. Konwaliowa,Rowerowe Łódzkie | ul. Lipowa,Rowerowe Łódzkie | ul. Makowska,Rowerowe Łódzkie | ul. Moniuszki 132,Rowerowe Łódzkie | ul. Nowobielańska,Rowerowe Łódzkie | ul. Rawska,Rowerowe Łódzkie | ul. Rynek,Rowerowe Łódzkie | ul. Szarych Szeregów,Rowerowe Łódzkie | ul. Waltera - Jankego/ ul. Nawrockiego,Rowerowe Łódzkie | ul. Warszawska 113,Rowerowe Łódzkie | ul. Warszawska 65,Rowerowe Łódzkie | ul. Wita Stwosza,Rowerowe Łódzkie | ul. Wyszyńskiego / Moniuszki,Rowerowe Łódzkie | ul. Zamkowa 64,Rowerowe Łódzkie | ul. Łaska 35,Rowerowe Łódzkie | ul. Św. M. Kolbego,Rowerowe Łódzkie | ul. św. Jana/ ul. Partyzancka,Rowerowe Łódzkie | Łask - Kolumna Plac Szarych Szeregów,Rowerowe Łódzkie | Łask - Kolumna ul. Lipowa,Rowerowe Łódzkie | Łask ul. Inki - Danuty Siedzikówny,Rowerowe Łódzkie | Łask ul. Jana Pawła II,Rowerowe Łódzkie | Łask ul. Szkolna,Rowerowe Łódzkie | Łask ul. Zielona,Rowerowe Łódzkie | Łaska – Pogoń,Rowerowe Łódzkie | Łowicz Przedmieście,Rowerowe Łódzkie | Łódzka – SP 12,Rowerowe Łódzkie | Łódź Andrzejów,Rowerowe Łódzkie | Łódź Arturówek,Rowerowe Łódzkie | Łódź Chojny,Rowerowe Łódzkie | Łódź Dąbrowa,Rowerowe Łódzkie | Łódź Fabryczna,Rowerowe Łódzkie | Łódź Kaliska,Rowerowe Łódzkie | Łódź Lublinek,Rowerowe Łódzkie | Łódź Marysin,Rowerowe Łódzkie | Łódź Niciarniana,Rowerowe Łódzkie | Łódź Pabianicka,Rowerowe Łódzkie | Łódź Radogoszcz Zachód,Rowerowe Łódzkie | Łódź Stoki,Rowerowe Łódzkie | Łódź Widzew,Rowerowe Łódzkie | Łódź Żabieniec,Rowerowe Łódzkie | Łąkoszyńska - SP6,Rowerowe Łódzkie | Ścieżka rowerowa Gałków- Justynów,Rowerowe Łódzkie | Świerkowa – Świetlica,Rowerowe Łódzkie | Świetlica w Starym Redzeniu,SWA Rad | Augsburg Nord,SWA Rad | City Galerie,SWA Rad | Die Junge Werkstatt,SWA Rad | Donauwörther Straße,SWA Rad | Ernst-Reuter-Platz,SWA Rad | Fachhochschule,SWA Rad | Friedberger Str. 165a,SWA Rad | Gaswerk,SWA Rad | Hammerschmiede,SWA Rad | Haunstetten-Nord,SWA Rad | Haunstetten-West,SWA Rad | Hauptbahnhof Radstation,SWA Rad | Hessing Kliniken,SWA Rad | Jugendherberge,SWA Rad | Karolinenstraße,SWA Rad | Kriegshaber,SWA Rad | Königsplatz,SWA Rad | Lechhausen / Neuer Ostfriedhof,SWA Rad | MAN,SWA Rad | Oberhausen Bahnhof,SWA Rad | P+R Friedberg-West,SWA Rad | Pfersee,SWA Rad | Rotes Tor,SWA Rad | SWA-Info-Box,SWA Rad | Schillstraße 98,SWA Rad | Sparkasse Halderstraße,SWA Rad | Stadtbergen / Altenheim,SWA Rad | Stadtwerke,SWA Rad | Universität Augsburg,SWA Rad | Zentralklinikum,SWA Rad | Zoo / Botanischer Garten,SWell Cycle | 101 W Evergreen,SWell Cycle | 1111 S. Alamo,SWell Cycle | 120 9th St,SWell Cycle | 1221 Broadway,SWell Cycle | 1800 Broadway,SWell Cycle | 200 W Jones,SWell Cycle | 2000 S Presa,SWell Cycle | 2332 N St. Mary's,SWell Cycle | 285 Mission Parkway,SWell Cycle | 305 E. Houston,SWell Cycle | 423 Blue Star,SWell Cycle | 430 Austin Street,SWell Cycle | 502 Brooklyn Ave,SWell Cycle | 801 North Olive,SWell Cycle | 8th St @ N Alamo,SWell Cycle | Ace Mart,SWell Cycle | Acequia Park,SWell Cycle | Alamo Plaza,SWell Cycle | Bexar County Garage,SWell Cycle | Blue Star,SWell Cycle | Brooks Greenline Park,SWell Cycle | Cesar Chavez@S. St. Mary's,SWell Cycle | Concepcion Park,SWell Cycle | Confluence Park,SWell Cycle | Convention Center Garage @ Bowie,SWell Cycle | Crockett Street,SWell Cycle | Eco Centro,SWell Cycle | Ellis Alley,SWell Cycle | Flores @ Cesar Chavez,SWell Cycle | Geekdom,SWell Cycle | Hemisfair Park,SWell Cycle | Hotel Havana,SWell Cycle | Labor@Santos,SWell Cycle | Main Plaza,SWell Cycle | Main@Sheridan,SWell Cycle | Market Square,SWell Cycle | Milam Park,SWell Cycle | Mission Espada,SWell Cycle | Mission Park Pavilions,SWell Cycle | Mission Road,SWell Cycle | Mission San Jose,SWell Cycle | Mission San Juan,SWell Cycle | Padre Park,SWell Cycle | Pearl Culinary Gardens,SWell Cycle | Pearl@Hotel Emma,SWell Cycle | Programadmincaleb,SWell Cycle | Roosevelt Park,SWell Cycle | S. Alamo@Nueva,SWell Cycle | S. St. Mary's@S. Alamo,SWell Cycle | S.A. Central Library,SWell Cycle | S.A.W.S.,SWell Cycle | S.W. General Hospital,SWell Cycle | SA Zoo,SWell Cycle | SAC @ Candler,SWell Cycle | Stadium Dr @ Jesse Jones Rec Area,SWell Cycle | The DoSeum,SWell Cycle | The Luxury,SWell Cycle | Travis Park,SWell Cycle | USO,SWell Cycle | Visitor's Center,SWell Cycle | Weston Centre,SWell Cycle | Witte @ Parking Garage,SWell Cycle | YMCA Tripoint,SWell Cycle | Yanaguana Garden,Saluzzo | Garibaldi,Saluzzo | Ospedale,Saluzzo | Piemonte,Saluzzo | Poste,Saluzzo | Risorgimento,Saluzzo | Stazione Bus,Saluzzo | Stazione FF.SS.,Saluzzo | Tribunale,Saluzzo | XX Settembre,Santander Cycles MK | Bradwell - Loughton Road,Santander Cycles MK | Bradwell Common  - Community Centre,Santander Cycles MK | Broughton - Oakworth Ave,Santander Cycles MK | Broughton - Warwick Ave,Santander Cycles MK | Caldecotte - Lakeside Grove,Santander Cycles MK | Caldecotte Lake - Monellan Grove,Santander Cycles MK | Central Milton Keynes  - Intu,Santander Cycles MK | Central Milton Keynes - Milton Keynes Theatre,Santander Cycles MK | Central Milton Keynes - Rillaton Walk,Santander Cycles MK | Central Milton Keynes - Santander,Santander Cycles MK | Central Milton Keynes - Train Station,Santander Cycles MK | Central Milton Keynes - Xscape,Santander Cycles MK | Crownhill - Lennon Dr,Santander Cycles MK | Downs Barn,Santander Cycles MK | Emerson Valley -Winfold Lane,Santander Cycles MK | Great Holm - Highgrove Hill,Santander Cycles MK | Great Linford - Central St Ledger Drive,Santander Cycles MK | Heelands - Glovers Lane,Santander Cycles MK | Kents Hill - Frithwood Cres,Santander Cycles MK | Kingston - Library,Santander Cycles MK | Linford Wood Business Park,Santander Cycles MK | Loughton - Paynes Drive Local Centre,Santander Cycles MK | MK Dons Stadium,Santander Cycles MK | Middleton - Noon Layer Dr,Santander Cycles MK | Monkston park - Plaistow Cres,Santander Cycles MK | Oakridge - Selkirk Drive,Santander Cycles MK | Oldbrook - Grafton Retail Park,Santander Cycles MK | Open University - St Michaels Drive,Santander Cycles MK | Shenley Brook End - Egerton Gate,Santander Cycles MK | Shenley Church End - Benbow Ct,Santander Cycles MK | Shenley Wood - Santander,Santander Cycles MK | Shenley lodge - Murrey Cl,Santander Cycles MK | Springfield - Ravensbourne Pl South,Santander Cycles MK | Tattenhoe - Giles Brook School,Santander Cycles MK | Tilbrook - Bradbourne Dr,Santander Cycles MK | Transport Systems Catapult,Santander Cycles MK | Two Mile Ash - The High Street,Santander Cycles MK | Walnut Tree - Hindhead Knoll,Santander Cycles MK | Walnut Tree - Lichfield Down South,Santander Cycles MK | Willen - Beaufort Drive,Santander Cycles MK | Willen Lake - Leisure Centre,Santander Cycles MK | Woolstone - Mill Lane,"Santander Cycles | 000959 - Milroy Walk, South Bank","Santander Cycles | 000960 - Hop Exchange, The Borough","Santander Cycles | 000961 - Union Street, The Borough","Santander Cycles | 000962 - Stamford Street, South Bank","Santander Cycles | 000963 - Bankside Mix, Bankside","Santander Cycles | 000964 - Bath Street, St. Luke's","Santander Cycles | 000965 - Tachbrook Street, Victoria","Santander Cycles | 000966 - New Kent Road, The Borough","Santander Cycles | 000967 - Golden Lane, Barbican","Santander Cycles | 000969 - Gower Place , Euston","Santander Cycles | 000970 - Scala Street, Fitzrovia","Santander Cycles | 000971 - Godliman Street, St. Paul's","Santander Cycles | 000972 - Hampstead Road, Euston","Santander Cycles | 000973 - Bethnal Green Road, Shoreditch","Santander Cycles | 000974 - Guilford Street , Bloomsbury","Santander Cycles | 000975 - Theobald's Road , Holborn","Santander Cycles | 000976 - Longford Street, The Regent's Park","Santander Cycles | 000978 - Russell Square Station, Bloomsbury","Santander Cycles | 000979 - Wenlock Road , Hoxton","Santander Cycles | 000980 - Malet Street, Bloomsbury","Santander Cycles | 000981 - British Museum, Bloomsbury","Santander Cycles | 000982 - Holborn Circus, Holborn","Santander Cycles | 000983 - Euston Road, Euston","Santander Cycles | 000984 - Finsbury Circus, Liverpool Street","Santander Cycles | 000985 - Hatton Garden, Holborn","Santander Cycles | 000986 - Finsbury Library , Finsbury","Santander Cycles | 000988 - Great Russell Street, Bloomsbury","Santander Cycles | 000989 - Murray Grove , Hoxton","Santander Cycles | 000990 - Cotton Garden Estate, Kennington","Santander Cycles | 000991 - Crosswall, Tower","Santander Cycles | 000992 - St. John Street, Finsbury","Santander Cycles | 000993 - Drummond Street , Euston","Santander Cycles | 000994 - Tanner Street, Bermondsey","Santander Cycles | 000995 - Little Argyll Street, West End","Santander Cycles | 000996 - Borough High Street, The Borough","Santander Cycles | 000997 - Worship Street, Shoreditch","Santander Cycles | 000998 - Lollard Street, Vauxhall","Santander Cycles | 000999 - Queen Street 1, Bank","Santander Cycles | 001000 - Vauxhall Cross, Vauxhall","Santander Cycles | 001001 - West Cromwell Road, Earl's Court","Santander Cycles | 001002 - Holy Trinity Brompton, Knightsbridge","Santander Cycles | 001003 - Chapel Place, Marylebone","Santander Cycles | 001004 - Doric Way , Somers Town","Santander Cycles | 001005 - Eversholt Street , Camden Town","Santander Cycles | 001006 - Bayley Street , Bloomsbury","Santander Cycles | 001007 - Drury Lane, Covent Garden","Santander Cycles | 001008 - Hatton Wall, Holborn","Santander Cycles | 001009 - Taviton Street, Bloomsbury","Santander Cycles | 001010 - Cartwright Gardens , Bloomsbury","Santander Cycles | 001011 - Belgrove Street , King's Cross","Santander Cycles | 001012 - Christopher Street, Liverpool Street","Santander Cycles | 001013 - St. Chad's Street, King's Cross","Santander Cycles | 001015 - New Globe Walk, Bankside","Santander Cycles | 001016 - Hereford Road, Bayswater","Santander Cycles | 001017 - Great Dover Street, The Borough","Santander Cycles | 001018 - Phillimore Gardens, Kensington","Santander Cycles | 001019 - Ampton Street , Clerkenwell","Santander Cycles | 001020 - Leonard Circus , Shoreditch","Santander Cycles | 001021 - Bouverie Street, Temple","Santander Cycles | 001022 - Brunswick Square, Bloomsbury","Santander Cycles | 001023 - River Street , Clerkenwell","Santander Cycles | 001024 - Park Street, Bankside","Santander Cycles | 001025 - Bolsover Street, Fitzrovia","Santander Cycles | 001026 - Roscoe Street, St. Luke's","Santander Cycles | 001027 - Warwick Avenue Station, Maida Vale","Santander Cycles | 001028 - William IV Street, Strand","Santander Cycles | 001029 - Windsor Terrace, Hoxton","Santander Cycles | 001030 - Lisson Grove, St. John's Wood","Santander Cycles | 001031 - Nesham Street, Wapping","Santander Cycles | 001032 - New Inn Yard, Shoreditch","Santander Cycles | 001033 - Paddington Street, Marylebone","Santander Cycles | 001034 - Bruton Street, Mayfair","Santander Cycles | 001035 - Boston Place, Marylebone","Santander Cycles | 001036 - Crawford Street, Marylebone","Santander Cycles | 001037 - Park Lane , Hyde Park","Santander Cycles | 001038 - Harrington Square 1, Camden Town","Santander Cycles | 001039 - Wapping High Street, Wapping","Santander Cycles | 001040 - West Smithfield Rotunda, Farringdon","Santander Cycles | 001041 - Westbourne Grove, Bayswater","Santander Cycles | 001042 - Woodstock Street, Mayfair","Santander Cycles | 001043 - Museum of London, Barbican","Santander Cycles | 001044 - The Guildhall, Guildhall","Santander Cycles | 001045 - Jewry Street, Aldgate","Santander Cycles | 001046 - Vauxhall Bridge , Pimlico","Santander Cycles | 001047 - Falkirk Street, Hoxton","Santander Cycles | 001048 - Queen Victoria Street, St. Paul's","Santander Cycles | 001049 - Finsbury Leisure Centre, St. Luke's","Santander Cycles | 001050 - Park Road (Baker Street), The Regent's Park","Santander Cycles | 001051 - Shoreditch Park, Hoxton","Santander Cycles | 001052 - Soho Square , Soho","Santander Cycles | 001053 - Clerkenwell Green, Clerkenwell","Santander Cycles | 001054 - East Road, Hoxton","Santander Cycles | 001055 - Wellington Road, St. John's Wood","Santander Cycles | 001056 - Finsbury Square , Moorgate","Santander Cycles | 001057 - Hardwick Street, Clerkenwell","Santander Cycles | 001058 - Edgware Road Station, Marylebone","Santander Cycles | 001059 - Albert Embankment, Vauxhall","Santander Cycles | 001060 - Torrens Street, Angel","Santander Cycles | 001062 - Braham Street, Aldgate","Santander Cycles | 001063 - Wood Street, Guildhall","Santander Cycles | 001064 - Old Street Station, St. Luke's","Santander Cycles | 001065 - Aldersgate Street, Barbican","Santander Cycles | 001066 - Calshot Street , King's Cross","Santander Cycles | 001067 - St. James's Square, St. James's","Santander Cycles | 001068 - Norton Folgate, Liverpool Street","Santander Cycles | 001069 - Eaton Square, Belgravia","Santander Cycles | 001070 - Bricklayers Arms, Borough","Santander Cycles | 001072 - Waterloo Station 3, Waterloo","Santander Cycles | 001073 - Kennington Road Post Office, Oval","Santander Cycles | 001074 - Newgate Street , St. Paul's","Santander Cycles | 001075 - Hyde Park Corner, Hyde Park","Santander Cycles | 001076 - Walnut Tree Walk, Vauxhall","Santander Cycles | 001077 - Royal London Hospital, Whitechapel","Santander Cycles | 001078 - Lambeth Road, Vauxhall","Santander Cycles | 001079 - Endsleigh Gardens, Euston","Santander Cycles | 001080 - Great Tower Street, Monument","Santander Cycles | 001081 - Liverpool Road (N1 Centre), Angel","Santander Cycles | 001082 - Borough Road, Elephant & Castle","Santander Cycles | 001083 - Commercial Street, Shoreditch","Santander Cycles | 001084 - Pindar Street, Liverpool Street","Santander Cycles | 001085 - Old Quebec Street, Marylebone","Santander Cycles | 001086 - Baker Street, Marylebone","Santander Cycles | 001087 - Belgrave Road, Victoria","Santander Cycles | 001088 - Triangle Car Park, Hyde Park","Santander Cycles | 001089 - Queen's Gate (Central), South Kensington","Santander Cycles | 001090 - Warren Street Station, Euston","Santander Cycles | 001091 - St. John's Wood Church, The Regent's Park","Santander Cycles | 001092 - Moorfields, Moorgate","Santander Cycles | 001093 - Kennington Cross, Kennington","Santander Cycles | 001094 - Wright's Lane, Kensington","Santander Cycles | 001095 - LSBU (Borough Road), Elephant & Castle","Santander Cycles | 001096 - Bayswater Road, Hyde Park","Santander Cycles | 001097 - Northumberland Avenue, Strand","Santander Cycles | 001099 - Frampton Street, Paddington","Santander Cycles | 001100 - Strand, Strand","Santander Cycles | 001101 - Knightsbridge, Hyde Park","Santander Cycles | 001102 - Leman Street, Aldgate","Santander Cycles | 001103 - Gloucester Street, Pimlico","Santander Cycles | 001104 - Claremont Square, Angel","Santander Cycles | 001105 - LMU Commercial Road, Whitechapel","Santander Cycles | 001106 - Rampayne Street, Pimlico","Santander Cycles | 001107 - Gloucester Road Station, South Kensington","Santander Cycles | 001108 - North Wharf Road, Paddington","Santander Cycles | 001109 - Wellington Arch, Hyde Park","Santander Cycles | 001110 - Palace Gate, Kensington Gardens","Santander Cycles | 001111 - Jubilee Gardens, South Bank","Santander Cycles | 001112 - Nutford Place, Marylebone","Santander Cycles | 001113 - Trebovir Road, Earl's Court","Santander Cycles | 001114 - Pont Street, Knightsbridge","Santander Cycles | 001115 - Ilchester Place, Kensington","Santander Cycles | 001116 - Emperor's Gate, South Kensington","Santander Cycles | 001117 - Lambeth North Station, Waterloo","Santander Cycles | 001118 - Hampton Street, Walworth","Santander Cycles | 001120 - Chepstow Villas, Notting Hill","Santander Cycles | 001121 - Lexham Gardens, Kensington","Santander Cycles | 001122 - Ashley Place, Victoria","Santander Cycles | 001123 - Southampton Place, Holborn","Santander Cycles | 001124 - Sumner Place, South Kensington","Santander Cycles | 001125 - Great Marlborough Street, Soho","Santander Cycles | 001126 - North Audley Street, Mayfair","Santander Cycles | 001127 - Risinghill Street, Angel","Santander Cycles | 001128 - New North Road 1, Hoxton","Santander Cycles | 001129 - Paddington Green Police Station, Paddington","Santander Cycles | 001130 - Grove End Road, St. John's Wood","Santander Cycles | 001131 - Graham Street, Angel","Santander Cycles | 001132 - Albert Gate, Hyde Park","Santander Cycles | 001133 - Baylis Road, Waterloo","Santander Cycles | 001134 - Warwick Road, Olympia","Santander Cycles | 001136 - London Zoo,  The Regent's Park","Santander Cycles | 001137 - Harper Road, The Borough","Santander Cycles | 001138 - Elizabeth Bridge, Victoria","Santander Cycles | 001139 - Carey Street, Holborn","Santander Cycles | 001140 - Grosvenor Road, Pimlico","Santander Cycles | 001141 - Kingsway, Covent Garden","Santander Cycles | 001142 - Tooley Street, Bermondsey","Santander Cycles | 001143 - Kensington Church Street, Kensington","Santander Cycles | 001144 - Poured Lines, Bankside","Santander Cycles | 001145 - Earnshaw Street , Covent Garden","Santander Cycles | 001146 - Tysoe Street, Clerkenwell","Santander Cycles | 001147 - Clifton Road, Maida Vale","Santander Cycles | 001148 - Queen Mother Sports Centre, Victoria","Santander Cycles | 001152 - Marylebone Lane, Marylebone","Santander Cycles | 001153 - Pall Mall East, West End","Santander Cycles | 001154 - Kennington Road  , Vauxhall","Santander Cycles | 001155 - Regency Street, Westminster","Santander Cycles | 001156 - Bedford Way, Bloomsbury","Santander Cycles | 001157 - Black Lion Gate, Kensington Gardens","Santander Cycles | 001158 - St. Martin's Street, West End","Santander Cycles | 001159 - Berry Street, Clerkenwell","Santander Cycles | 001160 - Craven Street, Strand","Santander Cycles | 001161 - Brushfield Street, Liverpool Street","Santander Cycles | 001162 - Dorset Square, Marylebone","Santander Cycles | 001163 - Wardour Street, Soho","Santander Cycles | 001164 - Portland Place, Marylebone","Santander Cycles | 001165 - Riverlight North, Nine Elms","Santander Cycles | 001166 - Bell Street , Marylebone","Santander Cycles | 001167 - South Wharf Road, Paddington","Santander Cycles | 001169 - Grosvenor Crescent, Belgravia","Santander Cycles | 001170 - Horseferry Road, Westminster","Santander Cycles | 001171 - New Road 1 , Whitechapel","Santander Cycles | 001172 - Queen's Gate (South), South Kensington","Santander Cycles | 001173 - Gloucester Terrace, Bayswater","Santander Cycles | 001174 - Alderney Street, Pimlico","Santander Cycles | 001175 - Mallory Street, Marylebone","Santander Cycles | 001176 - Waterloo Road, South Bank","Santander Cycles | 001177 - Seville Street, Knightsbridge","Santander Cycles | 001178 - Cleveland Gardens, Bayswater","Santander Cycles | 001179 - Chelsea Green, Chelsea","Santander Cycles | 001180 - Bourne Street, Belgravia","Santander Cycles | 001182 - Notting Hill Gate Station, Notting Hill","Santander Cycles | 001183 - Bramham Gardens, Earl's Court","Santander Cycles | 001184 - St. Mary Axe, Aldgate","Santander Cycles | 001186 - Belvedere Road 1, South Bank","Santander Cycles | 001187 - St. John's Wood Road, St. John's Wood","Santander Cycles | 001188 - London Zoo Car Park, The Regent's Park","Santander Cycles | 001189 - Long Lane , Bermondsey","Santander Cycles | 001190 - Kennington Lane Rail Bridge, Vauxhall","Santander Cycles | 001191 - Barbican Centre, Barbican","Santander Cycles | 001193 - Kensington Gore, Knightsbridge","Santander Cycles | 001194 - Westminster University, Marylebone","Santander Cycles | 001195 - St. George's Square, Pimlico","Santander Cycles | 001196 - Vincent Square, Westminster","Santander Cycles | 001197 - Sackville Street, Mayfair","Santander Cycles | 001199 - The Tennis Courts, The Regent's Park","Santander Cycles | 001200 - Ontario Street, Elephant & Castle","Santander Cycles | 001201 - Bank of England Museum, Bank","Santander Cycles | 001202 - Wellington Street , Strand","Santander Cycles | 001203 - Eastbourne Mews, Paddington","Santander Cycles | 001204 - Queen's Gate (North), Kensington","Santander Cycles | 001205 - Black Prince Road, Vauxhall","Santander Cycles | 001206 - Montpelier Street, Knightsbridge","Santander Cycles | 001207 - Tavistock Street, Covent Garden","Santander Cycles | 001208 - Dickens Square, Borough","Santander Cycles | 001209 - Empire Square, The Borough","Santander Cycles | 001210 - Nevern Place, Earl's Court","Santander Cycles | 001211 - Bunhill Row, Moorgate","Santander Cycles | 001212 - Concert Hall Approach 2, South Bank","Santander Cycles | 001213 - Curlew Street, Shad Thames","Santander Cycles | 001214 - Kensington Olympia Station, Olympia","Santander Cycles | 001216 - Swan Street, The Borough","Santander Cycles | 001217 - Serpentine Car Park, Hyde Park","Santander Cycles | 001218 - Flood Street, Chelsea","Santander Cycles | 001219 - Lower Marsh, Waterloo","Santander Cycles | 001220 - Imperial College, Knightsbridge","Santander Cycles | 001221 - St. George Street, Mayfair","Santander Cycles | 001222 - Goswell Road (City Uni), Finsbury","Santander Cycles | 001223 - Buxton Street 1, Shoreditch","Santander Cycles | 001224 - Vauxhall Street, Vauxhall","Santander Cycles | 001225 - George Street, Marylebone","Santander Cycles | 001226 - Macclesfield Rd, St Lukes","Santander Cycles | 001227 - Devonshire Terrace, Bayswater","Santander Cycles | 001228 - Southampton Street, Strand","Santander Cycles | 001229 - High Holborn , Covent Garden","Santander Cycles | 001230 - Millennium Hotel, Mayfair","Santander Cycles | 001231 - Queen's Gate, Kensington Gardens","Santander Cycles | 002585 - Orsett Terrace, Bayswater","Santander Cycles | 002586 - Cloudesley Road, Angel","Santander Cycles | 002587 - Wormwood Street, Liverpool Street","Santander Cycles | 002589 - Pembridge Villas, Notting Hill","Santander Cycles | 002633 - Palace Gardens Terrace, Notting Hill","Santander Cycles | 002635 - Concert Hall Approach 1, South Bank","Santander Cycles | 002636 - Prince Albert Road, The Regent's Park","Santander Cycles | 002637 - Bermondsey Street, Bermondsey","Santander Cycles | 002639 - King Edward Walk, Waterloo","Santander Cycles | 002641 - New North Road 2, Hoxton","Santander Cycles | 002648 - Waterloo Bridge, South Bank","Santander Cycles | 002649 - Sardinia Street, Holborn","Santander Cycles | 002660 - Frith Street, Soho","Santander Cycles | 002662 - Butler Place, Westminster","Santander Cycles | 002665 - Lord's, St. John's Wood","Santander Cycles | 002666 - Howick Place, Westminster","Santander Cycles | 002669 - Charlotte Street, Fitzrovia","Santander Cycles | 002670 - Paddington Green, Paddington","Santander Cycles | 002677 - Natural History Museum, South Kensington","Santander Cycles | 002678 - Farm Street, Mayfair","Santander Cycles | 002680 - Harrowby Street, Marylebone","Santander Cycles | 002681 - Harriet Street, Knightsbridge","Santander Cycles | 002682 - Turquoise Island, Notting Hill","Santander Cycles | 002683 - Millbank Tower, Pimlico","Santander Cycles | 002685 - South Kensington Station, South Kensington","Santander Cycles | 002686 - Royal College Street, Camden Town","Santander Cycles | 002687 - Brick Lane Market, Shoreditch","Santander Cycles | 002690 - City Road, Angel","Santander Cycles | 002691 - Howland Street, Fitzrovia","Santander Cycles | 002692 - Waterloo Station 2, Waterloo","Santander Cycles | 002693 - Shouldham Street, Marylebone","Santander Cycles | 002694 - Oval Way, Vauxhall","Santander Cycles | 002695 - Cadogan Gardens, Chelsea","Santander Cycles | 002696 - Waterloo Station 1, Waterloo","Santander Cycles | 002698 - Aberdeen Place, St. John's Wood","Santander Cycles | 002699 - Snow Hill, Farringdon","Santander Cycles | 002701 - Columbia Road, Shoreditch","Santander Cycles | 002703 - Fire Brigade Pier, Vauxhall","Santander Cycles | 003420 - Sedding Street, Sloane Square","Santander Cycles | 003421 - Red Lion Square, Holborn","Santander Cycles | 003422 - Charlbert Street, St. John's Wood","Santander Cycles | 003423 - Maida Vale, Maida Vale","Santander Cycles | 003424 - Broadcasting House, Marylebone","Santander Cycles | 003425 - Northington Street , Holborn","Santander Cycles | 003426 - Hampstead Road (Cartmel), Euston","Santander Cycles | 003427 - Fanshaw Street, Hoxton","Santander Cycles | 003428 - Pancras Road, King's Cross","Santander Cycles | 003429 - Abbey Orchard Street, Westminster","Santander Cycles | 003430 - Central House, Aldgate","Santander Cycles | 003431 - Grafton Street, Mayfair","Santander Cycles | 003432 - Farringdon Lane, Clerkenwell","Santander Cycles | 003433 - Sadlers Sports Centre, Finsbury","Santander Cycles | 003434 - Sancroft Street, Vauxhall","Santander Cycles | 003435 - Gloucester Road (Central), South Kensington","Santander Cycles | 003436 - Derry Street, Kensington","Santander Cycles | 003437 - Curzon Street, Mayfair","Santander Cycles | 003438 - Devonshire Square, Liverpool Street","Santander Cycles | 003439 - Tavistock Place, Bloomsbury","Santander Cycles | 003440 - Royal Avenue 1, Chelsea","Santander Cycles | 003441 - Vicarage Gate, Kensington","Santander Cycles | 003442 - Abingdon Villas, Kensington","Santander Cycles | 003444 - Penywern Road, Earl's Court","Santander Cycles | 003445 - Shoreditch High Street, Shoreditch","Santander Cycles | 003446 - De Vere Gardens, Kensington","Santander Cycles | 003447 - Gloucester Road (North), Kensington","Santander Cycles | 003448 - Webber Street , Southwark","Santander Cycles | 003449 - Breams Buildings, Holborn","Santander Cycles | 003450 - Great Titchfield Street, Fitzrovia","Santander Cycles | 003451 - Golden Square, Soho","Santander Cycles | 003452 - Panton Street, West End","Santander Cycles | 003453 - Chancery Lane, Holborn","Santander Cycles | 003454 - Denyer Street, Knightsbridge","Santander Cycles | 003455 - Arundel Street, Temple","Santander Cycles | 003457 - Rochester Row, Westminster","Santander Cycles | 003458 - Waterloo Place, St. James's","Santander Cycles | 003459 - Collingham Gardens, Earl's Court","Santander Cycles | 003460 - Warwick Square, Pimlico","Santander Cycles | 003461 - Sloane Avenue, Knightsbridge","Santander Cycles | 003462 - Royal Avenue 2, Chelsea","Santander Cycles | 003463 - Argyll Road, Kensington","Santander Cycles | 003464 - Green Street, Mayfair","Santander Cycles | 003465 - Eccleston Place, Victoria","Santander Cycles | 003467 - Dock Street, Wapping","Santander Cycles | 003468 - Margery Street, Clerkenwell","Santander Cycles | 003469 - Cadogan Place, Knightsbridge","Santander Cycles | 003470 - Great Percy Street, Clerkenwell","Santander Cycles | 003471 - Chadwell Street, Angel","Santander Cycles | 003472 - Colombo Street, Southwark","Santander Cycles | 003473 - Belgrave Square, Belgravia","Santander Cycles | 003476 - Hinde Street, Marylebone","Santander Cycles | 003477 - Porchester Place, Paddington","Santander Cycles | 003478 - Guildhouse Street, Victoria","Santander Cycles | 003479 - Old Brompton Road, South Kensington","Santander Cycles | 003480 - Smith Square, Westminster","Santander Cycles | 003481 - Rodney Road , Walworth","Santander Cycles | 003482 - Beaumont Street, Marylebone","Santander Cycles | 003483 - Fashion Street, Whitechapel","Santander Cycles | 003484 - Houghton Street, Strand","Santander Cycles | 003485 - Tyers Gate, Bermondsey","Santander Cycles | 003486 - St. Luke's Church, Chelsea","Santander Cycles | 003487 - Campden Hill Road, Notting Hill","Santander Cycles | 003488 - Charles II Street, West End","Santander Cycles | 003489 - Broadwick Street, Soho","Santander Cycles | 003490 - Southwick Street, Paddington","Santander Cycles | 003491 - Princes Square, Bayswater","Santander Cycles | 003492 - Putney Pier, Wandsworth","Santander Cycles | 003493 - South Audley Street, Mayfair","Santander Cycles | 003494 - Foley Street, Fitzrovia","Santander Cycles | 003495 - Wells Street, Fitzrovia","Santander Cycles | 003496 - Winsland Street, Paddington","Santander Cycles | 003497 - Rathbone Street, Fitzrovia","Santander Cycles | 003498 - Geraldine Street, Elephant & Castle","Santander Cycles | 003499 - Prince Consort Road, Knightsbridge","Santander Cycles | 003500 - Baldwin Street, St. Luke's","Santander Cycles | 003501 - Clifton Street, Shoreditch","Santander Cycles | 003502 - Palissy Street, Shoreditch","Santander Cycles | 003504 - Moor Street, Soho","Santander Cycles | 003505 - Marloes Road, Kensington","Santander Cycles | 003506 - Stanhope Gate, Mayfair","Santander Cycles | 003507 - Alfred Place, Bloomsbury","Santander Cycles | 010621 - Upper Grosvenor Street, Mayfair","Santander Cycles | 010623 - Greycoat Street , Westminster","Santander Cycles | 010624 - Strata, Elephant & Castle","Santander Cycles | 010625 - Penfold Street, Marylebone","Santander Cycles | 010627 - Grosvenor Square, Mayfair","Santander Cycles | 010628 - Cleaver Street, Kennington","Santander Cycles | 010629 - Walworth Road, Elephant & Castle","Santander Cycles | 010630 - George Place Mews, Marylebone","Santander Cycles | 010631 - Holland Park, Kensington","Santander Cycles | 010632 - Kensington Town Hall, Kensington","Santander Cycles | 022158 - Exhibition Road Museums, South Kensington","Santander Cycles | 022159 - Ebury Bridge, Pimlico","Santander Cycles | 022160 - Chelsea Bridge, Pimlico","Santander Cycles | 022161 - Vincent Street, Pimlico","Santander Cycles | 022162 - Southwark Station 1, Southwark","Santander Cycles | 022163 - Southwark Station 2, Southwark","Santander Cycles | 022164 - Eaton Square (South), Belgravia","Santander Cycles | 022165 - Fisherman's Walk West, Canary Wharf","Santander Cycles | 022166 - Albert Gardens, Stepney","Santander Cycles | 022167 - Millharbour, Millwall","Santander Cycles | 022169 - Wren Street, Holborn","Santander Cycles | 022170 - Kennington Station, Kennington","Santander Cycles | 022171 - Red Lion Street, Holborn","Santander Cycles | 022172 - Bromley High Street, Bow","Santander Cycles | 022173 - Old Ford Road, Bethnal Green","Santander Cycles | 022174 - Granby Street, Shoreditch","Santander Cycles | 022175 - Canton Street, Poplar","Santander Cycles | 022176 - Reardon Street, Wapping","Santander Cycles | 022177 - Christian Street, Whitechapel","Santander Cycles | 022178 - Lindfield Street, Poplar","Santander Cycles | 022179 - Exhibition Road, Knightsbridge","Santander Cycles | 022180 - Cheapside, Bank","Santander Cycles | 022181 - Harrington Square 2, Camden Town","Santander Cycles | 022182 - South Parade, Chelsea","Santander Cycles | 022183 - Crinan Street, King's Cross","Santander Cycles | 200001 - Limerston Street, West Chelsea","Santander Cycles | 200002 - Jubilee Street, Stepney","Santander Cycles | 200003 - Cheshire Street, Bethnal Green","Santander Cycles | 200004 - Lightermans Road, Millwall","Santander Cycles | 200005 - New Cavendish Street, Marylebone","Santander Cycles | 200006 - Hewison Street, Old Ford","Santander Cycles | 200007 - Holden Street, Battersea","Santander Cycles | 200008 - Portman Square, Marylebone","Santander Cycles | 200009 - Stebondale Street, Cubitt Town","Santander Cycles | 200010 - Manresa Road, Chelsea","Santander Cycles | 200011 - Furze Green, Bow","Santander Cycles | 200012 - Stepney Green Station, Stepney","Santander Cycles | 200013 - Aston Street, Stepney","Santander Cycles | 200014 - Gunmakers Lane, Old Ford","Santander Cycles | 200015 - Ladbroke Grove Central, Ladbroke Grove","Santander Cycles | 200016 - Castlehaven Road, Camden Town","Santander Cycles | 200017 - Lancaster Gate , Bayswater","Santander Cycles | 200018 - Spindrift Avenue, Millwall","Santander Cycles | 200019 - Malmesbury Road, Bow","Santander Cycles | 200020 - Shadwell Station, Shadwell","Santander Cycles | 200021 - Hermitage Court, Wapping","Santander Cycles | 200022 - Saunders Ness Road, Cubitt Town","Santander Cycles | 200023 - Heath Road, Battersea","Santander Cycles | 200024 - Queensbridge Road, Haggerston","Santander Cycles | 200025 - Bradmead, Battersea Park","Santander Cycles | 200026 - Greenland Road, Camden Town","Santander Cycles | 200027 - Ford Road, Old Ford","Santander Cycles | 200028 - Elysium Place, Fulham","Santander Cycles | 200029 - Finlay Street, Fulham","Santander Cycles | 200030 - Driffield Road, Old Ford","Santander Cycles | 200031 - East Ferry Road, Cubitt Town","Santander Cycles | 200032 - Kennington Oval, Oval","Santander Cycles | 200033 - Philpot Street, Whitechapel","Santander Cycles | 200034 - Wapping Lane, Wapping","Santander Cycles | 200035 - Walmer Road, Avondale","Santander Cycles | 200036 - Bell Lane, Liverpool Street","Santander Cycles | 200037 - Rectory Square, Stepney","Santander Cycles | 200038 - Ackroyd Drive, Bow","Santander Cycles | 200039 - Sail Street, Vauxhall","Santander Cycles | 200040 - Broomhouse Lane, Parsons Green","Santander Cycles | 200041 - Antill Road, Mile End","Santander Cycles | 200042 - York Hall, Bethnal Green","Santander Cycles | 200043 - Bishop's Avenue, Fulham","Santander Cycles | 200044 - New Fetter Lane, Holborn","Santander Cycles | 200045 - Garnet Street, Shadwell","Santander Cycles | 200046 - Napier Avenue, Millwall","Santander Cycles | 200047 - Bethnal Green Garden, Bethnal Green","Santander Cycles | 200048 - Page Street, Westminster","Santander Cycles | 200049 - St. Katharine's Way, Tower","Santander Cycles | 200050 - Naval Row, Blackwall","Santander Cycles | 200051 - Percival Street, Finsbury","Santander Cycles | 200053 - Killick Street, King's Cross","Santander Cycles | 200054 - Jubilee Crescent, Cubitt Town","Santander Cycles | 200056 - Vauxhall Walk, Vauxhall","Santander Cycles | 200057 - Belford House, Haggerston","Santander Cycles | 200058 - Northdown Street, King's Cross","Santander Cycles | 200059 - Crisp Road, Hammersmith","Santander Cycles | 200060 - Drayton Gardens, West Chelsea","Santander Cycles | 200061 - Westfield Southern Terrace ,Shepherd's Bush","Santander Cycles | 200062 - William Morris Way, Sands End","Santander Cycles | 200063 - Mexfield Road, East Putney","Santander Cycles | 200064 - Regent's Row , Haggerston","Santander Cycles | 200065 - Lansdowne Walk, Ladbroke Grove","Santander Cycles | 200066 - Import Dock, Canary Wharf","Santander Cycles | 200067 - Princedale Road , Holland Park","Santander Cycles | 200069 - Knaresborough Place, Earl's Court","Santander Cycles | 200070 - Arlington Road, Camden Town","Santander Cycles | 200071 - Hoxton Street, Hoxton","Santander Cycles | 200072 - Houndsditch, Aldgate","Santander Cycles | 200073 - Cephas Street, Bethnal Green","Santander Cycles | 200074 - Bury Place, Holborn","Santander Cycles | 200076 - Westminster Bridge Road, Elephant & Castle","Santander Cycles | 200077 - Vicarage Crescent, Battersea","Santander Cycles | 200078 - Aberfeldy Street, Poplar","Santander Cycles | 200079 - Ram Street, Wandsworth","Santander Cycles | 200080 - Russell Gardens, Olympia","Santander Cycles | 200081 - Coomer Place, West Kensington","Santander Cycles | 200082 - St. Mary & St. Michael Church, Stepney","Santander Cycles | 200083 - Pritchard's Road, Bethnal Green","Santander Cycles | 200084 - Doddington Grove, Kennington","Santander Cycles | 200086 - Ilchester Gardens, Bayswater","Santander Cycles | 200088 - Clarges Street, Mayfair","Santander Cycles | 200089 - Chrisp Street Market, Poplar","Santander Cycles | 200090 - Pennington Street, Wapping","Santander Cycles | 200091 - Wandsworth Town Station, Wandsworth","Santander Cycles | 200092 - Mudchute DLR, Cubitt Town","Santander Cycles | 200093 - Thurtle Road, Haggerston","Santander Cycles | 200094 - St. Bride Street, Holborn","Santander Cycles | 200096 - Green Park Station, Mayfair","Santander Cycles | 200097 - Beryl Road, Hammersmith","Santander Cycles | 200098 - Aintree Street, Fulham","Santander Cycles | 200099 - Upper Bank Street, Canary Wharf","Santander Cycles | 200101 - Monument Street, Monument","Santander Cycles | 200102 - Harford Street, Mile End","Santander Cycles | 200105 - Bonny Street, Camden Town","Santander Cycles | 200106 - Spanish Road, Clapham Junction","Santander Cycles | 200108 - Bishop's Bridge Road East, Bayswater","Santander Cycles | 200109 - Alpha Grove, Millwall","Santander Cycles | 200110 - Bishop's Bridge Road West, Bayswater","Santander Cycles | 200111 - Abbotsbury Road, Holland Park","Santander Cycles | 200112 - Cadogan Close, Victoria Park","Santander Cycles | 200113 - Smugglers Way, Wandsworth","Santander Cycles | 200114 - Orbel Street, Battersea","Santander Cycles | 200115 - Flamborough Street, Limehouse","Santander Cycles | 200116 - Vereker Road, West Kensington","Santander Cycles | 200118 - Parkway, Camden Town","Santander Cycles | 200119 - Dorothy Road, Clapham Junction","Santander Cycles | 200120 - Grant Road East, Clapham Junction","Santander Cycles | 200121 - Shoreditch Court, Haggerston","Santander Cycles | 200122 - Hawley Crescent, Camden Town","Santander Cycles | 200123 - Burdett Road, Mile End","Santander Cycles | 200124 - Clarendon Road, Avondale","Santander Cycles | 200125 - Putney Bridge Station, Fulham","Santander Cycles | 200126 - Usk Road, Clapham Junction","Santander Cycles | 200127 - East India DLR, Blackwall","Santander Cycles | 200128 - Queen Street 2, Bank","Santander Cycles | 200129 - Charlotte Terrace, Angel","Santander Cycles | 200131 - Clarkson Street, Bethnal Green","Santander Cycles | 200132 - Gaywood  Street, Elephant & Castle","Santander Cycles | 200133 - South Lambeth Road, Vauxhall","Santander Cycles | 200134 - Albany Street, The Regent's Park","Santander Cycles | 200135 - Selby Street, Whitechapel","Santander Cycles | 200136 - BBC White City, White City","Santander Cycles | 200137 - Caldwell Street, Stockwell","Santander Cycles | 200138 - Heron Quays DLR, Canary Wharf","Santander Cycles | 200141 - Westfield Ariel Way, White City","Santander Cycles | 200142 - Hammersmith Road, Hammersmith","Santander Cycles | 200143 - Lancaster Drive, Blackwall","Santander Cycles | 200144 - Sea Containers, South Bank","Santander Cycles | 200145 - Gloucester Avenue, Camden Town","Santander Cycles | 200146 - Newby Place, Poplar","Santander Cycles | 200147 - Salmon Lane, Limehouse","Santander Cycles | 200148 - Ansell House, Stepney","Santander Cycles | 200149 - Watney Street, Shadwell","Santander Cycles | 200150 - Cantrell Road, Bow","Santander Cycles | 200152 - Pitfield Street North,Hoxton","Santander Cycles | 200154 - Hansard Mews, Holland Park","Santander Cycles | 200156 - Pott Street, Bethnal Green","Santander Cycles | 200157 - Fournier Street, Whitechapel","Santander Cycles | 200158 - Whiston Road, Haggerston","Santander Cycles | 200159 - Goldsmith's Row, Haggerston","Santander Cycles | 200160 - Langdon Park, Poplar","Santander Cycles | 200161 - Clinton Road, Mile End","Santander Cycles | 200162 - Watney Market, Stepney","Santander Cycles | 200163 - Jubilee Plaza, Canary Wharf","Santander Cycles | 200165 - Wellington Row, Bethnal Green","Santander Cycles | 200166 - Southerton Road, Hammersmith","Santander Cycles | 200167 - Twig Folly Bridge, Mile End","Santander Cycles | 200168 - Southern Grove, Bow","Santander Cycles | 200169 - Ashley Crescent, Battersea","Santander Cycles | 200170 - Esmond Street, Putney","Santander Cycles | 200171 - Peterborough Road, Sands End","Santander Cycles | 200172 - Lansdowne Road, Ladbroke Grove","Santander Cycles | 200173 - Courland Grove, Wandsworth Road","Santander Cycles | 200174 - Mostyn Grove, Bow","Santander Cycles | 200175 - Wandsworth Rd, Isley Court, Wandsworth Road","Santander Cycles | 200176 - Sheepcote Lane, Battersea","Santander Cycles | 200177 - Santos Road, Wandsworth","Santander Cycles | 200178 - Buckingham Gate, Westminster","Santander Cycles | 200179 - Silverthorne Road, Battersea","Santander Cycles | 200180 - South Park, Sands End","Santander Cycles | 200181 - Richmond Way, Shepherd's Bush","Santander Cycles | 200182 - Rainville Road, Hammersmith","Santander Cycles | 200183 - Battersea Park Road, Nine Elms","Santander Cycles | 200184 - Erin Close, Walham Green","Santander Cycles | 200185 - St. John's Road, Clapham Junction","Santander Cycles | 200186 - Nantes Close, Wandsworth","Santander Cycles | 200187 - Morie Street, Wandsworth","Santander Cycles | 200188 - Neville Gill Close, Wandsworth","Santander Cycles | 200189 - Phene Street, Chelsea","Santander Cycles | 200190 - Queen's Circus, Battersea Park","Santander Cycles | 200191 - Spencer Park, Wandsworth Common","Santander Cycles | 200192 - Fawcett Close, Battersea","Santander Cycles | 200193 - Snowsfields, London Bridge","Santander Cycles | 200194 - Clarence Walk, Stockwell","Santander Cycles | 200195 - St Martins Close, Camden Town","Santander Cycles | 200196 - Simpson Street, Clapham Junction","Santander Cycles | 200197 - Barons Court Station, West Kensington","Santander Cycles | 200198 - Seymour Place, Marylebone","Santander Cycles | 200199 - Stanley Grove, Battersea","Santander Cycles | 200200 - Great Suffolk Street, The Borough","Santander Cycles | 200201 - Battersea Church Road, Battersea","Santander Cycles | 200202 - Storey's Gate, Westminster","Santander Cycles | 200203 - King Edward Street, St Pauls","Santander Cycles | 200204 - Northfields, Wandsworth","Santander Cycles | 200205 - Montserrat Road , Putney","Santander Cycles | 200207 - Hartington Road, Stockwell","Santander Cycles | 200208 - Sugden Road, Clapham","Santander Cycles | 200209 - Shepherd's Bush Road North, Shepherd's Bush","Santander Cycles | 200210 - Westbridge Road, Battersea","Santander Cycles | 200211 - Union Grove, Wandsworth Road","Santander Cycles | 200213 - Durant Street, Bethnal Green","Santander Cycles | 200214 - Woodstock Grove, Shepherd's Bush","Santander Cycles | 200215 - Greyhound Road, Hammersmith","Santander Cycles | 200216 - Maclise Road, Olympia","Santander Cycles | 200217 - Disraeli Road, Putney","Santander Cycles | 200219 - Osiers Road, Wandsworth","Santander Cycles | 200220 - Blythe Road West, Shepherd's Bush","Santander Cycles | 200221 - Crabtree Lane, Fulham","Santander Cycles | 200222 - Danvers Street, West Chelsea","Santander Cycles | 200223 - Ashmole Estate, Oval","Santander Cycles | 200224 - Colet Gardens, Hammersmith","Santander Cycles | 200226 - Kingsway Southbound, Strand","Santander Cycles | 200227 - Westfield Library Corner, Shepherd's Bush","Santander Cycles | 200229 - Fulham Park Road, Fulham","Santander Cycles | 200230 - The Green Bridge, Mile End","Santander Cycles | 200231 - Abingdon Green, Westminster","Santander Cycles | 200232 - Preston's Road, Cubitt Town","Santander Cycles | 200233 - South Quay East, Canary Wharf","Santander Cycles | 200234 - Bancroft Road, Bethnal Green","Santander Cycles | 200235 - Manbre Road, Hammersmith","Santander Cycles | 200236 - Greenberry Street, St.John's Wood","Santander Cycles | 200237 - Parson's Green , Parson's Green","Santander Cycles | 200238 - Westferry DLR, Limehouse","Santander Cycles | 200239 - Old Montague Street, Whitechapel","Santander Cycles | 200240 - Ferndale Road, Brixton.","Santander Cycles | 200241 - Bonner Gate, Victoria Park","Santander Cycles | 200242 - Merchant Street, Bow","Santander Cycles | 200243 - St. John's Park, Cubitt Town","Santander Cycles | 200244 - Hollybush Gardens, Bethnal Green","Santander Cycles | 200246 - Eagle Wharf Road, Hoxton","Santander Cycles | 200247 - Globe Town Market, Bethnal Green","Santander Cycles | 200248 - Pitfield Street Central, Hoxton","Santander Cycles | 200249 - Queen Mary's, Mile End","Santander Cycles | 200250 - Cleveland Way, Stepney","Santander Cycles | 200251 - Bow Road Station, Bow","Santander Cycles | 200252 - Bow Church Station, Bow","Santander Cycles | 200253 - Fore Street, Guildhall","Santander Cycles | 200254 - Teviot Street, Poplar","Santander Cycles | 200255 - Devons Road, Bow","Santander Cycles | 300001 - Sandilands Road, Walham Green","Santander Cycles | 300002 - Brook Green South, Brook Green","Santander Cycles | 300003 - Eel Brook Common, Walham Green","Santander Cycles | 300005 - Ethelburga Estate, Battersea Park","Santander Cycles | 300007 - Rifle Place, Avondale","Santander Cycles | 300008 - Normand Park, West Kensington","Santander Cycles | 300009 - World's End Place, West Chelsea","Santander Cycles | 300010 - Surrey Lane, Battersea","Santander Cycles | 300011 - Victoria Park Road, Hackney Central","Santander Cycles | 300012 - Irene Road, Parsons Green","Santander Cycles | 300013 - Austin Road, Battersea Park","Santander Cycles | 300014 - Falcon Road, Clapham Junction","Santander Cycles | 300015 - Binfield Road, Stockwell","Santander Cycles | 300018 - Charing Cross Hospital, Hammersmith","Santander Cycles | 300019 - Felsham Road, Putney","Santander Cycles | 300020 - West Kensington Station, West Kensington","Santander Cycles | 300021 - Podium, Queen Elizabeth Olympic Park","Santander Cycles | 300022 - Evesham Street, Avondale","Santander Cycles | 300023 - All Saints Church, Portobello","Santander Cycles | 300024 - Dunston Road , Haggerston","Santander Cycles | 300025 - Archbishop's Park, Waterloo","Santander Cycles | 300026 - All Saints' Road, Portobello","Santander Cycles | 300027 - Mile End Park Leisure Centre, Mile End","Santander Cycles | 300028 - Everington Street, Fulham","Santander Cycles | 300029 - Lee Valley VeloPark, Queen Elizabeth Olympic Park","Santander Cycles | 300030 - Thorndike Close, West Chelsea","Santander Cycles | 300031 - Islington Green, Angel","Santander Cycles | 300032 - Victoria & Albert Museum, South Kensington","Santander Cycles | 300033 - Putney Rail Station, Putney","Santander Cycles | 300034 - St. Mark's Road, North Kensington","Santander Cycles | 300035 - Carnegie Street, King's Cross","Santander Cycles | 300036 - Teversham Lane, Stockwell","Santander Cycles | 300037 - Ravenscourt Park Station, Hammersmith","Santander Cycles | 300038 - Star Road, West Kensington","Santander Cycles | 300039 - Wendon Street, Old Ford","Santander Cycles | 300040 - Ada Street, Hackney Central","Santander Cycles | 300041 - Finnis Street, Bethnal Green","Santander Cycles | 300042 - Upper Richmond Road, Putney","Santander Cycles | 300043 - St. Peter's Terrace, Fulham","Santander Cycles | 300044 - Putney Bridge Road, East Putney","Santander Cycles | 300045 - Albert Bridge Road, Battersea Park","Santander Cycles | 300046 - Alma Road, Wandsworth","Santander Cycles | 300047 - Alfreda Street, Battersea Park","Santander Cycles | 300048 - Stainsby Road , Poplar","Santander Cycles | 300049 - Aylward Street, Stepney","Santander Cycles | 300050 - Walworth Square, Walworth","Santander Cycles | 300051 - Hibbert Street, Battersea","Santander Cycles | 300052 - Parsons Green Station, Parsons Green","Santander Cycles | 300053 - Stephendale Road, Sands End","Santander Cycles | 300054 - Chesilton Road, Fulham","Santander Cycles | 300055 - Stewart's Road, Wandsworth Road","Santander Cycles | 300056 - Mile End Stadium, Mile End","Santander Cycles | 300058 - The Vale, Chelsea","Santander Cycles | 300064 - Ranelagh Gardens, Fulham","Santander Cycles | 300065 - Clapham Common North Side, Clapham Common","Santander Cycles | 300067 - Grenfell Road, Avondale","Santander Cycles | 300068 - Humbolt Road, Fulham","Santander Cycles | 300069 - Harcourt Terrace, West Brompton","Santander Cycles | 300070 - Imperial Wharf Station, Sands End","Santander Cycles | 300071 - Rossmore Road, Marylebone","Santander Cycles | 300072 - Broadley Terrace, Marylebone","Santander Cycles | 300073 - Prince of Wales Drive, Battersea Park","Santander Cycles | 300074 - Newton Street, Covent Garden","Santander Cycles | 300075 - Upcerne Road, West Chelsea","Santander Cycles | 300076 - Lots Road, West Chelsea","Santander Cycles | 300077 - Ingrave Street, Clapham Junction","Santander Cycles | 300078 - Oxford Road, Putney","Santander Cycles | 300079 - Manfred Road, East Putney","Santander Cycles | 300080 - Culvert Road, Battersea","Santander Cycles | 300081 - Haggerston Road, Haggerston","Santander Cycles | 300082 - Bridge Avenue, Hammersmith","Santander Cycles | 300083 - Duke Street Hill, London Bridge","Santander Cycles | 300084 - Sirdar Road, Avondale","Santander Cycles | 300085 - Freston Road, Avondale","Santander Cycles | 300086 - Fulham Broadway, Walham Green","Santander Cycles | 300087 - Imperial Road, Sands End","Santander Cycles | 300088 - Queensdale Road, Shepherd's Bush","Santander Cycles | 300089 - Ormonde Gate, Chelsea","Santander Cycles | 300090 - Blenheim Crescent, Ladbroke Grove","Santander Cycles | 300091 - Hortensia Road, West Brompton","Santander Cycles | 300092 - Hertford Road, De Beauvoir Town","Santander Cycles | 300093 - Park Lane, Mayfair","Santander Cycles | 300094 - Plough Terrace, Clapham Junction","Santander Cycles | 300095 - Michael Road, Walham Green","Santander Cycles | 300096 - Tallis Street, Temple","Santander Cycles | 300097 - Gwendwr Road, West Kensington","Santander Cycles | 300098 - Hurlingham Park, Parsons Green","Santander Cycles | 300099 - Abyssinia Close, Clapham Junction","Santander Cycles | 300100 - Limburg Road, Clapham Junction","Santander Cycles | 300101 - Little Brook Green, Brook Green","Santander Cycles | 300200 - East Village, Queen Elizabeth Olympic Park","Santander Cycles | 300201 - Coram Street, Bloomsbury","Santander Cycles | 300202 - Kings Gate House, Westminster","Santander Cycles | 300203 - Euston Square Gardens, Euston","Santander Cycles | 300204 - Lansdowne Way Bus Garage, Stockwell","Santander Cycles | 300205 - Cromer Street, Bloomsbury","Santander Cycles | 300206 - Saltoun Road, Brixton","Santander Cycles | 300207 - Stockwell Roundabout, Stockwell","Santander Cycles | 300208 - Lavington Street, Bankside","Santander Cycles | 300209 - Albert Square, Stockwell","Santander Cycles | 300210 - Halford Road, West Kensington","Santander Cycles | 300211 - Ossulston Street, Somers Town","Santander Cycles | 300212 - Birkenhead Street, King's Cross","Santander Cycles | 300213 - Monier Road, Hackney Wick","Santander Cycles | 300214 - Blackfriars Road, Southwark","Santander Cycles | 300215 - St John's Crescent, Brixton","Santander Cycles | 300217 - Here East North, Queen Elizabeth Olympic Park","Santander Cycles | 300219 - Here East South, Queen Elizabeth Olympic Park","Santander Cycles | 300221 - Battersea Power Station, Battersea Park","Santander Cycles | 300222 - Fore Street Avenue, Guildhall","Santander Cycles | 300224 - New Spring Gardens Walk, Vauxhall","Santander Cycles | 300225 - Normandy Road, Stockwell","Santander Cycles | 300227 - Timber Lodge, Queen Elizabeth Olympic Park","Santander Cycles | 300228 - Westferry Circus, Canary Wharf","Santander Cycles | 300229 - Sidney Road, Stockwell","Santander Cycles | 300230 - Wynne Road, Stockwell","Santander Cycles | 300231 - Lambeth Palace Road, Waterloo","Santander Cycles | 300232 - Riverlight South, Nine Elms","Santander Cycles | 300233 - Aquatic Centre, Queen Elizabeth Olympic Park","Santander Cycles | 300234 - Stratford Station, Stratford","Santander Cycles | 300236 - Bevington Road West, North Kensington","Santander Cycles | 300237 - Tate Modern, Bankside","Santander Cycles | 300238 - Southwark Street, Bankside","Santander Cycles | 300239 - Victory Place, Walworth","Santander Cycles | 300240 - Lincoln's Inn Fields, Holborn","Santander Cycles | 300241 - Handyside Street, King's Cross","Santander Cycles | 300242 - Allington Street, Victoria","Santander Cycles | 300243 - Good's Way, King's Cross","Santander Cycles | 300244 - Bevington Road, North Kensington","Santander Cycles | 300245 - Clapham Road, Lingham Street, Stockwell","Santander Cycles | 300246 - Belvedere Road 2, South Bank","Santander Cycles | 300247 - Cranmer Road, Stockwell","Santander Cycles | 300248 - Sopwith Way, Battersea Park",Santander Cycles | Fabian Way Park and Ride,Santander Cycles | National Waterfront Museum,Santander Cycles | Oystermouth,Santander Cycles | Swansea Civic Centre,Santander Cycles | Swansea University Bay Campus,Santander Cycles | Swansea University Singleton Campus,Santander Mönchengladbach | Aachener Straße/ Sandradstraße,Santander Mönchengladbach | Alter Markt,Santander Mönchengladbach | Am Landgericht,Santander Mönchengladbach | Amtsgericht - Brucknerallee,Santander Mönchengladbach | Aretzplätzke,Santander Mönchengladbach | Bahnhof Lürrip,Santander Mönchengladbach | Berliner Platz,Santander Mönchengladbach | Bismarckplatz,Santander Mönchengladbach | Buscherstraße,Santander Mönchengladbach | Croonsallee,Santander Mönchengladbach | Geneicken Bahnhof,Santander Mönchengladbach | Geroplatz,Santander Mönchengladbach | Grenzlandstadion,Santander Mönchengladbach | Hauptbahnhof - Europaplatz,Santander Mönchengladbach | Hauptbahnhof - Platz der Republik,Santander Mönchengladbach | Hindenburgstraße,Santander Mönchengladbach | Hochschule - Campus Mönchengladbach,Santander Mönchengladbach | Hochschule - FB Wirtschaftswissenschaften,Santander Mönchengladbach | Hohenzollernstraße/ Bismarckstraße,Santander Mönchengladbach | Krankenhaus Rheydt,Santander Mönchengladbach | Ludwig-Weber-Straße,Santander Mönchengladbach | Marienplatz Rheydt,Santander Mönchengladbach | Marktplatz Rheydt,Santander Mönchengladbach | Musikschule,Santander Mönchengladbach | Nordpark,Santander Mönchengladbach | Rheydt Hauptbahnhof,Santander Mönchengladbach | Richard-Wagner-Straße,Santander Mönchengladbach | Santander-Platz,Santander Mönchengladbach | Schmölderpark - Eisenbahnstraße,Santander Mönchengladbach | Schmölderpark - Urftstraße,Santander Mönchengladbach | Studentenwohnheim Rheydt,Santander Mönchengladbach | Theater,Santander Mönchengladbach | Wasserturm,Santander Mönchengladbach | Zentralbibliothek,Savigliano | Alstom,Savigliano | Biblioteca,Savigliano | Borgo Marene,Savigliano | Isoardi,Savigliano | Municipio,Savigliano | Ospedale,Savigliano | Palasport,Savigliano | Piazza Santarosa,Savigliano | Piazza del Popolo,Savigliano | Posta,Savigliano | Stazione FF.SS.,Savigliano | Togliatti,Savigliano | Universita`,Savona | 1. Centro polifunzionale Le Officine,Savona | 2. Campus Universita`,Savona | 3. Parcheggio Piscina C.so Colombo,Savona | 4. Priamar,Savona | 5. Parcheggio di P.zza del Popolo,Savona | 6. Giardini di Via Verdi,Savona | 7. Stazione FF.SS.,Scegli in Bici | Ciclofficina,Scegli in Bici | Liberta`,Scegli in Bici | Mantova,Scegli in Bici | Marconi,Scegli in Bici | Parcheggio Massarotti,Scegli in Bici | Stazione FS,Scegli in Bici | Stradivari,Scegli in Bici | Viale Po,Sellero | Stazione di Cedegolo,Sellero | Stazione di Sellero,Sevici | 001_GLORIETA OLIMPICA,Sevici | 002_GRAN PLAZA,Sevici | 003_PUERTA DE LA BARQUETA,Sevici | 004_CALLE LEONARDO DA VINCI,Sevici | 005_CAMINO DE LOS DESCUBRIMIENTOS,Sevici | 006_CAMINO DE LOS DESCUBRIMIENTOS,Sevici | 007_CALLE AMÉRICO VESPUCIO,Sevici | 008_CALLE AMERICO VESPUCIO,Sevici | 009_CAMINO DE LOS DESCUBRIMIENTOS,Sevici | 010_CALLE JOSE DIAZ,Sevici | 011_ALBERTO JIMÉNEZ BECERRIL,Sevici | 012_PLAZA DUQUESA DE ALBA,Sevici | 013_CALLE FERIA,Sevici | 014_AVENIDA SANCHEZ PIZJUAN,Sevici | 015_CALLE DR MARAÑON,Sevici | 016_CALLE DE MANUEL VILLALOBOS,Sevici | 017_CALLE DE MADRESELVA,Sevici | 018_AVENIDA EDUARDO DATO,Sevici | 019_PARLAMENTO,Sevici | 020_CALLE SAN JUAN DE RIBERA,Sevici | 021_CALLE MANUEL VILLALOBOS,Sevici | 022_AVENIDA DE LLANES,Sevici | 023_PARLAMENTO,Sevici | 024_CALLE LEÓN XIII,Sevici | 025_AVENIDA DE LA CRUZ ROJA,Sevici | 026_AVENIDA DE MIRAFLORES,Sevici | 027_AVENIDA DE LLANES,Sevici | 028_CALLE RAFAEL SALGADO,Sevici | 029_CARRETERA DE CARMONA,Sevici | 030_AVENIDA EDUARDO DATO,Sevici | 031_AVENIDA DE MIRAFLORES,Sevici | 032_CALLE MUÑOZ LEÓN,Sevici | 033_CALLE LEÓN XIII,Sevici | 034_PLAZA PUMAREJO,Sevici | 035_ALAMEDA DE HERCULES,Sevici | 036_CALLE SAN VICENTE,Sevici | 037_ALAMEDA DE HÉRCULES,Sevici | 038_CALLE DE INCA GARCILASO,Sevici | 039_PLAZA SAN ANTONIO DE PADUA,Sevici | 040_AVENIDA REINA MERCEDES,Sevici | 041_PLAZA CALDERÓN DE LA BARCA,Sevici | 042_PLAZA CRONISTA,Sevici | 043_RONDA CAPUCHINOS,Sevici | 044_RONDA CAPUCHINOS,Sevici | 045_CARRETERA DE CARMONA,Sevici | 046_PLAZA DEL PELICANO,Sevici | 047_CALLE HINIESTA,Sevici | 048_CALLE CHURRUCA,Sevici | 049_ALAMEDA DE HERCULES,Sevici | 050_CALLE DE HERNÁN CORTÉS,Sevici | 051_AVENIDA TORNEO,Sevici | 052_CALLE DEL INCA GARCILASO,Sevici | 053_CALLE REYES CATÓLICOS,Sevici | 054_PLAZA SAN JUAN DE LA PALMA,Sevici | 055_CALLE DE MARIA AUXILIADORA,Sevici | 056_PLAZA JERÓNIMO DE CORDOBA,Sevici | 057_PLAZA CRISTO DE BURGOS,Sevici | 058_CALLE REGINA,Sevici | 059_AVENIDA DE LA PALMERA,Sevici | 060_PLAZA DE LA CONCORDIA,Sevici | 061_PLAZA DEL MUSEO,Sevici | 062_PLAZA DE ARMAS,Sevici | 063_CALLE SAN PABLO,Sevici | 064_CALLE CUESTA DE ROSARIO,Sevici | 065_CALLE ALHÓNDIGA,Sevici | 066_CALLE ARROYO,Sevici | 067_CALLE LEONARDO DA VINCI,Sevici | 068_CALLE JUAN ANTONIO CABESTANY,Sevici | 069_CALLE JOSE LAGUILLO,Sevici | 070_ESTACIÓN RENFE SANTA JUSTA,Sevici | 071_AVENIDA KANSAS CITY,Sevici | 072_CALLE AMADOR DE LOS RIOS,Sevici | 073_PLAZA SAN AGUSTIN,Sevici | 074_PLAZA PILATOS,Sevici | 075_PLAZA SAN FRANCISCO,Sevici | 076_PLAZA NUEVA,Sevici | 077_PLAZA CHAPINA,Sevici | 078_CALLE ALFARERIA,Sevici | 079_PLAZA DE LAS MERCEDARIAS,Sevici | 080_CALLE LUIS MONTOTO,Sevici | 081_CALLE LUIS MONTOTO,Sevici | 082_CALLE LUIS MONTOTO,Sevici | 083_AVENIDA LA BUHAIRA,Sevici | 084_CALLE JOSÉ MARÍA MORENO GALVÁN,Sevici | 085_PASEO CATALINA RIBERA,Sevici | 086_CAMINO DE LOS DESCUBRIMIENTOS,Sevici | 087_PLAZA NUEVA,Sevici | 088_CALLE AMERICO VESPUCIO,Sevici | 089_CALLE ADRIANO,Sevici | 090_CALLE ROMA,Sevici | 091_CALLE PROCURADOR,Sevici | 092_RONDA DE TRIANA,Sevici | 093_RONDA DE TRIANA,Sevici | 094_PLAZA DEL ZURRAQUE,Sevici | 095_CALLE AMÉRICO VESPUCIO,Sevici | 096_CALLE BETIS,Sevici | 097_PASEO DE CRISTÓBAL COLÓN,Sevici | 098_AVENIDA DE ROMA,Sevici | 099_CALLE AMÉRICO VESPUCIO,Sevici | 100_PASEO CATALINA RIBERA,Sevici | 101_PRADO DE SAN SEBASTIAN,Sevici | 102_CALLE JUAN DE MATA CARRIAZO,Sevici | 103_AVENIDA EDUARDO DATO,Sevici | 104_AVENIDA EDUARDO DATO,Sevici | 105_CALLE FRANCISCO MURILLO,Sevici | 106_AVENIDA EDUARDO DATO,Sevici | 107_CALLE LUIS MORALES,Sevici | 108_AVENIDA EDUARDO DATO,Sevici | 109_AVENIDA SAN FRANCISCO JAVIER,Sevici | 110_CIUDAD DE RONDA,Sevici | 111_PZA FARMACÉUTICO MURILLO HERRERA,Sevici | 112_AVDA ESPERANZA DE TRIANA,Sevici | 113_PLAZA SAN MARTÍN DE PORRES,Sevici | 114_GLORIETA PLUS ULTRA,Sevici | 115_CALLE LOPEZ DE GOMARA,Sevici | 116_CALLE MANUEL SIUROT,Sevici | 117_AVDA ESPERANZA DE TRIANA,Sevici | 118_PLAZA DE CUBA,Sevici | 119_AVENIDA DE CHILE,Sevici | 120_GLORIETA SAN DIEGO,Sevici | 121_CALLE DOCTOR PEDRO DE CASTRO,Sevici | 122_CALLE ENRAMADILLA,Sevici | 123_ESTADIO OLIMPICO,Sevici | 124_CALLE ENRAMADILLA,Sevici | 125_AVENIDA SAN FRANCISCO JAVIER,Sevici | 126_AVENIDA REINA MERCEDES,Sevici | 127_CALLE VIRGEN DE LA VICTORIA,Sevici | 128_VIRGEN DE LORETO,Sevici | 129_CALLE VIRGEN DE LUJAN,Sevici | 130_GLORIETA REPUBLICA DOMINICANA,Sevici | 131_CALLE TABLADILLA,Sevici | 132_CALLE PAEZ DE RIVERA,Sevici | 133_AVENIDA SANTA FE,Sevici | 134_CALLE VIRGEN DE LUJÁN,Sevici | 135_CALLE VIRGEN DE LUJÁN,Sevici | 136_CALLE ASUNCIÓN,Sevici | 137_AVENIDA DE LA BORBOLLA,Sevici | 138_CALLE RAMÓN CARANDE,Sevici | 139_AVENIDA DIEGO MARTINEZ BARRIO,Sevici | 140 NUESTRA SEÑORA DE LAS MERCEDES,Sevici | 141_CALLE FELIPE II,Sevici | 142_CALLE RAMON DE CARRANZA,Sevici | 143_CALLE RAMON DE CARRANZA,Sevici | 144_AVENIDA DE LA PALMERA,Sevici | 145_AVENIDA REINA MERCEDES,Sevici | 146_AVENIDA REINA MERCEDES,Sevici | 147_CARRETERA DE CARMONA,Sevici | 148_CALLE THARSIS,Sevici | 149_CALLE ARROYO,Sevici | 150_CALLE SAN JUAN BOSCO,Sevici | 151_CALLE URQUIZA,Sevici | 152_CALLE SAMANIEGO,Sevici | 153_AVENIDA REINA MERCEDES,Sevici | 154_AVENIDA KANSAS CITY,Sevici | 155_AVENIDA KANSAS CITY,Sevici | 156_AVENIDA KANSAS CITY,Sevici | 157_AVENIDA CARDENAL BUENO MONREAL,Sevici | 158_AVENIDA CARDENAL BUENO MONREAL,Sevici | 159_AVENIDA CARDENAL BUENO MONREAL,Sevici | 160_PASEO CRISTOBAL COLON,Sevici | 161_AVENIDA ALCALDE MANUEL DEL VALLE,Sevici | 163_CALLE SINAÍ,Sevici | 164_CALLE LUIS MONTOTO,Sevici | 165_AVENIDA DE ANDALUCIA,Sevici | 166_RONDA DEL TAMARGUILLO,Sevici | 167_GLORIETA BIZCO AMATE,Sevici | 168_AVENIDA RAMÓN Y CAJAL,Sevici | 169_AVENIDA RAMÓN Y CAJAL,Sevici | 170_PLAZA ANTONIO APARICIO HERRERO,Sevici | 171_CALLE ALFONSO LASO DE LA VEGA,Sevici | 172_RONDA TAMARGUILLO,Sevici | 173_RONDA TAMARGUILLO,Sevici | 174_RONDA TAMARGUILLO,Sevici | 175_RONDA TAMARGUILLO,Sevici | 176_AVENIDA DE LA CIUDAD JARDÍN,Sevici | 177_AVENIDA ALCALDE JUAN FERNÁNDEZ,Sevici | 178_CALLE JOSÉ SARAMAGO,Sevici | 179_RONDA URBANA NORTE,Sevici | 180_CALLE DOCTOR JAIME MARCOS,Sevici | 181_RONDA URBANA NORTE,Sevici | 182_CALLE VICTORIA KENT,Sevici | 183_ALCALDE MANUEL DEL VALLE,Sevici | 184_AVENIDA ALCALDE MANUEL DEL VALLE,Sevici | 185_AVENIDA ALCALDE MANUEL DEL VALLE,Sevici | 186_CALLE ORFEBRE DOMINGUEZ VÁZQUEZ,Sevici | 187_CALLE DOCTOR LAFFON,Sevici | 188_AVENIDA HYTASA,Sevici | 189_AVENIDA HYTASA,Sevici | 190_AVENIDA HYTASA,Sevici | 191_GLORIETA CARLOS CANO,Sevici | 192_AVENIDA DE ALVAR NUÑEZ,Sevici | 193_AVENIDA DE CORIA,Sevici | 194_CALLE PARQUE DE DOÑANA,Sevici | 195_CALLE CORRAL DEL AGUA,Sevici | 196_CALLE ESTRELLA CANOPUS,Sevici | 197_CALLE AGRICULTORES,Sevici | 198_CALLE MAR DE ALBORÁN,Sevici | 199_MAR DE ALBORÁN,Sevici | 200_CAMINO DE LOS TOROS,Sevici | 201_CALLE PINO MONTANO,Sevici | 202_AVENIDA MUJER TRABAJADORA,Sevici | 203_CALLE TESALÓNICA,Sevici | 204_CALLE DOCTOR LAFFON,Sevici | 205_AVENIDA KANSAS CITY,Sevici | 206_AVENIDA KANSAS CITY,Sevici | 207_CALLE IFNI,Sevici | 208_AVENIDA DE GRECIA,Sevici | 209_AVENIDA ALEMANIA,Sevici | 210_PASEO DE EUROPA,Sevici | 211_AVENIDA DE ALEMANIA,Sevici | 212_AVENIDA REINIDO UNIDO,Sevici | 213_AVENIDA DE ANDALUCIA,Sevici | 215_CALLE ZORZAL,Sevici | 216_CALLE ANTIOQUIA,Sevici | 217_CALLE DE LA A.D.A.,Sevici | 218_PLAZA DEL ALTOZANO,Sevici | 219_CALLE DE LA A.D.A.,Sevici | 221_AVENIDA ALCALDE LUIS URUÑUELA,Sevici | 223_CALLE GEMA,Sevici | 224_AVENIDA DE LAS CIENCIAS,Sevici | 225_CALLE FLOR DE RETAMA,Sevici | 226_AVENIDA DOCTOR EMILIO LEMOS,Sevici | 227_AVENIDA ALCALDE LUIS URUÑUELA,Sevici | 228_AVENIDA DE LAS CIENCIAS,Sevici | 229_AVENIDA AERONAUTICA,Sevici | 230_AVENIDA DE LAS CIENCIAS,Sevici | 231_AVENIDA ALCALDE LUIS URUÑUELA,Sevici | 232_AVENIDA ALCALDE LUIS URUÑUELA,Sevici | 233_AVENIDA ALCALDE LUIS URUÑUELA,Sevici | 234_CALLE MÉDICOS SIN FRONTERA,Sevici | 235_CIUDAD DE CHIVA,Sevici | 236_CIUDAD DE CHIVA,Sevici | 237_CIUDAD DE CHIVA,Sevici | 238_CIUDAD DE CHIVA,Sevici | 239_CALLE CIUDAD DE LIRIA,Sevici | 240_AVENIDA ALCALDE LUIS URUÑUELA,Sevici | 241_PLAZA NUEVA,Sevici | 242_PLAZA NUEVA,Sevici | 243_GLORIETA DEL PRIMERO DE MAYO,Sevici | 244_AVENIDA LOS GAVILANES,Sevici | 245_CALLE LAS LEANDRAS,Sevici | 246_PUERTO DE LOS AZORES,Sevici | 247_AVDA. RAMON Y CAJAL,Sevici | 248_GLORIETA DE LOS FERROVIARIOS,Sevici | 249_CALLE NAVARRA,Sevici | 250_CALLE DE SALVADOR ALLENDE,Sevici | 251_AVDA. CRUZ CAMPO,Sevici | 252_GASPAR CALDERAS,Sevici | 253_HOSPITAL VALME,Sevici | 254_ALHAMBRA,Sevici | 255_PERO MINGO,Sevici | 256_MIGUEL MONTORO,Sevici | 257_TORRES ALBARRACIN,Sevici | 258_ESTACA DE VARES,Sevici | 259_OCHO DE MARZO,Sevici | 260_REVOLTOSA,Share-a-Bull Bikes | TEST - CCT - Coast Rack,Share-a-Bull Bikes | TEST - CCT Concessions,Share-a-Bull Bikes | TEST - CCT Cypress Point Park,Share-a-Bull Bikes | TEST - CCT Shelter No 4 - East,Share-a-Bull Bikes | TEST - CCT Shelter No 4 - West,Share-a-Bull Bikes | TEST - CCT Shelter No 5,Share-a-Bull Bikes | TEST - CCT Shelter No 6,Share-a-Bull Bikes | TEST - CCT Shelter No. 1,Share-a-Bull Bikes | TEST - CCT Shelter No. 3,Share-a-Bull Bikes | TEST - CCT Skyway Park,Share-a-Bull Bikes | U - ALN - John and Grace Allen Welcome Building - North,Share-a-Bull Bikes | U - BDG - Beard Drive Parking,Share-a-Bull Bikes | U - BKS - Bookstore,Share-a-Bull Bikes | U - BSF - Bio-Science - South West,Share-a-Bull Bikes | U - CMC - CAS Multidisciplinary Complex,Share-a-Bull Bikes | U - CMS - Childrens Medical Services,Share-a-Bull Bikes | U - CPH - College of Public Health,Share-a-Bull Bikes | U - CRU - USF Federal Credit Union,Share-a-Bull Bikes | U - ENA - Engineering Teaching Auditorium,Share-a-Bull Bikes | U - ENA - Lawn (Engineering Teaching Auditorium),Share-a-Bull Bikes | U - ENB - Engineering Building II,Share-a-Bull Bikes | U - ENC - Engineering III,Share-a-Bull Bikes | U - ENG - Engineering I (Edgar W. Kopp),Share-a-Bull Bikes | U - FAD - Fine Arts - Dance,Share-a-Bull Bikes | U - FAH - Fine Arts - North East,Share-a-Bull Bikes | U - FAH - Fine Arts - South East,Share-a-Bull Bikes | U - ISA - Interdisciplinary Sciences - North,Share-a-Bull Bikes | U - ISA - Interdisciplinary Sciences - South,Share-a-Bull Bikes | U - ISA - Interdisciplinary Sciences - West,Share-a-Bull Bikes | U - JPH - Juniper-Poplar Hall - North,Share-a-Bull Bikes | U - JPH - Juniper-Poplar Hall - South,Share-a-Bull Bikes | U - LDG - Laurel Drive Parking Facility - North West,Share-a-Bull Bikes | U - LSA - Life Science Annex,Share-a-Bull Bikes | U - Lot 18 north,Share-a-Bull Bikes | U - Lot 18 south,Share-a-Bull Bikes | U - Lot 43,Share-a-Bull Bikes | U - MAA - Magnolia Housing,Share-a-Bull Bikes | U - MAB - Magnolia Housing,Share-a-Bull Bikes | U - MAG - Magnolia Housing,Share-a-Bull Bikes | U - MAH - Magnolia Housing,Share-a-Bull Bikes | U - MDH - Morasani Center for Advanced Health Care,Share-a-Bull Bikes | U - MDN - USF Health and Nursing - North,Share-a-Bull Bikes | U - MHA - CBCS West Side Conference Center - North,Share-a-Bull Bikes | U - MRC - Moffitt Research Center - South East,Share-a-Bull Bikes | U - MSC - Marshall Student Center - East,Share-a-Bull Bikes | U - MSC - Marshall Student Center - North,Share-a-Bull Bikes | U - MSC - Marshall Student Center - South,Share-a-Bull Bikes | U - MUS - Music - South,Share-a-Bull Bikes | U - Magnolia Fields,Share-a-Bull Bikes | U - NEC - Northwest Educational Complex,Share-a-Bull Bikes | U - NES - Natural and Environmental Sciences - West,Share-a-Bull Bikes | U - PCD - Psych / Comm Science Building,Share-a-Bull Bikes | U - PPA - US Post Office,Share-a-Bull Bikes | U - SVC - Student Services,Share-a-Bull Bikes | U - Shop,Share-a-Bull Bikes | U - TAR - Theater Centre,Share-a-Bull Bikes | U- Athletics,"SiXT | Agenskalna tirgus, Nometnu 64","SiXT | Albert hotel, Dzirnavu/ Zaļās ielas krustojums","SiXT | Bellevue Park Hotel, Slokas/A.Grīna bulv. krustojums","SiXT | Bulduru pludmale, Vienības prospekts, Bulduri","SiXT | Bērnu pasaule, K.Barona/ Matīsa ielas krustojums","SiXT | Citadele banka, Republikas laukums 2a","SiXT | DUNTES biroji biznesam, Duntes iela 6","SiXT | Dailes Teatris, Brivibas iela 75","SiXT | Dzintaru koncertzāle, Turaidas iela 1, Dzintari",SiXT | Elizabetes/ Pulkveza Brieza ielas krustojums,"SiXT | Galerija Centrs, Valņu iela",SiXT | K.Valdemāra/ A.Briāna ielas krustojums,SiXT | Kalnciema/ Slokas ielas krustojums,"SiXT | Kongresu nams, Krisjana Valdemara iela 5","SiXT | Lattelecom, Dzirnavu iela 105",SiXT | MAXIMA XXX Deglava iela 67,"SiXT | Majoru stacija,  Lienes / Omnibusa ielas krustojums","SiXT | Moller Auto Krasta, Krasta iela 54",SiXT | Mūkusalas Biroju centrs,"SiXT | Radisson Blu Daugava Hotel, Kugu iela 24","SiXT | Radisson Blu Hotel Latvija, Elizabetes iela 55",SiXT | Tallinas/ Miera ielas krustojums,"SiXT | Teika, Brivibas gatves/ Lielvardes ielas krustojums",SiXT | Valnu/ Kalku ielas krustojums,SiXT | Zoodārzs,"SiXT | i/c Olimpia, Azenes iela 5",Siemianowicki Rower Miejski | BAŃGÓW-KRUPANKA,Siemianowicki Rower Miejski | Centrum I,Siemianowicki Rower Miejski | Centrum II,Siemianowicki Rower Miejski | Grunwaldzka,Siemianowicki Rower Miejski | Jagiełły,Siemianowicki Rower Miejski | Michałkowice,Siemianowicki Rower Miejski | Osiedle Bańgów,Siemianowicki Rower Miejski | Osiedle Młodych,Siemianowicki Rower Miejski | Park Pszczelnik,Siemianowicki Rower Miejski | Plac Alfreda,Siemianowicki Rower Miejski | Tuwim,Sitycleta | Aparcamiento Sanapú,Sitycleta | Autoridad portuaria,Sitycleta | Ayuntamiento,Sitycleta | Barranquillo Don Zoilo,Sitycleta | Base Naval,Sitycleta | C.C. El Muelle,Sitycleta | C.C. La Minilla,Sitycleta | Cabildo de Gran Canaria,Sitycleta | Canódromo,Sitycleta | Canódromo (electric),Sitycleta | Castillo de la Luz,Sitycleta | Churruca,Sitycleta | Ciudad de la Justicia,Sitycleta | Gabinete Literario,Sitycleta | IES Mesa y López,Sitycleta | Intermodal El Rincón,Sitycleta | Las Canteras - Luis Morote,Sitycleta | León y Castillo,Sitycleta | Mercado Central,Sitycleta | Muelle Deportivo,Sitycleta | Obelisco,Sitycleta | Oficina Sítycleta (elect.),Sitycleta | Oficina de la Sitycleta,Sitycleta | Parque Santa Catalina,Sitycleta | Parque del Estadio Insular,Sitycleta | Paseo de Chil - Av. Escaleritas,Sitycleta | Piscina Julio Navarro,Sitycleta | Plaza Manuel Becerra,Sitycleta | Plaza O'Shanahan,Sitycleta | Plaza San Agustín,Sitycleta | Plaza de América,Sitycleta | Plaza de España,Sitycleta | Plaza de la feria,Sitycleta | Plaza del Pilar,Sitycleta | Plazoleta de Farray,Sitycleta | San Bernardo,Sitycleta | San Cristóbal,Sitycleta | San Telmo,Sitycleta | Teatro Pérez Galdós,Sitycleta | Torre Las Palmas,Sitycleta | Torre Woermann,Skybike | 300 Clematis St,Skybike | 375 S. Rosemary Ave (598 Fern st),Skybike | 4th St & Flagler,Skybike | 510 Clematis St (Subculture),Skybike | Brightline Train Station,Skybike | Cheese Cake,Skybike | City Hall,Skybike | Clematis and Tamarind,Skybike | Dixie & Fern,Skybike | Good Sam P.B. Lakes and Flagler,Skybike | Hilton West Palm Beach,Skybike | Hyatt Place,Skybike | Iris and Dixie,Skybike | Loftin Place,"Skybike | PBAU, Gruber Pl",Skybike | Rosemary Square,Skybike | S Flagler & Datura,Skybike | Warehouse District,Skybike | Waterfront Park,Smartbike Delhi | Aga Khan Hall BQS Bhagwan Dass road,Smartbike Delhi | Akashwani bhawan Sansad Marg,"Smartbike Delhi | Barakhamba Gate No. 2, Metro Station",Smartbike Delhi | Barakhamba Gate No. 4 Metro Station,Smartbike Delhi | Bhai Veer Singh Marg,Smartbike Delhi | Bharatiya Vidya Bhawan KG Marg,Smartbike Delhi | British Council KG Marg,Smartbike Delhi | CP L Block Parking Outer Circle,Smartbike Delhi | CP Metro Gate No 1,Smartbike Delhi | CP Metro Gate No. 6,Smartbike Delhi | CP Metro Gate No. 7,Smartbike Delhi | CP P Block Parking Outer Circle,Smartbike Delhi | Delhi High Court,Smartbike Delhi | Doordarshan Bhawan,"Smartbike Delhi | Eastern Court, Janpath",Smartbike Delhi | Emporium building BKS Marg,Smartbike Delhi | GPO,Smartbike Delhi | Gole Market,Smartbike Delhi | HT Building KG Marg,"Smartbike Delhi | Janpath Gate No. 2, Metro Station",Smartbike Delhi | Jor Bagh Metro Station Gate No 3,Smartbike Delhi | Kautilya Marg,Smartbike Delhi | Khan Market Metro Station Humayun Road,Smartbike Delhi | LIC Building,Smartbike Delhi | Lodhi Garden Gate No 1,Smartbike Delhi | Lodhi Garden Gate No 2,Smartbike Delhi | Lodhi Garden Gate No. 4,Smartbike Delhi | Mandi House (Near Shaft) Metro Station,Smartbike Delhi | Mandi House Gate No.1 Metro Station,Smartbike Delhi | Mandi House Round About,Smartbike Delhi | Max MÃ¼ller Bhawan KG Marg,"Smartbike Delhi | Mayur Bhawan, CP Outer Circle",Smartbike Delhi | Mohan Singh Palace,Smartbike Delhi | Patel chowk metro station parking,"Smartbike Delhi | Prithviraj Lane, Near Khan Market",Smartbike Delhi | Sanchar Bhawan (Patel Chowk Metro Station),Smartbike Delhi | Scindiya House Kg Marg,Smartbike Delhi | Shivaji Stadium,Smartbike Delhi | Shivaji Stadium Metro Station BKS Marg,Smartbike Delhi | Statesman House,Smartbike Delhi | Supreme Court BQS Tilak Marg,Smartbike Delhi | Telangana House near R/A Jaswant Singh road,Smartbike Delhi | UPSC,Smartbike Delhi | Under Skywalk Tilak Marg,Smartbike Delhi | YMCA,Smartbike Vijayawada | AP Secretariat 1,Smartbike Vijayawada | AP Secretariat 2,Smartbike Vijayawada | AP Secretariat 3,SoBi | 270 Sherman,SoBi | Aberdeen at Queen,SoBi | Aberdeen at Studholme,SoBi | Ainslie at Emerson,SoBi | Athletic Centre Bike Racks,SoBi | Augusta at Hughson,SoBi | Augusta at John,SoBi | Barton and Belview - ERI05,SoBi | Barton at Lottridge - ERI03,SoBi | Barton at Ottawa - ERI06,SoBi | Barton at Wentworth,SoBi | Bay at Bold,SoBi | Bay at Macaulay,SoBi | Bay at Mulberry,SoBi | Bay at Strachan,SoBi | Bay at York,SoBi | Bayfront Park,SoBi | Belview at Cannon - ERI12,SoBi | Boardwalk at Edwards,SoBi | Boardwalk at Grand,SoBi | Boardwalk at Laurelton,SoBi | Boardwalk at Monroe,SoBi | Boardwalk at Neptune,SoBi | Cannon at Birch (Powell Park),SoBi | Cannon at Oak,SoBi | Cannon at Ottawa,SoBi | Cannon at Sherman,SoBi | Cannon at Wentworth - 96,SoBi | Catherine at Young,SoBi | Charlton at Locke,SoBi | Chedoke Stairs,SoBi | City Hall,SoBi | Cootes Drive Dundas,SoBi | Cootes at York and King,SoBi | Corktown Park,SoBi | Cumberland at Blake,SoBi | Delaware at Myrtle,SoBi | Discovery Drive,SoBi | Duke at James,SoBi | Dundurn St S,SoBi | Dundurn Stairs,SoBi | Dundurn at Aberdeen,SoBi | Dunsmure at Sherman - ERI10,SoBi | Durand Park,"SoBi | East End, Shore and Pacific",SoBi | Eastwood Arena,SoBi | Emerson at Whitney,SoBi | Ferguson at Barton,SoBi | Ferguson at Cannon,SoBi | Ferguson at King,SoBi | Ferguson at King William,SoBi | Ferrie at Furguson,SoBi | Forsyth at Sterling,SoBi | Frid at Main,SoBi | Gage Park,SoBi | Gage at Cannon - ERI11,SoBi | George Street,SoBi | Gore Park,SoBi | Haymarket at Hughson,SoBi | Herkimer at Queen,SoBi | Hess at king,SoBi | Hill Street Park,SoBi | Hughson at Picton,SoBi | Hunter GO Centre,SoBi | Hunter at Furguson,SoBi | Hunter at Hess,SoBi | Hunter at Park,SoBi | James North at Mulberry,SoBi | James S at Charlton,SoBi | James at Colbourne,SoBi | James at Guise,SoBi | James at Vine,SoBi | John at Main,SoBi | KEY FOOD @ E. Park and Roosevelt Blvd,SoBi | King Street Dundas,SoBi | King William at Hughson,SoBi | King William at John,SoBi | King William at Victoria,SoBi | King at Cline,SoBi | King at Dundurn,SoBi | King at Dunsmure - ERI09,SoBi | King at Mary,"SoBi | LIRR, Bus Shelter",SoBi | Locke at Napier,SoBi | Longwood at Edgevale,SoBi | Longwood at King,SoBi | MLK Community Center,SoBi | Macklin at King,SoBi | Main  at Eastbourne,SoBi | Main and Wellington,SoBi | Main at Columbia College,SoBi | Main at Dalewood,SoBi | Main at Dundurn,SoBi | Main at Longwood,SoBi | Main at Macnab,SoBi | Main at Whitney,SoBi | Maple at Rothsay - ERI08,SoBi | Maplewood at Springer,SoBi | Mars at Wentworth - ERI01,SoBi | Mary at Cannon,SoBi | McMaster Arthur Bourns,SoBi | McMaster Emerson,SoBi | McMaster Health Sciences,SoBi | McMaster Innovation Park,SoBi | McMaster Mary Keyes,SoBi | McMaster Stadium,SoBi | McMaster Student Centre,SoBi | Osler at Grant,SoBi | Osler at Main,SoBi | Ottawa at Dunsmure - ERI07,SoBi | Oxford at York,SoBi | Park at Robinson,SoBi | Pearl Street Bridge,SoBi | Pier 4,SoBi | Princess Point,SoBi | Queen at George,SoBi | Queen at Peter,SoBi | Rail Trail at Emerson,SoBi | Rail Trail at Stroud,"SoBi | Rec Center, West Bay at Magnolia",SoBi | Rifle Range at Rail Trail,SoBi | Ryerson Recreation Centre,SoBi | Sanders at Binkley,SoBi | Sanders at Hollywood,SoBi | Seedworks,SoBi | Sherman at Barton - ERI02,SoBi | Stadium,SoBi | Sterling at Haddon,SoBi | Sterling at Whitton,SoBi | Stinson at Blythe,SoBi | Stinson at West,SoBi | Strachan at Mary,SoBi | Tisdale at Main,SoBi | Van Wagners,SoBi | Victoria at Barton,SoBi | Wentworth Stairs,SoBi | Wentworth at King,"SoBi | West End Bus Stop, Nevada at Beech",SoBi | West Harbour GO Station,SoBi | West at Cannon,SoBi | Westdale Library,SoBi | Westdale Village,SoBi | Westinghouse at Barton - ERI13,SoBi | Whitney at Lower Horning,SoBi | York at Inchbury,SoBi | York at Macnab,Sondrio | Cimitero,Sondrio | Parco Ovest,Sondrio | Piastra,Sondrio | Stazione FF.SS.,Sosnowiecki Rower Miejski | Kościelna,Sosnowiecki Rower Miejski | Narutowicza,Sosnowiecki Rower Miejski | Park Środula,Sosnowiecki Rower Miejski | Parkowa,Sosnowiecki Rower Miejski | Piłsudskiego,Sosnowiecki Rower Miejski | Rondo Ludwik,Sosnowiecki Rower Miejski | Rondo Uznańskiego,Sosnowiecki Rower Miejski | Rondo Zagłębia Dąbrowskiego,Sosnowiecki Rower Miejski | Ślimak,Spartanburg BCycle | Converse College,Spartanburg BCycle | Morgan Square,Spartanburg BCycle | Rail Trail,Spartanburg BCycle | VCOM Station at Harvest Park,Spartanburg BCycle | Wofford College,Speziainbici | 01. Palasport,Speziainbici | 02. Piazza d'Armi,Speziainbici | 03. Stazione FF.SS.,Speziainbici | 04. Beverini,Speziainbici | 05. Sant'Agostino,Speziainbici | 06. Chiodo,Speziainbici | 07. Europa,Speziainbici | 08. Ospedale,Speziainbici | 09. Concordia,Speziainbici | 10. Tribunale,Speziainbici | 11. Marittime,Speziainbici | 12. Brin,Speziainbici | 13. Porto Lotti,Speziainbici | 14. Favaro,Speziainbici | 15. Battisti,Speziainbici | 16. Ginocchio,Speziainbici | 17. Stazione,Speziainbici | 18. Vivaldi,Speziainbici | 19. Bartolomeo,Stacje Sponsorskie Nextbike PRM | Factory Poznań,Stacje Sponsorskie Nextbike PRM | Galeria Malta,"Stacje Sponsorskie Nextbike PRM | Lidl, ul. Wilkońskich",Stacje Sponsorskie Nextbike PRM | Przystanek Franowo,Stacje Sponsorskie Nextbike Veturilo | AGORA,Stacje Sponsorskie Nextbike Veturilo | Al. Jerozolimskie - Emilii Plater,Stacje Sponsorskie Nextbike Veturilo | Arkadia,Stacje Sponsorskie Nextbike Veturilo | Atrium Targówek,Stacje Sponsorskie Nextbike Veturilo | Blue City,Stacje Sponsorskie Nextbike Veturilo | CH Marywilska 44,Stacje Sponsorskie Nextbike Veturilo | Central Park Ursynów,Stacje Sponsorskie Nextbike Veturilo | Citi,Stacje Sponsorskie Nextbike Veturilo | EMPARK,Stacje Sponsorskie Nextbike Veturilo | Eko - Rowery NFOŚiGW,Stacje Sponsorskie Nextbike Veturilo | Eurocentrum,Stacje Sponsorskie Nextbike Veturilo | Factory Annopol,Stacje Sponsorskie Nextbike Veturilo | Galeria Bemowo,Stacje Sponsorskie Nextbike Veturilo | Galeria Mokotów wejście główne,Stacje Sponsorskie Nextbike Veturilo | Galeria Mokotów wejście ul. Wołoska,Stacje Sponsorskie Nextbike Veturilo | IRIS,Stacje Sponsorskie Nextbike Veturilo | Marynarska 12,Stacje Sponsorskie Nextbike Veturilo | Metro Nowy Świat - Uniwersytet,Stacje Sponsorskie Nextbike Veturilo | Metro Świętokrzyska,Stacje Sponsorskie Nextbike Veturilo | Nestle House,Stacje Sponsorskie Nextbike Veturilo | New City,Stacje Sponsorskie Nextbike Veturilo | PRAGA306,Stacje Sponsorskie Nextbike Veturilo | Platan Park,Stacje Sponsorskie Nextbike Veturilo | Poleczki Park,Stacje Sponsorskie Nextbike Veturilo | Procter & Gamble,Stacje Sponsorskie Nextbike Veturilo | Proximo,Stacje Sponsorskie Nextbike Veturilo | Rondo ONZ,Stacje Sponsorskie Nextbike Veturilo | Sadyba Best Mall,Stacje Sponsorskie Nextbike Veturilo | Signum Work Station,Stacje Sponsorskie Nextbike Veturilo | Spektrum Tower,Stacje Sponsorskie Nextbike Veturilo | T-Mobile,Stacje Sponsorskie Nextbike Veturilo | The Park Warsaw,Stacje Sponsorskie Nextbike Veturilo | Warsaw Spire,Stacje Sponsorskie Nextbike Veturilo | Wiśniowy Business Park,Stacje Sponsorskie Nextbike Veturilo | Wola Park,Stacje Sponsorskie Nextbike Veturilo | al. Jana Pawła II - al. Solidarności,Stacje Sponsorskie Radom | E.Leclerc,Stacje Sponsorskie Radom | ITM Poland Os. Południe,Stadtrad | AMS-Geschäftsstelle,Stadtrad | Adolf-Pichler-Platz,Stadtrad | Anichstraße / Klinik,Stadtrad | Austria Trend Hotel,Stadtrad | Bachlechnerstr. / MED-EL,Stadtrad | Baggersee,Stadtrad | Bozner Platz,Stadtrad | Claudiaplatz,Stadtrad | Congress / Hofburg,Stadtrad | Dr. Stumpf-Straße,Stadtrad | Fürstenweg,Stadtrad | General-Eccher-Straße,Stadtrad | Gumppstraße,Stadtrad | Hafen,Stadtrad | Hauptbahnhof,Stadtrad | Höttinger Au /West,Stadtrad | Kaiserschützenplatz,Stadtrad | Langstraße,Stadtrad | Leipziger Platz,Stadtrad | Maria-Theresien-Straße,Stadtrad | Mariahilfpark,Stadtrad | Marktplatz,Stadtrad | Mitterweg,Stadtrad | Mühlauer Brücke,Stadtrad | Pacherstaße,Stadtrad | Philippine-Welser-Straße,Stadtrad | Purtschellerstraße,Stadtrad | Rathausgalerien,Stadtrad | SOWI,Stadtrad | Schöpfstraße / Klinik,Stadtrad | Sillpark,Stadtrad | Stubaitalbahnhof,Stadtrad | Studentenhaus,Stadtrad | TWI Technologiezentrum,Stadtrad | Technik,Stadtrad | Technikerhaus,Stadtrad | Tiroler Tageszeitung,Stadtrad | Triumphpforte/ Casino,Stadtrad | UNI-Sportstätten,Stadtrad | Universität,Stadtrad | Waltherpark,Stadtrad | Westbahnhof,Styr & Ställ | ALSTRÖMER/FRIGGAGATAN,Styr & Ställ | BASTIONSPLATSEN,Styr & Ställ | BERGAKUNGEN,Styr & Ställ | BERZELIIGATAN,Styr & Ställ | BOHUSGATAN,Styr & Ställ | BRUNNSGATAN,Styr & Ställ | CARLANDERSPLATSEN,Styr & Ställ | CHALMERSPLATSEN,Styr & Ställ | DOMKYRKAN,Styr & Ställ | DROTTNINGTORGET,Styr & Ställ | DÄMMEPLATSEN,Styr & Ställ | EKLANDA/UTLANDAGATAN,Styr & Ställ | ENGELBREKTSGATAN,Styr & Ställ | ESPERANTOPLATSEN,Styr & Ställ | FESKEKÖRKA,Styr & Ställ | FOLKUNGAGATAN,Styr & Ställ | FRIGÅNGSGATAN,Styr & Ställ | FÖRENINGSGATAN,Styr & Ställ | FÖRSTALÅNG/VÄRMLANDSGATAN,Styr & Ställ | GIBRALTARG/EKLANDAG,Styr & Ställ | GRÖNSAKSTORGET,Styr & Ställ | GULLBERGSVASS,Styr & Ställ | GULLBERGSVASS/GASVERKET,Styr & Ställ | GUSTAF ADOLFS TORG,Styr & Ställ | GÅRDATORGET,Styr & Ställ | HAGABION,Styr & Ställ | HAGAPARKEN,Styr & Ställ | HEDEN BUSSTERMINAL,Styr & Ställ | HEDEN SYD,Styr & Ställ | HEDEN/STENSTUREGATAN,Styr & Ställ | KAPELLPLATSEN,Styr & Ställ | KAPONJÄRSGATAN,Styr & Ställ | KASTELLGATAN,Styr & Ställ | KORSVÄGEN /SÖDRA VÄGEN,Styr & Ställ | KRISTINELUNDSGATAN,Styr & Ställ | KRUTHUSGATAN,Styr & Ställ | KUNGSGATAN/TELEKASERN,Styr & Ställ | KUNGSTORGET,Styr & Ställ | LILLA BOMMEN,Styr & Ställ | LINDHOLMSALLÉN/REGNBÅGSGATAN,Styr & Ställ | LINDHOLMSPLATSEN,Styr & Ställ | LINNÉPLATSEN,Styr & Ställ | LISEBERG STATION,Styr & Ställ | LÄPPSTIFTET,Styr & Ställ | LÄRAREGATAN/MOLINSGATAN,Styr & Ställ | MASTHUGGSTORGET,Styr & Ställ | MOLINSGATAN,Styr & Ställ | NILS-ERICSSON TERMINALEN,Styr & Ställ | OLOF PALMES PLATS,Styr & Ställ | OLSKROKSTORGET,Styr & Ställ | PACKHUSPLATSEN,Styr & Ställ | POSTGATAN,Styr & Ställ | POSTHUSET/ÅKAREPLATSEN,Styr & Ställ | ROSENLUND/FÄRJELÄGET,Styr & Ställ | SCANDINAVIUM,Styr & Ställ | SKANSTORGET,Styr & Ställ | SLOTTSKOGEN/PLIKTA,Styr & Ställ | SLUSSPLATSEN,Styr & Ställ | STENPIREN,Styr & Ställ | STORAN,Styr & Ställ | SVINGELN,Styr & Ställ | TREDJELÅNG/VÄRMLANDSGATAN,Styr & Ställ | ULLEVIGATAN,Styr & Ställ | VALAND,Styr & Ställ | VASAGATAN/HEDEN,Styr & Ställ | VASAGATAN/SCHILLERSKA,Styr & Ställ | VOLVO B-PORT LUNDBY,Styr & Ställ | ÅVÄGEN,Styr & Ställ | ÅVÄGEN NORRA,Styr & Ställ | ÖSTRA HAMNGATAN,Styr & Ställ | ÖSTRA HAMNGATAN/KRONHUSGATAN,System Legnicki Rower Miejski (SLRM) | Centrum Handlowe Auchan Legnica,System Legnicki Rower Miejski (SLRM) | Chojnowska / Krótka,System Legnicki Rower Miejski (SLRM) | Dworcowa (Dworzec kolejowy),System Legnicki Rower Miejski (SLRM) | Iwaszkiewicza (szpital),System Legnicki Rower Miejski (SLRM) | Jaworzyńska (SP 10),System Legnicki Rower Miejski (SLRM) | Moniuszki / Zesłańców Sybiru,System Legnicki Rower Miejski (SLRM) | Nowodworska / Jaworzyńska,System Legnicki Rower Miejski (SLRM) | Piłsudskiego / Horyzontalna,System Legnicki Rower Miejski (SLRM) | Piłsudskiego / Karkonoska,System Legnicki Rower Miejski (SLRM) | Piłsudskiego / Rondo Niepodległości,System Legnicki Rower Miejski (SLRM) | Rzeczypospolitej / Okrężna,System Legnicki Rower Miejski (SLRM) | Złotoryjska / Asnyka,System Legnicki Rower Miejski (SLRM) | Złotoryjska / Sejmowa,System Legnicki Rower Miejski (SLRM) | pl. Słowiański,System Legnicki Rower Miejski (SLRM) | pl. Wilsona,System Rowerów Miejskich w Pszczynie | Goczałkowice - Zdrój Korona zapory,System Rowerów Miejskich w Pszczynie | Goczałkowice - Zdrój Stary Dworzec PKP,System Rowerów Miejskich w Pszczynie | Osiedle Daszyńskiego,System Rowerów Miejskich w Pszczynie | Osiedle Piastów,System Rowerów Miejskich w Pszczynie | Osiedle Stara Wieś,System Rowerów Miejskich w Pszczynie | Ośrodek Sportów Wodnych,System Rowerów Miejskich w Pszczynie | Pszczyna - Dworzec PKP,System Rowerów Miejskich w Pszczynie | Rynek,System Rowerów Miejskich w Pszczynie | Teststation IT - Adrian (VET),Tarnowski Rower Miejski | Centrum Sztuki Mościce,Tarnowski Rower Miejski | Dworzec PKP,Tarnowski Rower Miejski | Góra Św. Marcina,Tarnowski Rower Miejski | Krzyska – Szkoła,Tarnowski Rower Miejski | Mościce – Kwiatkowskiego,Tarnowski Rower Miejski | Osiedle Koszyckie,Tarnowski Rower Miejski | Osiedle Zielone,Tarnowski Rower Miejski | Park Strzelecki,Tarnowski Rower Miejski | Plac Jana Szczepanika,Tarnowski Rower Miejski | Plac Sobieskiego,Terni | Bramante,Terni | Brin,Terni | Buozzi,Terni | Europa,Terni | Garibaldi,Terni | Manni,Terni | Martiri Della Liberta`,Terni | Ospedale,Terni | Pentima,Terni | Popolo,Terni | San Francesco,Terni | Stadio Prati,Terni | Staino,Terni | Stazione Autolinee,Terni | Stazione FF.SS.,Terni | Tacito,Terni | Vannucci,Terni | Villa Glori,ThessBike | Parking ΧΑΝΘ,ThessBike | port,ThessBike | tif,ThessBike | Όμιλος  (automated),ThessBike | Βασ.Όλγας 179,ThessBike | Βασ.Ηρακλείου 47,ThessBike | Δικαστήρια,ThessBike | Μέγαρο Μουσικής,Tigullionbike | Baia delle favole,Tigullionbike | Lungomare Descalzo,Tigullionbike | Parco Lavagnina,Tigullionbike | Riva Trigoso,Tigullionbike | San Bartolomeo,Tigullionbike | Sestri Levante FS,Tigullionbike | Tannino,Tirano in Bici | Madonna di Tirano,Tirano in Bici | Parco delle Torri,Tirano in Bici | Piazza Cavour,Tirano in Bici | Piazza delle Stazioni,Tirano in Bici | Stazione Autolinee,Topeka Metro Bikes | 19th Street Salon,Topeka Metro Bikes | Annie's Place,Topeka Metro Bikes | Avondale East - NetReach Center - CRC,Topeka Metro Bikes | Bike station - 25th & Adams - former bus stop,Topeka Metro Bikes | Blue Dot,Topeka Metro Bikes | Boot Barn,Topeka Metro Bikes | Boswell Park - SNCO Parks,Topeka Metro Bikes | Brown vs. Board of Education -- Employee Parking in Alley,Topeka Metro Bikes | Burnett's Mound - Skyline Drive entrance - SNCO Parks,Topeka Metro Bikes | Bus Shelter - 10th & Billard - Church's Chicken,Topeka Metro Bikes | Bus Shelter - 21st & Fillmore,Topeka Metro Bikes | Bus Shelter - 32nd and Topeka,Topeka Metro Bikes | Bus Shelter - 34th & Indiana,Topeka Metro Bikes | Bus Shelter - 37th St Walmart,Topeka Metro Bikes | Bus Shelter - 6th & Golden - Inbound,Topeka Metro Bikes | Bus Shelter - 6th & Golden - Outbound,Topeka Metro Bikes | Bus Shelter - BP Gas Station - 10th and Wanamaker,Topeka Metro Bikes | Bus Shelter - Fairlawn Plaza,Topeka Metro Bikes | Bus Shelter - Landon Trail and 37th St,Topeka Metro Bikes | Bus Shelter - Security Benefit,Topeka Metro Bikes | Bus Shelter - Wanamaker and Huntoon,Topeka Metro Bikes | Bus Shelter - Wanamaker at Westport - Denny's,Topeka Metro Bikes | Bus Shelter 10th & Parkview,Topeka Metro Bikes | Bus Shelter : Lane and Huntoon / Cristo Iglesias,Topeka Metro Bikes | Bus Shelter at 12th & Lane,Topeka Metro Bikes | Bus Shelter at 12th & Washburn Ave,Topeka Metro Bikes | Bus Shelter at Reser's on Croco,Topeka Metro Bikes | Bus Shelter at Topeka Housing Authority,Topeka Metro Bikes | Bus Shelter at Westridge Mall,Topeka Metro Bikes | Bus Shelter on 21st at Wanamaker,Topeka Metro Bikes | Bus Shelter- 21st & Belle,Topeka Metro Bikes | Bus Shelter- 29th and Fairway,Topeka Metro Bikes | Bus Shelters at 19th & Washburn,Topeka Metro Bikes | Bus Stop - 21st & Washburn - Henry T's,Topeka Metro Bikes | Bus Stop - 27th & Indiana,Topeka Metro Bikes | Bus Stop - 6th & Swygart,Topeka Metro Bikes | Bus Stop - 6th St - Gage Park - Chalet Apartments - two sets of racks,Topeka Metro Bikes | Bus Stop - Huntoon at Western,Topeka Metro Bikes | Bus Stop - Lane & 15th,Topeka Metro Bikes | Bus Stop - N. Kansas Ave. & Elm Row,Topeka Metro Bikes | Bus Stop at Garfield Park,Topeka Metro Bikes | Bus Stops - 21st & Potomac - Mt Vernon Apartments near Washburn,Topeka Metro Bikes | Bus Stops - 6th & Governors Row and View - Kaw River State Park,Topeka Metro Bikes | Bus Stops - Oakland - Sardou and Green,Topeka Metro Bikes | Bus Stops - Paramore and N. Topeka Blvd,Topeka Metro Bikes | Bus Stops at 6th & Jefferson - Ramada Inn,Topeka Metro Bikes | Bus shelter - 10th & Topeka - Walgreens,Topeka Metro Bikes | Bus shelter - 12th and Monroe,Topeka Metro Bikes | Bus shelter - 2nd & Kansas,Topeka Metro Bikes | Bus shelter - Topeka High - 10th & Western,Topeka Metro Bikes | Bus shelter 8th & Harrison downtown,Topeka Metro Bikes | Bus shelter at 29th & Atwood,Topeka Metro Bikes | Bus shelter at Payless Lyman & Topeka,Topeka Metro Bikes | Bus shelter at Valeo on 6th st,Topeka Metro Bikes | Bus shelters - NE and SW - 8th & Topeka,Topeka Metro Bikes | Bus stop - 10th & Clay,Topeka Metro Bikes | Bus stop - 10th & Wear,Topeka Metro Bikes | Bus stop - 6th & Fairlawn,Topeka Metro Bikes | Bus stop - 6th & Harrison,Topeka Metro Bikes | Bus stop - 6th & Washburn - TACO AL's,Topeka Metro Bikes | Bus stop - 6th at Woodland,Topeka Metro Bikes | Bus stop - 8th & Polk,Topeka Metro Bikes | Bus stop - Donut District,Topeka Metro Bikes | Bus stop - Harrison and N. Topeka Blvd,Topeka Metro Bikes | Bus stop - Huntoon and Buchanan,Topeka Metro Bikes | Bus stop - Indiana & 32nd St.,Topeka Metro Bikes | Bus stop - Kansas & Burgess,Topeka Metro Bikes | Bus stop - Morse & Jackson (North),Topeka Metro Bikes | Bus stop - Morse & N Topeka Blvd,Topeka Metro Bikes | Bus stop - N. Topeka Blvd and Grant,Topeka Metro Bikes | Bus stop - North Topeka Lyman Rd at Cottages,Topeka Metro Bikes | Bus stop at 19th and Adams,Topeka Metro Bikes | Bus stop at 21st and California,Topeka Metro Bikes | Bus stop at 6th and rice road,Topeka Metro Bikes | Bus stop- Highland Park Townhomes,Topeka Metro Bikes | Bus stop- Lane and Munson,Topeka Metro Bikes | Bus stop- Oakland- Mike's Market,Topeka Metro Bikes | Bus stops - both sides of 8th & Clay,Topeka Metro Bikes | Bus stops at 6th & Clay - Tilton's Westside Grocery,Topeka Metro Bikes | Capital City High School,Topeka Metro Bikes | Capitol Federal - 21st & Fairlawn,Topeka Metro Bikes | Capitol Federal - 29th & Kansas,Topeka Metro Bikes | Capitol Plaza Hotel,Topeka Metro Bikes | Chick-Fil-A,Topeka Metro Bikes | Classic Bean - Fairlawn Plaza,Topeka Metro Bikes | College Hill - 16th & Lane,Topeka Metro Bikes | College Hill - Burger Stand,Topeka Metro Bikes | College Hill - PT's Coffee,Topeka Metro Bikes | Community Action - 10th & Branner,Topeka Metro Bikes | Crestview Park - SNCO Parks,Topeka Metro Bikes | Deer Creek Community Center,Topeka Metro Bikes | Dillons Brookwood,Topeka Metro Bikes | Dillons East,Topeka Metro Bikes | Dillons Fairlawn,Topeka Metro Bikes | Dillons Gage / Fleming Place,Topeka Metro Bikes | Dillons North,Topeka Metro Bikes | Dillons West,Topeka Metro Bikes | Doorstep Inc.,Topeka Metro Bikes | Dornwood Spray Park - SNCO Parks,Topeka Metro Bikes | Downtown - 6th & Kansas,Topeka Metro Bikes | Downtown - 712 S Kansas Ave,Topeka Metro Bikes | Downtown - 8th & Kansas - Lupita's,Topeka Metro Bikes | Downtown - 900 S. Kansas Midblock Crossing Bike Corrals - The Pennant and Cyrus Hotel,Topeka Metro Bikes | Downtown - 9th & Kansas Pocket Park,Topeka Metro Bikes | Downtown - Blue Cross Blue Shield of Kansas,Topeka Metro Bikes | Downtown - Capitol Federal - 7th & Kansas,Topeka Metro Bikes | Downtown - City of Topeka - Holliday Building,Topeka Metro Bikes | Downtown - Curtis State Office Building - 10th & Jackson,Topeka Metro Bikes | Downtown - Jackson Street Lofts - Private Parking,Topeka Metro Bikes | Downtown - KDOT - 7th and Harrison,Topeka Metro Bikes | Downtown - Kansas Health Institute - 212 SW 8th St,Topeka Metro Bikes | Downtown - Kansas State Capitol Bike Parking,Topeka Metro Bikes | Downtown - Quincy Street Station (QSS),Topeka Metro Bikes | Downtown - Shawnee County Courthouse,Topeka Metro Bikes | Downtown - Sunflower Bike Racks - 822 S Kansas Ave,Topeka Metro Bikes | Downtown - TILRC - railing along 5th at Jackson,Topeka Metro Bikes | Downtown - TPD Station,Topeka Metro Bikes | Downtown - Topeka City Hall,"Topeka Metro Bikes | Downtown - Visit Topeka, Inc. - 618 S Kansas Ave",Topeka Metro Bikes | Downtown McDonald's,Topeka Metro Bikes | Edgewood Park - SNCO Parks,Topeka Metro Bikes | Eisenhower Building,Topeka Metro Bikes | Faith Lutheran Church 17th and Gage,Topeka Metro Bikes | Fire Station at Shunga and Fairlawn,Topeka Metro Bikes | Fire Station at Western and 21st,Topeka Metro Bikes | First Congregational Church,Topeka Metro Bikes | Fuzzy's Taco Shop,Topeka Metro Bikes | Gage Park - Blaisdell Pool - SNCO Parks,Topeka Metro Bikes | Gage Park - SNCO Parks,Topeka Metro Bikes | GraceMed Huntoon & Lane,Topeka Metro Bikes | GraceMed between the hospitals,Topeka Metro Bikes | Gracemed - East,Topeka Metro Bikes | GreatLife - YWCA,Topeka Metro Bikes | GreatLife Downtown - former old YMCA,Topeka Metro Bikes | Hanover Pancake House,Topeka Metro Bikes | Highland Park High School,Topeka Metro Bikes | Hope Street Academy High School,Topeka Metro Bikes | Hughes Park - Pickleball Courts - SNCO Parks,Topeka Metro Bikes | HyVee Grocery,Topeka Metro Bikes | Judicial Center 10th & Harrison Downtown,Topeka Metro Bikes | Judicial Center 12th & Topeka Lot 4 Downtown,Topeka Metro Bikes | Kansas Expocentre,Topeka Metro Bikes | Kwik Shop Topeka Blvd & 17th St,Topeka Metro Bikes | Lake Shawnee - Marina West - SNCO Parks,Topeka Metro Bikes | Lake Shawnee Campground SNCO Parks,Topeka Metro Bikes | Marian Clinic on East 6th St,Topeka Metro Bikes | McDonald's at 17th & Wanamaker,Topeka Metro Bikes | McDonald's at 29th & California,Topeka Metro Bikes | McDonalds - 12th & Gage,Topeka Metro Bikes | Midwest Health Aquatic Center - Shawnee County westside pool - SNCO Parks,"Topeka Metro Bikes | NOTO - Midblock crossing, 822 N Kansas Ave",Topeka Metro Bikes | NOTO Arts Center,Topeka Metro Bikes | Natural Grocers,Topeka Metro Bikes | Oakland Community Center - SNCO Parks,Topeka Metro Bikes | Old Prairie Town - SNCO Parks,Topeka Metro Bikes | Olive Garden - Employee bike parking,Topeka Metro Bikes | Pizagel's,Topeka Metro Bikes | Potwin Presbyterian Church parking lot - 5th & Lane,Topeka Metro Bikes | Reser's Salad - Loading Dock,Topeka Metro Bikes | Rowhouse Restaurant,Topeka Metro Bikes | SONIC - Huntoon & Gage,Topeka Metro Bikes | Shawnee County Health - 10th St & Jewell,Topeka Metro Bikes | Shawnee County Health Agency - MacVicar,Topeka Metro Bikes | Starbucks - South,Topeka Metro Bikes | Stormont-Vail Hospital,Topeka Metro Bikes | Stormont-Vail at 6th & Gage,Topeka Metro Bikes | Target,Topeka Metro Bikes | Teen Center - Boys and Girls Club - 10th & Indiana - SNCO Parks,Topeka Metro Bikes | Topeka Civic Theatre and Academy,Topeka Metro Bikes | Topeka High School,Topeka Metro Bikes | Topeka Housing Authority,Topeka Metro Bikes | Topeka Metro Admin Offices,Topeka Metro Bikes | Topeka West High School,Topeka Metro Bikes | Topeka Workforce Center Bus Shelter 15th and Topeka Blvd,Topeka Metro Bikes | Topeka and Shawnee County Public Library,Topeka Metro Bikes | VA Hospital,Topeka Metro Bikes | Valeo - 6th & Frazier,Topeka Metro Bikes | WIBW,Topeka Metro Bikes | Walgreen's at 37th and Topeka,Topeka Metro Bikes | Walgreens - 29th & Gage,Topeka Metro Bikes | Walgreens - North Topeka,Topeka Metro Bikes | Walmart East bike racks,Topeka Metro Bikes | Walmart Neighborhood Store 6th & MacVicar,Topeka Metro Bikes | Washburn - Lincoln Hall,Topeka Metro Bikes | Washburn Institute of Technology,Topeka Metro Bikes | Washburn Tech East,Topeka Metro Bikes | Washburn University - Art Building,Topeka Metro Bikes | Washburn University - Bennett Computer Center and Morgan Hall,Topeka Metro Bikes | Washburn University - Carnegie Book Drop,Topeka Metro Bikes | Washburn University - Henderson-Mabee,Topeka Metro Bikes | Washburn University - International House,Topeka Metro Bikes | Washburn University - KBI Building,Topeka Metro Bikes | Washburn University - KTWU,Topeka Metro Bikes | Washburn University - LLC SW,Topeka Metro Bikes | Washburn University - Lee Arena  - NE,Topeka Metro Bikes | Washburn University - Lee Arena - NW (0),Topeka Metro Bikes | Washburn University - Memorial Union,Topeka Metro Bikes | Washburn University - Morgan Hall - South,Topeka Metro Bikes | Washburn University - Morgan west,Topeka Metro Bikes | Washburn University - Plass Street Station,Topeka Metro Bikes | Washburn University - SRWC,Topeka Metro Bikes | Washburn University - Theater,Topeka Metro Bikes | Washburn University Village,Topeka Metro Bikes | West Ridge Mall SW entrance,Topeka Metro Bikes | Westboro Mart,Topeka Metro Bikes | Westridge Mall NW entrance,Topeka Metro Bikes | Westridge Mall north entrance,Topeka Metro Bikes | YMCA southwest,Topeka Metro Bikes | YWCA Downtown - 12th st entrance,Topeka Metro Bikes | Zoo Entrance Rack - SNCO Parks,Tradate | Comune,Tradate | Europa,Tradate | Museo Frera,Tradate | Ospedale,Tradate | Stazione,Tradate | Vittorio Veneto,Treviso | Borsa,Treviso | Ca` Foncello,Treviso | Cittadella Istituzioni,Treviso | Dal Negro,Treviso | Duomo,Treviso | Lanceri di Novara,Treviso | Matteotti,Treviso | Miani,Treviso | Monte di Pieta`,Treviso | Piscine,Treviso | Porta San Tommaso,Treviso | SS 40,Treviso | San Camillo,Treviso | Santa Maria del Rovere,Treviso | Sede Prov. S. Artemio,Treviso | Stadio Foro Boario,Treviso | Stazione FF.SS.,Treviso | Stazione FF.SS. Bis,Treviso | Strada Ovest 1,Treviso | Strada Ovest 2,Treviso | Strada Ovest 3,Treviso | Strada Ovest 4,Treviso | Strada Ovest 5,Treviso | Strada Ovest 6,Treviso | Strada Ovest 7,Treviso | Strada Ovest 8,Treviso | Strada Ovest 9,Treviso | Trentin,Treviso | Tribunale,Treviso | Universita`,Treviso | Vittoria,Tusbic | 001_JARDINES DE PEREDA,Tusbic | 002_PLAZA DE LAS BRISAS,Tusbic | 003_PARQUE LAS LLAMAS,Tusbic | 004_CORMORÁN,Tusbic | 005_GLORIETA DE LOS DELFINES,Tusbic | 006_FACULDAD DE CIENCIAS,Tusbic | 007_FACULTAD DE DERECHO,Tusbic | 008_PLAZA DE ITALIA,Tusbic | 009_AVENIDA DE LA MAGDALENA,Tusbic | 010_PLAZA DE SAN MARTIN,Tusbic | 011_PUERTO CHICO,Tusbic | 012_CALLE ALTA,Tusbic | 013_CALLE DE SAN FERNANDO,Tusbic | 014_ATILANO RODRIGUEZ,Tusbic | 015_AV.DE LOS CASTROS 141,Tusbic | 016_SEVERO OCHOA,Tusbic | 017_RUCANDIAL,Tychowski Rower Miejski | Dworcowa,Tychowski Rower Miejski | Kolejowa,Tyski Rower Miejski | Dworzec PKP,Tyski Rower Miejski | Jaśkowicka,Tyski Rower Miejski | Lodowisko,Tyski Rower Miejski | Paprocany,Tyski Rower Miejski | Piłsudskiego Targowisko,Tyski Rower Miejski | Plac Baczyńskiego,Tyski Rower Miejski | Tychy Centrum,UBike | AFC,UBike | Alderman,UBike | Arts,UBike | Bryan,UBike | Chemistry,UBike | Clark,UBike | FM,UBike | Gilmer,UBike | JPA,UBike | Lile-Maupin,UBike | McLeod,UBike | Minor,UBike | Monroe,UBike | Newcomb,UBike | North Grounds Rec,UBike | O-Hill,UBike | Preston,UBike | Scott Stadium,UBike | The Corner,UBike | Thornton,UBike | West Main,UBike | i.Lab,Udine | Andreuzzi,Udine | Autostazione,Udine | Caccia,Udine | Cavedalis,Udine | Cella,Udine | Chiavris,Udine | Diacono,Udine | Duomo,Udine | I Maggio,Udine | Kolbe,Udine | Magrini,Udine | Moretti,Udine | Ospedale,Udine | Petracco,Udine | Planis,Udine | Polo Scientifico,Udine | Poscolle,Udine | Stazione FF.SS.,Udine | Teatro,Udine | Terminal studenti,Udine | Tribunale,Udine | Ungheria,Udine | Vascello,Udine | XX Settembre,Ugento | Fontanelle,Ugento | Lido Marini,Ugento | Torre Mozza,Ugento | Torre San Giovanni - Annibale,Ugento | Torre San Giovanni - Lungomare Jonio,Ugento | Ugento,UsedomRad | AURELIA Hotel St. Hubertus Heringsdorf 5544,UsedomRad | Adler-Schiffe-Kai Stadtzentrum Swinemünde 5550,UsedomRad | Alte Fischräucherei Rankwitz - Hafen 5532,UsedomRad | Alte Schnitterkate Lassan 5632,UsedomRad | Am Autokino Koserow 5596,UsedomRad | Am Sackkanal 5595,UsedomRad | Am Warmbad Bansin 5522,UsedomRad | Antenne MV Rostock 5655,UsedomRad | Aquarius Ferienwohnungen Loddin 5557,UsedomRad | Bahnhof  Greifswald 5611,UsedomRad | Bahnhof Ahlbeck 5564,UsedomRad | Bahnhof Anklam 5536,UsedomRad | Bahnhof Bannemin - Mölschow 5509,UsedomRad | Bahnhof Bansin 5520,UsedomRad | Bahnhof Heringsdorf 5563,UsedomRad | Bahnhof Karlshagen 5524,UsedomRad | Bahnhof Koserow 5542,UsedomRad | Bahnhof Kölpinsee 5543,UsedomRad | Bahnhof Peenemünde  5501,UsedomRad | Bahnhof Schmollensee 5519,UsedomRad | Bahnhof Trassenheide 5558,UsedomRad | Bahnhof Trassenmoor 5525,UsedomRad | Bahnhof Zempin 5511,UsedomRad | Bahnhof Zinnowitz 5507,UsedomRad | Bahnhof Züssow 5539,UsedomRad | Bahnhof Ückeritz 5545,UsedomRad | Balticbike.pl Swinemünde 5528,UsedomRad | Balticpark Swinemünde 5548,UsedomRad | Best Western Hotel Hanse Kogge Koserow 5512,UsedomRad | Bike Hotel Vaske Karlshagen 5553,UsedomRad | Brücke Greifswald / Wieck 5612,UsedomRad | CSI Ferienwohnungen Schuldt Ahlbeck 5526,UsedomRad | Camping  Am Sandfeld  Koserow 5514,UsedomRad | Campingplatz 01 Ostseeblick Trassenheide 5567,UsedomRad | DJH - Jugendherberge  Greifswald 5605,UsedomRad | DJH - Jugendherberge  Heringsdorf 5622,UsedomRad | DJH - Jugendherberge Heringsdorf 5602,UsedomRad | DJH - Jugendherberge Murchin 5623,UsedomRad | DJH - Jugendherberge Stralsund 5625,UsedomRad | Dompassage Greifswald 5629,UsedomRad | Dünenwald Klinik Trassenheide 5505,UsedomRad | Energiepunkt Anklam 5529,UsedomRad | Energiepunkt Wolgast 5627,UsedomRad | Fahrradfachmarkt Pretzer Wolgast 5540,UsedomRad | Fahrradverleih Hertel Trassenheide 5503,UsedomRad | Fahrradverleih Holtz Karlshagen 5502,UsedomRad | Ferienpark Benz 5616,UsedomRad | Ferienwohnanlage `Alte Molkerei` Liepe 5533,UsedomRad | Fischräucherei Hafen Kamminke 5561,UsedomRad | Forstamt & Kletterwald Neu Pudagla 5518,UsedomRad | Golfhotel / Alte Schule Balm 5588,UsedomRad | Hafen Karlshagen 5583,UsedomRad | Hafen Karnin 5589,UsedomRad | Hafen Zinnowitz 5547,UsedomRad | Haffbad Ueckermünde 5592,UsedomRad | Hangar 10 am Flugplatz  5618,UsedomRad | Hauptbahnhof Wolgast 5586,UsedomRad | Historisch Technisches Museum Peenemünde  5552,UsedomRad | Hotel Forsthaus Damerow 5546,UsedomRad | Hotel Friesenhof Trassenheide 5513,UsedomRad | Hotel Inselhof Vineta Zempin 5566,UsedomRad | Hotel Leuchtfeuer Freest 5573,UsedomRad | Hotel Nautic Koserow 5570,UsedomRad | Hotel Ostseeländer Züssow 5601,UsedomRad | Hotel Seeklause Trassenheide 5559,UsedomRad | Hotel Spitzenhörnbucht Wolgast 5541,UsedomRad | Kanustation Anklam 5590,"UsedomRad | Kirche, Galerie & Feininger Rundweg Benz 5530",UsedomRad | Konzertmuschel Swinemünde 5549 /balticbike,UsedomRad | Kurhotel zu Heringsdorf 5626,UsedomRad | Kurverwaltung Seebad Lubmin 5599,UsedomRad | Landhaus am Haff 5614,UsedomRad | Landhotel Lieper Winkel Rankwitz 5577,UsedomRad | Marina Kröslin 5574,UsedomRad | Marina Seebad Lubmin 5598,UsedomRad | Marktplatz  Greifswald 5610,UsedomRad | Naturcamping Lassan 5538,UsedomRad | Naturcamping Lütow 5508,UsedomRad | Naturcamping Stagnieß 5562,UsedomRad | Naturhafen Krummin 5554,UsedomRad | Naturparkzentrum Stolpe bei Anklam 5606,UsedomRad | Ostseehotel Villen im Park Bansin 5580,UsedomRad | Ostseehotel Villen im Park Bansin Seestr.  5521,UsedomRad | Ostseestrandklinik Störtebeker Strandstr. Kölpinsee  5556,UsedomRad | Ostseetherme Heringsdorf 5631,UsedomRad | Parkplatz Förster - Schrödter - Straße Koserow 5523,UsedomRad | Parkplatz Lindenstr. Ahlbeck 5565,"UsedomRad | Pension ""Achterland"" Morgenitz 5613","UsedomRad | Pension ""Zum Himmel"" Groß Ernsthof 5609",UsedomRad | Pension Delia Will Ahlbeck 5615,UsedomRad | Pension Lindenhof Kachlin 5572,UsedomRad | Postel Wolgast 5617,UsedomRad | Promenadenhalle Wulf Zinnowitz 5576,UsedomRad | Rathaus Anklam  5537,UsedomRad | Rathaus Seebad Ahlbeck 5633,UsedomRad | Rehaklinik Ostseeblick Ückeritz 5571,UsedomRad | Rungeplatz Wolgast 5628,UsedomRad | SCHAWI Sport & Jugendhotel  Lubmin 5604,UsedomRad | Sandskulpturenfestival Usedom 5656,UsedomRad | Schloss Stolpe Usedom 5608,UsedomRad | Seebrücke Heringsdorf 5630,UsedomRad | Seebrücke Koserow 5587,UsedomRad | Seebrücke Seebad Lubmin 5597,UsedomRad | Stadtinfo im Naturparkhaus Usedom 5535,UsedomRad | Strandhotel Seerose Kölpinsee 5515,UsedomRad | Stützpunkt Balticbike.pl Swinemünde 5517,UsedomRad | Swingolf Middeke Reestow 5534,UsedomRad | Tierpark Ueckermünde 5593,UsedomRad | Tierpark Wolgast 5624,UsedomRad | Tourismus Information Mönkebude 5594,UsedomRad | Tourismus Information Ueckermünde 5591,UsedomRad | Tropenhaus Bansin 5621,UsedomRad | UBB Bahnhof Swinemünde / Balticbike.pl 5527,UsedomRad | Usedom Rad GmbH Zentrale 5555,UsedomRad | Vineta Hotels Zinnowitz 5560,UsedomRad | Waldcamp Freest 5603,UsedomRad | Wasserschloss Mellenthin 5531,UsedomRad | Yachthafen Swinemünde 5551,UsedomRad | Zur Fähre Greifswald  Wieck 5620,UsedomRad | Zweirad - Awe Strandpromenade Ückeritz 5516,Ustica | Cala Sidoti,Ustica | Faro,Ustica | Piazza Longo,Ustica | Urbana,VETURILO - Orlen | PKN Orlen - Al. Solidarności,VETURILO - Orlen | PKN Orlen - Bielańska,VETURILO - Orlen | PKN Orlen - Chodakowska,VETURILO - Orlen | PKN Orlen - E-bike Bielańska,VETURILO - Orlen | PKN Orlen - Filomatów,VETURILO - Orlen | PKN Orlen - Lazurowa,VETURILO - Orlen | PKN Orlen - Migdałowa,VETURILO - Orlen | PKN Orlen - Powsińska,VETURILO - Orlen | PKN Orlen - Wersalska,VETURILO - Orlen | PKN Orlen - Wydawnicza,VETURILO - Orlen | PKN Orlen - Śródziemnomorska,VETURILO | 1 Sierpnia - DK Włochy,VETURILO | 11 Listopada - Ratuszowa,VETURILO | 11 listopada - Środkowa,VETURILO | Abrahama - Kapelanów AK,VETURILO | Afrykańska - Egipska,VETURILO | Aluzyjna - Trąby,VETURILO | Andersa - Długa,VETURILO | Andersa - Muranowska,VETURILO | Anielewicza - Andersa,VETURILO | Anielewicza - Zamenhofa,VETURILO | Arkuszowa,VETURILO | Belgradzka - Rosoła,VETURILO | Belwederska - Gagarina,VETURILO | Białołęcki Ośrodek Sportu,VETURILO | Białołęka-Ratusz,VETURILO | Biblioteka Narodowa,VETURILO | Bielany-Ratusz,VETURILO | Blokowa - DK Zacisze,VETURILO | Bogusławskiego - Rodziny Połanieckich,VETURILO | Bonifraterska - Franciszkańska,VETURILO | Bora-Komorowskiego - Umińskiego,VETURILO | Bracka - Krucza,VETURILO | Broniewskiego - Krasińskiego,VETURILO | Broniewskiego - Perzyńskiego,VETURILO | Broniewskiego - Włościańska,VETURILO | Brukselska - PROM,VETURILO | Bukowiecka - Zamkowa,VETURILO | Bulwar – most Śląsko – Dąbrowski,VETURILO | Centrum Nauki Kopernik,VETURILO | Chodecka - Żuromińska,VETURILO | Ciszewskiego - Pileckiego,VETURILO | Czerniakowska - Gagarina,VETURILO | Czerniakowska - ZUS,VETURILO | Człuchowska - Rozłogi,VETURILO | Darwina - Nusbauma-Hilarowicza,VETURILO | Dereniowa - Płaskowickiej,VETURILO | Dewajtis - UKSW,VETURILO | Dickensa - Geodetów,VETURILO | Dwernickiego - Siennicka,VETURILO | Dworzec Wschodni - Kijowska,VETURILO | Dworzec Wschodni - Lubelska,VETURILO | Dzielna - Bellottiego,VETURILO | E-bike - Centrum Nauki Kopernik,VETURILO | E-bike - Karowa – Krakowskie Przedmieście,VETURILO | E-bike - Karowa – Wybrzeże Kościuszkowskie,VETURILO | E-bike - Krakowskie Przedmieście – Traugutta,VETURILO | E-bike - Metro Nowy Świat-Uniwersytet,VETURILO | E-bike - Miodowa,VETURILO | E-bike - Plac Trzech Krzyży,VETURILO | E-bike - Sowia,VETURILO | E-bike - Topiel – Tamka,VETURILO | E-bike - Wioślarska - Ludna,VETURILO | Emilii Plater - Al. Jerozolimskie,VETURILO | Emilii Plater - Wspólna,VETURILO | Emilii Plater - Świętokrzyska,VETURILO | Emilii Plater- Złota,VETURILO | Etiudy Rewolucyjnej - Miączyńska,VETURILO | Fabryka Wódek Koneser,VETURILO | Fieldorfa - Bukowskiego,VETURILO | Floriańska - Park Praski,VETURILO | Francuska - Walecznych,VETURILO | Frontowa – Czerwonych Beretów,VETURILO | Gałczyńskiego - Foksal,VETURILO | Grochowska - Mińska,VETURILO | Grójecka - Bitwy Warszawskiej 1920 roku,VETURILO | Gwiaździsta - Promyka,VETURILO | Górskiego - Szpitalna,VETURILO | Jagiellońska - ALK,VETURILO | Jagiellońska - Plac Hallera,VETURILO | Jagiellońska - Ratuszowa,VETURILO | Jana III Sobieskiego - al. Wilanowska,VETURILO | Jana Kazimierza - Gizów,VETURILO | Jana Olbrachta - Antka Rozpylacza,VETURILO | Jastrzębowskiego - SGGW,VETURILO | Jastrzębowskiego - SGGW 1,VETURILO | Kasprzaka - Karolkowa,VETURILO | Kasprzaka - Skierniewicka,VETURILO | Klaudyny - Rudzka,VETURILO | Kleszczowa - Krańcowa,VETURILO | Kochanowskiego - Galla Anonima,VETURILO | Kolejowa,VETURILO | Komandosów – Niedziałkowskiego,VETURILO | Kondratowicza - Chodecka,VETURILO | Kondratowicza - Przy Grodzisku,VETURILO | Kopińska - Białobrzeska,VETURILO | Kościelna - Piesza,VETURILO | Krakowskie Przedmieście - Traugutta,VETURILO | Krakowskie Przedmieście - Traugutta 2,VETURILO | Krakowskie Przedmieście - Trębacka,VETURILO | Krucza - Wspólna,VETURILO | Kruczkowskiego – PKP Powiśle,VETURILO | Książąt Mazowieckich - Heroldów,VETURILO | Książęca - Rozbrat,VETURILO | Lazurowa - Sternicza,VETURILO | Leszno - Młynarska,VETURILO | Lindleya - szpital,VETURILO | Lipowa - Dobra,VETURILO | Lipowa - Dobra 2,VETURILO | Madalińskiego - Kazimierzowska,VETURILO | Mariensztat,VETURILO | Marszałkowska - Al. Jerozolimskie,VETURILO | Marszałkowska - Hoża,VETURILO | Marszałkowska - Królewska,VETURILO | Marszałkowska - Litewska,VETURILO | Marszałkowska - Zielna,VETURILO | Marszałkowska - Złota,VETURILO | Marszałkowska - al. Solidarności,VETURILO | Marymoncka - Dewajtis,VETURILO | Marymoncka - Przy Agorze,VETURILO | Matejki - Wiejska,VETURILO | Meissnera - Fieldorfa,VETURILO | Metro Centrum,VETURILO | Metro Centrum Nauki Kopernik,VETURILO | Metro Dworzec Gdański,VETURILO | Metro Imielin,VETURILO | Metro Kabaty,VETURILO | Metro Marymont,VETURILO | Metro Młociny,VETURILO | Metro Natolin,VETURILO | Metro Plac Wilsona,VETURILO | Metro Racławicka,VETURILO | Metro Rondo Daszyńskiego,VETURILO | Metro Stadion Narodowy,VETURILO | Metro Stare Bielany,VETURILO | Metro Stokłosy,VETURILO | Metro Słodowiec,VETURILO | Metro Służew,VETURILO | Metro Ursynów I,VETURILO | Metro Ursynów II,VETURILO | Metro Wawrzyszew,VETURILO | Metro Wierzbno,VETURILO | Miodowa,VETURILO | Międzynarodowa - Walecznych,VETURILO | Modlińska - Żerańska,VETURILO | Mokotowska - Piękna,VETURILO | Muzeum Powstania Warszawskiego,VETURILO | Myśliborska - al. Kuklińskiego,VETURILO | Myśliwiecka - Rozbrat,VETURILO | Namysłowska - Darwina,VETURILO | Namysłowska - Szymanowskiego,VETURILO | Niepołomicka – Chełmżyńska,VETURILO | Noakowskiego - Koszykowa,VETURILO | Nowy Świat - Warecka,VETURILO | Obozowa - Ciołka,VETURILO | Obozowa - Radziwie,VETURILO | Oboźna - Kopernika,VETURILO | Obrońców Tobruku - Pieniążka,VETURILO | Ochota-Ratusz,VETURILO | Oczki - WUM,VETURILO | Okocimska - Olbrachta,VETURILO | Okopowa - Anielewicza,VETURILO | Okrzei - Panieńska,VETURILO | Opieńki – Maślaków,VETURILO | Ordonówny - Światowida,VETURILO | Ordynacka - Uniwersytet Muzyczny,VETURILO | Ostrobramska - Zamieniecka,VETURILO | PKP Rembertów – Cyrulików,VETURILO | PKP Rembertów – Marsa,VETURILO | PKP Ursus,VETURILO | PKP Ursus-Niedźwiadek,VETURILO | PKP Włochy,VETURILO | PKP Żwirki i Wigury,VETURILO | Paderewskiego – Czwartaków,VETURILO | Park Górczewska,VETURILO | Park Kultury w Powsinie,VETURILO | Park Kępa Potocka,VETURILO | Pasteura - Winnicka - UW,VETURILO | Pałac Kultury i Nauki,VETURILO | Pileckiego - Alternatywy,VETURILO | Plac Bankowy - Kino Muranów,VETURILO | Plac Bankowy - Ratusz,VETURILO | Plac Grunwaldzki,VETURILO | Plac Grzybowski,VETURILO | Plac Hallera - Sawinkowa,VETURILO | Plac Inwalidów,VETURILO | Plac Konstytucji,VETURILO | Plac Krasińskich,VETURILO | Plac Małachowskiego,VETURILO | Plac Na Rozdrożu,VETURILO | Plac Narutowicza,VETURILO | Plac Politechniki,VETURILO | Plac Politechniki 2,VETURILO | Plac Powstańców Warszawy,VETURILO | Plac Szembeka,VETURILO | Plac Trzech Krzyży,VETURILO | Plac Unii Lubelskiej,VETURILO | Plac Wileński,VETURILO | Plac Zawiszy,VETURILO | Plac Zbawiciela,VETURILO | Port Czerniakowski,VETURILO | Potocka - OSiR Żoliborz,VETURILO | Powstańców Śląskich - Człuchowska,VETURILO | Powstańców Śląskich - Pełczyńskiego,VETURILO | Powstańców Śląskich - Połczyńska,VETURILO | Powstańców Śląskich - Radiowa,VETURILO | Powstańców Śląskich - Wrocławska,VETURILO | Powązkowska - Burakowska,VETURILO | Powązkowska - Krasińskiego,VETURILO | Powązkowska - Plac Niemena,VETURILO | Poznańska - Zespół Szkół Gastronomicznych,VETURILO | Praga-Ratusz,VETURILO | Prosta - Wronia,VETURILO | Przasnyska - Rydygiera,VETURILO | Przyczółkowa - Branickiego,VETURILO | Przyczółkowa - Ptysiowa,VETURILO | Ptasia - Zimna,VETURILO | Puławska - Dolna,VETURILO | Puławska - Dworkowa,VETURILO | Puławska - Idzikowskiego,VETURILO | Puławska - Pileckiego,VETURILO | Pętla Bokserska,VETURILO | Pętla Bródno - Podgrodzie,VETURILO | Pętla Gocławek,VETURILO | Pętla Kawęczyńska-Bazylika,VETURILO | Pętla Nowe Bemowo,VETURILO | Pętla Stare Bemowo,VETURILO | Pętla Stegny,VETURILO | Pętla Szczęśliwice,VETURILO | Pętla Targówek,VETURILO | Radiowa - Wrocławska,VETURILO | Radzymińska - Piotra Skargi,VETURILO | Radzymińska - Wiosenna,VETURILO | Radzymińska - Łomżyńska,VETURILO | Radzymińska -Trocka,VETURILO | Rakowiecka - Św. A. Boboli,VETURILO | Raszyńska - Filtrowa,VETURILO | Raszyńska - Wawelska,VETURILO | Ratuszowa - ZOO,VETURILO | Rechniewskiego - Nowaka-Jeziorańskiego,VETURILO | Rembielińska - Kondratowicza,VETURILO | Rembielińska - Wyszogrodzka,VETURILO | Romera - Pieciolinii,"VETURILO | Rondo Fieldorfa ,,Nila’’",VETURILO | Rondo Jazdy Polskiej,VETURILO | Rondo Starzyńskiego,VETURILO | Rondo Waszyngtona - Stadion Narodowy,VETURILO | Rondo Waszyngtona - Stadion Narodowy 1,VETURILO | Rondo Wiatraczna,VETURILO | Rondo Zesłańców Syberyjskich,VETURILO | Rondo de Gaulle'a,VETURILO | Rondo Żaba,VETURILO | Rosoła - Ciszewskiego - SGGW,VETURILO | Rosoła - Gandhi,VETURILO | Rosoła - Wesoła,VETURILO | Rzymowskiego – Gotarda,VETURILO | Sanguszki - Wybrzeże Gdańskie,VETURILO | Sanocka - Pruszkowska,VETURILO | Senatorska - Bielańska,VETURILO | Sierakowskiego - Kłopotowskiego,VETURILO | Skarbka z Gór - Berensona,VETURILO | Skarbka z Gór - Magiczna,VETURILO | Skoroszewska - Prystora,VETURILO | Smocza - Anielewicza,VETURILO | Smocza - Miła,VETURILO | Smocza - Nowolipki,VETURILO | Smolna - PKP Powiśle,VETURILO | Sobieskiego - Chełmska,VETURILO | Sobieskiego - Mangalia,VETURILO | Sobieskiego - Nałęczowska,VETURILO | Sobieskiego - św. Bonifacego,VETURILO | Solec - Jaracza,VETURILO | Solec - al. 3 Maja,VETURILO | Sosnkowskiego - OSiR Ursus,VETURILO | Stalowa - 11 Listopada,VETURILO | Stalowa - Czynszowa,VETURILO | Stawki - Dubois,VETURILO | Stefana Banacha - UW,VETURILO | Stryjeńskich - Belgradzka,VETURILO | Stryjeńskich - Wąwozowa,VETURILO | Szaserów – Garwolińska,VETURILO | Szczęśliwicka - APS,VETURILO | Targowa - Kijowska,VETURILO | Targowa - Ząbkowska,VETURILO | Targówek-Ratusz,VETURILO | Topiel - Tamka,VETURILO | Urbanowicza - Kocjana,VETURILO | Ursus-Ratusz,VETURILO | Veturilko - Kępa Potocka,VETURILO | Veturilko - Park Bródnowski,VETURILO | Veturilko - Park Praski,VETURILO | Veturilko - Pole Mokotowskie,VETURILO | Veturilko - Rondo Waszyngtona - Stadion Narodowy,VETURILO | Veturilko - Sanguszki - Wybrzeże Gdańskie,VETURILO | Vogla - Syta,VETURILO | Warszawa Śródmieście WKD,VETURILO | Waszyngtona - Kinowa,VETURILO | Wałbrzyska - Wróbla,VETURILO | Wileńska - Rzeszotarskiej,VETURILO | Wola-Ratusz,VETURILO | Wolność - Bellottiego,VETURILO | Wolska - Elekcyjna,VETURILO | Wolska - Płocka,VETURILO | Wołoska - Kulskiego,VETURILO | Wołoska - Marynarska,VETURILO | Wołoska - Odyńca,VETURILO | Wrocławska – Bailly,VETURILO | Wybrzeże Gdyńskie - KS Spójnia,VETURILO | Wybrzeże Helskie - ZOO,VETURILO | Wybrzeże Szczecińskie - Stadion Narodowy,VETURILO | Wysockiego - Matki Teresy z Kalkuty,VETURILO | Wysockiego - Poborzańska,VETURILO | Wólczyńska - Conrada,VETURILO | Wąwozowa - Rosoła,VETURILO | Włochy-Ratusz,VETURILO | Zajączka - Bitwy Pod Rokitną,VETURILO | al. Armii Ludowej - Rektorska,VETURILO | al. Armii Ludowej – al. Niepodległości,VETURILO | al. Jana Pawła II - Anielewicza,VETURILO | al. Jana Pawła II - Grzybowska,VETURILO | al. Jana Pawła II - Nowolipki,VETURILO | al. Jana Pawła II - Plac Mirowski,VETURILO | al. Jana Pawła II - Stawki,VETURILO | al. Jana Pawła II - Złota,VETURILO | al. Jerozolimskie - Lindleya,VETURILO | al. Jerozolimskie - Niemcewicza,VETURILO | al. Jerozolimskie - Popularna,VETURILO | al. Jerozolimskie - rejon Rotundy,VETURILO | al. KEN – Przy Bażantarni,VETURILO | al. Lotników – Modzelewskiego,VETURILO | al. Niepodległości - Batorego,VETURILO | al. Niepodległości - Nowowiejska,VETURILO | al. Niepodległości - al. Wilanowska,VETURILO | al. Prymasa Tysiąclecia - Górczewska,VETURILO | al. Prymasa Tysiąclecia - Kasprzaka,VETURILO | al. Prymasa Tysiąclecia - Obozowa,VETURILO | al. Reymonta - Conrada,VETURILO | al. Rzeczypospolitej - Branickiego,VETURILO | al. Rzeczypospolitej - Klimczaka,VETURILO | al. Rzeczypospolitej - Oś Królewska,VETURILO | al. Solidarności - Szwedzka,VETURILO | al. Stanów Zjednoczonych - Międzynarodowa,VETURILO | al. Stanów Zjednoczonych - Ostrobramska,VETURILO | al. Wilanowska - Przyczółkowa,VETURILO | al. Zieleniecka - Teatr Powszechny,VETURILO | ul. Waryńskiego-ul. Nowowiejska-Metro Politechnika,VETURILO | Łabiszyńska – OSiR Targówek,VETURILO | Św. Wincentego – Kołowa,VETURILO | Światowida - Mehoffera,VETURILO | Żelazna - Chłodna,VETURILO | Żelazna - Grzybowska,VETURILO | Żelazna - Sienna,VETURILO | Żwirki i Wigury - Księcia Trojdena,VETURILO | Żwirki i Wigury - Racławicka,VISA | 4129-Dürerstraße,VISA | 4130-Walther-von-Cronberg Platz,VISA | 4131-Holzhausenschlösschen,VISA | 4132-Musterschule,VISA | 4135-Triftstraße,VISA | 4136-Frankfurt - Niederrad,VISA | 4138-Campus / Uni-Klinikum II,VISA | 4139-Campus / Uni-Klinikum I,VISA | 4155-Gartenstraße,VISA | 4156-Affentorplatz,VISA | 4157-Friedberger Landstraße,VISA | 4158-Sonnenmannstraße / VHS,VISA | 4160-Carlo-Schmid-Platz,VISA | 4180-Studierendenhaus an der Goethe-Universität,VISA | 4181 - Robert-Mayer-Straße,VISA | 4182 - Schloßstraße / Robert-Mayer-Straße,VISA | 4183 - Bockenheimer Warte / U-Bahn,VISA | 4184-Beethovenplatz,VISA | 4186-Finkenhofstraße,VISA | 4188 - Bremer Platz,VISA | 4189 - Gutleutstraße,VISA | 4191 -  Taunusanlage,VISA | 4192 -  Mainkai / Eiserner Steg,VISA | 4193 - Ostendstraße,VISA | 4194 - Friedberger Anlage / Uhrtürmchen,VISA | 4195 - Galluswarte / S-Bahn,VISA | 4197 - Voltastraße / Franklinstraße,VISA | 4198 - Frankfurt University (Gebäude 1),VISA | 4199 - Schloßstraße,VISA | 4200 - Frankfurt Main West,VISA | 4201 - Adalbertstraße,VISA | 4202 - Freibad Hausen,VISA | 4203 - Franz-Rücker-Allee,VISA | 4204 - Rebstöcker Straße,VISA | 4205 - Schwalbacher Straße,VISA | 4206 - Sandhofstraße,VISA | 4207 - Studentenwerk/Sandhoferstraße,VISA | 4209 - Schaumainkai/Friedensbrücke,VISA | 4211 - VISA,VISA | 4212 - DJH Jugendherberge,VISA | 4213 - Lokalbahnhof,VISA | 4214 - Holzhausenstraße,VISA | 4215 - Gerbermühle,VISA | 4217 - Frankfurter Garten,VISA | 4218 - Grüneburgweg/Eschersheimer Landstraße,VISA | 4220 - Fritz-Neumark-Weg,VISA | 4221 - Palmengarten,VISA | 4222 - Siolistraße,VISA | 4223 - Eschersheimer Landstraße,VISA | 4225 - Deutsche National Bibliothek,VISA | 4227 - AStA Frankfurt University of Applied Sciences,VISA | 4228 - Frankfurt University1,VISA | 4229 - Gisèle-Freund-Platz,VISA | 4230-Max-Horkheimer-Straße,VISA | 4231-Sebastian-Rinz-Straße,VISA | 4232-Cronstettenstraße,VISA | 4234 - Comeniusstraße,VISA | 4235 - Trianon,VISA | 4237 - Eschenheimer Turm / Hochstraße,VISA | 4238 - Roßmarkt / Junghofstr. (Goetheplatz),VISA | 4239 - Baseler Platz / Baseler Straße / Gutleutstr.,VISA | 4240 - Hauptbahnhof / Vorplatz,VISA | 4241 - Messe / Festhalle / Eingang U-Bahn,VISA | 4242 - Willy-Brandt-Platz / Neue Mainzer Str.,VISA | 4243 - Opernplatz / Bockenheimer Landstr.,VISA | 4244 - Fressgasse / Neue Mainzer Str.,VISA | 4245 - Hauptwache,VISA | 4246 - Römer / Touristeninformation,VISA | 4247 - Konstabler Wache / Conrad-Elektronik,VISA | 4248 - Zoo / Alfred-Brehm-Platz,VISA | 4249 - Merianplatz / Berger Str.,VISA | 4250 - Friedberger Platz / Café Harveys,VISA | 4251 - Höhenstraße / Berger Str.,VISA | 4252 - Nibelungenplatz / Friedberger Landstr.,VISA | 4254 - Eissporthalle/Kettelerallee,VISA | 4255 - Bornheim Mitte,VISA | 4256 - Freibad Eschersheim,VISA | 4257 - Bockenheimer Landstr. / Liebigstr.,VISA | 4258 - Bockenheimer Warte / Café Extrablatt,VISA | 4259 - Leipziger Str. / Markgrafenstr.,VISA | 4260 - Südbahnhof / Hedderichstr.,VISA | 4261 - Schweizer Platz / Diesterwegstr.,VISA | 4262 - Schaumainkai / Schweizer Str.,VISA | 4274 - USCC Jakob-Leisler Straße,VISA | 4275 - USCC Plieninger Straße,VISA | 4276 - USCC Haltestelle Platenstraße,VISA | 4277-Stralsunder Straße,VISA | 4278 - Uniklinikum,VISA | 4279 - Marriott Hotel / Hamburger Allee,VISA | 4280-Marbachweg / Sozialzentrum,VISA | 4281 - Kleiststraße / Gleimstraße,VISA | 4282-Hansaallee,VISA | 4283-Frauenfriedenskirche,VISA | 4284-Zentrum für Hochschulsport,VISA | 4285 - Sonnemannstraße / Windeckstraße,VISA | 4286 - Hotel Ramada City / Weserstr. / Kaiserstr.,VISA | 4287 - Hotel Macrander,VISA | 4288 - Hotel Derag,VISA | 4289 - Hülya Platz,VISA | 4290 - Hotel Ramada Hotel Messe,VISA | 4291 - Hotel Lindner Congress / Bolongarostr 100,VISA | 4292 - Hotel Accor / Ibis F-City Messe / Leonardo-da-Vinci-Allee 40,VISA | 4293 - Rödelheimer Straße,VISA | 4294 - Hotel Adina Apartment Frankfurt / Neue Oper / Wilhelm-Leuschner-Str 6,VISA | 4295 - Hotel Adina Apartment Frankfurt / Osloer Straße,VISA | 4296 - Hotel B&B Frankfurt City-Ost / Hanauer Landstr. 117,VISA | 4304-Karpfenweg/Ecke Werftstraße,VISA | AVIS - FRANKFURT CENTER,VISA | AVIS - FRANKFURT CITY,VISA | AVIS - FRANKFURT EAST HANAUER LANDSTR.,VISA | AVIS - FRANKFURT SUED,VISA | AVIS - FRANKFURT-HOECHST (WEST),VISA | AVIS - HAUPTBAHNHOF FRANKFURT MAIN,VISA | Heddernheimer Höfe,VRN | A5 - Universität West,VRN | Alter OEG-Bahnhof,VRN | Altstadt - Akademiestraße,VRN | Altstadt - Karlstorbahnhof,VRN | Altstadt - Marstall,VRN | Altstadt - Neckarmünzplatz,VRN | Altstadt - Theaterstraße,VRN | Altstadt – Bismarckplatz,VRN | Altstadt – Stadthalle,VRN | Altstadt – Universitätsplatz,VRN | Am Gartenschaupark,VRN | Amtsgericht,VRN | Anlegestelle Rhein,VRN | Aquadrom,VRN | Auerbach - Bahnhof,VRN | Auerbach - Kronepark,VRN | BASF Besucherzentrum,VRN | Bahnhof,VRN | Bahnhof / ZOB,VRN | Bahnhof Lützelsachsen,VRN | Bahnhof West,VRN | Bahnstadt Halle 02,VRN | Beim Pumpwerk,VRN | Bellamar,VRN | Bergheim - Altes Hallenbad,VRN | Bergheim - Kurfürstenanlage,VRN | Bergheim - rnv Betriebshof Bergheimerstr.,VRN | Berliner Platz,VRN | Bürgerbüro Salzgasse,VRN | DHBW Mannheim - Campus Coblitzallee,VRN | DHBW Mannheim - Campus Eppelheim,VRN | DHBW Mannheim - Campus Käfertalerstr.,VRN | Das Wormser,VRN | Davenportplatz,VRN | Demando / PRE-Park,VRN | Dom,VRN | Dr.-Heinrich-Winter-Straße,VRN | Duttweiler Straße,VRN | Dürreplatz,VRN | E1 - Paradeplatz,VRN | E4 - Rathaus,VRN | Einkaufszentrum Güterbahnhof,VRN | Eppelheimer Straße - CampusRad,VRN | Europaplatz,VRN | Festplatz,VRN | Franklin,VRN | Friedenstr. / Hilgardring,VRN | Friedhof,VRN | G7 - Westliche Unterstadt,VRN | GRN-Klinik Schwetzingen,VRN | Gewerkschaftshaus,VRN | Gießener Straße,VRN | Goetheschule,VRN | Graben,VRN | Gymnasium,VRN | HS Kaiserslautern,VRN | Hallenbad,VRN | Haltepunkt Blumenstraße,VRN | Haltepunkt Händelstraße,VRN | Haltepunkt Stahlbad,VRN | Handschuhsheim – Hans-Thoma-Platz,VRN | Hauptbahnhof,VRN | Hauptbahnhof / Zollamtstraße,VRN | Hauptbahnhof Mannheim,VRN | Hauptbahnhof Nord,VRN | Hauptbahnhof Ost / St-Albans-Platz,VRN | Hauptbahnhof West / Auxerreplatz,VRN | Hemshof - BASF Süd,VRN | Hemshof - Goerdelerplatz,VRN | Hilde-Mattauch-Platz,VRN | Hirschhorner Straße,VRN | Hochschule Campus Nord,VRN | Hochschule Campus Süd,VRN | Hochschule Ludwigshafen,VRN | Hochschule Mannheim,VRN | Hockenheimring,VRN | Holbeinring - CampusRad,VRN | Im Neuenheimer Feld / PH Heidelberg - CampusRad,VRN | Jugendherberge / Dom,VRN | Jugendzentrum GO IN,VRN | Jungbusch - Jungbuschstraße,VRN | Jungbusch - Popakademie,VRN | K1 - Kurpfalzbrücke,VRN | Kaiserpassage,VRN | Karl Kübel Schule,VRN | Karlsruher Straße,VRN | Kettelerstraße,VRN | Kirchheim – Rathaus,VRN | Klinikum,VRN | Kongresszentrum Rosengarten,VRN | Krankenhaus / Behördenzentrum,VRN | Kreiskrankenhaus,VRN | Kreisverwaltung - Europaplatz,VRN | Kronenstraße,VRN | Kunsthalle,VRN | L1 - Schloss,VRN | LU Süd - Rheinallee,VRN | LU Süd - Schützenplatz,VRN | Lindenhof - Johanniskirche,VRN | Lindenhof - Jugendherberge,VRN | Lindenhof - Lindenhofplatz,VRN | MVV Hochhaus,VRN | Mannheim Oststadt Karl-Ludwig-Straße,VRN | Mannheimer Straße,VRN | Marienkirche,VRN | Marktplatz,VRN | Marktplatz Hirschacker,VRN | Mozartstraße,VRN | N5 - Kapuzinerplanken,VRN | Nationaltheater,VRN | Neckarau - Hans-Sachs-Ring,VRN | Neckarau - Markuskirche,VRN | Neckarstadt - Alter Messplatz,VRN | Neckarstadt-Ost  - Carl-Zuckmayer-Straße,VRN | Neckarstadt-Ost - Lange Rötterstraße,VRN | Neckarstadt-West - Riedfeldstraße,VRN | Neuenheim – Kußmaulstraße,VRN | Neuenheim – Neckarwiese,VRN | Neuenheimer Feld – Jahnstraße,VRN | Neuenheimer Feld – Mathematikon,VRN | Neuenheimer Feld – Zentralmensa,VRN | Neuenheimer Feld – Zoo,VRN | Neumarkt,VRN | Neumarkt / Touristinformation,VRN | Nordstadt,VRN | Oststadt - Luisenpark,VRN | P7 - Fressgasse,VRN | PH Heidelberg - CampusRad,VRN | Parkhof,VRN | Parktheater,VRN | Parmaplatz,VRN | Pfaffplatz,VRN | Pfalzbau,VRN | Pfalzgrafenplatz,VRN | Postplatz,VRN | Prinz-Carl-Anlage,VRN | R1 - Marktplatz,VRN | REWE,VRN | Rathaus,VRN | Rhein-Galerie,VRN | Rhein-Neckar-Kreis / Kurfürstenanlage,VRN | Rheinbrücke,VRN | Rheinstraße - CampusRad,VRN | Richard-Wagner-Straße / Königstraße,VRN | Rohrbach – Markt,VRN | Rummelstraße,VRN | S-Bahn-Haltepunkt Nord/West,VRN | S-Bahnhof Schlierbach/Ziegelhausen,VRN | S-Bahnhof Weststadt/Südstadt,VRN | SWK Kaiserslautern Versorgung,VRN | SWK Verkehrs AG (Betriebshof),VRN | Schlosspark,VRN | Schlossplatz Schwetzingen,VRN | Schwanthalerplatz,VRN | Schwetzingerstadt - Dynamostraße,VRN | Schwetzingerstadt - Pestalozzischule,VRN | Schwetzingerstadt - rnv Betriebshof Möhlstraße,VRN | Sebastian-Bach-Straße,VRN | Speyer West - Berliner Platz,VRN | Sportzentrum Süd,VRN | Springer Verlag,VRN | Stadthalle,VRN | Stadtmitte / Fruchthalle,VRN | Stadtpark,VRN | Stiftsplatz,VRN | Stubenwald,VRN | Studentensiedlung Ludwig Frank,VRN | TUK - Innenhof Gebäude 47,VRN | TUK - Pfaffenbergstraße,VRN | TUK Mensa,VRN | Technoseum,VRN | Theresienkrankenhaus,VRN | Tiergartenschwimmbad,VRN | Tourist-Information,VRN | Trippstadter Straße / Institute,VRN | Universität,VRN | Universität Mensa,VRN | Universität Schloss,VRN | Universitätsklinik Mannheim - CampusRad,VRN | Untere Fußgängerzone,VRN | Volkspark,VRN | Waidsee,VRN | Waldschwimmbad,VRN | Weiherhausstraße,VRN | Westbahnhof / Gartenschau,VRN | Weststadthalle / Badesee,VRN | Wieblingen Mitte,VRN | Wohnmobilstellplatz,VRN | Wormser Straße,VRN | Wredestraße,VRN | Ziegelhausen – Neckarschule,VRN | Zähringerstraße,VRN | alla hopp!-Anlage,VRN | rnv Betriebshof Ludwigshafen (keine öffentliche Station),VRN | Ärztehaus - Bebelstr.,Valenbisi | 001_GUILLEN_DE_CASTRO,Valenbisi | 002_CALLE_SALVADOR_GINER_CALLE_MUSEO,Valenbisi | 003_PLAZA_MUSICO_LOPEZ_CHAVARRI,Valenbisi | 004_PLAZA_DE_LA_VIRGEN_CALLE_BAILIA,Valenbisi | 005_PINTOR_LOPEZ_PZA_POETA_LLORENTE,Valenbisi | 006_GUILLEN_CASTRO_CON_CALLE_SAN_PEDRO_PASCUAL,Valenbisi | 007_PZA_DEL_MERCADO_TAULA_DE_CANVIS,Valenbisi | 008_PLAZA_DE_LA_REINA_ESQUINA_CALLE_DEL_MAR,Valenbisi | 009_PLAZA_TETUAN_4,Valenbisi | 010_CALLE_DEL_HOSPITAL_FRENTE_CALLE_HORNO_DEL_HOSP,Valenbisi | 011_PZA_AYTO_CON_CALLE_COTANDA,Valenbisi | 012_CALLE_MINYANA,Valenbisi | 013_PZA. ALFONSO MAGNANIMO_CON_CALLE_LA_NAVE,Valenbisi | 014_BARÓN CARCER,Valenbisi | 015_RIBERA,Valenbisi | 016_COLON I,Valenbisi | 017_ESTACION RENFE I,Valenbisi | 018_COLON II,Valenbisi | 019_JUAN_LLORENS,Valenbisi | 020_FERNANDO_EL_CATOLICO_CALLE_QUART,Valenbisi | 021_JUAN_LLORENS_29,Valenbisi | 022_JUAN_LLORENS_57,Valenbisi | 023_GRAN_VIA_FERNANDO_EL_CATOLICO,Valenbisi | 024_GRAN_VIA_RAMON_Y_CAJAL,Valenbisi | 025_CALLE_DEL_ALBERIC,Valenbisi | 026_CALLE_SAN_JOSE_DE_CALASANZ,Valenbisi | 027_CALLE_SAN_VICENTE_MARTIR_129,Valenbisi | 028_NAVARRO REVERTE,Valenbisi | 029_PLAZA AMERICA,Valenbisi | 030_CIRILO AMOROS,Valenbisi | 031_CALLE SALAMANCA,Valenbisi | 032_C/ CONDE DE ALTEA,Valenbisi | 033_GRAN_VIA_GERMANIAS_ESQ_CALLE_RUZAFA,Valenbisi | 036_PZA_LOS_FUEROS_CONDE_TRENOR,Valenbisi | 057_CALLE PINTOR MONLEON,Valenbisi | 058_PLAZA DE ESPAÑA,Valenbisi | 059_AVDA. DE BALEARES I,Valenbisi | 060_AVDA.BALEARES II,Valenbisi | 061_VICENTE VIDAL,Valenbisi | 062_MENORCA,Valenbisi | 063_AVDA. DEL PUERTO I,Valenbisi | 064_AVDA. DEL PUERTO II,Valenbisi | 065_AVDA. DEL PUERTO III,Valenbisi | 066_GUILLEN DE ANGLESOLA,Valenbisi | 067_JUAN VERDEGUER,Valenbisi | 068_AVDA. DEL PUERTO IV,Valenbisi | 069_AVDA. DEL PUERTO,Valenbisi | 071_AVDA DEL PUERTO VI,Valenbisi | 072_RAMIRO MAETZU,Valenbisi | 073_JERONIMO MONSORIU,Valenbisi | 074_PLAZA SAN FELIPE NERI,Valenbisi | 075_CAMPOAMOR I,Valenbisi | 076_CAMPOAMOR II,Valenbisi | 078_AVDA. ARAGÓN I,Valenbisi | 079_AVDA. ARAGON II,Valenbisi | 080_AMADEO SAVOIA,Valenbisi | 081_DOCTOR FORNOS,Valenbisi | 082_GUILLEN_DE_CASTRO_TORRES_DE_QUART,Valenbisi | 085_AVDA_BLASCO IBAÑEZ 1,Valenbisi | 088_AVDA. BLASCO IBAÑEZ 3,Valenbisi | 091_CALLE_GRABADOR_JORDAN_46_PLAZA_ESCULTOR_PASTOR,"Valenbisi | 092_AVDA. DE ARAGON, 4 - ESQ AVDA BLASCO IBAÑEZ",Valenbisi | 094_AVDA. BLASCO IBAÑEZ 5,Valenbisi | 096_AVDA. BLASCO IBAÑEZ 6,Valenbisi | 097_AVDA. BLASCO IBAÑEZ 7,Valenbisi | 098_SANTOS JUSTO Y PASTOR,Valenbisi | 099_AVDA. BLASCO IBAÑEZ 8,Valenbisi | 100_AVDA. BLASCO IBAÑEZ 9,Valenbisi | 101_AVDA. BLASCO IBAÑEZ 10,Valenbisi | 102_AVDA.RAMON LLUL,Valenbisi | 103_RUBEN DARIO,Valenbisi | 104_ALBALAT DELS TARONGERS,Valenbisi | 105_AVDA. DE LOS NARANJOS,Valenbisi | 106_AVDA. DE LOS NARANJOS,Valenbisi | 107_C/ CAMPILLO ALTO BUEY,Valenbisi | 108_ LUIS PEIXO,Valenbisi | 109_AVDA. NARANJOS,Valenbisi | 110_KISSHOMARU,Valenbisi | 111_COLEGIO MAYOR,Valenbisi | 112_AVDA. DE LOS NARANJOS,Valenbisi | 113_ETS CAMINOS,Valenbisi | 114_ADOLFO SUAREZ,Valenbisi | 115_C/ DR. VICENTE ZARAGOZA,Valenbisi | 116_C/ DR. VICENTE ZARAGOZA,Valenbisi | 117_PRIMADO REIG,Valenbisi | 118_C/ DR. GOMEZ FERRER,Valenbisi | 119_C/ JAIME ROIG,Valenbisi | 120_C_DR VICENTE ZARAGOZA,Valenbisi | 121_C_MURTA,Valenbisi | 122_C_MÚSICO HIPÓLITO MARTÍNEZ,Valenbisi | 123_C_ALBOCACER,Valenbisi | 124_C/ AZAGADOR DE ALBORAYA,Valenbisi | 125_C/ MASQUEFA,Valenbisi | 126_C/ ALFAUIR,Valenbisi | 127_C/ DUQUE DE MANDAS,Valenbisi | 128_C/ ALFAUIR,Valenbisi | 129_C_ALMAZORA,Valenbisi | 130_C/ CONVENTO CARMELITAS,Valenbisi | 131_C/ ALBORAYA,Valenbisi | 132_C/ RUAYA,Valenbisi | 133_C/ ALFAMBRA,Valenbisi | 134_C/ MAXIMILIANO THOUS,Valenbisi | 135_AVDA. CONSTITUCIÓN,Valenbisi | 136_CALLE_ECONOMISTA_GAY,Valenbisi | 137_CALLE_ECONOMISTA_GAY,Valenbisi | 138_SAN_PANCRACIO,Valenbisi | 139_C/ REUS,Valenbisi | 140_AVENIDA_CAMPANAR,Valenbisi | 141_C/ GREGORIO GEA (PEATONAL),Valenbisi | 142_C/ GREGORIO GEA (PEATONAL),Valenbisi | 143_AVDA. MENENDEZ PIDAL,Valenbisi | 144_CALLE_MARQUES_DE_SAN_JUAN,Valenbisi | 145_PLAZA_BADAJOZ,Valenbisi | 146_AVDA. CAMPANAR,Valenbisi | 147_CALLE_PIE_DE_LA_CRUZ_CALLE_DE_LA_REJA,Valenbisi | 148_XÀTIVA_PLAZA_DE_TOROS,Valenbisi | 149_AVDA. PERIS Y VALERO,Valenbisi | 150_DR. MANUEL CANDELA,Valenbisi | 151_JERONIMO MONSORIU,Valenbisi | 152_C/ LITERATO AZORÍN,Valenbisi | 153_C/ LLANO DE ZAIDA,Valenbisi | 154_PESCADORES,Valenbisi | 155_C/ SALAMANCA,Valenbisi | 156_C/ CUBA,Valenbisi | 157_AVENIDA_PEREZ_GALDOS,Valenbisi | 158_DR.LLUNCH,Valenbisi | 159_FRANCISCO CUBELLS,Valenbisi | 160_JOSE MARIA DE HARO,Valenbisi | 161_MEDITERRANEO,Valenbisi | 162_PZA. ARMADA ESPAÑOLA,Valenbisi | 163_PASEO NEPTUNO,Valenbisi | 164_PAVIA 1,Valenbisi | 165_PAVIA 2,Valenbisi | 166_PROGRESO,Valenbisi | 167_PAVIA 3,Valenbisi | 168_AVDA. MALVARROSA,Valenbisi | 169_PAVIA 4,Valenbisi | 170_PAVIA 5,Valenbisi | 171_CALLE GRAN CANARIA,Valenbisi | 172_AVENIDA_PIO_XII,Valenbisi | 173_AVENIDA_PIO_XII_34,Valenbisi | 174_CALLE_MONDUBER,Valenbisi | 175_CALLE_JUAN_XXIII,Valenbisi | 176_CAMINO_DE_MONCADA_52,Valenbisi | 177_CALLE_ALCUDIA,Valenbisi | 178_CALLE_REIG_GENOVES,Valenbisi | 179_AVENIDA_DE_LA_PLATA_45,Valenbisi | 180_AVENIDA_DOCTOR_WAKSMAN,Valenbisi | 181_CALLE_DEL_SALINAR,Valenbisi | 182_AVDA_AUSIAS_MARCH,Valenbisi | 183_AVDA_AUSIAS_MARCH,Valenbisi | 184_CALLE_BOMBER_RAMON_DUART,Valenbisi | 185_AVDA_AUSIAS_MARCH,Valenbisi | 186_CALLE_INGENIERO_JOAQUIN_BENLLOCH,Valenbisi | 187_AVDA_AUSIAS_MARCH,Valenbisi | 188_HOSPITAL_NUEVA_FE,Valenbisi | 189_HOSPITAL_NUEVA_FE,Valenbisi | 190_CTRA_MALILLA,Valenbisi | 191_CTRA_MALILLA,Valenbisi | 192_CTRA_MALILLA,Valenbisi | 193_CALLE_CARTEROS,Valenbisi | 194_ESTACION_AVE_JOAQUIN_SOROLLA,Valenbisi | 195_CALLE_GIORGETA,Valenbisi | 196_AVDA_GASPAR_AGUILAR,Valenbisi | 197_CALLE_FONTANARS_DELS_AFORINS,Valenbisi | 198_CALLE_FONTANARS_DELS_AFORINS,Valenbisi | 199_CALLE_BEATO_NICOLAS_FACTOR,Valenbisi | 200_AVDA_DEL_CID,Valenbisi | 201_AVDA_PEREZ_GALDOS,Valenbisi | 202_PASEO_PECHINA,Valenbisi | 203_CALLE_REINA_VIOLANTE,Valenbisi | 204_AVDA_GENERAL_AVILES,Valenbisi | 205_CALLE_NICASIO_BENLLOCH,Valenbisi | 206_CALLE_PERIODISTA_GIL_SUMBIELA,Valenbisi | 207_CALLE_MILLARES_ESQ_CALLE_FEDERICO_GARCA_LORCA,Valenbisi | 208_CALLE_CARTEROS_ESQ_CALLE_MOSSEN_FEBRER,Valenbisi | 209_AVDA_GASPAR_AGUILAR_ESQ_CALLE_MUSICO_PENELLA,Valenbisi | 210_CALLE_CAMPOS_CRESPO_ESQ_CALLE_JUAN_DE_GARAY,Valenbisi | 211_CALLE_FRAY_JUNÍPERO_SERRA_ESQ_CALLE_VALL_D'UIX,Valenbisi | 212_CALLE_FRAY_JUANÍPERO_SERRA_ESQ_CALLE_TORRENTE,Valenbisi | 213_CALLE_ARCHIDUQUE_CARLOS_ESQ_CALLE_JOSE_MA_MOR,Valenbisi | 214_CALLE_SANTA_CRUZ_DE_TENERIFE_ESQ_CALLE_LLOMBA,Valenbisi | 215_CALLE_MUSICO_AYLLON_ESQ_CALLE_FRANCISCO_DOLZ,Valenbisi | 216_AVDA_DEL_CID_ESQ_CALLE_BURGOS,Valenbisi | 217_CALLE_9_DE_OCTUBRE_ESQ_CALLE_PINTOR_STOLZ,Valenbisi | 218_CALLE_SALVADOR_FERRANDIS_LUNA_ESQ_CALLE_JUAN_B,Valenbisi | 219_CALLE_CASTAN_TOBEÑAS_ESQ_CALLE_VELAZQUEZ,Valenbisi | 220_CALLE_CASTAN_TOBEÑAS_ESQ_CALLE_DE_GOYA,Valenbisi | 221_AVDA_MANUEL_DE_FALLA_ESQ_CALLE_HERNANDEZ_LAZAR,Valenbisi | 222_AVDA_MAESTRO_RODRIGO_ESQ_AVDA_MANUEL_DE_FALLA,Valenbisi | 223_CALLE_VALLE_BALLESTERA_ESQ_PLAZA_POLICIA_LOCAL,Valenbisi | 224_PLAZA_JOSE_MONFORTE_TUDELA_ESQ_CALLE_HERNANDEZ,Valenbisi | 225_CALLE_PADRE_BARRANCO_DESPUES_CALLE_BENIFAIRO,Valenbisi | 226_CALLE_SAFOR_ESQ_AVDA_DE_LAS_CORTES_VALENCIANAS,Valenbisi | 227_CALLE_SAN_CLEMENTE_ENTRA_HOSPITAL_ARNAU_VILANO,Valenbisi | 228_AVDA_NICASIO_BENLLOCH_ESQ_CALLE_L'HORTA_SUD,Valenbisi | 229_CALLE_AITANA_ESQ_AVDA_BURJASSOT,Valenbisi | 230_CALLE_POETA_SERRANO_CLAVERO_EQ_GENERAL_LLORENS,Valenbisi | 231_CALLE_DE_ALCAÑIZ_ESQ_CALLE_CAMBRILS,Valenbisi | 232_SAN_VICENTE_DE_PAUL_SANTIAGO_RUSIÑOL,Valenbisi | 233_SAN_JUAN_BOSCO_SANTIAGO_RUSIÑOL,Valenbisi | 234_PLAZA MUSICO_ESPI_JOSE_ESTEVE,Valenbisi | 235_CONDE_DE_TORREFIEL_CECILIO_PLA,Valenbisi | 236_RIO_SEGRE_RAFAEL_COMPANY,Valenbisi | 237_LEVANTE_UD_AVDA_ECUADOR,Valenbisi | 238_SAN_JOSE_ARTESANO_FRANCISCO_MOROTE_GREUS,Valenbisi | 239_LA_FLORISTA_TRANVIA_PALACIO_CONGRESOS,Valenbisi | 240_CAMP_DEL_TURIA_AVDA_CORTES_VALENCIANAS,Valenbisi | 241_VALL_DE_ALBAIDA_PEATONAL,Valenbisi | 242_LA_SAFOR_AVDA_MAESTRO_RODRIGO,Valenbisi | 243_ALBACETE_ESQ_MALUQUER,Valenbisi | 244_AVDA_PIO_BAROJA_VALLE_DE_LA_BALLESTERA,Valenbisi | 245_9_DE_OCTUBRE_CIEZA,Valenbisi | 246_AVDA_TRES_CRUCES_ENTRADA_HOSPITAL_GENERAL,Valenbisi | 247_AVDA_TRES_CRUCES_MUSICO_AYLLON,Valenbisi | 248_AVDA_TRES_CRUCES_JOSE_MARIA_MORTES_LERMA,Valenbisi | 249_AVDA_TRES_CRUCES_SEGUNDA_REPUBLICA_ESPAÑOLA,Valenbisi | 250_AVDA_TRES_CRUCES_PIO_XI,Valenbisi | 251_ARQUITECTO_SEGURA_LAGO_CAMINO_NUEVO_DE_PICAÑA,Valenbisi | 252_DE_LOS_GREMIOS_CAMPOS_CRESPO,Valenbisi | 253_PLAZA_JOSE_MELIA_CASTELLO_CAMPOS_CRESPO,Valenbisi | 254_AVDA_DR_TOMAS_SALA_CARTEROS,Valenbisi | 255_SAN_VICENTE_MARTIR_TOMAS_DE_VILLAROYA,Valenbisi | 256_AVDA_TRES_FORQUES_TURIS,Valenbisi | 257_PLAZA_SALVADOR_SORIA_ESQ_PIO_X,Valenbisi | 258_PINTOR_RAFAEL_SOLVES_ESQ_JOSE_SOTO_MICO,Valenbisi | 259_CALLE_PIO_IX_POLIDEPORTIVO_RAMBLETA,Valenbisi | 260_DELS_FERRERS_ESQ_TRAGINERS,Valenbisi | 261_PZA_XUQUER_ESQ_VINALOPO,Valenbisi | 262_AVDA_TRES_FORQUES_COLONIA_ESPANOLA_DE_MEXICO,Valenbisi | 263_PADRE ESTEBAN_PERNET_ANTES_CASA_MISERICORDIA,Valenbisi | 264_AVDA_CID_ANTES_MARCONI,Valenbisi | 265_C_ALCASSER_POETA_ALBERTO_LISTA,Valenbisi | 266_PLANA_ALTA_ESQ_AVDA_MAESTRO_RODRIGO,Valenbisi | 267_C_BENIFERRI_VICENTE_TOMAS_MARTI,Valenbisi | 268_PZA_LUIS_CANO_5,Valenbisi | 269_CAMPAMENTO_81,Valenbisi | 270_CALLE_NINOT_ESQ_PZA_REGINO_MAS,Valenbisi | 271_CALLE_SALVADOR_CERVERÓ_CALLE_CARLOS_CORTINA,Valenbisi | 272_VICENTE_LA_RODA_C_INGENIERO_FAUSTO_ELIO,Valenbisi | 273_CALLE_MORAIRA_CALLE_DALT_DE_LA_MAR,Valenbisi | 274_MANUEL_ANDRES_CASTELL_DE_POLOP,Valenbisi | 275_CAMINO_DE_LAS_MORERAS_ESQ_RONDA_DE_NAZARET,Valenbisi | 276_EDIFICIO_VELES_E_VENTS,Valenbisi | 34_AVDA. ANTIGUO REINO DE VALENCIA,Valenbisi | 35_C/ DUQUE DE CALABRIA,Valenbisi | 37_AVDA. PERIS Y VALERO,Valenbisi | 38_AVDA. PERIS Y VALERO,Valenbisi | 39_AVDA. PERIS Y VALERO,Valenbisi | 40_CALLE_BARCAS_FRENTE _TEATRO_PRINCIPAL,Valenbisi | 41_AVDA. GRAL. URRUTIA,Valenbisi | 42_AVDA. DE LA PLATA,Valenbisi | 43_C/ DE ORIENTE,Valenbisi | 44_AVDA. GRAL. URRUTIA,Valenbisi | 45_AVDA. GRAL. URRUTIA,Valenbisi | 46_AVDA. INSTITUTO OBRERO DE VALENCIA,Valenbisi | 47_AVDA. AUTOPISTA DEL SALER,Valenbisi | 48_AVDA. ANTONIO FERRANDIS,Valenbisi | 49_C/ RICARDO MUÑOZ SUAY,Valenbisi | 50_AVDA. AUTOPISTA DEL SALER,Valenbisi | 51_PSO. DE LAS MORERAS,Valenbisi | 52_C/ LUIS GARCIA BERLANGA,Valenbisi | 53_C/ LUIS GARCIA BERLANGA,Valenbisi | 54_PASEO ALAMEDA,Valenbisi | 55_AVDA. DE FRANCIA,Valenbisi | 56_AVDA. DE FRANCIA,Valenbisi | 70_CALLE_COLON_ESQ_ALMIRANTE_ROGER_DE_LAURIA,Valenbisi | 77_C/ MOLINELL,Valenbisi | 83_PZA. DE LA LEGIÓN ESPAÑOLA,Valenbisi | 84_SERRERIA_ESQ_PINTOR FERRER CALATAYUD,Valenbisi | 86_AVDA_GASPAR_AGUILAR_ESQ_VICENTE_PARRA,Valenbisi | 87_AVDA BLASCO IBAÑEZ 2,Valenbisi | 89_AVDA. BLASCO IBAÑEZ,Valenbisi | 90_AVDA. BLASCO IBAÑEZ,Valenbisi | 93_AVADA_BLASCO_IBAÑEZ_DESP_C_POETA_DURAN_TORTAJAD,Valenbisi | 95_AVDA. DE LOS NARANJOS,Velam | 01 - SAINT PIERRE,Velam | 02- LES HALLES,Velam | 03- VOGEL,Velam | 04- PLACE AU FEURRE,Velam | 05- ST LEU,Velam | 06- CITADELLE MONTRESCU,Velam | 07- COLLEGE SAINT-MARTIN,Velam | 08- VANMARCKE,Velam | 09- CATHEDRALE,Velam | 10- PALAIS DE JUSTICE,Velam | 11- PORT D' AMONT,Velam | 12- AMIENS 2,Velam | 13- GARE JULES BARNI,Velam | 14- GARE CINEMA,Velam | 15- JACOBINS,Velam | 16- JOFFRE,Velam | 17- CIRQUE,Velam | 19- REPUBLIQUE,Velam | 20- BRANLY,Velam | 21- MAISON DE LA CULTURE,Velam | 22- QUATRE CHENES,Velam | 23- ST ROCH,Velam | 24- COLISEUM,Velam | 25- LA HOTOIE,Velam | 26- MARCHE AUX CHEVAUX,Velam | 27- CITÉ SCOLAIRE,Veli'k | 01 KSTU - КГТУ /МГАХИ ИМ. СУРИКОВА,Veli'k | 02 CITY HALL - ГОРОДСКАЯ РАТУША,Veli'k | 03 KREMLIN - КРЕМЛЬ,Veli'k | 04 KFU - КФУ,Veli'k | 06 KAMAL THEATER - ТЕАТР ИМ. Г. КАМАЛА,Veli'k | 10 K NADGHIMI STR. - УЛ. К. НАДЖМИ,Velib' Métropôle | 11 Novembre 1918 - 8 Mai 1945,Velib' Métropôle | 18 juin 1940 - Buzenval,Velib' Métropôle | 8 Mai 1945 - 10 Juillet 1940,Velib' Métropôle | Abbeville - Faubourg Poissonnière,Velib' Métropôle | Abbé Carton - Plantes,Velib' Métropôle | Abbé Groult - Convention,Velib' Métropôle | Aboukir - Alexandrie,Velib' Métropôle | Adolphe Lalyre - Armand Silvestre,Velib' Métropôle | Adolphe Pinard - Victor Hugo,Velib' Métropôle | Alexander Fleming - Belvédère,Velib' Métropôle | Alexandre Dumas - Place de la Réunion,Velib' Métropôle | Alexandre Dumas - Voltaire,Velib' Métropôle | Alexandre Parodi - Quai de Valmy,Velib' Métropôle | Alfred Roll - Berthier,Velib' Métropôle | Alfred de Vigny - Place du Général Brocard,Velib' Métropôle | Alger - Rivoli,Velib' Métropôle | Alibert - Jemmapes,Velib' Métropôle | Alouettes - Maréchal de Lattre de Tassigny,Velib' Métropôle | Alésia - Suisses,Velib' Métropôle | Amaury Duval - Gabriel Péri,Velib' Métropôle | Ambroise Rendu - Porte Brunet,Velib' Métropôle | Amelot - Saint-Sébastien,Velib' Métropôle | Amédée Huon - Fort d'Ivry,Velib' Métropôle | Anatole France - Jean Lolive,Velib' Métropôle | Anatole France - Louise Michel,Velib' Métropôle | Anatole France - President Roosevelt,Velib' Métropôle | Ancien Canal - Hélène Brion,Velib' Métropôle | Ancienne Mairie - André Morizet,Velib' Métropôle | André Karman - République,Velib' Métropôle | André Maurois - Joseph et Marie Hackin,Velib' Métropôle | André Mazet - Saint-André des Arts,Velib' Métropôle | André Theuriet - Blagis,Velib' Métropôle | Aqueduc - Villette,Velib' Métropôle | Arago - Glacière,Velib' Métropôle | Archives - Pastourelle,Velib' Métropôle | Archives - Rivoli,Velib' Métropôle | Arcole - Notre-Dame,Velib' Métropôle | Argenson - Château,Velib' Métropôle | Aristide Briand - Gare de Bagneux,Velib' Métropôle | Aristide Briand - Place de la Résistance,Velib' Métropôle | Arsonval - Falguière,Velib' Métropôle | Arsène Houssaye - Champs-Elysées,Velib' Métropôle | Arthur Auger - Jean Jaurès,Velib' Métropôle | Arthur Ranc - Hôpital Bichat,Velib' Métropôle | Artois - Berri,Velib' Métropôle | Assas - Luxembourg,Velib' Métropôle | Assas - Rennes,Velib' Métropôle | Assas - Vaugirard,Velib' Métropôle | Assemblée Nationale,Velib' Métropôle | Athènes - Clichy,Velib' Métropôle | Aubervilliers - Curial,Velib' Métropôle | Auguste Blanqui - Corvisart,Velib' Métropôle | Auguste Blanqui - Glacière,Velib' Métropôle | Auguste Cain - Jean Moulin,Velib' Métropôle | Averroès - Aimé Césaire,Velib' Métropôle | Bachaumont - Montmartre,Velib' Métropôle | Bagnolet - Orteaux,Velib' Métropôle | Bagnolet - Place Saint-Blaise,Velib' Métropôle | Balard - Montagne de la Fage,Velib' Métropôle | Balzac - Champs Elysées,Velib' Métropôle | Balzac - Olympes de Gouges,Velib' Métropôle | Bara - Henri Farman,Velib' Métropôle | Barbès - Monique Maunoury,Velib' Métropôle | Bargue -  Dutot,Velib' Métropôle | Bas - Gabriel Péri,Velib' Métropôle | Bassano -  Iéna,Velib' Métropôle | Bastille - Beaumarchais,Velib' Métropôle | Bastille - Biscornet,Velib' Métropôle | Bastille - Quai de la Rapée,Velib' Métropôle | Batignolles - Abel Truchet,Velib' Métropôle | Batignolles - Beudant,Velib' Métropôle | Batignolles - Place de Clichy,Velib' Métropôle | Batignolles - Rome,Velib' Métropôle | Bayen - Pereire,Velib' Métropôle | Beaubourg - Michel-le-Comte,Velib' Métropôle | Beaujon - Wagram,Velib' Métropôle | Beaumarchais - Pas de la Mule,Velib' Métropôle | Beaumarchais - Saint-Gilles,Velib' Métropôle | Beaux-Arts - Bonaparte,Velib' Métropôle | Beffroy,Velib' Métropôle | Belfort - Voltaire,Velib' Métropôle | Belidor - Gouvion-Saint-Cyr,Velib' Métropôle | Bellefond - Maubeuge,Velib' Métropôle | Bellefond - Poissonnière,Velib' Métropôle | Belles Feuilles - Place de Mexico,Velib' Métropôle | Belleville -  Pré Saint-Gervais,Velib' Métropôle | Belleville - Couronnes,Velib' Métropôle | Belleville - Porte des Lilas,Velib' Métropôle | Belleville - Pyrénées,Velib' Métropôle | Belleville - Télégraphe,Velib' Métropôle | Belliard - Damrémont,Velib' Métropôle | Benjamin Delessert - Jean Lolive,Velib' Métropôle | Benjamin Godard - Victor Hugo,Velib' Métropôle | Benoît Frachon - République,Velib' Métropôle | Bercy,Velib' Métropôle | Bercy - Traversiére,Velib' Métropôle | Bercy - Villot,Velib' Métropôle | Berges de Seine - Musée d'Orsay,Velib' Métropôle | Berri - Haussmann,Velib' Métropôle | Berthier - Place Stuart Merril,Velib' Métropôle | Berthier - Porte de Clichy,Velib' Métropôle | Bertie Albrecht - Hoche,Velib' Métropôle | Bertrand Sincholle - Henri Barbusse,Velib' Métropôle | Bessières - Porte de Clichy,Velib' Métropôle | Bibliothèque Nationale,Velib' Métropôle | Bibliothèque Nationale de France,Velib' Métropôle | Bienfaisance - Place de Narvik,Velib' Métropôle | Billancourt - Général Leclerc,Velib' Métropôle | Bineau - Louise Michel,Velib' Métropôle | Bir Hakeim,Velib' Métropôle | Blaise-Desgoffe - Vaugirard,Velib' Métropôle | Blancs-Manteaux - Archives,Velib' Métropôle | Bleue - Trévise,Velib' Métropôle | Bobillot - Moulin des Prés,Velib' Métropôle | Bobillot - Paulin Mery,Velib' Métropôle | Bobillot - Tolbiac,Velib' Métropôle | Bois de Vincennes,Velib' Métropôle | Bois de Vincennes - Gare,Velib' Métropôle | Bois de Vincennes - Polygone,Velib' Métropôle | Bois de Vincennes - Porte Jaune,Velib' Métropôle | Boissière - Etienne Dolet,Velib' Métropôle | Bordier - Félix Faure,Velib' Métropôle | Bosquet - Saint-Dominique,Velib' Métropôle | Botzaris - Crimée,Velib' Métropôle | Botzaris - Parc des Buttes Chaumont,Velib' Métropôle | Boudreau - Auber,Velib' Métropôle | Boulangers - Cardinal Lemoine,Velib' Métropôle | Boulard - Daguerre,Velib' Métropôle | Boulets - Faubourg Saint-Antoine,Velib' Métropôle | Boulets - Voltaire,Velib' Métropôle | Bourdon - Pont Morland,Velib' Métropôle | Bourdonnais - Tour Eiffel,Velib' Métropôle | Bourg l'Abbé - Saint-Martin,Velib' Métropôle | Bourse du Travail,Velib' Métropôle | Boussingault - Tolbiac,Velib' Métropôle | Boutroux - Porte de Vitry,Velib' Métropôle | Boyer - Ménilmontant,Velib' Métropôle | Boyer-Barret - Raymond Losserand,Velib' Métropôle | Boétie - Ponthieu,Velib' Métropôle | Brancion - Lefebvre,Velib' Métropôle | Bridaine - Lamandé,Velib' Métropôle | Brillat-Savarin - Küss,Velib' Métropôle | Brochant - Clichy,Velib' Métropôle | Brochant - Square des Batignolles,Velib' Métropôle | Bruant - Vincent Auriol,Velib' Métropôle | Bruneseau - Quai d'Ivry,Velib' Métropôle | Bréa - Raspail,Velib' Métropôle | Bréguet - Sabin,Velib' Métropôle | Buffon - Jardin des Plantes,Velib' Métropôle | Buisson Saint-Louis - Saint-Maur,Velib' Métropôle | Butte aux Cailles - Esperance,Velib' Métropôle | Buzenval - Avron,Velib' Métropôle | Buzenval - Vignoles,Velib' Métropôle | Bézout - Général Leclerc,Velib' Métropôle | Cadet - La Fayette,Velib' Métropôle | Cadix - Hameau,Velib' Métropôle | Caire - Dussoubs,Velib' Métropôle | Calmette,Velib' Métropôle | Cambon - Rivoli,Velib' Métropôle | Cambrai - Benjamin Constant,Velib' Métropôle | Cambronne - Mademoiselle,Velib' Métropôle | Cambronne - Villa Croix Nivert,Velib' Métropôle | Camille Groult - Guy Môquet,Velib' Métropôle | Camille Risch - Paul Armangot,Velib' Métropôle | Candale - Mehul,Velib' Métropôle | Cardinal Lavigerie,Velib' Métropôle | Carducci - Place Hannah Arendt,Velib' Métropôle | Carnot - Général Lanrezac,Velib' Métropôle | Carnot - Pâquerettes,Velib' Métropôle | Carpeaux - Place Jacques Froment,Velib' Métropôle | Carrefour Pleyel,Velib' Métropôle | Cassini - Denfert-Rochereau,Velib' Métropôle | Cauchy - Cévennes,Velib' Métropôle | Caulaincourt - Place Constantin Pecqueur,Velib' Métropôle | Caumartin - Provence,Velib' Métropôle | Ceinture du Lac Inferieure - Saint-Cloud,Velib' Métropôle | Censier - Jardin des Plantes,Velib' Métropôle | Censier - Santeuil,Velib' Métropôle | Centenaire - Sorins,Velib' Métropôle | Centquatre,Velib' Métropôle | Centre Georges Pompidou,Velib' Métropôle | Cesaria Evora - Rosa Parks,Velib' Métropôle | Cevennes - Bergers,Velib' Métropôle | Chabrol - d'Hauteville,Velib' Métropôle | Champ de Mars - Cler,Velib' Métropôle | Champeaux - Gallieni,Velib' Métropôle | Championnet,Velib' Métropôle | Championnet - Vauvenargues,Velib' Métropôle | Champs de Manoeuvre - Cartoucherie,Velib' Métropôle | Champs-Elysees - Bassano,Velib' Métropôle | Chancé Milly - Cimetière Communal Sud,Velib' Métropôle | Chanzy - Sud-Est,Velib' Métropôle | Charenton - Diderot,Velib' Métropôle | Charenton - Jardiniers,Velib' Métropôle | Charenton - Place du Col Bourgoin,Velib' Métropôle | Charenton - Prague,Velib' Métropôle | Charenton - Wattignies,Velib' Métropôle | Charentonneau - Maisons Alfort,Velib' Métropôle | Charles Delescluze,Velib' Métropôle | Charles Frérot - Albert Guilpin,Velib' Métropôle | Charles Gide - Fort de Bicêtre,Velib' Métropôle | Charles Lecocq - Lecourbe,Velib' Métropôle | Charles Tillon - Cimetière Communal,Velib' Métropôle | Charles de Gaulle - Beauté,Velib' Métropôle | Charles de Gaulle - Graviers,Velib' Métropôle | Charles de Gaulle - Jean Lolive,Velib' Métropôle | Charles de Gaulle - Louis-Philippe,Velib' Métropôle | Charles de Gaulle - Madrid,Velib' Métropôle | Charles de Gaulle - Orléans,Velib' Métropôle | Charles de Gaulle - Plateau de Vanves,Velib' Métropôle | Charonne - Alexandre Dumas,Velib' Métropôle | Charonne - Avron,Velib' Métropôle | Charonne - Bureau,Velib' Métropôle | Charonne - Faubourg Saint-Antoine,Velib' Métropôle | Charonne - Philippe-Auguste,Velib' Métropôle | Charonne - Pierre Bayle,Velib' Métropôle | Charonne - Robert et Sonia Delauney,Velib' Métropôle | Chartres - La Charbonnière,Velib' Métropôle | Chateaubriand - Friedland,Velib' Métropôle | Chausson - Gabriel Péri,Velib' Métropôle | Chaussée d'Antin - Haussmann,Velib' Métropôle | Chazelles - Courcelles,Velib' Métropôle | Chemin Vert - Fraternité,Velib' Métropôle | Chemin Vert - Saint-Maur,Velib' Métropôle | Chemin de Bretagne,Velib' Métropôle | Cherche-Midi - Hôpital Necker,Velib' Métropôle | Chernoviz - Raynouard,Velib' Métropôle | Chevaleret - Louise Weiss,Velib' Métropôle | Chevaleret - Tolbiac,Velib' Métropôle | Chevreuse - Montparnasse,Velib' Métropôle | Choiseul - Quatre Septembre,Velib' Métropôle | Choisy - Malmaisons,Velib' Métropôle | Choisy - Tolbiac,Velib' Métropôle | Choron - Martyrs,Velib' Métropôle | Château - Bineau,Velib' Métropôle | Château - Place de Catalogne,Velib' Métropôle | Château - République,Velib' Métropôle | Château de Vincennes,Velib' Métropôle | Cimetière,Velib' Métropôle | Cimetière Communal,Velib' Métropôle | Cimetière communal,Velib' Métropôle | Cimetière de Montmartre,Velib' Métropôle | Cimetière de Montrouge,Velib' Métropôle | Cité Riverin - Château d'Eau,Velib' Métropôle | Cité Vaneau,Velib' Métropôle | Cité de la Musique,Velib' Métropôle | Cité des Sciences et de l'Industrie,Velib' Métropôle | Clapeyron - Moscou,Velib' Métropôle | Claude Bernard - Arbalète,Velib' Métropôle | Claude Debussy - Marc Bloch,Velib' Métropôle | Claude Decaen - Cannebière,Velib' Métropôle | Claude Vellefaux - Hôpital Saint-Louis,Velib' Métropôle | Claude Vellefaux - Sambre et Meuse,Velib' Métropôle | Clichy - Douai,Velib' Métropôle | Clichy - Place Blanche,Velib' Métropôle | Clignancourt - Ordener,Velib' Métropôle | Cloître Saint-Merri - Renard,Velib' Métropôle | Cléry - Montmartre,Velib' Métropôle | Colisée - Champs-Elysées,Velib' Métropôle | Colmar - Victor Hugo,Velib' Métropôle | Colonel Monteil - Brune,Velib' Métropôle | Colonel Pierre Avia,Velib' Métropôle | Commandant Charcot - Bretteville,Velib' Métropôle | Commandant Rivière,Velib' Métropôle | Commandant l'Herminier - Gallieni,Velib' Métropôle | Commerce - Letellier,Velib' Métropôle | Concorde - Stalingrad,Velib' Métropôle | Condorcet - Turgot,Velib' Métropôle | Conservatoire de Musique,Velib' Métropôle | Constantine - Université,Velib' Métropôle | Convention - Lourmel,Velib' Métropôle | Convention - Saint-Charles,Velib' Métropôle | Convention - Vaugirard,Velib' Métropôle | Coquillière - Louvre,Velib' Métropôle | Cordelières - Arago,Velib' Métropôle | Cossonnerie - Sébastopol,Velib' Métropôle | Courcelles - Pierre Demours,Velib' Métropôle | Courcelles - Place des Ternes,Velib' Métropôle | Cours de Vincennes - Davout,Velib' Métropôle | Cours de Vincennes - Soult,Velib' Métropôle | Cours de l'Ile Seguin - Parc Billancourt,Velib' Métropôle | Crevaux - Bugeaud,Velib' Métropôle | Crimée - Ourcq,Velib' Métropôle | Croix Nivert - Square Saint-Lambert,Velib' Métropôle | Croulebarde - Corvisart,Velib' Métropôle | Crozatier - Faubourg Saint-Antoine,Velib' Métropôle | Cujas - Saint-Michel,Velib' Métropôle | Custine - Ramey,Velib' Métropôle | Damrémont - Caulaincourt,Velib' Métropôle | Damrémont - Ordener,Velib' Métropôle | Danielle Casanova - Ledru-Rollin,Velib' Métropôle | Danielle Casanova - Opéra,Velib' Métropôle | Danielle Casanova - Place Vendôme,Velib' Métropôle | Danton - République,Velib' Métropôle | Danton - Serpente,Velib' Métropôle | Dantzig - Lefebvre,Velib' Métropôle | Dareau - Broussais,Velib' Métropôle | Daumesnil - Hébrard,Velib' Métropôle | Daumesnil - Picpus,Velib' Métropôle | Daunou - Louis le Grand,Velib' Métropôle | David Weill - Parc Montsouris,Velib' Métropôle | Davout - Volga,Velib' Métropôle | De Toqueville - Terrasse,Velib' Métropôle | Delizy - Louis Nadot,Velib' Métropôle | Delphine Seyrig - Général Leclerc,Velib' Métropôle | Demi-Lune - Aristide Briand,Velib' Métropôle | Departement - Pajol,Velib' Métropôle | Desaix - Edgar Faure,Velib' Métropôle | Diderot - Pierre Bourdan,Velib' Métropôle | Diderot - Reuilly,Velib' Métropôle | Didot - Mariniers,Velib' Métropôle | Didot - Place de Moro-Giafferi,Velib' Métropôle | Docteurs Déjérine - Pte de Montreuil,Velib' Métropôle | Dom-Pérignon - Gravelle,Velib' Métropôle | Dominique Pado - Croix Nivert,Velib' Métropôle | Douai - Bruxelles,Velib' Métropôle | Douai - Pierre Fontaine,Velib' Métropôle | Dugommier,Velib' Métropôle | Duhamel - André Gide,Velib' Métropôle | Duméril - Jeanne d'Arc,Velib' Métropôle | Dunkerque - Alsace,Velib' Métropôle | Dunkerque - Rocroy,Velib' Métropôle | Dunkerque - Trudaine,Velib' Métropôle | Dunois - Clisson,Velib' Métropôle | Dupleix - du Guesclin,Velib' Métropôle | Duroc - Place de Breteuil,Velib' Métropôle | Dutot - Place Alleray,Velib' Métropôle | Dôme - République,Velib' Métropôle | Ecole Militaire - Place Joffre,Velib' Métropôle | Ecoles - Carmes,Velib' Métropôle | Edgar Quinet - Gaité,Velib' Métropôle | Edgar Quinet - Raspail,Velib' Métropôle | Edith Cavell - Volta,Velib' Métropôle | Edouard Pailleron - Bouret,Velib' Métropôle | Edouard Pailleron - Simon Bolivar,Velib' Métropôle | Edouard Poisson - Victor Hugo,Velib' Métropôle | Edouard Tremblay - Julian Grimau,Velib' Métropôle | Edouard Vaillant - Galliéni,Velib' Métropôle | Edouard Vaillant - Paul-Adolphe Souriau,Velib' Métropôle | Eglise d'Auteuil,Velib' Métropôle | Emeriau - Beaugrenelle,Velib' Métropôle | Emeriau - Place de Brazzaville,Velib' Métropôle | Emile Blemont - Poteau,Velib' Métropôle | Emile Reynaud - Porte de la Villette,Velib' Métropôle | Emile Zola - Fondary,Velib' Métropôle | Enfants du Paradis - Peupliers,Velib' Métropôle | Enghien - Faubourg Poissonnière,Velib' Métropôle | Epée de Bois - Mouffetard,Velib' Métropôle | Ernest Renan - Parc des Expositions,Velib' Métropôle | Esplanade du Foncet - Camille Desmoulins,Velib' Métropôle | Estienne d'Orves - Henri Ginoux,Velib' Métropôle | Estrapade - Ulm,Velib' Métropôle | Etienne Dolet - Place Maurice Chevalier,Velib' Métropôle | Etienne Jodelle - Saint Ouen,Velib' Métropôle | Etienne Marcel - Montorgueil,Velib' Métropôle | Eugène Oudiné - Dessous Des Berges,Velib' Métropôle | Eugène Varlin - Place de la Paix,Velib' Métropôle | Euryale Dehaynin - Loire,Velib' Métropôle | Evangile - Aubervilliers,Velib' Métropôle | Evariste Galois,Velib' Métropôle | Exelmans - Michel-Ange,Velib' Métropôle | Exelmans - Versailles,Velib' Métropôle | Eylau - Trocadéro,Velib' Métropôle | Fabre d'Eglantine - Place de la Nation,Velib' Métropôle | Faidherbe - Dahomey,Velib' Métropôle | Faubourg Du Temple - Republique,Velib' Métropôle | Faubourg Montmartre - La Fayette,Velib' Métropôle | Faubourg Poissonniere - Delta,Velib' Métropôle | Faubourg Poissonnière - Dunkerque,Velib' Métropôle | Faubourg St-Antoine - Place de la Nation,Velib' Métropôle | Faustin Hélie - Desbordes-Valmore,Velib' Métropôle | Fauvettes - Bénards,Velib' Métropôle | Favart - Italiens,Velib' Métropôle | Fernand Braudel - Vincent Auriol,Velib' Métropôle | Ferrus - Saint-Jacques,Velib' Métropôle | Fessart - Château,Velib' Métropôle | Fief - République,Velib' Métropôle | Fille du Calvaire - Turenne,Velib' Métropôle | Filles Saint-Thomas - Place de la Bourse,Velib' Métropôle | Flandre - Alphonse Karr,Velib' Métropôle | Flandre - Ourcq,Velib' Métropôle | Flandre - Riquet,Velib' Métropôle | Flandrin - Henri Martin,Velib' Métropôle | Flandrin - Longchamp,Velib' Métropôle | Fontainebleau - Edmond Michelet,Velib' Métropôle | Fontenay - Libération,Velib' Métropôle | Fort d'Aubervilliers,Velib' Métropôle | Fragonard - Porte de Clichy,Velib' Métropôle | Franciade - Gabriel Péri,Velib' Métropôle | Francoeur - Caulaincourt,Velib' Métropôle | Francoeur - Marcadet,Velib' Métropôle | Franquet - Labrouste,Velib' Métropôle | Française - Etienne Marcel,Velib' Métropôle | François 1er - Lincoln,Velib' Métropôle | François 1er - Montaigne,Velib' Métropôle | François Debergue - Croix de Chavaux,Velib' Métropôle | François Ponsard - La Muette,Velib' Métropôle | François Truffaut - Saint Emilion,Velib' Métropôle | Froidevaux - Boulard,Velib' Métropôle | Froment - Bréguet,Velib' Métropôle | Frères Flavien - Porte des Lilas,Velib' Métropôle | Fédération - Suffren,Velib' Métropôle | Félix Faure - Convention,Velib' Métropôle | Félix Faure - Lourmel,Velib' Métropôle | Félix Faure - Sadi Carnot,Velib' Métropôle | Félix Ziem - Armand Gauthier,Velib' Métropôle | Gabriel Lamé,Velib' Métropôle | Gabriel Péri - Danielle Casanova,Velib' Métropôle | Gabriel Péri - Francisco Ferrer,Velib' Métropôle | Gabrielle Josserand - Edouard Vaillant,Velib' Métropôle | Galilée - Kléber,Velib' Métropôle | Galilée - Vernet,Velib' Métropôle | Gambetta - Hôpital Tenon,Velib' Métropôle | Gambetta - Michelet,Velib' Métropôle | Gambetta - Père Lachaise,Velib' Métropôle | Gambetta - Saint Fargeau,Velib' Métropôle | Gambetta - Tourelles,Velib' Métropôle | Gardenat-Lapostol - Velettes,Velib' Métropôle | Gare Arcueil - Cachan,Velib' Métropôle | Gare Montparnasse - Arrivée,Velib' Métropôle | Gare Montparnasse - Edgar Quinet,Velib' Métropôle | Gare Montparnasse - René Mouchotte,Velib' Métropôle | Gare Montparnasse - Vaugirard,Velib' Métropôle | Gare RER,Velib' Métropôle | Gare RER - Canadiens,Velib' Métropôle | Gare RER - Malleret-Joinville,Velib' Métropôle | Gare RER - Maurice Grandcoing,Velib' Métropôle | Gare RER de Gentilly,Velib' Métropôle | Gare RER de Vincennes,Velib' Métropôle | Gare RER les Ardoines,Velib' Métropôle | Gare RER les Grésillons,Velib' Métropôle | Gare Rer de Fontenay sous Bois,Velib' Métropôle | Gare Rosny-Bois-Perrier,Velib' Métropôle | Gare Routière,Velib' Métropôle | Gare SNCF Vanves-Malakoff,Velib' Métropôle | Gare Saint-Lazare - Cour du Havre,Velib' Métropôle | Gare Saint-Lazare - Isly,Velib' Métropôle | Gare Saint-Lazare - Place de Budapest,Velib' Métropôle | Gare Saint-Lazare - Stockholm,Velib' Métropôle | Gare d'Argenteuil,Velib' Métropôle | Gare d'Asnières sur Seine,Velib' Métropôle | Gare d'Austerlitz,Velib' Métropôle | Gare d'Austerlitz - Pont Charles de Gaulle,Velib' Métropôle | Gare d'Austerlitz - Quai Saint-Bernard,Velib' Métropôle | Gare de Bellevue,Velib' Métropôle | Gare de Bercy,Velib' Métropôle | Gare de Chaville Rive Gauche,Velib' Métropôle | Gare de Clamart,Velib' Métropôle | Gare de Clichy-Levallois,Velib' Métropôle | Gare de Courbevoie,Velib' Métropôle | Gare de Laplace,Velib' Métropôle | Gare de Lyon - Chalon,Velib' Métropôle | Gare de Lyon - Place Louis Armand,Velib' Métropôle | Gare de Lyon - Roland Barthes,Velib' Métropôle | Gare de Lyon - Van Gogh,Velib' Métropôle | Gare de Nanterre Ville,Velib' Métropôle | Gare de Nogent-le-Perreux,Velib' Métropôle | Gare de Pont-Cardinet,Velib' Métropôle | Gare de Reuilly - Picpus,Velib' Métropôle | Gare de Robinson,Velib' Métropôle | Gare de l'Est - Chateau Landon,Velib' Métropôle | Gare de l'Est - Faubourg-Saint-Martin,Velib' Métropôle | Gare de l'Est - Fidélité,Velib' Métropôle | Gare de l'Est - Place du 11 Novembre 1918,Velib' Métropôle | Gare de l'Est - Verdun,Velib' Métropôle | Gare de la Garenne-Colombes,Velib' Métropôle | Gare des Vallées,Velib' Métropôle | Gare du Nord - Demarquay,Velib' Métropôle | Gare du Nord - Denain,Velib' Métropôle | Gare du Nord - Dunkerque,Velib' Métropôle | Gare du Nord - Faubourg Saint-Denis,Velib' Métropôle | Gare du Nord - Hôpital Lariboisière,Velib' Métropôle | Gare du Nord - La Chapelle,Velib' Métropôle | Gare du Nord - Place de Valenciennes,Velib' Métropôle | Gare du Nord - Saint-Vincent de Paul,Velib' Métropôle | Gare du Stade,Velib' Métropôle | Gaston Roussel - Commune de Paris,Velib' Métropôle | Gaston Tessier - Rosa Parks RER,Velib' Métropôle | Gay Lussac - Saint-Jacques,Velib' Métropôle | Geoffroy - Marie,Velib' Métropôle | Geoffroy-Saint-Hilaire - Saint-Marcel,Velib' Métropôle | George Sand - Jean de La Fontaine,Velib' Métropôle | George V - Christophe Colomb,Velib' Métropôle | Georges Bernanos - Port Royal,Velib' Métropôle | Georges V - François 1er,Velib' Métropôle | Gergovie - Alésia,Velib' Métropôle | Gergovie - Vercingétorix,Velib' Métropôle | Glacière - Soeur Catherine Marie,Velib' Métropôle | Gobelins - Port-Royal,Velib' Métropôle | Godot de Mauroy - Madeleine,Velib' Métropôle | Gouthière - Poterne des Peupliers,Velib' Métropôle | Goutte d'or - Barbès,Velib' Métropôle | Grand Prieuré - Crussol,Velib' Métropôle | Grande Armée - Brunel,Velib' Métropôle | Grande Rue - Europe,Velib' Métropôle | Grande Truanderie - Saint-Denis,Velib' Métropôle | Grands Moulins de Pantin,Velib' Métropôle | Granges aux Belles,Velib' Métropôle | Granges aux Belles - Hôpital Saint-Louis,Velib' Métropôle | Gravelle - Route du Bac,Velib' Métropôle | Grenelle - Dr Finlay,Velib' Métropôle | Grenelle - Violet,Velib' Métropôle | Greneta - Sebastopol,Velib' Métropôle | Guersant - Gouvion-Saint-Cyr,Velib' Métropôle | Guichet - Jean Jaurès,Velib' Métropôle | Guillaume Bertrand - République,Velib' Métropôle | Guillaume Tell - Parc Henri Barbusse,Velib' Métropôle | Gustave Eiffel - Parc des Impressionnistes,Velib' Métropôle | Guy Môquet - Compoint,Velib' Métropôle | Guy Môquet - Etienne Dolet,Velib' Métropôle | Guy Môquet - Parvis Georges Marchais,Velib' Métropôle | Guy Môquet - Saint-Ouen,Velib' Métropôle | Guynemer - Jardin du Luxembourg,Velib' Métropôle | Guynemer - Séverine,Velib' Métropôle | Génie - Mozart,Velib' Métropôle | Général De Gaulle - Alouette,Velib' Métropôle | Général De Gaulle - Vivien,Velib' Métropôle | Général Leclerc - Bièvre,Velib' Métropôle | Général Martial Valin - Pont du Garigliano,Velib' Métropôle | Général Michel Bizot - Claude Decaen,Velib' Métropôle | Gérando - Rochechouart,Velib' Métropôle | Haies - Réunion,Velib' Métropôle | Halle Freyssinet - Parvis Alan Turing,Velib' Métropôle | Halles - Bourdonnais,Velib' Métropôle | Hameau Fleuri - Marché,Velib' Métropôle | Harpe - Saint-Germain,Velib' Métropôle | Hautes Bornes - Stalingrad,Velib' Métropôle | Hauteville - Bonne Nouvelle,Velib' Métropôle | Hautpoul - Jean Jaurès,Velib' Métropôle | Haxo - Surmelin,Velib' Métropôle | Hector Malot - Daumesnil,Velib' Métropôle | Henri Barbusse - Stalingrad,Velib' Métropôle | Henri Chevreau - Couronnes,Velib' Métropôle | Henri Ravera - Gabriel Péri,Velib' Métropôle | Henri Ste-Claire Déville - Paul Héroult,Velib' Métropôle | Henry Farman,Velib' Métropôle | Herschel - Observatoire,Velib' Métropôle | Hippodrome Paris-Vincennes,Velib' Métropôle | Hoche - Jean Lolive,Velib' Métropôle | Hoche - Tilsitt,Velib' Métropôle | Honoré d'Estienne d'Ovres - Grilles,Velib' Métropôle | Hôpital - Campo-Formio,Velib' Métropôle | Hôpital Bégin,Velib' Métropôle | Hôpital Européen Georges Pompidou,Velib' Métropôle | Hôpital Necker,Velib' Métropôle | Hôpital Pitié Salpêtrière,Velib' Métropôle | Hôpital Robert Debré,Velib' Métropôle | Hôtel de Ville,Velib' Métropôle | Hôtel de Ville - Pont d'Arcole,Velib' Métropôle | Hôtel de Ville - Pont-Marie,Velib' Métropôle | Hôtel de Ville de Fontenay-aux-Roses,Velib' Métropôle | Hôtel de Ville de Rueil-Malmaison,Velib' Métropôle | Hôtel de Ville de Vincennes,Velib' Métropôle | Hôtel de ville de Fontenay-sous-Bois,Velib' Métropôle | Indre - Prairies,Velib' Métropôle | Institut de France,Velib' Métropôle | Institut du Monde Arabe - Saint-Germain,Velib' Métropôle | Invalides - Duroc,Velib' Métropôle | Italie - Jardin Joan Miro,Velib' Métropôle | Ivry - Baudricourt,Velib' Métropôle | Ivry - Simone Weil,Velib' Métropôle | Jacquard - Ternaux,Velib' Métropôle | Jacques Callot - Mazarine,Velib' Métropôle | Jacques Kellner - Saint-Ouen,Velib' Métropôle | Jacquier - Didot,Velib' Métropôle | Jardin Marguerite Long,Velib' Métropôle | Jardin d'Acclimatation,Velib' Métropôle | Jardin de l'Hospice Debrousse,Velib' Métropôle | Jardins d'Eole,Velib' Métropôle | Javel - André Citroën,Velib' Métropôle | Jean Bleuzen - Square du 11 Novembre,Velib' Métropôle | Jean Bologne - Passy,Velib' Métropôle | Jean Calvin - Tournefort,Velib' Métropôle | Jean Colly - Tolbiac,Velib' Métropôle | Jean Jaurès - Jean Baptiste Clément,Velib' Métropôle | Jean Jaurès - Jules Jacquemin,Velib' Métropôle | Jean Jaurès - Ouvrières Pivéreuses,Velib' Métropôle | Jean Jaurès - Presles,Velib' Métropôle | Jean Jaurès - Reine,Velib' Métropôle | Jean Jaurès - Salvador Allende,Velib' Métropôle | Jean Lolive - Parc Stalingrad,Velib' Métropôle | Jean Macé - Faidherbe,Velib' Métropôle | Jean Marin Naudin - Stalingrad,Velib' Métropôle | Jean Mermoz - Champs-Elysées,Velib' Métropôle | Jean Monnet - Iles,Velib' Métropôle | Jean Moulin - Paul Doumer,Velib' Métropôle | Jean Moulin - Place Victor et Hélène Basch,Velib' Métropôle | Jean Oestreicher - Porte de Champerret,Velib' Métropôle | Jean de la Fontaine - Boulainvilliers,Velib' Métropôle | Jean-Baptiste Charcot - Sainte-Geneviève,Velib' Métropôle | Jean-Baptiste Pigalle - La Bruyere,Velib' Métropôle | Jean-François Lépine - Stephenson,Velib' Métropôle | Jean-Jacques Rousseau - Deux Ecus,Velib' Métropôle | Jean-Pierre Timbaud - Vaucouleurs,Velib' Métropôle | Jeanne Hornet - Girardot,Velib' Métropôle | Jemmapes - Ecluses Saint-Martin,Velib' Métropôle | Jemmapes - Grange aux Belles,Velib' Métropôle | Jessaint - Marx Dormoy,Velib' Métropôle | Jeûneurs - Mulhouse,Velib' Métropôle | Joffre - Aigle,Velib' Métropôle | Jonquière - Docteur Paul Brousse,Velib' Métropôle | Jonquoy - Didot,Velib' Métropôle | Joseph Dijon - Ornano,Velib' Métropôle | Joseph Liouville - Croix Nivert,Velib' Métropôle | Joseph Sansboeuf - Saint Lazare,Velib' Métropôle | Jouffroy d'Abbans - Malesherbes,Velib' Métropôle | Jouffroy d'Abbans - Villiers,Velib' Métropôle | Jouffroy d'Abbans - Wagram,Velib' Métropôle | Jourdain - Place des Grandes Rigoles,Velib' Métropôle | Jourdan - Cité Universitaire,Velib' Métropôle | Jourdan - Monticelli,Velib' Métropôle | Jourdan - Stade Charléty,Velib' Métropôle | Jules Ferry - Faubourg du Temple Paris,Velib' Métropôle | Jules Guesde - Alsace,Velib' Métropôle | Jules Guesde - Laennec,Velib' Métropôle | Jules Guesde - Pont du Port à l'Anglais,Velib' Métropôle | Jules Guesdes - Carnot,Velib' Métropôle | Jules Guesdes - Général de Gaulle,Velib' Métropôle | Jules Vallès - Charonne,Velib' Métropôle | Jussieu - Fossés Saint-Bernard,Velib' Métropôle | Jussieu - Guy de la Brosse,Velib' Métropôle | Karl Marx,Velib' Métropôle | Keller - La Roquette,Velib' Métropôle | Kléber - Gouverneur Général Eboué,Velib' Métropôle | Kléber - National,Velib' Métropôle | LCL Campus - Place Oscar Niemeyer,Velib' Métropôle | La Jarry - Place Diderot,Velib' Métropôle | La Motte-Picquet - Grenelle,Velib' Métropôle | La Motte-Picquet - La Tour Maubourg,Velib' Métropôle | Lac Daumesnil - Saint-Maurice,Velib' Métropôle | Lacuée - Lyon,Velib' Métropôle | Lacépède - Linné,Velib' Métropôle | Lacépède - Monge,Velib' Métropôle | Laffitte - Italiens,Velib' Métropôle | Lagny - Auguste Blanqui,Velib' Métropôle | Lagny - Joffre,Velib' Métropôle | Lagny - Victor Basch,Velib' Métropôle | Lakanal - Commerce,Velib' Métropôle | Lallier - Trudaine,Velib' Métropôle | Lally-Tollendal - Armand Carrel,Velib' Métropôle | Lamartine - Faubourg Montmartre,Velib' Métropôle | Lamennais - Washington,Velib' Métropôle | Lampes,Velib' Métropôle | Landy - Heurtault,Velib' Métropôle | Larmeroux - Baudelaire,Velib' Métropôle | Las Cases - Bourgogne,Velib' Métropôle | Lassus - Delouvain,Velib' Métropôle | Laumière - Petit,Velib' Métropôle | Lauriston - Copernic,Velib' Métropôle | Lavandieres Sainte Opportune - Rivoli,Velib' Métropôle | Lavoisier - Missak Manouchian,Velib' Métropôle | Le Brix et Mesmin - Jourdan,Velib' Métropôle | Le Brun - Gobelins,Velib' Métropôle | Le Corbusier - Jean Jaurès,Velib' Métropôle | Le Goff - Gay-Lussac,Velib' Métropôle | Le Vau - Maurice Bertaux,Velib' Métropôle | Lebrun - Colonel Fabien,Velib' Métropôle | Lecourbe - Convention,Velib' Métropôle | Lecourbe - Jean Maridor,Velib' Métropôle | Ledru-Rollin - Charonne,Velib' Métropôle | Ledru-Rollin - Place du Père Chaillet,Velib' Métropôle | Legendre - Clichy,Velib' Métropôle | Legendre - Dulong,Velib' Métropôle | Legendre - Nollet,Velib' Métropôle | Leibniz - Jean Dollfus,Velib' Métropôle | Lemercier - Cardinet,Velib' Métropôle | Lepic - Armée d'Orient,Velib' Métropôle | Leredde - Tolbiac,Velib' Métropôle | Les Blagis,Velib' Métropôle | Les Halles - Saint-Eustache,Velib' Métropôle | Les Juilliottes,Velib' Métropôle | Les Planètes,Velib' Métropôle | Liard - Amiral Mouchez,Velib' Métropôle | Liberté - Vert-de-Maisons,Velib' Métropôle | Lieutenant Chauré - Etienne Marey,Velib' Métropôle | Lisbonne - Monceau,Velib' Métropôle | Liège - Moscou,Velib' Métropôle | Lobau - Hôtel de Ville,Velib' Métropôle | Londres - Amsterdam,Velib' Métropôle | Londres - Place d'Estienne d'Orves,Velib' Métropôle | Longchamp - Place d'Iéna,Velib' Métropôle | Lorraine - Jean Jaurès,Velib' Métropôle | Louis Blanc - Aqueduc,Velib' Métropôle | Louis Blanc - Jemmapes,Velib' Métropôle | Louis Blanc - La Chapelle,Velib' Métropôle | Louis Ganne - Davout,Velib' Métropôle | Louis Lejeune - Barbès,Velib' Métropôle | Louis Lumière,Velib' Métropôle | Louis Lumière - Porte de Bagnolet,Velib' Métropôle | Louis Pasteur - Albert Petit,Velib' Métropôle | Louis Rolland - République,Velib' Métropôle | Louis Xavier de Ricard - Ancienne Mairie,Velib' Métropôle | Louis le Grand - Italiens,Velib' Métropôle | Lourmel - Marie Skobtsov,Velib' Métropôle | Lucie Aubrac - Fort,Velib' Métropôle | Lucie Aubrac - Franklin,Velib' Métropôle | Lucien Bossoutrot - Général Martial Vallin,Velib' Métropôle | Lucien Lanternier - Le Luth,Velib' Métropôle | Lucien Sampaix - Récollets,Velib' Métropôle | Léon - Doudeauville,Velib' Métropôle | Léon Frot - Charonne,Velib' Métropôle | Léonard de Vinci,Velib' Métropôle | M.- A. Lagroua Weill-Hallé -  F. Dolto,Velib' Métropôle | Mac-Mahon - Brey,Velib' Métropôle | Macdonald - Césaria Evora,Velib' Métropôle | Madagascar - Meuniers,Velib' Métropôle | Madame de Sanzillon - Mozart,Velib' Métropôle | Madeleine Michelis - Roule,Velib' Métropôle | Magenta - Chabrol,Velib' Métropôle | Mahatma Gandhi,Velib' Métropôle | Maine - Antoine Bourdelle,Velib' Métropôle | Maine - Jean Zay,Velib' Métropôle | Maine - Liancourt,Velib' Métropôle | Mairie,Velib' Métropôle | Mairie d'Issy les Moulineaux,Velib' Métropôle | Mairie d'Ivry-sur-Seine,Velib' Métropôle | Mairie de Bagnolet,Velib' Métropôle | Mairie de Clamart,Velib' Métropôle | Mairie de Clichy,Velib' Métropôle | Mairie de Montreuil,Velib' Métropôle | Mairie de Neuilly sur Seine,Velib' Métropôle | Mairie de Romainville,Velib' Métropôle | Mairie de Rosny-sous-Bois,Velib' Métropôle | Mairie de quartier du Plateau - Mont-Valérien,Velib' Métropôle | Mairie des Lilas,Velib' Métropôle | Mairie du 10ème,Velib' Métropôle | Mairie du 11ème,Velib' Métropôle | Mairie du 12ème,Velib' Métropôle | Mairie du 14ème,Velib' Métropôle | Mairie du 15ème,Velib' Métropôle | Mairie du 16ème,Velib' Métropôle | Mairie du 17ème,Velib' Métropôle | Mairie du 18ème,Velib' Métropôle | Mairie du 19ème,Velib' Métropôle | Mairie du 20ème,Velib' Métropôle | Mairie du 2ème,Velib' Métropôle | Mairie du 3ème,Velib' Métropôle | Mairie du 4ème,Velib' Métropôle | Mairie du 7ème,Velib' Métropôle | Mairie du 8ème,Velib' Métropôle | Mairie du 9ème,Velib' Métropôle | Mairie du Kremlin-Bicêtre,Velib' Métropôle | Maison de Radio - France,Velib' Métropôle | Malakoff - Place de la Porte Maillot,Velib' Métropôle | Malesherbes - Place de la Madeleine,Velib' Métropôle | Manin - Carrières d'Amérique,Velib' Métropôle | Manin - Crimée,Velib' Métropôle | Manin - Secrétan,Velib' Métropôle | Manin - Simon Bolivar,Velib' Métropôle | Manufacture Nationale,Velib' Métropôle | Marc Sangnier - Division Leclerc,Velib' Métropôle | Marc Sangnier - Porte de Vanves,Velib' Métropôle | Marcadet - Barbès,Velib' Métropôle | Marcadet - Ramey,Velib' Métropôle | Marceau - Chaillot,Velib' Métropôle | Marceau - Président Wilson,Velib' Métropôle | Marcel Pourtout - Édouard Manet,Velib' Métropôle | Marcel Yol - Jullien,Velib' Métropôle | Marcelin Berthelot,Velib' Métropôle | Marcelle - Thalie,Velib' Métropôle | Marché Saint-Germain,Velib' Métropôle | Marché Saint-Quentin,Velib' Métropôle | Marché Secrétan,Velib' Métropôle | Marché aux fleurs,Velib' Métropôle | Marché d'Auteuil,Velib' Métropôle | Marie-Georges Picquart - Pereire,Velib' Métropôle | Marignan - Champs-Elysées,Velib' Métropôle | Marne - Charles de Gaulle,Velib' Métropôle | Marne - Germain Dardan,Velib' Métropôle | Marseille - Beaurepaire,Velib' Métropôle | Maréchal Joffre - Verdun,Velib' Métropôle | Mathis - Flandre,Velib' Métropôle | Mathurins - Auber,Velib' Métropôle | Matignon - Faubourg Saint-Honoré,Velib' Métropôle | Maurice Payret-Dortail,Velib' Métropôle | Maurice d'Ocagne - General Maudhuy,Velib' Métropôle | Maxime Gorki - Louis Aragon,Velib' Métropôle | Maxime Gorki - Paul Vaillant-Couturier,Velib' Métropôle | Mazagran - Bonne Nouvelle,Velib' Métropôle | Mazagran - Pierre de Coubertin,Velib' Métropôle | Melun - Jean Jaurès,Velib' Métropôle | Messine - Place Du Pérou,Velib' Métropôle | Metz - Faubourg Saint-Denis,Velib' Métropôle | Metz - Marne,Velib' Métropôle | Michel-Ange - Parent de Rosan,Velib' Métropôle | Michelet - Assas,Velib' Métropôle | Milton - Manuel,Velib' Métropôle | Miromesnil - La Boétie,Velib' Métropôle | Molitor - Chardon-Lagache,Velib' Métropôle | Molitor - Michel-Ange,Velib' Métropôle | Molière - République,Velib' Métropôle | Monceau - Malesherbes,Velib' Métropôle | Moncey - Blanche,Velib' Métropôle | Mont Valérien - Michel Salles,Velib' Métropôle | Montgallet - Charenton,Velib' Métropôle | Montgallet - Reuilly,Velib' Métropôle | Montmartre - Etienne Marcel,Velib' Métropôle | Montparnasse -  Square Ozanam,Velib' Métropôle | Montreuil - Gonnet,Velib' Métropôle | Montreuil - République,Velib' Métropôle | Montreuil - Voltaire,Velib' Métropôle | Morice - Général Leclerc,Velib' Métropôle | Morillons - Dantzig,Velib' Métropôle | Mornay - Sully,Velib' Métropôle | Moulin de la Pointe,Velib' Métropôle | Mouton Duvernet - Général Leclerc,Velib' Métropôle | Mozart - Jasmin,Velib' Métropôle | Murat - Porte de Saint-Cloud,Velib' Métropôle | Musée d'Orsay,Velib' Métropôle | Mutualité,Velib' Métropôle | Méchain - Faubourg Saint-Jacques,Velib' Métropôle | Ménilmontant - Oberkampf,Velib' Métropôle | Ménilmontant - Pelleport,Velib' Métropôle | Ménilmontant - Père Lachaise,Velib' Métropôle | Mézières - Rennes,Velib' Métropôle | Naples - Rome,Velib' Métropôle | Nationale - Marcel Duchamp,Velib' Métropôle | Nationale - Place Jules Guesde,Velib' Métropôle | Nationale - Vincent Auriol,Velib' Métropôle | Navier - Epinettes,Velib' Métropôle | Neuilly - Petit,Velib' Métropôle | Neuve Saint-Pierre - Beautreillis,Velib' Métropôle | Ney - Charles Hermite,Velib' Métropôle | Ney - Porte de Clignancourt,Velib' Métropôle | Ney - Porte de Montmartre,Velib' Métropôle | Niger - Soult,Velib' Métropôle | Noisy le Sec - Jean-Baptiste Clément,Velib' Métropôle | Notre-Dame-des-Champs - Stanislas,Velib' Métropôle | Oberkampf - République,Velib' Métropôle | Octave Feuillet - Albéric Magnard,Velib' Métropôle | Octave Gréard - Tour Eiffel,Velib' Métropôle | Odessa - Départ,Velib' Métropôle | Olivier de Serres - Leriche,Velib' Métropôle | Olympiades,Velib' Métropôle | Oratoire - Rivoli,Velib' Métropôle | Ordener - Poissonniers,Velib' Métropôle | Orteaux - Mouraud,Velib' Métropôle | Ouest - Château,Velib' Métropôle | Paganini - Davout,Velib' Métropôle | Paix - Verdun,Velib' Métropôle | Pajol - Place Herbert,Velib' Métropôle | Pajol - Riquet,Velib' Métropôle | Palais des Sports,Velib' Métropôle | Panthéon - Valette,Velib' Métropôle | Paradis - Hauteville,Velib' Métropôle | Parc André Citroën,Velib' Métropôle | Parc Eli Lotar,Velib' Métropôle | Parc Floral du Bel Air,Velib' Métropôle | Parc Georges Brassens - Brancion,Velib' Métropôle | Parc Monceau,Velib' Métropôle | Parc Pierre Lagravère,Velib' Métropôle | Parc Roger Salengro,Velib' Métropôle | Parc Suzanne Lenglen,Velib' Métropôle | Parc de Belleville - Julien Lacroix,Velib' Métropôle | Parc de Choisy,Velib' Métropôle | Parc de Sceaux - Centre-Ville,Velib' Métropôle | Paris - Désiré Préaux,Velib' Métropôle | Paris - Emile Zola,Velib' Métropôle | Paris - Laitières,Velib' Métropôle | Parme - Clichy,Velib' Métropôle | Parmentier - Abel rabaud,Velib' Métropôle | Parmentier - Fontaine au Roi,Velib' Métropôle | Parmentier - Hôpital Saint-Louis,Velib' Métropôle | Parmentier - République,Velib' Métropôle | Parvis Corentin Celton,Velib' Métropôle | Parvis Robert Schuman - Roger Salengro,Velib' Métropôle | Pascal - Claude Bernard,Velib' Métropôle | Passy - Place du Costa Rica,Velib' Métropôle | Pasteur - Cotentin,Velib' Métropôle | Pau Casals - Neuve Tolbiac,Velib' Métropôle | Paul Barruel - Vaugirard,Velib' Métropôle | Paul Bodin - Clichy,Velib' Métropôle | Paul Doumer - La Tour,Velib' Métropôle | Paul Doumer - Stalingrad,Velib' Métropôle | Paul Klee - Place Augusta Holmes,Velib' Métropôle | Paul Signac - Aristide Briand,Velib' Métropôle | Paul Vaillant Couturier - Chaptal,Velib' Métropôle | Paul Vaillant-Couturier - Gare RER,Velib' Métropôle | Paul Vaillant-Couturier - Victor Hugo,Velib' Métropôle | Paul Valery - Victor Hugo,Velib' Métropôle | Pelleport - Belgrand,Velib' Métropôle | Pelée - Alphonse Baudin,Velib' Métropôle | Pereire - Place de Wagram,Velib' Métropôle | Pereire - Rennequin,Velib' Métropôle | Pereire - Saussure,Velib' Métropôle | Pereire - Ternes,Velib' Métropôle | Pergolèse - Malakoff,Velib' Métropôle | Pergolèse - Marbeau,Velib' Métropôle | Perle - Vieille du Temple,Velib' Métropôle | Pernety - Raymond Losserand,Velib' Métropôle | Petit - Manin,Velib' Métropôle | Petit Palais,Velib' Métropôle | Petites Ecuries - Faubourg Poissonnière,Velib' Métropôle | Petites Ecuries - Faubourg Saint-Denis,Velib' Métropôle | Phalsbourg - Villiers,Velib' Métropôle | Philippe-Auguste,Velib' Métropôle | Piat - Parc de Belleville,Velib' Métropôle | Picpus - Louis Braille,Velib' Métropôle | Pierre Brossolette - 12 Février 1934,Velib' Métropôle | Pierre Brossolette - Adolphe Pinard,Velib' Métropôle | Pierre Charron - Champs-Elysées,Velib' Métropôle | Pierre Demours - Laugier,Velib' Métropôle | Pierre Ginier - Clichy,Velib' Métropôle | Pierre Grenier - Pont de Billancourt,Velib' Métropôle | Pierre Joseph Desault,Velib' Métropôle | Pierre Lefaucheux - Traversière,Velib' Métropôle | Pierre Levée - Fontaine Timbaud,Velib' Métropôle | Pierre Sarrazin - Saint-Michel,Velib' Métropôle | Pierre et Marie Curie - Julien Grimau,Velib' Métropôle | Pierre et Marie Curie - Maurice Thorez,Velib' Métropôle | Pierret - Madrid,Velib' Métropôle | Pirogues de Bercy - Libourne,Velib' Métropôle | Pitié-Salpêtrière,Velib' Métropôle | Place Adolphe Cherioux - Vaugirard,Velib' Métropôle | Place Aimé Césaire,Velib' Métropôle | Place Albert Kahn,Velib' Métropôle | Place Alphonse Deville,Velib' Métropôle | Place André Malraux,Velib' Métropôle | Place Aristide Briand,Velib' Métropôle | Place Balard,Velib' Métropôle | Place Carnot,Velib' Métropôle | Place Centrale,Velib' Métropôle | Place Charles Digeon,Velib' Métropôle | Place Charles Michels,Velib' Métropôle | Place Charles Vallin,Velib' Métropôle | Place Charles de Gaulle,Velib' Métropôle | Place Denfert-Rochereau,Velib' Métropôle | Place Du Général De Gaulle,Velib' Métropôle | Place Edmond Michelet,Velib' Métropôle | Place Etienne Pernet,Velib' Métropôle | Place Eustache Deschamps,Velib' Métropôle | Place Falguière,Velib' Métropôle | Place Fernand Forest,Velib' Métropôle | Place François Mitterand,Velib' Métropôle | Place Georges Guillaumin,Velib' Métropôle | Place Ginette Hamelin,Velib' Métropôle | Place Jacques Bonsergent,Velib' Métropôle | Place Jacques Madaule,Velib' Métropôle | Place Jacques et Thérèse Tréfouël,Velib' Métropôle | Place Jean Delay,Velib' Métropôle | Place Jean Ferrat,Velib' Métropôle | Place Jean-Baptiste Clément,Velib' Métropôle | Place Jean-Spire-Lemaître,Velib' Métropôle | Place Jeanne d'Arc,Velib' Métropôle | Place Joffre - Frédéric le Play,Velib' Métropôle | Place Jules Ferry,Velib' Métropôle | Place Lafayette,Velib' Métropôle | Place Léon Gambetta,Velib' Métropôle | Place Madeleine Daniélou,Velib' Métropôle | Place Marcel Cachin,Velib' Métropôle | Place Marcel Sembat,Velib' Métropôle | Place Mireille Havet,Velib' Métropôle | Place Monge,Velib' Métropôle | Place Mongolfier,Velib' Métropôle | Place Nationale - Château-des-Rentiers,Velib' Métropôle | Place Nelson Mandela,Velib' Métropôle | Place Pasdeloup,Velib' Métropôle | Place Paul Delouvrier,Velib' Métropôle | Place Paul Eluard,Velib' Métropôle | Place Pigalle,Velib' Métropôle | Place Robert Guillemard,Velib' Métropôle | Place Saint-André des Arts,Velib' Métropôle | Place Saint-Ferdinand,Velib' Métropôle | Place Saint-Just,Velib' Métropôle | Place Tony de Graaff,Velib' Métropôle | Place Tristan Bernard,Velib' Métropôle | Place Valhubert,Velib' Métropôle | Place Violet,Velib' Métropôle | Place aux Étoiles,Velib' Métropôle | Place d'Italie - Soeur Rosalie,Velib' Métropôle | Place d'Italie - Vincent Auriol,Velib' Métropôle | Place de Barcelone - Mirabeau,Velib' Métropôle | Place de Finlande,Velib' Métropôle | Place de Lévis,Velib' Métropôle | Place de Passy,Velib' Métropôle | Place de Rhin et Danube,Velib' Métropôle | Place de Rungis,Velib' Métropôle | Place de Verdun,Velib' Métropôle | Place de l'Eglise,Velib' Métropôle | Place de l'Europe,Velib' Métropôle | Place de l'Hôtel de Ville,Velib' Métropôle | Place de l'Insurrection d'Août 1944,Velib' Métropôle | Place de l'Édit de Nantes,Velib' Métropôle | Place de la Division Leclerc,Velib' Métropôle | Place de la Fraternité,Velib' Métropôle | Place de la Gare,Velib' Métropôle | Place de la Madeleine - Royale,Velib' Métropôle | Place de la Montagne du Goulet,Velib' Métropôle | Place de la Nation - Charonne,Velib' Métropôle | Place de la Nation - Picpus,Velib' Métropôle | Place de la Nation - Taillebourg,Velib' Métropôle | Place de la Porte de Champerret,Velib' Métropôle | Place de la Porte de Châtillon,Velib' Métropôle | Place de la Porte de Paris,Velib' Métropôle | Place de la Porte de Passy,Velib' Métropôle | Place de la Reine Astrid,Velib' Métropôle | Place de la République,Velib' Métropôle | Place de la République - Temple,Velib' Métropôle | Place de la République - Voltaire,Velib' Métropôle | Place de la vache noire,Velib' Métropôle | Place des Abbesses,Velib' Métropôle | Place des Droits de l'Enfant,Velib' Métropôle | Place des Larris,Velib' Métropôle | Place des Marseillais,Velib' Métropôle | Place des Ternes,Velib' Métropôle | Place des Victoires,Velib' Métropôle | Place du 14 Juillet,Velib' Métropôle | Place du 8 mai 1945,Velib' Métropôle | Place du Canada,Velib' Métropôle | Place du Colonel Fabien,Velib' Métropôle | Place du Cornillon - Stade de France,Velib' Métropôle | Place du Docteur Yersin,Velib' Métropôle | Place du Front Populaire - George Sand,Velib' Métropôle | Place du Général de Gaulle,Velib' Métropôle | Place du Lieutenant Henri Karcher,Velib' Métropôle | Place du Maquis du Vercors,Velib' Métropôle | Place du Maréchal Juin - Péreire,Velib' Métropôle | Place du Maréchal de Lattre de Tassigny,Velib' Métropôle | Place du Moulin de Javel,Velib' Métropôle | Place du Palais Royal,Velib' Métropôle | Place du Président Salvador Allende,Velib' Métropôle | Placette Grégoire Collas,Velib' Métropôle | Plantes - Moulin Vert,Velib' Métropôle | Point du Jour - Jean Jaurès,Velib' Métropôle | Poissonniers - Championnet,Velib' Métropôle | Poissonniers - Nord,Velib' Métropôle | Poissy - Saint-Germain,Velib' Métropôle | Pont De Charenton,Velib' Métropôle | Pont Neuf - Rivoli,Velib' Métropôle | Pont de Levallois-bécon,Velib' Métropôle | Pont de Lodi - Dauphine,Velib' Métropôle | Pont de Suresnes,Velib' Métropôle | Pont-Neuf - Quai du Louvre,Velib' Métropôle | Pontoise - La Tournelle,Velib' Métropôle | Port Royal - Hôpital Cochin,Velib' Métropôle | Port-Royal - Hôpital du Val-de-Grâce,Velib' Métropôle | Porte Dorée,Velib' Métropôle | Porte Maillot - Pereire,Velib' Métropôle | Porte Molitor,Velib' Métropôle | Porte Pouchet-Bessières,Velib' Métropôle | Porte Saint-Martin,Velib' Métropôle | Porte d'Asnières,Velib' Métropôle | Porte d'Aubervilliers,Velib' Métropôle | Porte d'Auteuil,Velib' Métropôle | Porte d'Italie,Velib' Métropôle | Porte d'Ivry,Velib' Métropôle | Porte d'Orléans,Velib' Métropôle | Porte de Bagnolet,Velib' Métropôle | Porte de Charenton,Velib' Métropôle | Porte de Clignancourt,Velib' Métropôle | Porte de Clignancourt - Ney,Velib' Métropôle | Porte de Ménilmontant,Velib' Métropôle | Porte de Pantin,Velib' Métropôle | Porte de Pantin - Petits Ponts,Velib' Métropôle | Porte de Saint Cloud - Parc des Princes,Velib' Métropôle | Porte de Saint-Ouen - Bessières,Velib' Métropôle | Porte de Saint-Ouen - Henri Huchard,Velib' Métropôle | Porte de Vanves,Velib' Métropôle | Porte de Versailles,Velib' Métropôle | Porte de Vincennes,Velib' Métropôle | Porte de la Chapelle,Velib' Métropôle | Porte de la Muette,Velib' Métropôle | Porte de la Plaine,Velib' Métropôle | Porte de la Plaine - Lefebvre,Velib' Métropôle | Porte de la Villette,Velib' Métropôle | Porte des Lilas - Faidherbe,Velib' Métropôle | Portugais - Kléber,Velib' Métropôle | Poulet - Barbès,Velib' Métropôle | Primo Levi - Frigos,Velib' Métropôle | Professeur René Leriche - Général Leclerc,Velib' Métropôle | Proudhon - Président Wilson,Velib' Métropôle | Provence - Chaussée d'Antin,Velib' Métropôle | Pré Saint-Gervais - Lilas,Velib' Métropôle | Président Wilson - Baudin,Velib' Métropôle | Président Wilson - Jean Jaures,Velib' Métropôle | Pyramide - Ecole du Breuil,Velib' Métropôle | Pyramide - Parc Floral,Velib' Métropôle | Pyrénées - Avron,Velib' Métropôle | Pyrénées - Charles Renouvier,Velib' Métropôle | Pyrénées - Cours de Vincennes,Velib' Métropôle | Pyrénées - Dagorno,Velib' Métropôle | Pyrénées - Emmery,Velib' Métropôle | Pyrénées - Maraîchers,Velib' Métropôle | Pyrénées - Ménilmontant,Velib' Métropôle | Pyrénées - Plaine,Velib' Métropôle | Quai Anatole France - Musée d'Orsay,Velib' Métropôle | Quai Jules Guesde - Saint-Simon,Velib' Métropôle | Quai Marcel Boyer - Victor Hugo,Velib' Métropôle | Quai Panhard et Levassor,Velib' Métropôle | Quai Voltaire,Velib' Métropôle | Quai aux Fleurs - Pont Saint-Louis,Velib' Métropôle | Quai d'Orsay - Invalides,Velib' Métropôle | Quai de Béthune - Pont de la Tournelle,Velib' Métropôle | Quai de Valmy,Velib' Métropôle | Quai de l'Aisne - Général Leclerc,Velib' Métropôle | Quai de l'Horloge - Pont Neuf,Velib' Métropôle | Quai de l'Oise - Aisne,Velib' Métropôle | Quai de la Loire - Jean Jaurès,Velib' Métropôle | Quai de la Seine,Velib' Métropôle | Quai des Célestins - Henri IV,Velib' Métropôle | Quai du Président Roosevelt - Pont Aval,Velib' Métropôle | Quatre Vents - Carrefour de l'Odéon,Velib' Métropôle | Raffet - Montmorency,Velib' Métropôle | Rampal - Belleville,Velib' Métropôle | Ramponeau - Belleville,Velib' Métropôle | Ranelagh - Maison de la Radio,Velib' Métropôle | Ranelagh - Mozart,Velib' Métropôle | Rapp - Place du Général Gouraud,Velib' Métropôle | Raspail - Albert Schweitzer,Velib' Métropôle | Raspail - Bac,Velib' Métropôle | Raspail - Chomel,Velib' Métropôle | Raspail - Manufacture des Oeillets,Velib' Métropôle | Raspail - Varenne,Velib' Métropôle | Raymond Poincaré - Place Victor Hugo,Velib' Métropôle | Regard - Rennes,Velib' Métropôle | Regnault - Patay,Velib' Métropôle | Reims - Porte d'Asnières,Velib' Métropôle | Reims - Raymond Pitet,Velib' Métropôle | René Binet - Porte de Montmartre,Velib' Métropôle | René Boulanger - Lancry,Velib' Métropôle | René Coty - Parc Montsouris,Velib' Métropôle | René Coty - Place Denfert-Rochereau,Velib' Métropôle | Repos - Cimetière du Père Lachaise,Velib' Métropôle | Reuilly - Daumesnil,Velib' Métropôle | Reuilly - Place Felix Eboue,Velib' Métropôle | Reynaldo Hahn - Lagny,Velib' Métropôle | Richard Lenoir - Jean-Pierre Timbaud,Velib' Métropôle | Richard Lenoir - Place de la Bastille,Velib' Métropôle | Richard Lenoir - Republique,Velib' Métropôle | Richard Lenoir - Voltaire,Velib' Métropôle | Richard Wallace - Place du 8 Mai 1945,Velib' Métropôle | Riquet - Marx Dormoy,Velib' Métropôle | Rivoli - Musée du Louvre,Velib' Métropôle | Rochechouart - Martyrs,Velib' Métropôle | Rochechouart lamartine,Velib' Métropôle | Rocher - Laborde,Velib' Métropôle | Roger Salengro - Général de Gaulle,Velib' Métropôle | Romain Rolland,Velib' Métropôle | Romainville - Vaillant-Couturier,Velib' Métropôle | Rome - Provence,Velib' Métropôle | Rond-Point Rhin et Danube,Velib' Métropôle | Rond-Point de la Chapelle,Velib' Métropôle | Rond-point du Dr Albert Schweitzer,Velib' Métropôle | Roquette - Auguste Laurent,Velib' Métropôle | Roquette - Folie Regnault,Velib' Métropôle | Roquette - Thiéré,Velib' Métropôle | Roquépine - Malesherbes,Velib' Métropôle | Rossini - Laffitte,Velib' Métropôle | Rottembourg - Général Michel Bizot,Velib' Métropôle | Rougemont - Poissonnière,Velib' Métropôle | Rouget de Lisle,Velib' Métropôle | Route de Sèvres - Porte de Bagatelle,Velib' Métropôle | Route de la Muette - Porte de Neuilly,Velib' Métropôle | Ruisseau - Ordener,Velib' Métropôle | Réaumur - Montmartre,Velib' Métropôle | Récollets - Square Villemin,Velib' Métropôle | République - Auguste Perret,Velib' Métropôle | République - Henri Barbusse,Velib' Métropôle | République - Louis Loucheur,Velib' Métropôle | Résistance - Hoche,Velib' Métropôle | Résistance - Parmentier,Velib' Métropôle | Réunion - Avron,Velib' Métropôle | Sablons - Georges Mandel,Velib' Métropôle | Sabot - Rennes,Velib' Métropôle | Sadi Carnot - François Mitterrand,Velib' Métropôle | Sahel - Général Michel Bizot,Velib' Métropôle | Saint Georges - d'Aumale,Velib' Métropôle | Saint-Amand - Labrouste,Velib' Métropôle | Saint-Ambroise - Parmentier,Velib' Métropôle | Saint-Antoine Sévigné,Velib' Métropôle | Saint-Augustin,Velib' Métropôle | Saint-Benoît - Jacob,Velib' Métropôle | Saint-Blaise - Mouraud,Velib' Métropôle | Saint-Bon - Rivoli,Velib' Métropôle | Saint-Denis - Rivoli,Velib' Métropôle | Saint-Denis - Réaumur,Velib' Métropôle | Saint-Didier - Raymond Poincaré,Velib' Métropôle | Saint-Fargeau - Mortier,Velib' Métropôle | Saint-Fiacre - Poissonière,Velib' Métropôle | Saint-François-Xavier,Velib' Métropôle | Saint-Germain - Ciseaux,Velib' Métropôle | Saint-Germain - Thenard,Velib' Métropôle | Saint-Germain-des-Prés,Velib' Métropôle | Saint-Gilles - Turenne,Velib' Métropôle | Saint-Honoré - 29 juillet,Velib' Métropôle | Saint-Honoré - Musée du Louvre,Velib' Métropôle | Saint-Jacques - Soufflot,Velib' Métropôle | Saint-Jacques - Tombe Issoire,Velib' Métropôle | Saint-Jacques - Val de Grâce,Velib' Métropôle | Saint-Lazare - Place d'Estienne d'Orves,Velib' Métropôle | Saint-Mande - Picpus,Velib' Métropôle | Saint-Mandé - Docteur Arnold Netter,Velib' Métropôle | Saint-Mandé - Fabre d'Eglantine,Velib' Métropôle | Saint-Marcel - Hôpital,Velib' Métropôle | Saint-Maur - Roquette,Velib' Métropôle | Saint-Maur - République,Velib' Métropôle | Saint-Michel - Luxembourg,Velib' Métropôle | Saint-Placide - Cherche Midi,Velib' Métropôle | Saint-Romain - Cherche-Midi,Velib' Métropôle | Saint-Sulpice,Velib' Métropôle | Saint-Séverin - Saint-Michel,Velib' Métropôle | Saint-Vincent - Verdun,Velib' Métropôle | Sainte-Elisabeth - Turbigo,Velib' Métropôle | Sambre et Meuse - Villette,Velib' Métropôle | Santé - Arago,Velib' Métropôle | Sarrette - Général Leclerc,Velib' Métropôle | Schoelcher - Raspail,Velib' Métropôle | Sebastopol - Rambuteau,Velib' Métropôle | Seine - Flandre,Velib' Métropôle | Senard - Charles Blum,Velib' Métropôle | Serrurier,Velib' Métropôle | Siam - La Pompe,Velib' Métropôle | Sibelle - Alésia,Velib' Métropôle | Silly - Galliéni,Velib' Métropôle | Silly - Louis Blériot,Velib' Métropôle | Simon Bolivar - Henri Turot,Velib' Métropôle | Solitaires - Place des Fêtes,Velib' Métropôle | Sommerard - Saint-Jacques,Velib' Métropôle | Sorbier - Gasnier-Guy,Velib' Métropôle | Sorbier - Ménilmontant,Velib' Métropôle | Sorbonne - Ecoles,Velib' Métropôle | Square Alban Satragne,Velib' Métropôle | Square Bela Bartok,Velib' Métropôle | Square Boucicaut,Velib' Métropôle | Square Cambronne,Velib' Métropôle | Square Claude Bernard,Velib' Métropôle | Square Denise Buisson,Velib' Métropôle | Square Desnouettes,Velib' Métropôle | Square Edmond Pépin,Velib' Métropôle | Square Emile - Chautemps,Velib' Métropôle | Square Etienne Jarousse,Velib' Métropôle | Square Georges Melies,Velib' Métropôle | Square Gilbert Thomain,Velib' Métropôle | Square Louis XVI,Velib' Métropôle | Square Louise Michel,Velib' Métropôle | Square Léon,Velib' Métropôle | Square Montholon,Velib' Métropôle | Square Pierre Lazareff,Velib' Métropôle | Square Raymond Souplex,Velib' Métropôle | Square René Viviani - Montebello,Velib' Métropôle | Square Saint-Ambroise,Velib' Métropôle | Square Simon Bolivar,Velib' Métropôle | Square Victor Basch,Velib' Métropôle | Square d'Anvers,Velib' Métropôle | Square de la rue Pixérécourt,Velib' Métropôle | Square des Amandiers,Velib' Métropôle | Square des Epinettes,Velib' Métropôle | Square des Saint-Simoniens,Velib' Métropôle | Square du Bataclan,Velib' Métropôle | Square du Carrefour de l'Insurrection,Velib' Métropôle | Square du Théâtre du Garde-Chasse,Velib' Métropôle | St-Ouen - Lamarck,Velib' Métropôle | Stade Auguste Delaune,Velib' Métropôle | Stade Georges Carpentier,Velib' Métropôle | Stade Pershing,Velib' Métropôle | Stade de France,Velib' Métropôle | Stalingrad - Désiré Chevalier,Velib' Métropôle | Stalingrad - Ludwig Van Beethoven,Velib' Métropôle | Stalingrad - Rigollots,Velib' Métropôle | Stephenson - Doudeauville,Velib' Métropôle | Suffren - Champ de Mars,Velib' Métropôle | Suffren - La Motte-Piquet,Velib' Métropôle | Suffren - Pérignon,Velib' Métropôle | Surcouf - Université,Velib' Métropôle | Sèvres - Général Leclerc,Velib' Métropôle | Sèvres - Lecourbe,Velib' Métropôle | Sèvres-Gallieni,Velib' Métropôle | Ségur - d'Estrées,Velib' Métropôle | Sénat - Condé,Velib' Métropôle | Taitbout - Châteaudun,Velib' Métropôle | Taitbout - La Fayette,Velib' Métropôle | Tanger - Place du Maroc,Velib' Métropôle | Tardieu - Chappe,Velib' Métropôle | Temple - Charlot,Velib' Métropôle | Temple - Haudriettes,Velib' Métropôle | Temple - Jean-Pierre Timbaud,Velib' Métropôle | Terroirs de France - Lheureux,Velib' Métropôle | Tertres - Fontaine,Velib' Métropôle | Thionville - Ourcq,Velib' Métropôle | Thouin - Cardinal Lemoine,Velib' Métropôle | Théophile Gautier - François Millet,Velib' Métropôle | Thérèse - Opéra,Velib' Métropôle | Théâtre,Velib' Métropôle | Théâtre - Lourmel,Velib' Métropôle | Théâtre des Amandiers - Palais des sports,Velib' Métropôle | Tiron - Rivoli,Velib' Métropôle | Toffier Decaux - Cartier Bresson,Velib' Métropôle | Tombe Issoire - René Coty,Velib' Métropôle | Toqueville - Cardinet,Velib' Métropôle | Toudouze - Clauzel,Velib' Métropôle | Tour d'Auvergne - Rodier,Velib' Métropôle | Traktir - Foch,Velib' Métropôle | Transvaal - Charles de Gaulle,Velib' Métropôle | Traversière - Ledru-Rollin,Velib' Métropôle | Tremblay - Lac des Minimes,Velib' Métropôle | Turbigo - Française,Velib' Métropôle | Turbigo - Réaumur,Velib' Métropôle | Université,Velib' Métropôle | Université Paris Dauphine,Velib' Métropôle | Uzès - Montmartre,Velib' Métropôle | Vaneau - Sèvres,Velib' Métropôle | Vanne - Général de Gaulle,Velib' Métropôle | Vanne - Saussaies,Velib' Métropôle | Varenne,Velib' Métropôle | Vasco de Gama,Velib' Métropôle | Vaugirard - Monsieur le Prince,Velib' Métropôle | Vaugirard - Pasteur,Velib' Métropôle | Ventadour - Opéra,Velib' Métropôle | Verdier - République,Velib' Métropôle | Verdun - Adrien Damalix,Velib' Métropôle | Verdun - Place Henri IV,Velib' Métropôle | Versailles - Claude Terrasse,Velib' Métropôle | Victoire - Chaussée d'Antin,Velib' Métropôle | Victoire - Laffitte,Velib' Métropôle | Victor Cresson - Telles de la Poterie,Velib' Métropôle | Victor Hugo - Bineau,Velib' Métropôle | Victor Hugo - Ecoles,Velib' Métropôle | Victor Hugo - Galliéni,Velib' Métropôle | Victor Hugo - Jeanne Jugan,Velib' Métropôle | Victor Hugo - La Pompe,Velib' Métropôle | Victor Hugo - Magasins Généraux,Velib' Métropôle | Victor Massé - Jean-Baptiste Pigalle,Velib' Métropôle | Victoria - Place du Chatelet,Velib' Métropôle | Vieille du Temple - Francs Bourgeois,Velib' Métropôle | Vignerons - Minimes,Velib' Métropôle | Vignes - Boulainvilliers,Velib' Métropôle | Vigée-Lebrun - Anselme Payen,Velib' Métropôle | Village Saint-Paul,Velib' Métropôle | Villersexel - Saint-Germain,Velib' Métropôle | Villette - Belleville,Velib' Métropôle | Villiers - Batignolles,Velib' Métropôle | Villiers de l'Isle Adam - Pyrénées,Velib' Métropôle | Vinaigriers - Magenta,Velib' Métropôle | Vincennes - Douy-Delcupe,Velib' Métropôle | Vincent Auriol - Louise Weiss,Velib' Métropôle | Vistule - Choisy,Velib' Métropôle | Vitruve - Davout,Velib' Métropôle | Vivaldi - Antoine-Julien Hénard,Velib' Métropôle | Vivienne - Montmartre,Velib' Métropôle | Vladimir Ilitch Lénine - Andrée Chedid,Velib' Métropôle | Volontaire - Lecourbe,Velib' Métropôle | Volontaires - Vaugirard,Velib' Métropôle | Voltaire - Anatole France,Velib' Métropôle | Véron - Lepic,Velib' Métropôle | Westermeyer - Paul Vaillant-Couturier,Velib' Métropôle | Wilson - Landy,Velib' Métropôle | Wilson - Métallurgie,Velib' Métropôle | Wurtz - Tolbiac,Velib' Métropôle | Youri Gagarine - Commune de Paris,Velib' Métropôle | Youri Gagarine - Karl Marx,Velib' Métropôle | Édouard Vaillant - Place Jean Jaurès,Velib' Métropôle | Île de la Jatte,Velo Antwerpen | 001- Centraal Station - Astrid,Velo Antwerpen | 002- Centraal Station - Astrid 2,Velo Antwerpen | 003- Centraal station Kievit 2,Velo Antwerpen | 004- De Keyserlei,Velo Antwerpen | 005- Centraal Station / Kievit,Velo Antwerpen | 006- Premetro Plantin,Velo Antwerpen | 007- NMBS Berchem,Velo Antwerpen | 008- NMBS Berchem 2,Velo Antwerpen | 010- NMBS Zuid,Velo Antwerpen | 011- Roosevelt,Velo Antwerpen | 012- Brussel,Velo Antwerpen | 013- De Singel,Velo Antwerpen | 014- Markgrave,Velo Antwerpen | 015- Schone Kunsten,Velo Antwerpen | 016- Marnixplaats,Velo Antwerpen | 017- Groenplaats,Velo Antwerpen | 018- Meirbrug,Velo Antwerpen | 019- Eiermarkt,Velo Antwerpen | 020- Groenplaats 2,Velo Antwerpen | 021- Driekoningen,Velo Antwerpen | 022- Statie,Velo Antwerpen | 023- Rubenshuis,Velo Antwerpen | 024- Opera,Velo Antwerpen | 025- Teniersplaats,Velo Antwerpen | 026- Meir-Antoon Van Dijck,Velo Antwerpen | 027- Lange Nieuwstraat,Velo Antwerpen | 028- Keizerstraat,Velo Antwerpen | 029- Lozana,Velo Antwerpen | 030- Het Laar,Velo Antwerpen | 031- Wezenberg,Velo Antwerpen | 032- Permeke,Velo Antwerpen | 033- Hessenhuis,Velo Antwerpen | 034- M HKA,Velo Antwerpen | 035- Cockerillkaai,Velo Antwerpen | 036- Bourla,Velo Antwerpen | 037- Theater,Velo Antwerpen | 039- Koxplein,Velo Antwerpen | 040- Desguinlei,Velo Antwerpen | 041- Van Eyck,Velo Antwerpen | 042- Harmonie,Velo Antwerpen | 043- Grétrystraat,Velo Antwerpen | 044- Belgielei,Velo Antwerpen | 045- Falconplein,Velo Antwerpen | 046- De Merode,Velo Antwerpen | 047- Militair Hospitaal,Velo Antwerpen | 048- De Keyserlei 2,Velo Antwerpen | 049- Tolhuis,Velo Antwerpen | 050- Klapdorp,Velo Antwerpen | 051- Mutsaardplein,Velo Antwerpen | 052- Waaslandtunnel,Velo Antwerpen | 053- Paardenmarkt,Velo Antwerpen | 054- Ossenmarkt,Velo Antwerpen | 055- Zonnebloemstraat,Velo Antwerpen | 056- Minderbroedersrui,Velo Antwerpen | 057- Wolstraat,Velo Antwerpen | 058- Noorderterras,Velo Antwerpen | 059- Het Steen,Velo Antwerpen | 060- Grote Markt,Velo Antwerpen | 061- Victor Jacobslei,Velo Antwerpen | 062- Station Dam,Velo Antwerpen | 063- Slachthuis,Velo Antwerpen | 064- Zuiderterras,Velo Antwerpen | 065- Plantinkaai,Velo Antwerpen | 066- Modemuseum,Velo Antwerpen | 067- Oudaan,Velo Antwerpen | 068-  Turnhoutsepoort,Velo Antwerpen | 069- Fonteinstraat,Velo Antwerpen | 070- Sint Andries,Velo Antwerpen | 071- Sint-Michielskaai,Velo Antwerpen | 072- Tropisch Instituut,Velo Antwerpen | 073- Maarschalk Gérard,Velo Antwerpen | 074- Vismijn,Velo Antwerpen | 075- Vlaamsekaai,Velo Antwerpen | 076- Prekersplein,Velo Antwerpen | 077- Blauwtorenplein,Velo Antwerpen | 078- Oud Gerechtshof,Velo Antwerpen | 079- Nationale Bank,Velo Antwerpen | 080- Montigny,Velo Antwerpen | 081- Justitiepaleis,Velo Antwerpen | 082- Fotografiemuseum,Velo Antwerpen | 083- Brederode,Velo Antwerpen | 084- Elzenveld,Velo Antwerpen | 085- Den Bell,Velo Antwerpen | 086- Troonplaats,Velo Antwerpen | 087- Lange Elzen,Velo Antwerpen | 088- Haantjeslei,Velo Antwerpen | 089- Hof van Leysen,Velo Antwerpen | 090- Ballaarstraat,Velo Antwerpen | 091- Hemelstraat,Velo Antwerpen | 092- Sint-Thomas,Velo Antwerpen | 093- Sint Vincentius,Velo Antwerpen | 094- Paleisstraat,Velo Antwerpen | 095- Quinten Matsijslei,Velo Antwerpen | 096- Stadspark,Velo Antwerpen | 097- Cuperus,Velo Antwerpen | 099- Generaal Leman,Velo Antwerpen | 100- Van Hombeeckplein,Velo Antwerpen | 101- Premetro Handel,Velo Antwerpen | 102- Duinstraat,Velo Antwerpen | 103- Oude Kerk Berchem,Velo Antwerpen | 104- Mercator,Velo Antwerpen | 106- Draakplaats,Velo Antwerpen | 107- Moorkensplein,Velo Antwerpen | 108- Krugerpark,Velo Antwerpen | 109- Kerkstraat,Velo Antwerpen | 110- Dageraadplaats,Velo Antwerpen | 111- Van Der Meyden,Velo Antwerpen | 112- Pretoriastraat,Velo Antwerpen | 113- Helmstraat,Velo Antwerpen | 114- ZNA Stuivenberg,Velo Antwerpen | 115- Metro Elisabeth,Velo Antwerpen | 116- Loosplaats,Velo Antwerpen | 117- Sint Jansplein,Velo Antwerpen | 118- Dambrugge,Velo Antwerpen | 119- Ploeg,Velo Antwerpen | 120- Eendracht,Velo Antwerpen | 121- Stuivenbergplein,Velo Antwerpen | 122- Schijnpoort,Velo Antwerpen | 123- Park Spoor Noord 2,Velo Antwerpen | 124- Park Spoor Noord 1,Velo Antwerpen | 125- Sint-Norbertus,Velo Antwerpen | 126- Lange Dijk,Velo Antwerpen | 127- FOD Financiën,Velo Antwerpen | 129- Godefriduskaai,Velo Antwerpen | 130- Lamoriniere,Velo Antwerpen | 131- De Wittestraat,Velo Antwerpen | 132- Montgomery,Velo Antwerpen | 133- Willemdok,Velo Antwerpen | 134- MAS,Velo Antwerpen | 135- Loodswezen,Velo Antwerpen | 136- Spoor Noord Skatebowl,Velo Antwerpen | 137- Sint-Laureiskaai,Velo Antwerpen | 138- Amsterdamstraat,Velo Antwerpen | 139- Londenstraat,Velo Antwerpen | 140- Jachthaven LO,Velo Antwerpen | 141- Sint-Anna,Velo Antwerpen | 142- Esmoreitlaan,Velo Antwerpen | 143- Melis Stokelaan,Velo Antwerpen | 144- August Vermeylenlaan,Velo Antwerpen | 145- De Coster,Velo Antwerpen | 146- Reinaartlaan,Velo Antwerpen | 147- Halewijnlaan,Velo Antwerpen | 148- Verhaerenlaan,Velo Antwerpen | 149- Van Eedenplein,Velo Antwerpen | 150- Waterhoenlaan,Velo Antwerpen | 151- Van Cauwelaert,Velo Antwerpen | 152- Blancefloerlaan,Velo Antwerpen | 153- Beatrijslaan,Velo Antwerpen | 154- Terloplein,Velo Antwerpen | 155- Statielei,Velo Antwerpen | 156- Gasstraat,Velo Antwerpen | 157- Berchem Kerk,Velo Antwerpen | 158- Zuidervelodroom,Velo Antwerpen | 159- Den Bell 2,Velo Antwerpen | 160- Vlinderpaleis,Velo Antwerpen | 161 - Hospitaalplein,Velo Antwerpen | 162 - Regatta,Velo Antwerpen | 163 - Pluvier,Velo Antwerpen | 201- Havana,Velo Antwerpen | 202- Squarepark,Velo Antwerpen | 203- Venezuelastraat,Velo Antwerpen | 204- Luchtbal winkelcentrum,Velo Antwerpen | 205- Kinepolis,Velo Antwerpen | 206- Station Luchtbal,Velo Antwerpen | 207- Winkelstap,Velo Antwerpen | 208- Ringlaan Atheneum,Velo Antwerpen | 209- Melgeshof,Velo Antwerpen | 210- Maantjessteenweg,Velo Antwerpen | 211- Cultuurcentrum,Velo Antwerpen | 212- Rode Loop,Velo Antwerpen | 213- Kroonplein,Velo Antwerpen | 214- Kerkhofblommen,Velo Antwerpen | 215- Nieuwdreef,Velo Antwerpen | 216- Zwembad Merksem,Velo Antwerpen | 217- Joske Vermeulen,Velo Antwerpen | 218- Groenendaalcollege,Velo Antwerpen | 219- Districtshuis Merksem,Velo Antwerpen | 220- 't Dokske,Velo Antwerpen | 221-Havenhuis,Velo Antwerpen | 222- Cadix Oost,Velo Antwerpen | 223- Red Star Line,Velo Antwerpen | 224- Indiestraat,Velo Antwerpen | 225- Verbindingsdok Eilandje,Velo Antwerpen | 226- Noordschippersdok,Velo Antwerpen | 227- Amstel,Velo Antwerpen | 228- Van Heetvelde,Velo Antwerpen | 229- Jozef Nellens,Velo Antwerpen | 230- Bosuil,Velo Antwerpen | 231- den Antwerp,Velo Antwerpen | 232- Wim Saerens,Velo Antwerpen | 233- Gallifort,Velo Antwerpen | 234- Deurne Atheneum,Velo Antwerpen | 235- Cogelsplein,Velo Antwerpen | 236- Districtshuis Deurne,Velo Antwerpen | 237- Ter Rivieren,Velo Antwerpen | 238- Ertbrugge,Velo Antwerpen | 239- Zwarte Arend,Velo Antwerpen | 240- Park Groot Schijn,Velo Antwerpen | 241- Kerkendijk,Velo Antwerpen | 242- Te Boelaerlei,Velo Antwerpen | 243- Mestputteke,Velo Antwerpen | 244- Waterbaan,Velo Antwerpen | 245- AZ Monica,Velo Antwerpen | 246- Arena,Velo Antwerpen | 247- ZNA Sint Erasmus,Velo Antwerpen | 248- De Schans,Velo Antwerpen | 249- Frans De Vriend,Velo Antwerpen | 250- Borsbeekbrug,Velo Antwerpen | 251- Te Boelaerpark Noord,Velo Antwerpen | 252- Te Boelaerpark/Gitschotellei,Velo Antwerpen | 253- Vosplein,Velo Antwerpen | 254- Sint-Jozef,Velo Antwerpen | 255- Van den Haute,Velo Antwerpen | 256- Zillebeek,Velo Antwerpen | 257- Hofstade,Velo Antwerpen | 258- Hof van Nauwelaerts,Velo Antwerpen | 259- Posthofbrug,Velo Antwerpen | 260- Ter Schrieck,Velo Antwerpen | 261- Brilschans,Velo Antwerpen | 262- Hoogveld,Velo Antwerpen | 263- Fruithoflaan 2,Velo Antwerpen | 264- Filip Williotstraat,Velo Antwerpen | 265- Pulhof,Velo Antwerpen | 266- Fruithoflaan 1,Velo Antwerpen | 267- Leopold,Velo Antwerpen | 268- ZNA Middelheim,Velo Antwerpen | 269- Middelheim,Velo Antwerpen | 270- Dikke Mee,Velo Antwerpen | 271- Middelheimmuseum,Velo Antwerpen | 272- Groenenborger,Velo Antwerpen | 273- Campus Groenenborger,Velo Antwerpen | 274- De Bist,Velo Antwerpen | 275- Sneeuwbes,Velo Antwerpen | 276- Corbusier,Velo Antwerpen | 277- Ahornen,Velo Antwerpen | 278- Oversnes,Velo Antwerpen | 279- Ieperman,Velo Antwerpen | 280- Marmotteke,Velo Antwerpen | 281- Hof van Tichelen,Velo Antwerpen | 282- De Letter,Velo Antwerpen | 283- Hollebeek,Velo Antwerpen | 284- Steynsstraat,Velo Antwerpen | 285- Hoge Beuken,Velo Antwerpen | 286- Station Hoboken/Polderstad,Velo Antwerpen | 287- Kioskplaats/Centrum,Velo Antwerpen | 288- Draaiboom,Velo Antwerpen | 289- Broydenborgpark,Velo Antwerpen | 290- Coöperatielaan,Velo Antwerpen | 291- Braem blokken,Velo Antwerpen | 292- Kielpark,Velo Antwerpen | 293- Edgard Castelein,Velo Antwerpen | 294- Den Tir,Velo Antwerpen | 295- Sporthal Kiel,Velo Antwerpen | 296- Mastvest,Velo Antwerpen | 297- Tentoonstellingswijk,Velo Antwerpen | 298- Koornbloem,Velo Antwerpen | 299- Antwerp expo,Velo Antwerpen | 300- Wilrijksepleinen,Velo Antwerpen | 301- Luchthaven,Velo Antwerpen | 302- Rozenkrans,Velo Antwerpen | 303-Kambala,Velo Antwerpen | 304 - Campinia,Velo Antwerpen | 305 - Ter Nieuwerbrugge,Velo Antwerpen | 307 - Baron Sadoin,Velo Antwerpen | 308 - KDG Campus Hoboken,Velo Antwerpen | 309 - De Torekens,Velo Antwerpen | 310 - Sporthal Sorghvliedt,Velo Antwerpen | 311 - Cockerillhof,Velo Antwerpen | 312 - Graspolder,Velo Antwerpen | 314 - Schoonselhof,Velo Antwerpen | 316 - D.E. Van Damme,Velo Antwerpen | 317 - Distelhoek,Velo Antwerpen | 319 - Schaliemolen,Velo Antwerpen | 320 - Den Brem,Velo Antwerpen | 321 - Monnikenplein,Velo Antwerpen | 322 - Malisgoed,Velo Antwerpen | 323 - Sint-Augustinus,Velo Antwerpen | 324 - Dordrechlaan,Velo Antwerpen | 325 - Paul Vekemans,Velo Antwerpen | 326 - Krugerbrug,Velo Antwerpen | 327 - Ridderveld,Velo Antwerpen | 328 - Oude Terminus,Velo Antwerpen | 329 - Prosper de Wit,Velo Antwerpen | 330 - Meerlenhof,Velo Antwerpen | 331 - Zaatlaan,Velo Antwerpen | 332 - Valkstraat,Velo Antwerpen | 333 - Frans Adriaenssen / Joma,Velo Antwerpen | 334 - Den Haas,Velo Antwerpen | 335- Speelplein,Velo Antwerpen | 336 -Sneeuwbeslaan,Velo Antwerpen | 337 - Verenigde Naties,Velo Antwerpen | 339 - 't Veer,Velo Antwerpen | 340 - Dokter Donny,Velo Antwerpen | 342 - Nieuw Zuid,Velo Antwerpen | Centraal Station 3,Velo Antwerpen | Eksterlaar,Velo Antwerpen | Fod Financiën 2,Velo2 | 50001 - CER01 - GARE LES HAUTS DE CERGY(CB),Velo2 | 50002 - CER02 - AVENUE DU HAZAY,Velo2 | 50004 - CER04 - LE BON TEMPS,Velo2 | 50005 - CER05 - MOULIN A VENT,Velo2 | 50006 - CER06 - LE CHAT PERCHÉ,Velo2 | 50007 - CER07 -  PARC ST-CHRISTOPHE,Velo2 | 50008 - CER08 - AXE MAJEUR (CB),Velo2 | 50009 - CER09 - RUE DU BRÛLOIR,Velo2 | 50010 - CER10 - GARE CERGY AXE MAJ HORLOGE (CB),Velo2 | 50011 - CER11 - PLACE DE L'HOTEL DE VILLE (CB),Velo2 | 50012 - CER12 - PLACE DU HAUT-GENCY,Velo2 | 50013 - CER13 - ROND-POINT DES RAIES,Velo2 | 50014 - CER14 - AVENUE DU NORD,Velo2 | 50015 - CER15 - PLACE DES LINANDES (CB),Velo2 | 50016 - CER16 - UNIVERSITÉ LES CHÊNES (CB),Velo2 | 50017 - CER17 - CERGY VILLAGE CENTRE,Velo2 | 50018 - CER18 - PORT CERGY (CB),Velo2 | 50019 - CER19 - RUE DES LILAS,Velo2 | 50020 - CONSEIL GÉNÉRAL,Velo2 | 50021 - CER21 - DALLE PIÉTONNE GRAND CENTRE,Velo2 | 50022 - CER22 - GARE CERGY GRAND CENTRE (CB),Velo2 | 50023 - CER23 - LES TOULEUSES,Velo2 | 50024 - CER24 - CROIX PETIT,Velo2 | 50025 - CER25 - ARENICE,Velo2 | 50101 - PÔLE GARE (CB),Velo2 | 53001 - PON01 - RUE SERE-DEPOIN (CB),Velo2 | 53002 - PON02 - PLACE DE LA LIBÉRATION,Velo2 | 53003 - PON03 - UNIVERSITÉ ST MARTIN,Velo2 | 53004 - PON04 - LA PALETTE,Velo2 | 53101 - SOA01 - PLACE CARNOT (CB),Velo2 | 53102 - SOA02 - GARE SOA CENTRE,Velo2 | 54901 - VAU01 - PLACE DU RDV (CB),Velo2 | 54902 - VAU02 - MAIRIE CROIX-LIEU(CB),Velo2 | 54904 - VAU04 - MENDES FRANCE,Velo2 | 56101 - ERA01 - LA DANNE,Velo2 | 56102 - ERA02 - CHARLES DE GAULLE,Velo2 | 56103 - ERA03 - GARE D'ERAGNY (CB),Velo2 | 56104 - ERA04 - LA CHALLE (CB),Velo2 | 56105 - ERA05- BAS NOYER (CB),Velo2 | 56106 - ERA06 - CENTRE TECHNIQUE MUNICIPAL,Velo2 | 56401 - COU01 - LA LOUVIERE (CB),Veloh | #00001-LEON XIII,Veloh | #00002-GARE CENTRALE 2,Veloh | #00003-STROOSSBUERGER PLAZ,Veloh | #00004-ROCADE,Veloh | #00006-AL BRÉCK,Veloh | #00007-ROUSEGAERTCHEN,Veloh | #00008-METZER PLAZ,Veloh | #00009-CONVICT,Veloh | #00010-MÄRELER PARC,Veloh | #00011-WINSTON CHURCHILL,Veloh | #00013-GELLE FRA,Veloh | #00014-KNUEDLER,Veloh | #00015-THEATER PLAZ,Veloh | #00016-AMELIE,Veloh | #00017-ROBERT SCHUMAN,Veloh | #00018-CAMPUS LAMPERTSBIERG,Veloh | #00019-PHILHARMONIE,Veloh | #00020-COQUE,Veloh | #00021-JEAN MONNET,Veloh | #00022-CAMPUS KIRCHBIERG,Veloh | #00023-REIMERWEE,Veloh | #00024-WEICKER,Veloh | #00025-KIEM,Veloh | #00026-HOLLERECHER PLAZ,Veloh | #00027-MERCIER,Veloh | #00028-CHARLY'S GARE,Veloh | #00029-MONTEREY,Veloh | #00030-MERKELS PLAZ,Veloh | #00031-PLACE DE FRANCE,Veloh | #00032-PISCINE OLYMPIQUE,Veloh | #00033-K. ADENAUER,Veloh | #00034-KOLLEISCH,Veloh | #00035-GASTON DIDERICH,Veloh | #00036-J.B. GELLE,Veloh | #00037-GAULOIS,Veloh | #00038-HELLEG GEESCHT,Veloh | #00039-KRAIZGRENNCHEN,Veloh | #00040-GLACIS KAPELL,Veloh | #00041-PLACE LAURENT,Veloh | #00042-SQUARE ANDRE,Veloh | #00043-LYCEE TECHNIQUE DE BONNEVOIE,Veloh | #00044-ARELER STROOSS,Veloh | #00045-AUBEPINES,Veloh | #00046-LONKECHER STROOSS,Veloh | #00047-LEOPOLD GOEBEL,Veloh | #00048-BGL BNP PARIBAS,Veloh | #00049-MARGUERITES,Veloh | #00050-EUROPAPARLAMENT,Veloh | #00051-SAUERWISS,Veloh | #00052-BEI DER AUER,Veloh | #00053-LUDWIG VAN BEETHOVEN,Veloh | #00054-CLOCHE D' OR,Veloh | #00055-SCHAARFEN ECK,Veloh | #00056-FISCHERHAFF,Veloh | #00057-BOUILLON,Veloh | #00058-SCHLUECHTHAUS,Veloh | #00059-ST HUBERT,Veloh | #00060-BOCH,Veloh | #00061-FRIEDEN,Veloh | #00062-LEYDENBACH,Veloh | #00063-LABOURS,Veloh | #00064-GRENIER,Veloh | #00065-BEI DER SCHOUL,Veloh | #00066-BEIM TENNIS,Veloh | #00067-MAIRIE DE HESPERANGE,Veloh | #00068-UM SCHLASS,Veloh | #00069-UM REIMERWEE,Veloh | #00070-GEMENG STROOSSEN,Veloh | #00071-LES THERMES,Veloh | #00072-AN DER BOURMICHT,Veloh | #00073-JEANNE D'ARC,Veloh | #00074-SAINTE CUNEGONDE,Veloh | #00075-BEINCHEN,Veloh | #00076-SAUVAGE,Veloh | #00077-FUNICULAIRE,Veloh | #00078-ST MATHIEU,Veloh | #00080-INS,Veloh | #00081-CARMEL,Veloh | #00083-PULVERMÜHL,Veloh | #00084-BITBOURG,Veloh | #00085-EINSTEIN,Veloh | #00086-PWC - BD KOCKELSCHEUER,Veloh | #00089-PLACE THORN,Veloh | #00090-HUBERTY (MÜHLENBACH),Veloh | #00091-MERSCH (MÜHLENBACH),Veloh | #00092-BRILL (CESSANGE),Veloh | #00093-GODCHAUX (BONNEVOIE),Veloh | #00094-HAMM-COLONIE,Veloh | #00095-MAIRIE DE BERTRANGE,Veloh | TEST PLAISIR 2,Venezia | C.so del Popolo,Venezia | Candiani,Venezia | Carbonifera,Venezia | Castellana A,Venezia | Cialdini,Venezia | Circonvallazione,Venezia | Da Vinci,Venezia | Malamocco,Venezia | Municipio,Venezia | Palazzo del Cinema,Venezia | San Girolamo,Venezia | San Giuliano,Venezia | Santa Maria Elisabetta,Venezia | Santa Maria dei Battuti,Venezia | Sicilia,Venezia | Stazione F.S.,Venezia | Stazione FS 2,Venezia | Ulloa FS,Venezia | Universita`,Vercelli | Ferrovia,Vercelli | Mazzini,Vercelli | Ospedale S. Andrea,Vercelli | Paietta,Vercelli | Park Garrone,V³ | Allees de Chartres,V³ | Arena,V³ | Arts et Metiers,V³ | Barriere St Genes,V³ | Barriere St Medard,V³ | Barriere de Begles,V³ | Barriere de Pessac,V³ | Barriere de Toulouse,V³ | Barriere du Medoc,V³ | Bassins a flot,V³ | Begles Poste,V³ | Belcier,V³ | Berges de Garonne,V³ | Bergonie,V³ | Bougnard,V³ | Bourranville,V³ | Bruges Hotel de Ville,V³ | Bruges La Vache,V³ | Buttiniere,V³ | CAPC,V³ | CREPS,V³ | Camille Godard,V³ | Camping International,V³ | Capucins,V³ | Castaing,V³ | Cauderan,V³ | Cenon Gare,V³ | Centre Commercial St Medard,V³ | Centre commercial du Lac,V³ | Charles Perrens,V³ | Chartrons,V³ | Cite Administrative,V³ | Claveau,V³ | Compostelle,V³ | Conservatoire,V³ | Cours Le Rouzic,V³ | Cours St Louis Medoc,V³ | Cours de la Somme,V³ | Cours du Medoc,V³ | Darwin,V³ | Doyen Brus,V³ | Dravemont,V³ | Dubreuil Turenne,V³ | Ecole de Management,V³ | Eglise St Aubin,V³ | Eglise St Louis,V³ | Eglise Ste Croix,V³ | Feydeau,V³ | Fontaine d'Arlac,V³ | Forum,V³ | France Alouette,V³ | Francois Mitterrand,V³ | Francois de Sourdis,V³ | Galin,V³ | Gambetta mobile,V³ | Gare Pessac Alouette,V³ | Gare St Jean,V³ | Gare d'Orleans,V³ | Gare de Begles,V³ | Gare de Blanquefort,V³ | Gavinies,V³ | Grand Lebrun,V³ | Grand Parc,V³ | Grand Theatre,V³ | Grosse Cloche,V³ | Hopital Haut Leveque,V³ | Hopital Pellegrin,V³ | Hopital Robert Picque,V³ | Hotel de Ville,V³ | Hotel de Ville Merignac,V³ | Huguerie,V³ | Jardin Botanique,V³ | Jardin Public,V³ | Jean Jaures,V³ | Jean Moulin,V³ | Jean Zay,V³ | Kennedy Parc Hotelier,V³ | La Benauge,V³ | La Chataigneraie,V³ | La Cite du Vin,V³ | La Gardette,V³ | Lauriers,V³ | Le Bouscat Mairie,V³ | Le Burck,V³ | Le Haillan Rostand,V³ | Le Taillan Mairie,V³ | Les Aubiers,V³ | Les Hangars,V³ | Les Pins,V³ | Liberation,V³ | Lucien Faure,V³ | Lycee Bremontier,V³ | Lycee Vaclav Havel,V³ | Magendie,V³ | Mairie du Haillan,V³ | Mandron Godard,V³ | Medoquine,V³ | Meriadeck,V³ | Merignac Capeyron,V³ | Merignac Centre,V³ | Merignac Quatre Chemins,V³ | Merignac Soleil,V³ | Montaigne Montesquieu,V³ | Musee Mer Marine,V³ | Musee d'Aquitaine,V³ | Palais Gallien,V³ | Palais de Justice,V³ | Palais des Congres,V³ | Parc Bordelais,V³ | Parc Riviere,V³ | Parc Sourreil,V³ | Parc aux Angeliques,V³ | Parc des Expositions,V³ | Parc des Sports,V³ | Patinoire,V³ | Peixotto,V³ | Pessac Bersol,V³ | Pessac Centre,V³ | Pins Francs,V³ | Piscine Judaique,V³ | Place Amedee Larrieu,V³ | Place Ampere,V³ | Place Bernard Roumegoux,V³ | Place Florale,V³ | Place Jean Jaures,V³ | Place Mondesir,V³ | Place Paul Doumer,V³ | Place Ravezies,V³ | Place St Martial,V³ | Place St Michel,V³ | Place St Projet,V³ | Place Ste Eulalie,V³ | Place de Longchamps,V³ | Place de l'Europe,V³ | Place de la Bourse,V³ | Place de la Victoire,V³ | Place du 14 juillet,V³ | Place du Maucaillou,V³ | Place du Palais,V³ | Pont de la Maye,V³ | Porte de Bourgogne,V³ | Puy Paulin,V³ | Quai de Paludate,V³ | Quinconces,V³ | Republique,V³ | Rue Achard,V³ | Rue Paulin,V³ | Rue St Vincent de Paul,V³ | Rue de la Croix Blanche,V³ | Rue du Mirail,V³ | Sacre Coeur,V³ | Square Andre Lhote,V³ | St Augustin,V³ | St Bruno,V³ | St Louis Haussmann,V³ | St Medard Republique,V³ | St Nicolas,V³ | St Paul,V³ | St Seurin,V³ | Stade Chaban Delmas,V³ | Stalingrad,V³ | Terres Neuves,V³ | Thouars,V³ | Tivoli,V³ | Village 6 IUT,V³ | Xaintrailles,Vél'in | 01 : Lafayette,Vél'in | 02 : Théatre,Vél'in | 03 : Hôtel de ville,Vél'in | 04 : Gare SNCF,Vél'in | 05 : Richelieu,Vél'in | 06 : Place d'Armes,Vél'in | 07 : Pluviose,Vél'in | 08 : Milieu de digue,Vél'in | 09 : Eglise de Blériot,Vél'in | 10 : Camping de Blériot,Vél'in | 11 : Base de voile,Vél'in | 12 : CC La Française,Vél'in | 13 : Pôle administratif,Vél'in | 14 : Cité de la dentelle,Vél'in | 15 : Université,Vél'in | 16 : Lycée Berthelot,Vél'in | 17 : Mogador,Vél'in | 18 : Piscine patinoire Icéo,Vél'in | 19 : Matelote,Vél'in | 20 : IUT,Vél'in | 21 : Coubertin,Vél'in | 22 : Diderot,Vél'in | 23 : Condorcet,Vél'in | 24 : Nation,Vél'in | 25 : Copernic,Vél'in | 26 : Joffre,Vél'in | 27 : Montréal,Vél'in | 28 : Coquelles - Charles de Gaulle,Vél'in | 29 : Sangatte - Mairie,Vél'in | 30 : Coulogne - Eglise,Vél'in | 31 : Coulogne - Marronniers,Vél'in | 32 : Marck - Mairie,Vél'in | 33 : Marck - Stade,Vél'in | 34 : Marck - Schweitzer,Vél'in | 35 : Hôpital,Vél'in | 36 : Conservatoire,Vél'in | 37 : Marcel Doret,Vél'in | 38 : Dryades,Vél'in | 39 :  Gare des Fontinettes,Vél'in | 40 : Camping de Calais,Vél'in | 41 : Quai de la Loire,Vél'in | 42 : Terminal Transmanche,Vél'in | 43 : Gavet,Vélo Bleu | Station n°001,Vélo Bleu | Station n°003,Vélo Bleu | Station n°004,Vélo Bleu | Station n°006,Vélo Bleu | Station n°007,Vélo Bleu | Station n°008,Vélo Bleu | Station n°010,Vélo Bleu | Station n°011,Vélo Bleu | Station n°012,Vélo Bleu | Station n°013,Vélo Bleu | Station n°014,Vélo Bleu | Station n°015,Vélo Bleu | Station n°016,Vélo Bleu | Station n°017,Vélo Bleu | Station n°018,Vélo Bleu | Station n°019,Vélo Bleu | Station n°020,Vélo Bleu | Station n°021,Vélo Bleu | Station n°022,Vélo Bleu | Station n°023,Vélo Bleu | Station n°024,Vélo Bleu | Station n°025,Vélo Bleu | Station n°026,Vélo Bleu | Station n°029,Vélo Bleu | Station n°030,Vélo Bleu | Station n°031,Vélo Bleu | Station n°032,Vélo Bleu | Station n°033,Vélo Bleu | Station n°034,Vélo Bleu | Station n°035,Vélo Bleu | Station n°036,Vélo Bleu | Station n°037,Vélo Bleu | Station n°038,Vélo Bleu | Station n°039,Vélo Bleu | Station n°041,Vélo Bleu | Station n°042,Vélo Bleu | Station n°043,Vélo Bleu | Station n°044,Vélo Bleu | Station n°045,Vélo Bleu | Station n°046,Vélo Bleu | Station n°047,Vélo Bleu | Station n°048,Vélo Bleu | Station n°049,Vélo Bleu | Station n°050,Vélo Bleu | Station n°051,Vélo Bleu | Station n°052,Vélo Bleu | Station n°053,Vélo Bleu | Station n°054,Vélo Bleu | Station n°055,Vélo Bleu | Station n°056,Vélo Bleu | Station n°057,Vélo Bleu | Station n°058,Vélo Bleu | Station n°059,Vélo Bleu | Station n°060,Vélo Bleu | Station n°061,Vélo Bleu | Station n°062,Vélo Bleu | Station n°063,Vélo Bleu | Station n°064,Vélo Bleu | Station n°065,Vélo Bleu | Station n°066,Vélo Bleu | Station n°067,Vélo Bleu | Station n°068,Vélo Bleu | Station n°069,Vélo Bleu | Station n°070,Vélo Bleu | Station n°071,Vélo Bleu | Station n°072,Vélo Bleu | Station n°073,Vélo Bleu | Station n°074,Vélo Bleu | Station n°075,Vélo Bleu | Station n°076,Vélo Bleu | Station n°077,Vélo Bleu | Station n°078,Vélo Bleu | Station n°079,Vélo Bleu | Station n°080,Vélo Bleu | Station n°081,Vélo Bleu | Station n°082,Vélo Bleu | Station n°083,Vélo Bleu | Station n°084,Vélo Bleu | Station n°085,Vélo Bleu | Station n°086,Vélo Bleu | Station n°087,Vélo Bleu | Station n°088,Vélo Bleu | Station n°089,Vélo Bleu | Station n°090,Vélo Bleu | Station n°091,Vélo Bleu | Station n°092,Vélo Bleu | Station n°096,Vélo Bleu | Station n°097,Vélo Bleu | Station n°098,Vélo Bleu | Station n°099,Vélo Bleu | Station n°100,Vélo Bleu | Station n°101,Vélo Bleu | Station n°102,Vélo Bleu | Station n°104,Vélo Bleu | Station n°105,Vélo Bleu | Station n°106,Vélo Bleu | Station n°107,Vélo Bleu | Station n°108,Vélo Bleu | Station n°109,Vélo Bleu | Station n°110,Vélo Bleu | Station n°111,Vélo Bleu | Station n°112,Vélo Bleu | Station n°113,Vélo Bleu | Station n°114,Vélo Bleu | Station n°115,Vélo Bleu | Station n°116,Vélo Bleu | Station n°117,Vélo Bleu | Station n°118,Vélo Bleu | Station n°121,Vélo Bleu | Station n°122,Vélo Bleu | Station n°123,Vélo Bleu | Station n°124,Vélo Bleu | Station n°125,Vélo Bleu | Station n°126,Vélo Bleu | Station n°127,Vélo Bleu | Station n°128,Vélo Bleu | Station n°129,Vélo Bleu | Station n°130,Vélo Bleu | Station n°132,Vélo Bleu | Station n°134,Vélo Bleu | Station n°135,Vélo Bleu | Station n°136,Vélo Bleu | Station n°137,Vélo Bleu | Station n°148,Vélo Bleu | Station n°149,Vélo Bleu | Station n°150,Vélo Bleu | Station n°151,Vélo Bleu | Station n°152,Vélo Bleu | Station n°153,Vélo Bleu | Station n°154,Vélo Bleu | Station n°155,Vélo Bleu | Station n°161,Vélo Bleu | Station n°162,Vélo Bleu | Station n°163,Vélo Bleu | Station n°164,Vélo Bleu | Station n°165,Vélo Bleu | Station n°167,Vélo Bleu | Station n°168,Vélo Bleu | Station n°171,Vélo Bleu | Station n°172,Vélo Bleu | Station n°173,Vélo Bleu | Station n°174,Vélo Bleu | Station n°201,Vélo Bleu | Station n°202,Vélo Bleu | Station n°203,Vélo Bleu | Station n°204,Vélo Bleu | Station n°205,Vélo Bleu | Station n°206,Vélo Bleu | Station n°208,Vélo Bleu | Station n°209,Vélo Bleu | Station n°210,Vélo Bleu | Station n°211,Vélo Bleu | Station n°212,Vélo Bleu | Station n°301,Vélo Bleu | Station n°302,Vélo Bleu | Station n°303,Vélo Bleu | Station n°304,Vélo Bleu | Station n°305,Vélo Bleu | Station n°308,Vélo Bleu | Station n°310,Vélo Bleu | Station n°311,Vélo Bleu | Station n°313,Vélo Bleu | Station n°314,Vélo Bleu | Station n°317,Vélo Bleu | Station n°320,Vélo Bleu | Station n°321,Vélo Bleu | Station n°323,Vélo Bleu | Station n°326,Vélo Bleu | Station n°327,Vélo Bleu | Station n°331,Vélo Bleu | Station n°332,Vélo Bleu | Station n°409,Vélo Bleu | Station n°414,Vélo Bleu | Station n°440,Vélo Bleu | Station n°443,Vélo Bleu | Station n°446,Vélo'V | 0-555 - ATELIER VÉLO'V,Vélo'V | 08060 - SANTY/BEAUVISAGE,Vélo'V | 10001 - IUT / FEYSSINE,Vélo'V | 10002 - INSA,Vélo'V | 10004 - TONKIN,Vélo'V | 10005 - BOULEVARD DU 11 NOVEMBRE,Vélo'V | 10006 - CHARPENNES,Vélo'V | 10007 - PIATON / CONDORCET,Vélo'V | 10008 - SALENGRO / VAILLANT,Vélo'V | 1001 - TERREAUX / TERME,Vélo'V | 10011 - GRATTE CIEL,Vélo'V | 10012 - ZOLA / FRANCE,Vélo'V | 10013 - CUSSET,Vélo'V | 10014 - GARE L. BONNEVAY,Vélo'V | 10016 - PLACE DE LA PAIX,Vélo'V | 10018 - TOLSTOÏ / FLORIAN,Vélo'V | 10019 - RACINE,Vélo'V | 10021- GRANDCLÉMENT,Vélo'V | 10024 - MAISONS NEUVES,Vélo'V | 10025 - TOTEM,Vélo'V | 10027 - MAIRIE DE VILLEURBANNE,Vélo'V | 10028 - ECOLE DE MUSIQUE,Vélo'V | 1003 - PLACE SATHONAY,Vélo'V | 10030 - GREUZE,Vélo'V | 10031 - CROIX LUIZET,Vélo'V | 10032 - PRIMAT / DECORPS,Vélo'V | 10034 - DOCTEUR DAMIDOT,Vélo'V | 10035 - BOIRON GRANGÉ,Vélo'V | 10036 - STALINGRAD,Vélo'V | 10038 - CONDORCET,Vélo'V | 10039 - BOUVIER,Vélo'V | 10041 - KIMMERLING,Vélo'V | 10043 - SALENGRO / FEYSSINE,Vélo'V | 10047 - LHERMINIER/PRESSENSÉ,Vélo'V | 10048 - PLACE MARENGO,Vélo'V | 10049 - PRESSENSÉ,Vélo'V | 1005 - MEISSONNIER,Vélo'V | 10053 - ROSSELINI / 11 NOVEMBRE,Vélo'V | 10054 - STALINGRAD / MELIÈS,Vélo'V | 10055 - CONDORCET / GALLINE,Vélo'V | 10056 - 11 NOVEMBRE / GASTON BERGER,Vélo'V | 10058 - MÉTRO FLACHET,Vélo'V | 10059 - ANATOLE FRANCE / ZOLA,Vélo'V | 10060 - SAINT EXUPÉRY,Vélo'V | 10061 - RÉPUBLIQUE,Vélo'V | 10063 - PERRIN / JEAN JAURÈS,Vélo'V | 10064 - 4 AOÛT 1789,Vélo'V | 10071 - LYCÉE MARIE CURIE,Vélo'V | 10072 - JACQUES BREL,Vélo'V | 10073 - INSTITUT D'ART CONTEMPORAIN,Vélo'V | 10074 - ZOLA / PASSAGE REY,Vélo'V | 10075 - GABRIEL PÉRI,Vélo'V | 10079 - ANATOLE FRANCE / BARBUSSE,Vélo'V | 10080 - VAILLANT / PERRONCEL,Vélo'V | 10083 - CHATEAU GAILLARD / BIENVENUS,Vélo'V | 10084 - DOUA / AVENUE DES ARTS,Vélo'V | 10086 - ANATOLE FRANCE,Vélo'V | 10087 - BARATIN,Vélo'V | 10088 - 4 AOÛT 1789 / PRESSENSÉ,Vélo'V | 10089 - COLIN / PERRONCEL,Vélo'V | 10091 - CHÂTEAU GAILLARD / FORT,Vélo'V | 10092 - MONTGOLFIER / CHATEAU GAILLARD,Vélo'V | 10101 - EINSTEIN / BOULEVARD DU 11 NOVEMBRE,Vélo'V | 10102 - DOUA / G. BERGER,Vélo'V | 10103 - DOUA / RUE DES SPORTS,Vélo'V | 10110 - MÉMOIRE ET SOCIÉTÉ,Vélo'V | 10111 - CHARLES HERNU,Vélo'V | 10112 - PLACE DE LA RECONNAISSANCE,Vélo'V | 10113 - GARE DE VILLEURBANNE,Vélo'V | 10114 - BEL AIR / LES BROSSES,Vélo'V | 10115 - PLACE D'ESPAGNE / STADE KRUGER,Vélo'V | 10116 - BLUM / FAYS,Vélo'V | 10117 - LA PERALLIÈRE,Vélo'V | 10118 - VOYANT / CHAMBORD,Vélo'V | 10119 - VILLEURBANNE SAINT JEAN,Vélo'V | 1012 - AMPÈRE / BOURSE,Vélo'V | 10120 - SALENGRO / DESCARTES,Vélo'V | 10121 - PARC DU CENTRE,Vélo'V | 10122 - VERDUN / DESGRAND,Vélo'V | 1013 - MARTINIÈRE,Vélo'V | 1016 - PÊCHERIE,Vélo'V | 1020 - TERREAUX / CHENAVARD,Vélo'V | 1021 - TERREAUX / BEAUX ARTS,Vélo'V | 1022 - PLACE TOLOZAN,Vélo'V | 1023 - CROIX ROUSSE / PERFETTI,Vélo'V | 1024 - ROUVILLE,Vélo'V | 1031 - PLACE DE LA PAIX,Vélo'V | 1032 - PIZAY,Vélo'V | 1034 - CARMÉLITES,Vélo'V | 1035 - QUAI LASSAGNE,Vélo'V | 1036 - AVEYRON,Vélo'V | 11001 - GARE DE CUIRE,Vélo'V | 11002 - SAINT CLAIR,Vélo'V | 11003 - LA ROCHETTE,Vélo'V | 11005 - PASSERELLE DE LA PAIX,Vélo'V | 12001 - LA SOIE,Vélo'V | 12002 - POUDRETTE LA SOIE,Vélo'V | 17002 - PLACE DES 4 CHEMINS,Vélo'V | 2001 - BELLECOUR / RÉPUBLIQUE,Vélo'V | 2002 - BELLECOUR / ST EXUPÉRY,Vélo'V | 2003 - PLACE AMPÈRE,Vélo'V | 2004 - PERRACHE / CARNOT,Vélo'V | 2005 - CONFLUENCE HÔTEL DE RÉGION,Vélo'V | 2006 - PLACE DE L'HIPPODROME,Vélo'V | 2007 - PATINOIRE CHARLEMAGNE,Vélo'V | 2008 - PLACE ANTONIN PONCET,Vélo'V | 2009 - CONFLUENCE DOCKS,Vélo'V | 2010 - CONFLUENCE DARSE,Vélo'V | 2011 - SALA / RUE DU PLAT,Vélo'V | 2012 - GAILLETON,Vélo'V | 2013 - CÉLESTINS,Vélo'V | 2014 - JACOBINS,Vélo'V | 2015 - PLACE DE LA RÉPUBLIQUE / STELLA,Vélo'V | 2016 - PLACE REGAUD,Vélo'V | 2017 - RÉPUBLIQUE / FERRANDIÈRE,Vélo'V | 2020 - MUSEE DES CONFLUENCES,Vélo'V | 2022 - PLACE CARNOT,Vélo'V | 2024 - RÉPUBLIQUE / MAUPIN,Vélo'V | 2025 - MERCIÈRE / FERRANDIÈRE,Vélo'V | 2026 - RÉPUBLIQUE / PAUFIQUE,Vélo'V | 2028- SAINTE BLANDINE,Vélo'V | 2030 - RÉPUBLIQUE / POULAILLERIE,Vélo'V | 2035 - CHILDEBERT / RIVIÈRE,Vélo'V | 2036 - PLACE GOURJU,Vélo'V | 2037 - PLACE DES ARCHIVES,Vélo'V | 2039 - CHARITÉ / RÉCAMMIER,Vélo'V | 2041 - SALA / CHARITE,Vélo'V | 2042 - JOFFRE / VAUBECOUR,Vélo'V | 3003 - PART-DIEU / DERUELLE,Vélo'V | 3004 - BOURSE DU TRAVAIL,Vélo'V | 3005 - SAXE-GAMBETTA,Vélo'V | 3006 - VILLETTE ANTOINE,Vélo'V | 3007 - PLACE D'ARSONVAL,Vélo'V | 3008 - INSTITUT LUMIERE,Vélo'V | 3009 - MUSEE AFRICAIN,Vélo'V | 3011 - PART DIEU / CUIRASSIERS,Vélo'V | 3012 - PLACE DU CHÂTEAU,Vélo'V | 3013 - PLACE ANTOINETTE,Vélo'V | 3015 - SERVIENT / GARIBALDI,Vélo'V | 3016 - LIBERTÉ / PART-DIEU,Vélo'V | 3018 - CRÉQUI / VOLTAIRE,Vélo'V | 3021 - PLACE DE LA FERRANDIÈRE,Vélo'V | 3024 - ROCKEFELLER / ESQUIROL,Vélo'V | 3029 - PLACE ARISTIDE BRIAND,Vélo'V | 3031 - CORNEILLE / SERVIENT,Vélo'V | 3036 - FELIX FAURE / VIVIER MERLE,Vélo'V | 3037 - PAUL BERT / GARIBALDI,Vélo'V | 3038 - VIVIER MERLE / PAUL BERT,Vélo'V | 3039 - PLACE BIR-HAKEIM,Vélo'V | 3043 - PLACE ROUGET DE L'ISLE,Vélo'V | 3044 - QUAI AUGAGNEUR,Vélo'V | 3050 - FRICHE RVI,Vélo'V | 3051 - PLACE HENRI,Vélo'V | 3053 - GAMBETTA / JUSSERAND,Vélo'V | 3058 - PLACE DU LAC,Vélo'V | 3067 - HACHETTE,Vélo'V | 3069 - DAUPHINE MAXIMIN,Vélo'V | 3071 - BIOPARC,Vélo'V | 3079 - PLACE LOUISE,Vélo'V | 3080 - PART-DIEU / VILLETTE,Vélo'V | 3081 - PART-DIEU / FRANCFORT,Vélo'V | 3082 - PLACE BAHADOURIAN,Vélo'V | 3083 - LES HALLES,Vélo'V | 3084 - DESAIX,Vélo'V | 3085 - SACRE COEUR,Vélo'V | 3086 - FEUILLAT / LACASSAGNE,Vélo'V | 3087 - PART-DIEU / GARIBALDI,Vélo'V | 3088 - PLACE GUICHARD,Vélo'V | 3089 - TRARIEUX / LACASSAGNE,Vélo'V | 3090 - VINATIER,Vélo'V | 3091 - HOPITAL NEUROLOGIQUE,Vélo'V | 3094 - VILLETTE,Vélo'V | 3097 - AUGAGNEUR / FOSSE AUX OURS,Vélo'V | 3099 - PLACE SAINTE ANNE,Vélo'V | 3100 - SISLEY / DAUPHINE,Vélo'V | 3101 - PATINOIRE BARABAN,Vélo'V | 3102 - DR LONG / AUBEPINS,Vélo'V | 3103 - PLACE DANTON,Vélo'V | 4001 - CONSERVATOIRE BIS,Vélo'V | 4002 - MAIRIE DU 4°,Vélo'V | 4003- PLACE COMMANDANT  ARNAUD,Vélo'V | 4004 - HÉNON,Vélo'V | 4005 - PLACE BERTONE,Vélo'V | 4007 - PLACE FLAMMARION,Vélo'V | 4009 - JACQUARD / DENFERT-ROCHEREAU,Vélo'V | 4011 - PLACE JEAN AMBRE,Vélo'V | 4012 - PLACE ADRIEN GODIEN,Vélo'V | 4014 - PHILIPPE DE LASSALLE / PILLEMENT,Vélo'V | 4017 - PLACE DES TAPIS,Vélo'V | 4021 - TABAREAU,Vélo'V | 4022 - PLACE DE LA CROIX-ROUSSE,Vélo'V | 4023 - PONT MAZARYK,Vélo'V | 4024 - LYON METROPOLE,Vélo'V | 4025 - CHAZIÈRE,Vélo'V | 4026 - BIRMINGHAM,Vélo'V | 4041 - BOUSSANGES / AUSTERLITZ,Vélo'V | 4042 - GREGORY COUPET,Vélo'V | 5001 - PLACE VARILLON (FUNICULAIRE ST JUST),Vélo'V | 5002 - PLACE DES COMPAGNONS DE LA CHANSON,Vélo'V | 5004 - SAINT JEAN,Vélo'V | 5005 - SAINT PAUL,Vélo'V | 5006 - QUAI ROMAIN ROLLAND,Vélo'V | 5007 - PLACE DE TRION,Vélo'V | 5008 - SAINTE IRÉNÉE,Vélo'V | 5009 - PLACE FOUSSERET,Vélo'V | 5015 - FULCHIRON,Vélo'V | 5016 - MAIRIE DU 5°,Vélo'V | 5026 - RUE DE LA BALEINE,Vélo'V | 5029 - PLACE GERSON,Vélo'V | 5030 - CHARCOT / RÉSIDENCE UNIVERSITAIRE,Vélo'V | 5031- MENIVAL/J.CURIE,Vélo'V | 5033 - BORNE TEST (VILLEURBANNE),Vélo'V | 5036 - LA SALETTE,Vélo'V | 5040 - PLACE CRÉPU,Vélo'V | 5041 - L'HOMME DE LA ROCHE,Vélo'V | 5044 - CHAMPVERT,Vélo'V | 5045 - VALDO / RIVET,Vélo'V | 5047 - ALBÉRIC PONT,Vélo'V | 5050 - THEATRE ROMAIN,Vélo'V | 5053 - SAINT JUST,Vélo'V | 5054 - CHAMPVERT,Vélo'V | 5055 - BUYER / APOLLINAIRE,Vélo'V | 6001 - GARE DES BROTTEAUX,Vélo'V | 6002 - PORTE DES ENFANTS DU RHÔNE,Vélo'V | 6003 - AVENUE VERGUIN,Vélo'V | 6004 - FOCH,Vélo'V | 6005 - PLACE EDGAR QUINET,Vélo'V | 6006 - BOULEVARD DES BELGES,Vélo'V | 6007 - MASSÉNA,Vélo'V | 6008 - PLACE JULES FERRY,Vélo'V | 6011- MAIRIE DU 6ÈME,Vélo'V | 6012 - PLACE PUVIS DE CHAVANNES,Vélo'V | 6020 - MUSÉE GUIMET,Vélo'V | 6021- GARIBALDI,Vélo'V | 6022- PLACE MARÉCHAL LYAUTEY,Vélo'V | 6023 - QUAI SARRAIL,Vélo'V | 6024 - TRONCHET / ANATOLE FRANCE,Vélo'V | 6025 - HELVETIE,Vélo'V | 6028 - RECAMMIER / TÊTE D'OR,Vélo'V | 6031 - LAFAYETTE/CORNEILLE,Vélo'V | 6032 - PRÉFECTURE / SARRAIL,Vélo'V | 6033 - CREQUI/LAFAYETTE,Vélo'V | 6035 - CITÉ INTERNATIONALE,Vélo'V | 6036 - MUSÉE D'ART CONTEMPORAIN,Vélo'V | 6037 - CITÉ INTERNATIONALE / INTERPOL,Vélo'V | 6040 - LES HALLES,Vélo'V | 6041 - CITÉ INTERNATIONALE / TÊTE D'OR NORD,Vélo'V | 6042 - CITÉ INTERNATIONALE - RÉSIDENCE HÔTELIÈRE,Vélo'V | 6043 - CITÉ INTERNATIONALE - CINÉMA,Vélo'V | 6044 - CHARMETTES / BELLECOMBE,Vélo'V | 6045 - BROTTEAUX / VAUBAN,Vélo'V | 7001 - PLACE GABRIEL PÉRI,Vélo'V | 7002 - UNIVERSITÉS LYON III / LYON II,Vélo'V | 7003 - GAMBETTA / GARIBALDI,Vélo'V | 7004 - MAIRIE DU 7ÈME,Vélo'V | 7005 - DEBOURG,Vélo'V | 7006 - GERLAND,Vélo'V | 7007 - FARGE / AYASSE,Vélo'V | 7008 - JEAN JAURÈS / GUILLOTIÈRE,Vélo'V | 7009 - JEAN JAURÈS,Vélo'V | 7010 - CENTRE BERTHELOT,Vélo'V | 7011 - BERTHELOT / GARIBALDI,Vélo'V | 7012 - PLACE DES PAVILLONS,Vélo'V | 7013 - HALLE TONY GARNIER,Vélo'V | 7014 - MARSEILLE / FÉLISSENT,Vélo'V | 7015 - TECHSUD,Vélo'V | 7016 - PLACE SAINT LOUIS,Vélo'V | 7018 - LYCEE LOUISE LABE,Vélo'V | 7020 - PARC DE GERLAND,Vélo'V | 7021- CHALLEMEL LACOUR / GERLAND,Vélo'V | 7022 - JAURÈS / LAGRANGE,Vélo'V | 7023 - BERTHELOT / ROUTE DE VIENNE,Vélo'V | 7024 - BANCEL / CHEVREUL,Vélo'V | 7030 - QUARTIER GENERAL FRERE,Vélo'V | 7031 - JAURÈS / GERLAND,Vélo'V | 7033 - ST LUC / ST JOSEPH,Vélo'V | 7034 - PISCINE DU RHÔNE,Vélo'V | 7035 - MARSEILLE / UNIVERSITÉ,Vélo'V | 7036 - THIBAUDIERE GRYPHE,Vélo'V | 7038 - PLACE STALINGRAD,Vélo'V | 7039 - GUILLOTIÈRE / MADELEINE,Vélo'V | 7041 - DOMER / CHEVREUL,Vélo'V | 7045 - PARC DES BERGES,Vélo'V | 7046 - PLACE DE L'ECOLE,Vélo'V | 7049 - CITÉ SCOLAIRE INTERNATIONALE,Vélo'V | 7052 - PARC BLANDAN,Vélo'V | 7053 - JAURÈS / THIBAUDIÈRE,Vélo'V | 7055 - SERVANT / JABOULAY,Vélo'V | 7056 - PLACE RASPAIL,Vélo'V | 7057 - JAURES / BOLLIER,Vélo'V | 7061 - JAURES / UNIVERSITE,Vélo'V | 7062 - GARIBALDI / DOMER,Vélo'V | 7064 - CROUS,Vélo'V | 8001 - UNIVERSITÉ LYON III,Vélo'V | 8002- PLACE AMBROISE COURTOIS,Vélo'V | 8003 - CLAUDE BERNARD LYON I,Vélo'V | 8004 - MAIRIE DU 8ÈME,Vélo'V | 8006 - PLACE DU 8 MAI 1945,Vélo'V | 8007 - FRÈRES LUMIÈRE,Vélo'V | 8008 - BEAUVISAGE / PRESSENSÉ,Vélo'V | 8009 - JEAN XXIII / MERMOZ,Vélo'V | 8010 - PLACE MENDÈS FRANCE,Vélo'V | 8011 - PLACE LEBRET,Vélo'V | 8015 - BOULEVARD JEAN XXIII,Vélo'V | 8020 - MOULIN A VENT,Vélo'V | 8021 - PAUL SANTY,Vélo'V | 8023 - MERMOZ PINEL,Vélo'V | 8024 - MERMOZ / MICHELET,Vélo'V | 8025 - DUMONT / JOUVET,Vélo'V | 8029 - ETATS UNIS LEVIGNE,Vélo'V | 8030 - LAËNNEC,Vélo'V | 8033 - BERTHELOT CAZENEUVE,Vélo'V | 8034 - BERTHELOT / VILLON,Vélo'V | 8035 - SANS SOUCI,Vélo'V | 8037 - CAZENEUVE,Vélo'V | 8038 - ALBERT THOMAS / VILLON,Vélo'V | 8039 - PIERRE DELORE,Vélo'V | 8040 - AMBROISE PARÉ,Vélo'V | 8041 - ETATS UNIS / VIVIANI,Vélo'V | 8042 - FRANCIS DE PRESSENSÉ,Vélo'V | 8050 - BATAILLE KRUGER,Vélo'V | 8051 - HÔPITAL ST JEAN DE DIEU,Vélo'V | 8052 - CLINIQUE MONPLAISIR,Vélo'V | 8053 - LUMIERE / TROUILHET,Vélo'V | 8054 - MARTINIERE MONPLAISIR,Vélo'V | 8056 - DELORE / AUDIBERT ET LAVIROTTE,Vélo'V | 8057 - VIENNE / MONTAGNY,Vélo'V | 8058 - LONGEFER / KRUGER,Vélo'V | 8059 - LAENNEC / PINEL,Vélo'V | 8061 - STADE VUILLERMET,Vélo'V | 9002 - MAIRIE DU 9°,Vélo'V | 9003 - PLACE VALMY,Vélo'V | 9004 - GARE DE VAISE,Vélo'V | 9006 - THÉÂTRE NOUVELLE GÉNÉRATION,Vélo'V | 9008 - L'ILE BARBE,Vélo'V | 9010 - PISCINE DE VAISE,Vélo'V | 9011 - CONSERVATOIRE,Vélo'V | 9013 - QUAI PAUL SÉDALLIAN,Vélo'V | 9014 - QUAI DU COMMERCE,Vélo'V | 9020 - BOURBONNAIS,Vélo'V | 9022 - RUE MASARYK / SAINT CYR,Vélo'V | 9029 - SAINT PIERRE DE VAISE,Vélo'V | 9032 - PLACE DU PORT MOUTON,Vélo'V | 9033 - GORGE DE LOUP,Vélo'V | 9040 - PLACE RHODIACETA,Vélo'V | 9041 - CARRET / SÉDALLIAN,Vélo'V | 9042 - VAISE DOCKS,Vélo'V | 9043 - MARIETTON OUEST,Vélo'V | 9044 - MASSET / SAINT PIERRE DE VAISE,Vélo'V | 9049 - SERGENT BERTHET / GORGE DE LOUP,Vélo'V | 9050 - ALLEE DE L'EUROPE,Vélo'V | 9051 - ANDREI SAKHAROV,Vélo'V | 9052 - BALMONT,VéloCité | 01 - GARE VIOTTE (CB),VéloCité | 01 - PARVIS DE LA GARE,VéloCité | 02 - REPUBLIQUE,VéloCité | 02 - SQUARE BOUCHOT,VéloCité | 03 - MADELEINE (CB),VéloCité | 03 - PLACE DE LA CONCORDE,VéloCité | 04 - FLORE,VéloCité | 04 - PARC SALVATOR,VéloCité | 05 - ISEMBART,VéloCité | 05 - METZ,VéloCité | 06 - OFFICE DE TOURISME (CB),VéloCité | 06 - PORTE JEUNE,VéloCité | 07 - GARE MOUILLERE,VéloCité | 07 - MAIRIE,VéloCité | 08 - MARULAZ,VéloCité | 08 - PORTE HAUTE,VéloCité | 09 - LA CITY (CB),VéloCité | 09 - NESSEL,VéloCité | 10 - 8 SEPTEMBRE (CB),VéloCité | 10 - PLACE DE LA PAIX,VéloCité | 11 - JEAN CORNET,VéloCité | 11 - PLACE DU PRINTEMPS,VéloCité | 12 - GRANVELLE (CB),VéloCité | 12 - STALINGRAD,VéloCité | 13 - MARCHE,VéloCité | 13 - VICTOR HUGO,VéloCité | 14 - JACOBINS,VéloCité | 14 - SCHUMANN,VéloCité | 15 - GRAND REX,VéloCité | 15 - TASSIGNY,VéloCité | 16 - BEAUREGARD,VéloCité | 16 - PLACE FRANKLIN,VéloCité | 17 - PLACE DE LA REUNION,VéloCité | 17 - PREFECTURE,VéloCité | 18 - CLEMENCEAU,VéloCité | 18 - SAINT-JACQUES (CB),VéloCité | 19 - BEAUX-ARTS,VéloCité | 19 - LES TROIS ROIS,VéloCité | 20 - FILATURE,VéloCité | 20 - REVOLUTION,VéloCité | 21 - DEPORTES,VéloCité | 21 - FONDERIE,VéloCité | 22 - LIBERTE,VéloCité | 22 - ST SAUVEUR,VéloCité | 23 - HASENRAIN,VéloCité | 23 - RIVOTTE,VéloCité | 24 - MEDIATHEQUE,VéloCité | 24 - TIVOLI,VéloCité | 25 - MORAND,VéloCité | 25 - PALAIS DES SPORTS,VéloCité | 26 - BERSOT,VéloCité | 26 - GOERICH,VéloCité | 27 - CITE ADMINISTRATIVE,VéloCité | 27 - MAIRIE,VéloCité | 28 - LECLERC,VéloCité | 28 - SCHUMAN LEFEB,VéloCité | 29 - BELFORT,VéloCité | 29 - LAURENT,VéloCité | 30 -  HARDT,VéloCité | 30 - XAVIER MARMIER,VéloCité | 31 - KINEPOLIS,VéloCité | 32- CAMPUS,VéloCité | 33 - AUBERGE,VéloCité | 34 - PATINOIRE,VéloCité | 35 - EUROPE,VéloCité | 36 - MUSEE DE L'AUTO,VéloCité | 37 - TUNNEL,VéloCité | 38 - WANNE,VéloCité | 39 - PORTE DE RIEDISHEIM,VéloCité | 40 - GARE DE DORNACH,Vélopop | 01 Jaurès,Vélopop | 02 Place Pie,Vélopop | 03 Hôtel de Ville,Vélopop | 05 Carmes,Vélopop | 08 Porte de l'Oulle,Vélopop | 09 Porte Saint-Lazare,Vélopop | 11 Porte Limbert,Vélopop | 12 Porte Thiers,Vélopop | 13 Saint Ruf,Vélopop | 14 Maison pour tous,Vélopop | 15 Mairie Nord,Vélopop | 16 Rotondes,Vélopop | 17 Dunant,Vélopop | 24 Villeneuve,Vélopop | 26 Parking Piot,Vélopop | 28 Médiathèque,Vélopop | 29 Maria Casares,Vélopop | 30 Pamard,Vélô | 00001 - POIDS DE L'HUILE,Vélô | 00002 - LAFAYETTE,Vélô | 00003 - POMME,Vélô | 00004 - STE URSULE,Vélô | 00005 - LEDUC,Vélô | 00006 - LOIS,Vélô | 00007 - PLACE VICTOR HUGO,Vélô | 00008 - ESPACE SAINT GEORGES,Vélô | 00009 - MAILLART - ROQUEMAUREL,Vélô | 00010 - PLACE ESQUIROL,Vélô | 00011 - PLACE DE LA DAURADE,Vélô | 00012 - PARGAMINIERES,Vélô | 00013 - LOIS ESQUILE,Vélô | 00014 - PERIGORD,Vélô | 00015 - PONT MONTAUDRAN,Vélô | 00016 - STRASBOURG BAYARD,Vélô | 00017 - STRASBOURG SARDANE,Vélô | 00018 - STRASBOURG JEAN JAURES,Vélô | 00019 - CARNOT PERI,Vélô | 00020 - CARNOT TROIS JOURNEES,Vélô | 00021 - CARNOT LABEDA,Vélô | 00022 - CARNOT ROLAND,Vélô | 00023 - COMBATTANTS,Vélô | 00024 - PLACE SAINT ETIENNE,Vélô | 00025 - PLACE ROUAIX,Vélô | 00026 - DALBADE - DE GORSSE,Vélô | 00027 - QUAI DE TOUNIS,Vélô | 00028 - PLACE SAINT PIERRE,Vélô | 000288 - METZ - RUE DES MARCHANDS,Vélô | 00029 - VALADE,Vélô | 00030 - PLACE ANATOLE FRANCE,Vélô | 00031 - SALENQUES,Vélô | 00032 - MUSEE ST RAYMOND,Vélô | 00033 - BERALDI,Vélô | 00034 - SAINT LAZARE,Vélô | 00035 - PLACE JEANNE D'ARC,Vélô | 00036 - PLACE SCHUMAN,Vélô | 00037 - STE LUCIE,Vélô | 00038 - JAURES BACHELIER,Vélô | 00039 - PLACE DAMLOUP,Vélô | 00040 - COLOMBETTE,Vélô | 00041 - ST AUBIN CAMICHEL,Vélô | 00042 - DAURIAC ESCANDE,Vélô | 00043 - DUPUY,Vélô | 00044 - PALAIS NIEL,Vélô | 00045 - OZENNE,Vélô | 00046 - PLACE DES CARMES,Vélô | 00047 - NAZARETH LANGUEDOC,Vélô | 00048 - PLACE DU SALIN,Vélô | 00049 - COUTELIER - METZ,Vélô | 00050 - GARONNETTE,Vélô | 00051 - DUPORTAL BRIENNE,Vélô | 00052 - DUPORTAL CITE ADMIN.,Vélô | 00053 - PLACE SAINT JULIEN,Vélô | 00054 - CHAINE,Vélô | 00055 - ST SERNIN G. ARNOULT,Vélô | 00056 - SAINT SERNIN  MERLY,Vélô | 00057 - MERLY ARCOLE,Vélô | 00058 - CONCORDE ARCOLE,Vélô | 00059 - CONCORDE,Vélô | 00060 - ROQUELAINE,Vélô | 00062 - JAURES STALINGRAD,Vélô | 00063 - PISCINE LEO LAGRANGE,Vélô | 00064 - PERI MERCADIER,Vélô | 00065 - VERDIER - GRAND ROND,Vélô | 00066 - JARDIN ROYAL,Vélô | 00067 - MUSEUM,Vélô | 00068 - METRO - PALAIS DE JUSTICE,Vélô | 00069 - FEUGA,Vélô | 00070 - FER A CHEVAL,Vélô | 00071 - COURS DILLON,Vélô | 00072 - FITTE CUGNAUX,Vélô | 00073 - FITTE TEINTURIERS,Vélô | 00074 - LAGANNE TEINTURIERS,Vélô | 00075 - CHATEAU D EAU,Vélô | 00076 - REPUBLIQUE PL. OLIVIER,Vélô | 00077 - PLACE INT SAINT CYPRIEN,Vélô | 00078 - PLACE INT ST CYP. DARRE,Vélô | 00079 - PLACE LANGE,Vélô | 00080 - FITTE VARSI,Vélô | 00081 - JARDIN RAYMOND VI,Vélô | 00082 - SEJOURNE CATALANS,Vélô | 00083 - SEJOURNE AMIDONNIERS,Vélô | 00084 - BRIENNE MANUFACTURE,Vélô | 00085 - MARECHAL LECLERC,Vélô | 00086 - HERACLES - BEARNAIS,Vélô | 00087 - LASCROSSES LECLERC,Vélô | 00088 - DUPORTAL LASCROSSES,Vélô | 00089 - ESP COMPANS CAFFARELLI,Vélô | 00090 - LASCROSSES- A. BERNARD,Vélô | 00091 - ARCOLE BALANCE,Vélô | 00092 - CHALETS,Vélô | 00093 - PRINTEMPS,Vélô | 00094 - SEMARD GARE ROUTIERE,Vélô | 00095 - THEATRE GARONNE,Vélô | 00096 - MEDIATHEQUE,Vélô | 00097 - RAYMOND IV,Vélô | 00098 - PONT DES DEMOISELLES,Vélô | 00099 - REMPART ST ETIENNE,Vélô | 00100 - PORT ST SAUVEUR,Vélô | 00101 - CAPT PORT ST SAUVEUR,Vélô | 00102 -  MISTRAL - FLEURANCE,Vélô | 00103 - ST MICHEL ST CATHERINE,Vélô | 00104 - MURET BARTHERE,Vélô | 00105 - BILLIERE -CHAMPETRE,Vélô | 00106 - BRIENNE PASSERELLE,Vélô | 00107 - SEBASTOPOL,Vélô | 00108 - SEBASTOPOL - RITAY,Vélô | 00109 - METRO CANAL DU MIDI,Vélô | 00110 - CABANEL - SERRES,Vélô | 00111 - MINIMES PASSERELLE,Vélô | 00112 - PLACE RUSSELL - BRANLY,Vélô | 00113 - MUSEUM LAMARCK,Vélô | 00114 - BD MONTPLAISIR - CANAL,Vélô | 00115 - DEMOISELLES MISTRAL,Vélô | 00116 - ST MICHEL NOTRE DAME,Vélô | 00117 - BILLIERES -POSTE,Vélô | 00118 - PLACE DU BUSCA,Vélô | 00119 - CHAPOU,Vélô | 00120 - PONTS JUMEAUX,Vélô | 00121 - SERRES - A. BERNARD,Vélô | 00122 - PASSERELLE HAEDENS,Vélô | 00123 - CHAUSSAS EMBOUCHURE,Vélô | 00124 - EGLISE DES MINIMES,Vélô | 00125 - BARRIÈRE DE PARIS,Vélô | 00126 - ECOLE BONNEFOY,Vélô | 00127 - BEGUE - DEMOISELLES,Vélô | 00128 - PRISON ST MICHEL,Vélô | 00129 - CROIX DE PIERRE,Vélô | 00130 - BILLIERES - PATTE D OIE,Vélô | 00131 - BERNIES,Vélô | 00132 - MINIMES BILARD,Vélô | 00133 - MARCHE AUX COCHONS,Vélô | 00134 - EGLISE BONNEFOY,Vélô | 00135 - BONNEFOY   LEMAITRE,Vélô | 00136 - FONTAINES,Vélô | 00137 - BRUNHES-FONTAINES,Vélô | 00138 - BARRIERE DE BAYONNE,Vélô | 00139 - BARRIERE DE LOMBEZ,Vélô | 00140 - EMILE MALE,Vélô | 00141 - FONTAINE LESTANG,Vélô | 00142 - SEVERAC,Vélô | 00144 - SUISSE - LAUSANE,Vélô | 00145 - GOUNOD - GARROS,Vélô | 00146 - SANG DE SERP - DAGNAUX,Vélô | 00147 - CHAUSSAS - DAUDET,Vélô | 00148 - COLLIGNON,Vélô | 00149 - RAISIN MINIMES,Vélô | 00150 - CURIE CAMPISTRON,Vélô | 00151 - CURIE - NEGRENEYS,Vélô | 00152 - MAZADES,Vélô | 00153 - BOURGES MAUNOURY,Vélô | 00154 - GALLOIS,Vélô | 00155 - RECOLLETS,Vélô | 00156 - METRO EMPALOT,Vélô | 00157 - U.R.S.S  PEYROUSET,Vélô | 00158 - URSS ST THOMAS D AQUIN,Vélô | 00159 - U.R.S.S DEVIC,Vélô | 00160 - THEATRE JULES JULIEN,Vélô | 00161 - RANGUEIL - BEDOUCE,Vélô | 00162 - PLACE D'ITALIE,Vélô | 00163 - BEDOUCE / MIDI,Vélô | 00164 - BEDOUCE SAOUZELONG,Vélô | 00165 - PLACE DES AVIONS,Vélô | 00166 - RANGUEIL GUYOU,Vélô | 00167 - LAPUJADE-FLANDRES,Vélô | 00168 - BILA   /  ROUTE D ALBI,Vélô | 00169 - ALBI  / JAFFARY,Vélô | 00170 - ROUTE D ALBI   / CUVIER,Vélô | 00171 - ROUTE D ALBI / CACTUS,Vélô | 00172 - NETWILLER / LAFORGUE,Vélô | 00173 - MAUNOURY / SEGELA,Vélô | 00174 - MAUNOURY / MELA,Vélô | 00175 - METRO MAUNOURY,Vélô | 00176 - GENERAL COMPANS,Vélô | 00177 - BAILLAUD BRUNAUD,Vélô | 00178 - BRUNAUD / PLANA,Vélô | 00179 - CASSAING PLANA,Vélô | 00180 - PLACE SOUPETARD,Vélô | 00181 - PLANA GARNIER,Vélô | 00182 - CHAUBET,Vélô | 00183 - RUE DE CUGNAUX,Vélô | 00184 - MICHOUN,Vélô | 00185 - ROUBICHOU ARLES,Vélô | 00186 - DESBALS BOUALAM,Vélô | 00187 - DESBALS MONTDORE,Vélô | 00188 - MURET/LAFAGE,Vélô | 00189 - MURET BOUTINON,Vélô | 00190 - ESPAGNE LES OUSTALOUS,Vélô | 00191 - RUE DU 14 JUILLET,Vélô | 00192 - RTE DE ST SIMON/PRADO,Vélô | 00193 - LOMBEZ / PETITE VITESSE,Vélô | 00194 - LOMBEZ / HIPPODROME,Vélô | 00195 - LARROUSSE -RIEUX,Vélô | 00196 - GOUJON - GUILHEMERY,Vélô | 00197 - CASERNE PERIGNON,Vélô | 00198 - LAFILAIRE - DELTOUR,Vélô | 00199 - DELTOUR - RIEUX,Vélô | 00200 - PLACE DE L'ORMEAU,Vélô | 00201 - POTEZ -ST EXUPERY,Vélô | 00202 - ST EX. - COURREGE,Vélô | 00203 - ST EX. - PETIT PRINCE,Vélô | 00204 - PL. ROGER ARNAUD,Vélô | 00205 - COTTAGE/ RIEUX,Vélô | 00206 - LEYGUE/ RIEUX,Vélô | 00207 - CHRIST ROI,Vélô | 00208 - LIMAYRAC/ DARASSE,Vélô | 00209 - BAROUX/ DARASSE,Vélô | 00210 - TERRASSE/ CENTRE CO.,Vélô | 00211 - LE DORMEUR/ LA TERRASSE,Vélô | 00212 - CHAUMIERE/ CRETES,Vélô | 00213 - PUJOL/ CHAUBET,Vélô | 00214 - CASTRES/ ACHIARY,Vélô | 00215 - METRO ARGOULETS,Vélô | 00216 - ARGOULETS HOUDON,Vélô | 00217 - AMOUROUX/ ST TROPEZ,Vélô | 00218 - AMOUROUX /STE AUGUSTINE,Vélô | 00219 - PUCCINI/ BLAGNAC,Vélô | 00220 - TABAR /UNIVERSITE,Vélô | 00221 - VAUQUELIN,Vélô | 00222 - CAMBOU / ROCHE,Vélô | 00223 - ENAC,Vélô | 00224 - CAMPUS SUPAERO,Vélô | 00225 - BELIN ONERA,Vélô | 00226 - FONTAINES /CASSELARDIT,Vélô | 00227 - METRO UPS,Vélô | 00228 - METRO PHARMACIE,Vélô | 00229 - IUT RANGUEIL,Vélô | 00230 - RANGUEIL TRIPODE B,Vélô | 00231 - NARBONNE MARFAING,Vélô | 00232 - NARBONNE/ MIROUSE,Vélô | 00233 - NARBONNE /SAHUQUE,Vélô | 00234 - LOIN / RAYNAL,Vélô | 00235 - PAUL VERLAINE,Vélô | 00236 - TOEC / LEMIRE,Vélô | 00237 - CNRS,Vélô | 00238 - HERBETTES / BUTTE,Vélô | 00239 - LESPINET / HERBETTES,Vélô | 00240 - RTE DE BLAGNAC / JOB,Vélô | 00241 - ESPAGNE CHARPENTIER,Vélô | 00242 -  RAIMBAUD / COLETTE,Vélô | 00243 - ETATS-UNIS / FERRY,Vélô | 00244 - RENAN / VITRY,Vélô | 00245 - GRANDE BRETAGNE / BADIOU,Vélô | 00246 - WAGNER / JEAN BRUNHES,Vélô | 00247 - LAUNAGUET / AUDIBERT,Vélô | 00248 - BOUQUETINS/E. ROSTAND,Vélô | 00249 - CROIX DAURADE,Vélô | 00250 - 11 NOVEMBRE,Vélô | 00251 - BLUM / JOUHAUX,Vélô | 00252 - NEGRENEYS /CASENEUVE,Vélô | 00253 - ETATS-UNIS / ROBERT,Vélô | 00254 - LOT - VESTREPAIN,Vélô | 00255 - HENRI SELLIER,Vélô | 00256 - PLACE DE LA RONTONDE,Vélô | 00257 - CHATEAU DE L'HERS,Vélô | 00258 - CAMBARD,Vélô | 00259 - PLACE RICHE,Vélô | 00260 - DUCLOS - FRONTON,Vélô | 00261 - VAN DYCK - LAUNAGUET,Vélô | 00262 - ROND POINT CHEMIN DE BORDEROUGE,Vélô | 00263 - LYCEE POLYVALENT,Vélô | 00264 - LAFOURGUETTE,Vélô | 00265 - PASSAGE BORDELONGUE,Vélô | 00266 - TOURAINE,Vélô | 00267 - GONIN,Vélô | 00268 - PLACE BAYLAC,Vélô | 00269 - PLACE SAUVEGRAIN,Vélô | 00270 - SILVIO TRENTIN,Vélô | 00271 - ANCELY,Vélô | 00272 - ANDRE VASSEUR,Vélô | 00273 - PASSERIEU - ST SIMON,Vélô | 00274 - GALLIENI,Vélô | 00275 - PLACE DES PRADETTES,Vélô | 00276 - MARIN REBOUL,Vélô | 00277 - ZAMENHOF,Vélô | 00278 - ARENES ROMAINE,Vélô | 00279 - GUY ESPAGNO,Vélô | 00285 - METRO BALMA-GRAMONT,Vélô | 00287 - STADE ERNEST-WALLON STADE TOULOUSAIN,Vélô | 01033 - BORNE TEST BDX,Vélô | 280 - CHARBONNIERE,Vélô | 281 - NIEL,Vélô | 282 - RICHARD WAGNER,Vélô | 283 - PLACE MICOULEAU,WK-Bike | Admiralstrasse,WK-Bike | Am Dobben,WK-Bike | Am Speicher XI,WK-Bike | Am Waller Strandpark Waller Sand,WK-Bike | BSAG-Zentrum,WK-Bike | Bahnhof Blumenthal,WK-Bike | Bahnhof Bremen-Farge,WK-Bike | Bahnhof Dreye,WK-Bike | Bahnhof Kirchweyhe,WK-Bike | Bahnhof Mahndorf,WK-Bike | Bahnhof Sebaldsbrück,WK-Bike | Bahnhof Vegesack,WK-Bike | Bahnhof Walle,WK-Bike | Berliner Freiheit,WK-Bike | Caroline Henschel Strasse,WK-Bike | Die Sparkasse Bremen Mühlenviertel,WK-Bike | Domsheide,WK-Bike | Europahafen / Hansator,WK-Bike | Findorffmarkt,WK-Bike | Flughafen Bremen,WK-Bike | Freibad Weyhe,WK-Bike | Föhrenstraße,WK-Bike | GEWOBA | Heideplatz 1,WK-Bike | GEWOBA | Heinrich-Schulz 57,WK-Bike | GEWOBA | Kurt-Schumacher 11,WK-Bike | GEWOBA | Ludwig-Beck 2a,WK-Bike | GEWOBA | Wilh.-Liebknecht 1,WK-Bike | GOP / Steigenberger,WK-Bike | Gewerbegebiet Dreye-West III,WK-Bike | Golden City Hafenbar,WK-Bike | Gottfried-Menken-Str.,WK-Bike | Haltestelle Alfred-Faust-Str.,WK-Bike | Haltestelle Am Wall,WK-Bike | Haltestelle Borgfelder Allee,WK-Bike | Haltestelle Emmastr.,WK-Bike | Haltestelle Gastfeldstr.,WK-Bike | Haltestelle Gustavstrasse,WK-Bike | Haltestelle Huckelriede,WK-Bike | Haltestelle Lilienthal-Falkenberg,WK-Bike | Haltestelle Wartburgstraße,WK-Bike | Haltestelle Weserwehr,WK-Bike | Hauptbahnhof / Übersee Museum,WK-Bike | Hemmstrasse,WK-Bike | Henry-Wetjen-Platz,WK-Bike | Herdentor,WK-Bike | Humboldtstr. / Horner Straße,WK-Bike | Irgendwo Festival,WK-Bike | Jacobs University,WK-Bike | KAEFER Isoliertechnik,WK-Bike | Karl-Marx-Str. / Ohserstr.,WK-Bike | Konsul-Smidt-Str.,WK-Bike | Kunsthalle Bremen,WK-Bike | Landmark-Tower,WK-Bike | Langemarckstr. / Erlenstr.,WK-Bike | Marktplatz Kirchweyhe,WK-Bike | Martinianleger,WK-Bike | Meierei im Bürgerpark,WK-Bike | Mondelez Deutschland Services GmbH,WK-Bike | Mühlenfeldstr. / Rockwinkeler Heerstr.,WK-Bike | Neustadtswall,WK-Bike | Oberneulander Heerstr. / Rockwinkeler Heestr.,WK-Bike | P&R Sielhof,WK-Bike | Park Hotel,WK-Bike | Präsident-Kennedy-Platz,WK-Bike | Pusdorfer Marktplatz,WK-Bike | Rathaus Weyhe,WK-Bike | Rudolf-Alexander-Schröder Str.,WK-Bike | Schwachhauser Heerstr. / Kirchbachstr.,WK-Bike | Sielwallfähre,WK-Bike | Tabak Quartier,WK-Bike | Theater am Leibnizplatz,WK-Bike | Twiedelftsweg,WK-Bike | Uni Bremen,WK-Bike | Uni Bremen TAB,WK-Bike | Universum Bremen,WK-Bike | WESER-KURIER | Pressehaus,WK-Bike | Wachmannstr. / Hartwigstr.,WK-Bike | Waller Straße,WK-Bike | Weser-Stadion,WK-Bike | Woltmershauser Str.,WK-Bike | Wümme-Zeitung,WK-Bike | hanseWasser Bremen GmbH,WRM | Aleja Bielany,WRM | Aleja Hallera / Mielecka,WRM | Aleja Kromera,WRM | Bacciarellego,WRM | Bacciarellego / pętla autobusowa,WRM | Bardzka / Piękna,WRM | Bałtycka / Żmigrodzka,WRM | Berenta / Kasprowicza,WRM | Bezpieczna / Obornicka,WRM | Boguszowska / Kosmonautów,WRM | Borowska (Uniw. Szpital Kliniczny),WRM | Buforowa - Vivaldiego,WRM | Bystrzycka / Idzikowskiego,WRM | Centrum Handlowe Auchan Bielany,WRM | Czekoladowa / Wałbrzyska,WRM | Drobnera / Dubois,WRM | Drobnera / Plac Bema,WRM | Drzewieckiego / Dedala,WRM | Dworzec Główny,"WRM | Dworzec Główny, południe",WRM | Dyrekcyjna / Borowska (Wroclavia),WRM | Fabryczna / Wagonowa,WRM | Fabryczna  (WSB),WRM | Fosa Miejska ,WRM | Gliniana / Gajowa,WRM | Gorlicka / Litewska,WRM | Grabiszyńska / Aleja Hallera,WRM | Grabiszyńska / Magazynierska (Corte Verona),WRM | Grabiszyńska / Stalowa,WRM | Graniczna / Strzegomska,"WRM | Grochowa / Jemiołowa,",WRM | Grota-Roweckiego / Parafialna,WRM | Hallera / Odkrywców,WRM | Hermanowska / Kołobrzeska,WRM | Hubska / Prudnicka,WRM | Jagiełły / Dmowskiego,WRM | Jagodzińska / Buforowa,WRM | Janiszewskiego (PWr),WRM | Jedności Narodowej / Wyszyńskiego,WRM | Jerzmanowska,WRM | Joliot-Curie (Uwr),WRM | Kamienna / Borowska (Aquapark),WRM | Kamienna / Tomaszowska,WRM | Kamieńskiego / Jutrosińska,WRM | Karwińska / Opolska,WRM | Kasprowicza / Syrokomli,WRM | Kazimierza Wielkiego (Helios),WRM | Kiełczowska,WRM | Klecińska / Duńska,WRM | Komandorska / Kamienna,WRM | Komandorska / Sanocka,WRM | Konduktorska,"WRM | Kosmonautów / Fieldorfa, szpital wojewódzki",WRM | Kosmonautów / Glinianki / WUWA2,WRM | Koszarowa / UWr,WRM | Kozanowska / Pilczycka,WRM | Kołłątaja / Podwale,WRM | Kościuszki / Komuny Paryskiej / Zgodna,WRM | Kościuszki / Pułaskiego,WRM | Krakowska / Leroy Merlin,WRM | Kraszewskiego / Trzebnicka,WRM | Krucza / Mielecka / Stalowa,WRM | Krzycka / Aleja Karkonoska (Park Południowy),WRM | Krzywoustego - Rynek Psie Pole,WRM | Krzywoustego / Korona,WRM | Księgarska / Dekarska / Zduńska,WRM | Kurkowa / Dubois,WRM | Legnicka (Park Magnolia),WRM | Legnicka / Młodych Techników,WRM | Legnicka / Wejherowska,WRM | Legnicka / Zachodnia ,WRM | Leśnica - pętla tramwajowa,WRM | Lotnicza / Bajana,WRM | Lotnicza / Metalowców,WRM | Lotnicza / Na Ostatnim Groszu,WRM | Marca Polo (Olimpia Port),WRM | Maślicka / Stodolna,WRM | Mickiewicza / pętla tramwajowa,WRM | Miłoszycka / Swojczycka,WRM | Mińska / stanisławowska,WRM | Mościckiego (stacja kolejowa),WRM | Mościckiego / Chińska ,WRM | Mrągowska / Rolna,WRM | Młodych Techników,WRM | Na Grobli (PWr - Geocentrum),WRM | Na Ostatnim Groszu,WRM | Norwida / Wyspiańskiego (PWr),WRM | Nowowiejska / Górnickiego,WRM | Nowowiejska / Jedności Narodowej,WRM | Nowowiejska / Wyszyńskiego,WRM | Nyska / Jesionowa,WRM | Nyska / Piękna,WRM | Obornicka / Bałtycka,WRM | Okulickiego,WRM | Olszewskiego / Spółdzielcza,"WRM | Olszewskiego, pętla tramwajowa",WRM | Opolska / Siemianowicka,WRM | Opolska / pętla tramwajowa,WRM | Oporów (pętla tramwajowa),WRM | Osobowicka - pętla tramwajowa,WRM | Osobowicka / Ostrowska,"WRM | Paprotna / Obornicka, zajezdnia MPK",WRM | Partyzantów / Okrzei,WRM | Pereca / Grabiszyńska,WRM | Pełczyńska / stacja kolejowa,WRM | Piaskowa / św. Ducha,WRM | Pilczycka (Stadion Miejski),WRM | Pilczycka / Koszykarska,WRM | Pilczycka / Kozanowska,WRM | Plac Dominikański (Galeria Dominikańska),WRM | Plac Grunwaldzki (DS Ołówek),WRM | Plac Grunwaldzki / Polaka,WRM | Plac Jana Pawła II (Akademia Muzyczna),WRM | Plac Kościuszki (Renoma),WRM | Plac Legionów,WRM | Plac Powstańców Warszawy (Muzeum Narodowe),WRM | Plac Powstańców Śląskich,WRM | Plac Staszica,WRM | Plac Strzegomski / Poznańska,WRM | Plac Uniwersytecki (UWr),WRM | Plac Świętego Macieja / Trzebnicka,WRM | Poleska / Litewska,WRM | Poniatowskiego / Oleśnicka,WRM | Popowicka,WRM | Popowicka / Niedźwiedzia,WRM | Powstańcow Śląskich / Aleja Hallera,WRM | Powstańców Śląskich (Arkady Wrocławskie),WRM | Prochowicka / Dolnobrzeska,WRM | Promenady Wrocławskie,WRM | Przyjaźni,WRM | Przyjaźni / Karkonoska,WRM | Racławicka / Rymarska,WRM | Radeckiego / Marcinkowskiego (Uniw. Medyczny - CNIM),WRM | Reymonta / Kleczkowska,WRM | Robotnicza / Fabryczna,WRM | Rogowska / Zemska,WRM | Rondo Reagana,WRM | Rynek,WRM | Semaforowa,WRM | Sienkiewicza / Piastowska,WRM | Sienkiewicza / Wyszyńskiego,WRM | Skarbowców / Wietrzna,WRM | Solskiego / al. Piastów,WRM | Sołtysowicka / Redycka,WRM | Stabłowicka,WRM | Stabłowicka / Główna,WRM | Stacyjna (Dworzec Mikołajów),WRM | Strachocińska / Wieśniacza,WRM | Strachowskiego / Parafialna,WRM | Strzegomska / Estońska,WRM | Strzegomska / Rogowska,WRM | Szczęśliwa (Sky Tower),WRM | Szewska / Kazimierza Wielkiego ,WRM | Tarnogajska / Klimasa,WRM | Traktatowa (przystanek kolejowy),WRM | Traugutta / Kościuszki,WRM | Traugutta / Pułaskiego,WRM | Trymanda / Mińska,WRM | Tyrmanda / Trawowa,WRM | Waniliowa / Cynamonowa,WRM | Wałbrzyska - pętla tramwajowa,WRM | Wilanowska,WRM | Wita Stwosza / Szewska,WRM | Wojanowska / Arbuzowa,"WRM | Wrocław Leśnica, stacja kolejowa","WRM | Wrocław Stadion, stacja kolejowa",WRM | Wróblewskiego (Teki),WRM | Wróblewskiego (ZOO),WRM | Wyszyńskiego / Szczytnicka,WRM | Zachodnia / Poznańska,WRM | Zaporoska / Gajowicka,WRM | Zaporoska / Grabiszyńska,WRM | Zaporoska / Wielka / Krucza,WRM | Zatorska / Królewska - pętla MPK,WRM | Zwycięska / Agrestowa,WRM | Zwycięska / Ołtaszyńska,WRM | al. Armii Krajowej / Bardzka,WRM | al. Armii Krajowej / Borowska,WRM | al. Armii Krajowej / Tarnogajska,WRM | al. Brücknera / Kwidzyńska,WRM | al. Jana III Sobieskiego / stacja kolejowa,WRM | al. Karkonoska / Jeździecka,WRM | al. Kochanowskiego / Kopernika,WRM | al. Kochanowskiego / Śniadeckich ,WRM | al. Poprzeczna / stacja kolejowa,WRM | pl. Orląt Lwowskich,WRM | pl. Powstańców Wielkopolskich,WRM | Łukasiewicza / Smoluchowskiego (PWr),WRM | Ślężna / Aleja Wiśniowa,WRM | Ślężna / Kamienna (Uniw. Ekonomiczny),WRM | Ślężna / Skierniewicka,WRM | Ślężna / pętla tramwajowa,WRM | Średzka / Dolnobrzeska,WRM | Śrubowa / Strzegomska,WRM | Świdnicka / Piłsudskiego (Hotel Scandic),WRM | Świeradowska (Ferio Gaj ),WRM | Świeradowska / Krynicka,WRM | Żelazna / Pereca,WRM | Żernicka,WRM | Żeromskiego / Daszyńskiego,WRM | Żeromskiego / Kluczborska,WRM | Żmigrodzka / Broniewskiego,WRM | Żmigrodzka / Marino,Wavelo | 001 Plac Wszystkich Świętych,Wavelo | 002 Teatr Bagatela I,Wavelo | 003 Cracovia Błonia,Wavelo | 004 Plac Inwalidów,Wavelo | 005 Politechnika,Wavelo | 006 Dworzec Główny Wschód,Wavelo | 007 Rondo Mogilskie,Wavelo | 008 Rondo Grzegórzeckie I,Wavelo | 009 Miodowa,Wavelo | 010 Plac Bohaterów Getta,Wavelo | 011 Korona,Wavelo | 012 Plac Wolnica,Wavelo | 013 Poczta Główna,Wavelo | 014 Wawel,Wavelo | 015 Centrum Kongresowe ICE,Wavelo | 016 Szwedzka,Wavelo | 017 Jubilat,Wavelo | 018 Salwator,Wavelo | 019 Cichy Kącik,Wavelo | 020 Uniwersytet Pedagogiczny,Wavelo | 021 Łobzów PKP,Wavelo | 022 Nowy Kleparz,Wavelo | 023 Bratysławska,Wavelo | 024 Krowodrza Górka,Wavelo | 025 Mackiewicza,Wavelo | 026 Uniwersytet Rolniczy,Wavelo | 027 Wieczysta,Wavelo | 028 Rondo Kocmyrzowskie,Wavelo | 029 DH Wanda,Wavelo | 030 Rondo Czyżyńskie,Wavelo | 031 Azory,Wavelo | 032 Miasteczko Studenckie AGH,Wavelo | 033 Starowiślna,Wavelo | 035 Most Grunwaldzki,Wavelo | 036 Kościuszki,Wavelo | 037 Reymonta,Wavelo | 038 Czarnowiejska,Wavelo | 039 Kawiory,Wavelo | 040 AGH Czysta,Wavelo | 041 Rondo Hipokratesa,Wavelo | 042 Plac Bieńczycki,Wavelo | 043 Dunikowskiego,Wavelo | 044 Wiślicka,Wavelo | 045 Rondo Grzegórzeckie II,Wavelo | 046 Fabryka Schindlera,Wavelo | 047 Bronowice Małe,Wavelo | 048 Francesco Nullo,Wavelo | 049 Ofiar Dąbia,Wavelo | 050 Osiedle Zgody - UMK,Wavelo | 051 Hala Targowa,Wavelo | 052 Balicka Wiadukt,Wavelo | 053 Bronowice,Wavelo | 054 Prokocim Rynek,Wavelo | 055 Smoleńsk,Wavelo | 056 Garbarska,Wavelo | 057 Powstania Warszawskiego - UMK,Wavelo | 058 Grunwaldzka - UMK,Wavelo | 059 Rondo Dywizjonu 308,Wavelo | 060 Osiedle Kolorowe,Wavelo | 061 Galicyjska,Wavelo | 062 Plac Centralny,Wavelo | 063 Zdrowa,Wavelo | 064 Stradom II,Wavelo | 065 Reymonta - Kapitol,Wavelo | 066 Uniwersytet Ekonomiczny,Wavelo | 067 Cmentarz Rakowicki,Wavelo | 068 Miechowity,Wavelo | 069 Rondo Młyńskie,Wavelo | 070 Narzymskiego I,Wavelo | 071 Biprostal,Wavelo | 072 Urzędnicza,Wavelo | 073 Łobzowska,Wavelo | 074 Struga,Wavelo | 075 Zalew Nowohucki,Wavelo | 076 Żeromskiego,Wavelo | 077 Osiedle Na Skarpie,Wavelo | 078 Okulickiego,Wavelo | 079 Osiedle Piastów,Wavelo | 080 Teatr Bagatela II,Wavelo | 081 Krowoderska,Wavelo | 082 Racławicka,Wavelo | 083 Mazowiecka,Wavelo | 084 Wesele,Wavelo | 085 Prokocim Szpital,Wavelo | 086 Wrocławska,Wavelo | 087 Cmentarz Podgórski - UMK,Wavelo | 088 Kraków Płaszów,Wavelo | 089 Dauna,Wavelo | 090 Wlotowa,Wavelo | 091 Myśliwska,Wavelo | 092 Bieżanowska,Wavelo | 093 Kuklińskiego,Wavelo | 094 Rzebika,Wavelo | 095 Saska,Wavelo | 096 Św. Wawrzyńca,Wavelo | 097 Ludwinów,Wavelo | 098 Rondo Matecznego I,Wavelo | 099 Nowosądecka,Wavelo | 100 Kurdwanów,Wavelo | 101 Wysłouchów,Wavelo | 102 Czerwone Maki,Wavelo | 103 Grota-Roweckiego,Wavelo | 104 Norymberska,Wavelo | 105 Borsucza,Wavelo | 106 Kobierzyńska,Wavelo | 107 Miłkowskiego,Wavelo | 108 Stojałowskiego,Wavelo | 109 Kampus UJ - Łojasiewicza,Wavelo | 110 Zachodnia,Wavelo | 111 Ruczaj,Wavelo | 112 Chmieleniec,Wavelo | 113 Rynek Dębnicki,Wavelo | 114 Zielińskiego,Wavelo | 115 Zalew Bagry,Wavelo | 116 Turniejowa,Wavelo | 117 Narzymskiego II,Wavelo | 118 Olszecka,Wavelo | 119 Osiedle Złotego Wieku,Wavelo | 120 Kleeberga,Wavelo | 121 Politechnika - Wydział Mechaniczny,Wavelo | 122 Łokietka,Wavelo | 123 Rondo Barei,Wavelo | 124 Bociana,Wavelo | 125 Pachońskiego,Wavelo | 126 Mistrzejowice,Wavelo | 127 Prądnik Czerwony,Wavelo | 128 Mały Płaszów,Wavelo | 129 Bohomolca,Wavelo | 130 Akacjowa,Wavelo | 131 Radzikowskiego,Wavelo | 132 Dworcowa,Wavelo | 133 Łagiewniki,Wavelo | 134 Borek Fałęcki,Wavelo | 135 Zabłocie,Wavelo | 136 Rondo Matecznego II,Wavelo | 137 Makowskiego,Wavelo | 138 Pawia,Wavelo | 139 Teligi,Wavelo | 140 Ćwiklińskiej,Wavelo | 141 Macedońska,Wavelo | 142 Powiśle,Wavelo | 143 Sławkowska,Wavelo | 144 Kopernika,Wavelo | 145 Ugorek,Wavelo | 146 Brogi-Bosaków,Wavelo | 147 Prądnicka,Wavelo | 148 Centralna,Wavelo | 149 AWF,Wavelo | 150 Kampus UJ - Gronostajowa,Wavelo | 151 IKEA,Wavelo | 152 Rondo Czyżyńskie II,Wavelo | 153 Medweckiego,Wavelo | 154 Włodarczyka,Wavelo | 155 Marii Dąbrowskiej,Wavelo | 156 Galeria Bronowice,Wavelo | 157 Quattro Business Park,Wavelo | 158 Bonarka Shopping Center,Wavelo | 159 Bulwary Kurlandzkie,Wavelo | 160 B4B bonarka for business,Wavelo | 161 Centrum Biurowe Jasnogórska 1,Wavelo | 162 Centrum Serenada,Wavelo | 163 Fitness Platinium Bratysławska,Wavelo | 164 Fitness Platinium Aleja Pokoju,Wavelo | 165 Kapelanka 42,Wavelo | 166 Dot Office,Wavelo | 167 ABB Business Services,Wavelo | 168 O3 Business Campus,Wavelo | 169 Piaski Nowe,Wavelo | Galeria Krakowska,Wavelo | Hot Spot UJ Collegium Medicum,Wavelo | Hot Spot UJ Ruczaj,Wavelo | Stacja Mobilna M01,We Love bike | Lodi,WhiteBikes | ALZBETKA,WhiteBikes | ARCHITEKTI,WhiteBikes | ATRIAKY,WhiteBikes | AUPARK,WhiteBikes | AUPARKTOWER,WhiteBikes | BERNARD,WhiteBikes | BINARIUM,WhiteBikes | BOHROVA,WhiteBikes | CENTRAL,WhiteBikes | CULTUS,WhiteBikes | CYKLOKUCHYNA,WhiteBikes | CYKLOKUCHYNASERVIS,WhiteBikes | DANUBIA,WhiteBikes | DELFIN,WhiteBikes | DREAM,WhiteBikes | DULOVO,WhiteBikes | EUROVEA,WhiteBikes | FIGARO,WhiteBikes | FINANCIE,WhiteBikes | FURDEKOVA,WhiteBikes | GARDA,WhiteBikes | GAVLOVICOVA,WhiteBikes | HERLIANSKA,WhiteBikes | HLAVNA,WhiteBikes | HRANICIAROV,WhiteBikes | HURBANOVO,WhiteBikes | HURBANOVOSERVIS,WhiteBikes | JASOVSKA,WhiteBikes | JURIGOVO,WhiteBikes | KAMENNE,WhiteBikes | KARADZICOVA,WhiteBikes | KARLOVKA,WhiteBikes | KOLLARKO,WhiteBikes | KORVINA,WhiteBikes | MAJKOVA,WhiteBikes | MANDERLAK,WhiteBikes | MATFYZ,WhiteBikes | MIEROVA,WhiteBikes | MOSKOVSKA,WhiteBikes | NIVY,WhiteBikes | NOVEMESTO,WhiteBikes | PEKNA,WhiteBikes | PETRZALKA,WhiteBikes | PLYNARENSKA,WhiteBikes | POLARNA,WhiteBikes | POLUS,WhiteBikes | POSTOVA,WhiteBikes | PREDMESTIE,WhiteBikes | PRISTAV,WhiteBikes | PYRAMIDA,WhiteBikes | RACKO,WhiteBikes | REDUTA,WhiteBikes | RIVER,WhiteBikes | RYBNE,WhiteBikes | SABINOVSKA,WhiteBikes | SAFKO,WhiteBikes | SALEZIANI,WhiteBikes | SASINKOVA,WhiteBikes | SATINSKEHO,WhiteBikes | SHERLOCK,WhiteBikes | SPITALSKA,WhiteBikes | STEIN,WhiteBikes | STEINSERVIS,WhiteBikes | SUNAVCOVA,WhiteBikes | SUSTEKOVA,WhiteBikes | TECHNOPOL,WhiteBikes | TOVARENSKA,WhiteBikes | TRENCIANSKA,WhiteBikes | TUPOLEVOVA,WhiteBikes | VAJNORSKA,WhiteBikes | VAZOVOVA,WhiteBikes | VAZOVOVASERVIS,WhiteBikes | VINOHRADY,WhiteBikes | VLASTENECKE,WhiteBikes | ZAHRADNICKA,WhiteBikes | ZELINARSKA,WhiteBikes | ZIMAK,WhiteBikes | ZUPA,Zabrzański Rower Miejski | Aquarius Kopernik,Zabrzański Rower Miejski | Grzybowice,Zabrzański Rower Miejski | Guido,Zabrzański Rower Miejski | Plac Dworcowy,Zabrzański Rower Miejski | Politechnika Śląska,Zabrzański Rower Miejski | Rokitnica Pętla,Zabrzański Rower Miejski | Sztolnia Królowa Luiza,Zabrzański Rower Miejski | Sztolnia Port,Zielonogórski Rower Miejski | 1 Maja (Zielona Strzała),Zielonogórski Rower Miejski | Agrestowa,Zielonogórski Rower Miejski | Batorego/Obywatelska,Zielonogórski Rower Miejski | Batorego/Zamoyskiego,Zielonogórski Rower Miejski | Botaniczna (Ogród botaniczny - Mini ZOO),Zielonogórski Rower Miejski | Cisowa,Zielonogórski Rower Miejski | Dworcowa (dworzec PKP),Zielonogórski Rower Miejski | Dworcowa (dworzec PKS),Zielonogórski Rower Miejski | Francuska/Dunikowskiego,Zielonogórski Rower Miejski | Konstytucji 3 Maja (Wenus),Zielonogórski Rower Miejski | Kraljevska,Zielonogórski Rower Miejski | Krośnieńska (Zielona Strzała),Zielonogórski Rower Miejski | Krępowska (Chynów),Zielonogórski Rower Miejski | Kupiecka (Bachus),Zielonogórski Rower Miejski | Kupiecka/Wojska Polskiego,Zielonogórski Rower Miejski | Morelowa,Zielonogórski Rower Miejski | Nowa/Browarna,Zielonogórski Rower Miejski | Nowojędrzychowska / Makowa,Zielonogórski Rower Miejski | Odrzańska (Łężyca),Zielonogórski Rower Miejski | Osiedle Pomorskie,Zielonogórski Rower Miejski | Osiedle Śląskie,Zielonogórski Rower Miejski | Plac Bohaterów,Zielonogórski Rower Miejski | Plac Słowiański,Zielonogórski Rower Miejski | Podgórna (UZ),Zielonogórski Rower Miejski | Podgórna/Waryńskiego,Zielonogórski Rower Miejski | Rondo 11 Listopada,Zielonogórski Rower Miejski | Stary Rynek/Jana Sobieskiego,Zielonogórski Rower Miejski | Sulechowska (CRS),Zielonogórski Rower Miejski | Szafrana (UZ),Zielonogórski Rower Miejski | Wojska Polskiego (UZ),Zielonogórski Rower Miejski | Wojska Polskiego/Reja,Zielonogórski Rower Miejski | Wojska Polskiego/Wyszyńskiego,Zielonogórski Rower Miejski | Wyspiańskiego (pływalnia),Zielonogórski Rower Miejski | Wyszyńskiego/Monte Cassino,Zielonogórski Rower Miejski | Wyszyńskiego/Słowacka,Zielonogórski Rower Miejski | Wyszyńskiego/Wiśniowa,Zielonogórski Rower Miejski | Zacisze/Prosta,Zielonogórski Rower Miejski | Zawadzkiego/Cyryla i Metodego,Zielonogórski Rower Miejski | Zdrojowa,Zielonogórski Rower Miejski | Zjednoczenia/Dekoracyjna,[TO]BIKE | 01. Certosa / P.le Avis,[TO]BIKE | 01. Concordia,[TO]BIKE | 01. Gerbido,[TO]BIKE | 01. Largo Oropa,[TO]BIKE | 01. Municipio,[TO]BIKE | 02. BIKE POINT Mandria,[TO]BIKE | 02. Berlinguer,[TO]BIKE | 02. Dalla Chiesa / Pastrengo,[TO]BIKE | 02. Fabbrichetta,[TO]BIKE | 02. Pettiti,[TO]BIKE | 03. Borgo,[TO]BIKE | 03. C. Commerciale I Portici,[TO]BIKE | 03. Leumann,[TO]BIKE | 04. Metro Paradiso,[TO]BIKE | 04. Reggia,[TO]BIKE | 04. Villa Claretta,[TO]BIKE | 05. Corso Garibaldi,[TO]BIKE | 05. Savonera,[TO]BIKE | 05. Universita`,[TO]BIKE | 06. Fermi,[TO]BIKE | 06. Le Serre,[TO]BIKE | 06. Municipio,[TO]BIKE | 07. Buozzi,[TO]BIKE | 07. Stazione F.S.,[TO]BIKE | 07. Stazione Ferroviaria Paradiso,[TO]BIKE | 08. Gramsci,[TO]BIKE | 08. Lupo,[TO]BIKE | 08. San Marchese,[TO]BIKE | 09. Lesna,[TO]BIKE | 09. Municipio,[TO]BIKE | 09. Rigola,[TO]BIKE | 10. Europa Unita,[TO]BIKE | 10. Gallo Praile,[TO]BIKE | Adriano,[TO]BIKE | Agnelli,[TO]BIKE | Arbarello,[TO]BIKE | Arcivescovado,[TO]BIKE | Baldissera,[TO]BIKE | Baretti,[TO]BIKE | Bava,[TO]BIKE | Belfiore,[TO]BIKE | Belgio 2,[TO]BIKE | Belgio 3,[TO]BIKE | Bernini,[TO]BIKE | Bertola,[TO]BIKE | Bodoni,[TO]BIKE | Bologna,[TO]BIKE | Bolzano,[TO]BIKE | Borromini,[TO]BIKE | Bottesini,[TO]BIKE | CLN,[TO]BIKE | Caio Mario,[TO]BIKE | Cairoli,[TO]BIKE | Carducci,[TO]BIKE | Carlo Alberto,[TO]BIKE | Carrara,[TO]BIKE | Castelfidardo,[TO]BIKE | Castello 1,[TO]BIKE | Castello 2,[TO]BIKE | Cernaia,[TO]BIKE | Chieri,[TO]BIKE | Cibrario,[TO]BIKE | Cigna,[TO]BIKE | Cimitero Monumentale,[TO]BIKE | Consolata,[TO]BIKE | Corte d`Appello,[TO]BIKE | Crispi,[TO]BIKE | Dante,[TO]BIKE | De Amicis,[TO]BIKE | De Gasperi,[TO]BIKE | Dora Firenze,[TO]BIKE | Dora Siena 1,[TO]BIKE | Ferrucci,[TO]BIKE | Filadelfia,[TO]BIKE | Fiume,[TO]BIKE | Galileo Ferraris 1,[TO]BIKE | Galileo Ferraris 2,[TO]BIKE | Galileo Ferraris 3,[TO]BIKE | Galileo Ferraris 4,[TO]BIKE | Galileo Ferraris 5,[TO]BIKE | Galileo Ferraris 6,[TO]BIKE | Galimberti,[TO]BIKE | Giambone,[TO]BIKE | Giardini Cavour,[TO]BIKE | Giolitti 1,[TO]BIKE | Giolitti 2,[TO]BIKE | Giordano Bruno,[TO]BIKE | Giulia di Barolo,[TO]BIKE | Gran Madre,[TO]BIKE | IV Marzo,[TO]BIKE | Inghilterra 1,[TO]BIKE | Lagrange,[TO]BIKE | Lingotto Fiere,[TO]BIKE | Lione,[TO]BIKE | Livorno,[TO]BIKE | Livorno 2,[TO]BIKE | Lungo Po Cadorna,[TO]BIKE | Madama Cristina,[TO]BIKE | Marconi 1,[TO]BIKE | Maria Vittoria,[TO]BIKE | Marmolada,[TO]BIKE | Matteotti 1,[TO]BIKE | Matteotti 2,[TO]BIKE | Matteotti 3,[TO]BIKE | Mauriziano 1,[TO]BIKE | Mauriziano 2,[TO]BIKE | Meucci,[TO]BIKE | Molinette 1,[TO]BIKE | Molinette 2,[TO]BIKE | Montevideo,[TO]BIKE | Moretta,[TO]BIKE | Murazzi,[TO]BIKE | Nizza 1,[TO]BIKE | Nizza 2,[TO]BIKE | Nizza 3,[TO]BIKE | Novara,[TO]BIKE | O.G.R.,[TO]BIKE | Oddone,[TO]BIKE | Olimpico,[TO]BIKE | Orbassano,[TO]BIKE | Orvieto,[TO]BIKE | Padova,[TO]BIKE | Paleocapa,[TO]BIKE | Paravia,[TO]BIKE | Pasini,[TO]BIKE | Peschiera,[TO]BIKE | Piazza Carlina,[TO]BIKE | Piazza Nizza,[TO]BIKE | Piazza d'Armi 2,[TO]BIKE | Piazza d`Armi,[TO]BIKE | Pietro Micca,[TO]BIKE | Pio VII,[TO]BIKE | Pio VII 2,[TO]BIKE | Politecnico 1,[TO]BIKE | Politecnico 2,[TO]BIKE | Politecnico 3,[TO]BIKE | Politecnico 4,[TO]BIKE | Ponte Dora,[TO]BIKE | Porta Nuova 1,[TO]BIKE | Porta Nuova 2,[TO]BIKE | Porta Palatina,[TO]BIKE | Porta Susa 1,[TO]BIKE | Porta Susa 2,[TO]BIKE | Principi d`Acaja 1,[TO]BIKE | Principi d`Acaja 2,[TO]BIKE | RAI,[TO]BIKE | Raffaello,[TO]BIKE | Re Umberto,[TO]BIKE | Re Umberto 2,[TO]BIKE | Regina Margherita 1,[TO]BIKE | Regina Margherita 2,[TO]BIKE | Regina Margherita 3,[TO]BIKE | Regina Margherita 4,[TO]BIKE | Regina Margherita 5,[TO]BIKE | Regina Margherita 6,[TO]BIKE | Regio Parco,[TO]BIKE | Risorgimento,[TO]BIKE | Rivoli,[TO]BIKE | Robilant,[TO]BIKE | Sabotino,[TO]BIKE | Saccarelli,[TO]BIKE | San Francesco da Paola,[TO]BIKE | San Maurizio,[TO]BIKE | Santa Rita,[TO]BIKE | Sant´Anselmo,[TO]BIKE | Sebastopoli,[TO]BIKE | Solferino 2,[TO]BIKE | Sommeiller,[TO]BIKE | Spezia 1,[TO]BIKE | Stati Uniti 1,[TO]BIKE | Statuto 2,[TO]BIKE | Svizzera,[TO]BIKE | Tassoni,[TO]BIKE | Tazzoli,[TO]BIKE | Torino Esposizioni,[TO]BIKE | Tortona,[TO]BIKE | Traiano 1,[TO]BIKE | Tribunale,[TO]BIKE | Turati,[TO]BIKE | Umbria,[TO]BIKE | Universita` 1,[TO]BIKE | Universita`3,[TO]BIKE | Valdo Fusi,[TO]BIKE | Valdocco,[TO]BIKE | Valdocco 2,[TO]BIKE | Valentino 1,[TO]BIKE | Valentino 2,[TO]BIKE | Ventimiglia,[TO]BIKE | Vittorio Emanuele II 1,[TO]BIKE | Vittorio Emanuele II 2,[TO]BIKE | Vittorio Emanuele II 3,[TO]BIKE | Vittorio Emanuele II 4,[TO]BIKE | Vittorio Emanuele II 5,[TO]BIKE | Vittorio Emanuele II 6,[TO]BIKE | Vittorio Emanuele II 7,[TO]BIKE | Vittorio Veneto 2,[TO]BIKE | XI Febbraio,[TO]BIKE | Zara,[TO]BIKE | stazione test - non operativa,bike4all | Byblos Exit,bike4all | Edde Sands,bike4all | Fishing Port,bike4all | IBL Bank,bike4all | Public Garden,bike4all | Wax Museum,cy'clic | 01 - THEATRE DES ARTS,cy'clic | 02- PASTEUR - FAC DE DROIT,cy'clic | 03- VIEUX MARCHE,cy'clic | 04- MUSEE DES BEAUX ARTS,cy'clic | 05- HOTEL DE VILLE,cy'clic | 06- CHU - RUE DE GERMONT,cy'clic | 07- CHU - BOULEVARD GAMBETTA,cy'clic | 08- SAINT MARC,cy'clic | 09 - REPUBLIQUE - QUAI CORNEILLE,cy'clic | 10- PLACE CARNOT,cy'clic | 11- CLEMENCEAU JOFFRE,cy'clic | 12- PLACE DES COTONNIERS,cy'clic | 13- SAINT SEVER,cy'clic | 14- BALZAC - BOULEVARD DE L' EUROPE,cy'clic | 15-GARE,cy'clic | 16-ILE LACROIX,cy'clic | 17- SAINT CLEMENT,cy'clic | 18 - DOCKS,cy'clic | 19 - JARDIN DES PLANTES,cy'clic | 20 - AUBERGE DE JEUNESSE,cy'clic | 21 - SIMONE DE BEAUVOIR,cy'clic | 22 - CATHEDRALE,cy'clic | 23 - HANGAR 106,cy'clic | 24 - HANGAR 108,cy'clic | 25 - ARMADA,cyclocity | 丸の内 MARUNOUCHI,cyclocity | 北新町１丁目 KITASHIN-MACHI 1,cyclocity | 南口駅前広場STATION PLAZA SOUTH ENTRANCE,cyclocity | 呉羽丘陵多目的広場　KUREHA HILLS MULTI-PURPOSE SQUARE,cyclocity | 城址公園東 CASTLE PARK EAST,cyclocity | 堤町通り TSUTSUMICHO STREET,cyclocity | 大手町 OTE-MACHI,cyclocity | 富山大学前 TOYAMA UNIVERSITY MAE,cyclocity | 富山大学構内　TOYAMA UNIVERSITY CAMPUS,cyclocity | 富山駅北 TOYAMA STATION NORTH,cyclocity | 富山駅南① TOYAMA STATION SOUTH 1,cyclocity | 富山駅南② TOYAMA STATION SOUTH 2,cyclocity | 市役所 CITY HALL,cyclocity | 旅籠町 HATAGO-MACHI,cyclocity | 本町 HON-MACHI,cyclocity | 桜橋通り SAKURABASHI STREET,cyclocity | 民俗民芸村　MUNICIPAL FOLKCRAFT VILLAGE,cyclocity | 水墨美術館　SUIBOKU MUSEUM,cyclocity | 環水公園東 CANAL PARK　EAST,cyclocity | 環水公園西　CANAL PARK WEST,cyclocity | 県庁前公園　KENCHOMAE PARK,cyclocity | 荒町 ARA-MACHI,cyclocity | 西町 NISHI-CHO,dublinbikes | AVONDALE ROAD,dublinbikes | BENSON STREET,dublinbikes | BLACKHALL PLACE,dublinbikes | BLESSINGTON STREET,dublinbikes | BOLTON STREET,dublinbikes | BROOKFIELD ROAD,dublinbikes | BUCKINGHAM STREET LOWER,dublinbikes | CATHAL BRUGHA STREET,dublinbikes | CHARLEMONT PLACE,dublinbikes | CHARLEVILLE ROAD,dublinbikes | CHRISTCHURCH PLACE,dublinbikes | CITY QUAY,dublinbikes | CLONMEL STREET,dublinbikes | COLLINS BARRACKS MUSEUM,dublinbikes | CONVENTION CENTRE,dublinbikes | CUSTOM HOUSE,dublinbikes | CUSTOM HOUSE QUAY,dublinbikes | DAME STREET,dublinbikes | DENMARK STREET GREAT,dublinbikes | DEVERELL PLACE,dublinbikes | EARLSFORT TERRACE,dublinbikes | ECCLES STREET,dublinbikes | ECCLES STREET EAST,dublinbikes | EMMET ROAD,dublinbikes | EXCHEQUER STREET,dublinbikes | EXCISE WALK,dublinbikes | FENIAN STREET,dublinbikes | FITZWILLIAM SQUARE EAST,dublinbikes | FITZWILLIAM SQUARE WEST,dublinbikes | FOWNES STREET UPPER,dublinbikes | FRANCIS STREET,dublinbikes | FREDERICK STREET SOUTH,dublinbikes | GEORGES LANE,dublinbikes | GEORGES QUAY,dublinbikes | GOLDEN LANE,dublinbikes | GRAND CANAL DOCK,dublinbikes | GRANGEGORMAN LOWER (CENTRAL),dublinbikes | GRANGEGORMAN LOWER (NORTH),dublinbikes | GRANGEGORMAN LOWER (SOUTH),dublinbikes | GRANTHAM STREET,dublinbikes | GRATTAN STREET,dublinbikes | GREEK STREET,dublinbikes | GUILD STREET,dublinbikes | HANOVER QUAY,dublinbikes | HARCOURT TERRACE,dublinbikes | HARDWICKE PLACE,dublinbikes | HARDWICKE STREET,dublinbikes | HATCH STREET,dublinbikes | HERBERT PLACE,dublinbikes | HERBERT STREET,dublinbikes | HEUSTON BRIDGE (NORTH),dublinbikes | HEUSTON BRIDGE (SOUTH),dublinbikes | HEUSTON STATION (CAR PARK),dublinbikes | HEUSTON STATION (CENTRAL),dublinbikes | HIGH STREET,dublinbikes | JAMES STREET,dublinbikes | JERVIS STREET,dublinbikes | JOHN STREET WEST,dublinbikes | KEVIN STREET,dublinbikes | KILLARNEY STREET,dublinbikes | KILMAINHAM GAOL,dublinbikes | KILMAINHAM LANE,dublinbikes | KING STREET NORTH,dublinbikes | LEINSTER STREET SOUTH,dublinbikes | LIME STREET,dublinbikes | MARKET STREET SOUTH,dublinbikes | MATER HOSPITAL,dublinbikes | MERRION SQUARE EAST,dublinbikes | MERRION SQUARE SOUTH,dublinbikes | MERRION SQUARE WEST,dublinbikes | MOLESWORTH STREET,dublinbikes | MOUNT BROWN,dublinbikes | MOUNT STREET LOWER,dublinbikes | MOUNTJOY SQUARE EAST,dublinbikes | MOUNTJOY SQUARE WEST,dublinbikes | NEW CENTRAL BANK,dublinbikes | NEWMAN HOUSE,dublinbikes | NORTH CIRCULAR ROAD,dublinbikes | NORTH CIRCULAR ROAD (O'CONNELL'S),dublinbikes | OLIVER BOND STREET,dublinbikes | ORMOND QUAY UPPER,dublinbikes | PARKGATE STREET,dublinbikes | PARNELL SQUARE NORTH,dublinbikes | PARNELL STREET,dublinbikes | PEARSE STREET,dublinbikes | PHIBSBOROUGH ROAD,dublinbikes | PORTOBELLO HARBOUR,dublinbikes | PORTOBELLO ROAD,dublinbikes | PRINCES STREET / O'CONNELL STREET,dublinbikes | RATHDOWN ROAD,dublinbikes | ROTHE ABBEY,dublinbikes | ROYAL HOSPITAL,dublinbikes | SANDWITH STREET,dublinbikes | SIR PATRICK DUN'S,dublinbikes | SMITHFIELD,dublinbikes | SMITHFIELD NORTH,dublinbikes | SOUTH DOCK ROAD,dublinbikes | ST JAMES HOSPITAL (LUAS),dublinbikes | ST. JAMES HOSPITAL (CENTRAL),dublinbikes | ST. STEPHEN'S GREEN EAST,dublinbikes | ST. STEPHEN'S GREEN SOUTH,dublinbikes | TALBOT STREET,dublinbikes | THE POINT,dublinbikes | TOWNSEND STREET,dublinbikes | UPPER SHERRARD STREET,dublinbikes | WESTERN WAY,dublinbikes | WILTON TERRACE,dublinbikes | WILTON TERRACE (PARK),dublinbikes | WOLFE TONE STREET,dublinbikes | YORK STREET EAST,dublinbikes | YORK STREET WEST,e.motion | Aeroporto,e.motion | Azienda Sanitaria,e.motion | Balista,e.motion | Bezzi,e.motion | Biblioteca,e.motion | Bren Center,e.motion | Brione,e.motion | Centro Intermodale,e.motion | Centro Santa Chiara,e.motion | Cimitero,e.motion | Gardolo,e.motion | Lidorno,e.motion | Lizzana,e.motion | Madrano,e.motion | Marco,e.motion | Mart,e.motion | Municipio,e.motion | Muse,e.motion | Noriglio,e.motion | Orvea,e.motion | Ospedale,e.motion | P. Rosmini,e.motion | Piazza Gavazzi,e.motion | Piazza Venezia,e.motion | Piazza della Mostra,e.motion | Piazza di Centa,e.motion | Piscina,e.motion | Quercia,e.motion | Sacco,e.motion | San Cristoforo,e.motion | Spiaz de le Oche,e.motion | Stazione Autocorriere,e.motion | Stazione FF.SS.,e.motion | Stazione FFSS - Ospedale,e.motion | Stazione Mori,e.motion | Susa` - Scuola Elementare,e.motion | Tegazzo,e.motion | Top Center,e.motion | Universita`,e.motion | Vannetti,e.motion | Via Paoli,e.motion | Villa Lagarina,e.motion | Zona Industriale,iBike | Al Awaha,iBike | Al Marooj,iBike | Al Sharooq,iBike | Bay La Sun Hotel,iBike | Beach Promenade,iBike | Juman Park,iBike | Marina 2&3,iBike | Net Zone,iBike | The Views,lecce | Foro Boario,lecce | Mazzini,lecce | Sant'Oronzo,lecce | Settelacquare,lecce | Stazione Centrale FF.SS.,lecce | Torre del Parco,"metropolradruhr | ""Bochumer Fenster"" / Massenbergstr.",metropolradruhr | AKAFÖ Auf der Papenburg,metropolradruhr | AKAFÖ Erlenkamp,metropolradruhr | AKAFÖ Europahaus,metropolradruhr | AKAFÖ Grunewald,metropolradruhr | AKAFÖ Hegge-Kolleg,metropolradruhr | AKAFÖ Kalwes,metropolradruhr | AKAFÖ Priesterseminar,metropolradruhr | AKAFÖ Q-West,metropolradruhr | AKAFÖ Stiepeler Str.,metropolradruhr | AKAFÖ Studidorf,metropolradruhr | AKAFÖ Wodanstraße,metropolradruhr | Aktienstr.,metropolradruhr | Alsfeld Jägerstr.,metropolradruhr | Alstaden Flockenfeld,metropolradruhr | Alte Straße,metropolradruhr | Altenbochum Kirche,metropolradruhr | Altenessen Bahnhof,metropolradruhr | Altenessen Mitte,metropolradruhr | Am Beilstück,metropolradruhr | Am Blumenkampshof,metropolradruhr | Am Gardenkamp,metropolradruhr | Am Kaiserbrunnen,metropolradruhr | An der Palmweide,metropolradruhr | An der Schalwiese,metropolradruhr | Archäologie-Museum / Kreuzkirche,metropolradruhr | Arenapark,metropolradruhr | Auf der Wenge / Sankt-Jörgen-Platz,metropolradruhr | August-Bebel-Platz,metropolradruhr | Bahnhof,metropolradruhr | Bahnhof Buer-Süd,metropolradruhr | Bahnhof Schlenk,metropolradruhr | Bahnstraße / RS1,metropolradruhr | Barop Parkhaus,metropolradruhr | Baroper Strasse,metropolradruhr | Bergbaumuseum,metropolradruhr | Berliner Platz,metropolradruhr | Berliner Str.,metropolradruhr | Bismarckplatz,metropolradruhr | Bocksbarttrasse,metropolradruhr | Borbeck Bahnhof,metropolradruhr | Borsigplatz / Oesterholzstr.,metropolradruhr | Brackel Kirche,metropolradruhr | Bredeney,metropolradruhr | Brenscheder Str. / U35,metropolradruhr | Breslauer Str.,metropolradruhr | Broicher Mitte,metropolradruhr | Broicher Waldweg,metropolradruhr | Brundelstr. / Oberstr.,metropolradruhr | Brückenplatz,metropolradruhr | Brüderstraße,metropolradruhr | Buer Nordbahnhof,metropolradruhr | Buscheyplatz,metropolradruhr | Buschhausen Mitte,metropolradruhr | CCC Dortmund,metropolradruhr | CCC Duisburg,metropolradruhr | CCC ESSEN,metropolradruhr | Campus Süd H-Bahn,metropolradruhr | Cinestar,metropolradruhr | Corneliastraße,metropolradruhr | Dahlhausen Bahnhof,metropolradruhr | Dellplatz,metropolradruhr | Dorstfeld Süd S-Bahnhof,metropolradruhr | Dortmund West/S-Bahnhof,metropolradruhr | Duissern,metropolradruhr | EVAG-Betriebshof Mitte,metropolradruhr | EVAG-Betriebshof Schweriner Str.,metropolradruhr | Eisenbahnmuseum,metropolradruhr | Emil-Figge-Strasse 9,metropolradruhr | Explorado,metropolradruhr | FH-Dortmund Emil-Figge-Straße 42,metropolradruhr | FH-Dortmund Sonnenstraße,metropolradruhr | Florastr.,metropolradruhr | Forum,metropolradruhr | Freigrafendamm / 302/310,metropolradruhr | Freiheit,metropolradruhr | Freiheitstraße / Wattenscheid Rathaus,metropolradruhr | Fridays for Future!,metropolradruhr | Friedensplatz,metropolradruhr | Friedrich-von-Hardenberg Haus,metropolradruhr | Friedrichsplatz,metropolradruhr | Frohnhauser Platz,metropolradruhr | Gathestr.,metropolradruhr | Gemarkenplatz,metropolradruhr | Gerichtsplatz,metropolradruhr | Germania/S-Bahnhof,metropolradruhr | Gertrudisplatz,metropolradruhr | Gervinusstraße,metropolradruhr | Geschwister-Scholl-Str.,metropolradruhr | Girardethaus,metropolradruhr | Goetheplatz,metropolradruhr | Grendplatz,metropolradruhr | Grillo-Gymnasium,metropolradruhr | Gußmannplatz,metropolradruhr | HRW Campus Styrum,metropolradruhr | HRW/Duisburger Straße,metropolradruhr | HRW/Lützowstraße,metropolradruhr | HRW/Parkhaus,metropolradruhr | HSHL Campus Hamm,metropolradruhr | Hafen,metropolradruhr | Hahnenfähre,metropolradruhr | Hainallee / Südbad,metropolradruhr | Hansastr.,metropolradruhr | Hauptbahnhof,metropolradruhr | Hauptbahnhof Bahnhofsvorplatz,metropolradruhr | Hauptbahnhof Haupteingang,metropolradruhr | Hauptbahnhof Nordausgang,metropolradruhr | Hauptbahnhof Nordeingang,metropolradruhr | Hauptbahnhof Oberhausen,metropolradruhr | Hauptbahnhof Osteingang,metropolradruhr | Hauptbahnhof Südausgang,metropolradruhr | Hauptbahnhof Verknüpfungshalle Ost,metropolradruhr | Hauptbahnhof Verknüpfungshalle West,metropolradruhr | Hauptbahnhof Westeingang,metropolradruhr | Hauptbahnhof/Bahnhofsvorplatz,metropolradruhr | Hauptfriedhof,metropolradruhr | Heiligegartenstr.,metropolradruhr | Heiliger Weg / Kronprinzenstr.,metropolradruhr | Heinrich-König-Platz,metropolradruhr | Heinrich-von-Kleist-Forum,metropolradruhr | Heißen Kirche,metropolradruhr | Helbingstraße / RVR / Emschergen.,metropolradruhr | Herne Bahnhof,metropolradruhr | Hiltropwall,metropolradruhr | Hirschlandplatz,metropolradruhr | Hochschule Bochum,metropolradruhr | Hochschule Parkplatz,metropolradruhr | Hochschule für Gesundheit,metropolradruhr | Hochschule für Gesundheit / Veranstaltungszentrum,metropolradruhr | Holten Bahnhof,metropolradruhr | Hombruch Marktplatz,metropolradruhr | Horneburg,metropolradruhr | Hufelandplatz,metropolradruhr | Hustadt / Schattbachstr. / U35,metropolradruhr | Huttropstraße,metropolradruhr | Höntrop Bahnhof,metropolradruhr | Hörde Bahnhof,metropolradruhr | Hügel / Regattahaus,metropolradruhr | Hüttenwerk / Eingang Landschaftspark,metropolradruhr | Immermannstr./Klinikzentrum,metropolradruhr | Innenhafen Nord,metropolradruhr | Innenstadt Alt-OB/Bert-Brecht-Haus,metropolradruhr | Isenbergstr.,metropolradruhr | Jugendherberge / MSV Stadion,metropolradruhr | Jugendhotel,metropolradruhr | Kaiserplatz,metropolradruhr | Kammerstraße/Wohnheim,metropolradruhr | Kampstr. / Freistuhl,metropolradruhr | Karl-Liebknecht-Str.,metropolradruhr | Karlsplatz,metropolradruhr | Kettwig Bahnhof,metropolradruhr | Kettwig Brücke,metropolradruhr | Klarastraße,metropolradruhr | Kleine Lenbachstraße,metropolradruhr | Klinikum Duisburg,metropolradruhr | Klostermarkt,metropolradruhr | Knappschaftskrankenhaus,metropolradruhr | Kopstadtplatz,metropolradruhr | Kreuzstraße,metropolradruhr | Kronenburg,metropolradruhr | Kronprinzenstraße,metropolradruhr | Kuckelke,metropolradruhr | Kuithanstr.,metropolradruhr | Königshardt Falkestr.,metropolradruhr | Körne West/S-Bahnhof,metropolradruhr | Langendreer Amt,metropolradruhr | Langendreer Bahnhof,metropolradruhr | Langendreer Markt,metropolradruhr | Langendreer West Bahnhof / Lünsender Str.,metropolradruhr | Lehmbruckmuseum,metropolradruhr | Lennershof,metropolradruhr | Lirich Wickstraße,metropolradruhr | Lohring / 302/310,metropolradruhr | Lütgendortmund / Bus-Bahnhof,metropolradruhr | M1 - Tenderweg,metropolradruhr | MWB / Friedrich-Ebert-Straße,metropolradruhr | Margarethenhöhe,metropolradruhr | Marina / Sea Life,metropolradruhr | Markgrafenstr.,metropolradruhr | Markstr. / U35,metropolradruhr | Marktplatz Röhlinghausen,metropolradruhr | Marktstr. / Wörthstr.,metropolradruhr | Marten S-Bahnhof,metropolradruhr | Martinstr.,metropolradruhr | Max-Ophüls-Platz,metropolradruhr | Max-Planck-Gymnasium,metropolradruhr | Maximare,metropolradruhr | Meiderich Südbahnhof,metropolradruhr | Meitnerweg,metropolradruhr | Messe Ost/Gruga,metropolradruhr | Metternichstraße,metropolradruhr | Mobilstation Landgericht,metropolradruhr | Mobilstation Steele,metropolradruhr | Märkische Str. / B1,metropolradruhr | Möllerbrücke,metropolradruhr | Mühlenstr.,metropolradruhr | Neidenburger Straße,metropolradruhr | Neudorfer Markt,metropolradruhr | Neue Mitte / CentrO.,metropolradruhr | Nordmarkt,metropolradruhr | Nordsternpark,metropolradruhr | Nordstraße,metropolradruhr | Nortkirchenstraße/Wilo,metropolradruhr | Oberlandesgericht,metropolradruhr | Oespel S-Bahnhof,metropolradruhr | Oppspring,metropolradruhr | Oskar-Hoffmann-Str. / U35,metropolradruhr | Ostenberg,metropolradruhr | Osterfeld Südbahnhof,metropolradruhr | Oststr.,metropolradruhr | Otto-Hahn-Str.,metropolradruhr | Paulinenstr.,metropolradruhr | Pferdemarkt,metropolradruhr | Philharmonie,metropolradruhr | Phoenix See / Hörder Burg,metropolradruhr | Phönix West,metropolradruhr | Platz am Südwall,metropolradruhr | Platz von Netanya,metropolradruhr | Polizeipräsidium,metropolradruhr | Priorstr. / Münsterstr.,metropolradruhr | RRZ/ Festival-Garden,metropolradruhr | RUB Audimax / Mensa,metropolradruhr | RUB CASPO / Botanischer Garten,metropolradruhr | RUB Campus Center,metropolradruhr | RUB Fakultät für Sportwissenschaft,metropolradruhr | RUB GA,metropolradruhr | RUB GB,metropolradruhr | RUB HZO Ost,metropolradruhr | RUB HZO West,metropolradruhr | RUB IC,metropolradruhr | RUB ID,metropolradruhr | RUB MA,metropolradruhr | RUB NA / NB,metropolradruhr | RUB NC,metropolradruhr | RUB P36,metropolradruhr | RUB Parkhaus West,metropolradruhr | RVR,metropolradruhr | RWE Tower,metropolradruhr | Raffelberg,metropolradruhr | Rathaus,metropolradruhr | Rathaus / Burgplatz,metropolradruhr | Rathaus / Gustav-Heinemann-Platz,metropolradruhr | Rathaus / Kuhstr.,metropolradruhr | Rathaus / Willy-Brandt-Platz,metropolradruhr | Rathaus Buer / Kunstmuseum,metropolradruhr | Rathaus Oberhausen,metropolradruhr | Rheinelbe-Park,metropolradruhr | Rheinischer Platz,metropolradruhr | Rheinpark,metropolradruhr | Ritterhausstr.,metropolradruhr | Romanusplatz,metropolradruhr | Rombergpark,metropolradruhr | Ruhr Congress Bochum,metropolradruhr | Ruhr-Universität U35,metropolradruhr | Ruhrallee,metropolradruhr | Ruhrbahn Essen,metropolradruhr | Ruhrorter Straße/Wohnheim,metropolradruhr | Röntgenstr.,metropolradruhr | Rüschebrinkstrasse,metropolradruhr | Rüttenscheider Platz,metropolradruhr | Rüttenscheider Stern,metropolradruhr | Saarlandstr. / Hohe Str.,metropolradruhr | Sanddornweg,metropolradruhr | Schauspielhaus,metropolradruhr | Schloss Broich / Stadthalle,metropolradruhr | Schloss Oberhausen,metropolradruhr | Schloss Strünkede,metropolradruhr | Schmachtendorf Mitte,metropolradruhr | Schwanentor,metropolradruhr | Schwanenwall,metropolradruhr | Schützenbahn,metropolradruhr | Schützenstrasse,metropolradruhr | Sonnenwall BZA Mitte,metropolradruhr | Speldorf-Betriebshof,metropolradruhr | Sportzentrum Südstraße,metropolradruhr | Springerplatz,metropolradruhr | Stadtgarten,metropolradruhr | Stadthaus,metropolradruhr | Stadtmitte / Leineweberstr.,metropolradruhr | Stadttheater,metropolradruhr | Stadtwaldplatz,metropolradruhr | Steigenberger Hotel / Berswordtstr.,metropolradruhr | Sterkrade Bahnhof,metropolradruhr | Styrum Bahnhof,metropolradruhr | Styrum Josefstr.,metropolradruhr | Städtische Kliniken,metropolradruhr | Sumperkamp,metropolradruhr | Sunderweg,metropolradruhr | Südbahnhof,metropolradruhr | TU Dortmund Emil-Figge-Straße 50,metropolradruhr | TU Dortmund Hörsaalgebäude 2,metropolradruhr | TU Dortmund Seminarraumgebäude 1,metropolradruhr | Tausendfensterhaus,metropolradruhr | Technische Berufliche Schule 1,metropolradruhr | Technisches Rathaus,metropolradruhr | Technologiepark,metropolradruhr | Technologiequartier,metropolradruhr | U35 / Wasserstr.,metropolradruhr | UDE / Sportcampus,metropolradruhr | UDE – AStA Keller Duisburg,metropolradruhr | Uni Lotharstr. / Walramsweg,metropolradruhr | Uni-Center Ost,metropolradruhr | Uni-Center West / Hallenbad,metropolradruhr | Uni-Nord Lotharstr.,metropolradruhr | Uniklinikum,metropolradruhr | Unionstr.,metropolradruhr | Universität,metropolradruhr | Universität/AStA,metropolradruhr | Universität/S-Bahnhof,metropolradruhr | Universitätsstr.,metropolradruhr | Univiertel,metropolradruhr | Untere Hochstr.,metropolradruhr | Veledastraße/Wohnheim,metropolradruhr | Vereinstr.,metropolradruhr | Versorgungsamt,metropolradruhr | Viehofer Platz,metropolradruhr | Vinckeplatz,metropolradruhr | Virchowstraße/Lehrzentrum,metropolradruhr | Volksbank,metropolradruhr | Von-Bock-Str.,metropolradruhr | Von-der-Tann-Str.,metropolradruhr | Voßkuhle,metropolradruhr | Waldring / U35,metropolradruhr | Wanne-Eickel Hbf,metropolradruhr | Wasserbahnhof,metropolradruhr | Wattenscheid Bahnhof,metropolradruhr | Wehrstr. / Mellinghofer Str.,metropolradruhr | Werden Bahnhof,metropolradruhr | Wertgasse,metropolradruhr | Weserstraße,metropolradruhr | Westausgang Hbf/LVR-Industriemuseum,metropolradruhr | Westbahnhof,metropolradruhr | Westentor,metropolradruhr | Westfalenhalle,metropolradruhr | Westfalenpark,metropolradruhr | Westfalenpark / Am Kaiserhain,metropolradruhr | Westfälische Hochschule,metropolradruhr | Westviertel,metropolradruhr | Wiesenstr.,metropolradruhr | Wildenbruchplatz,metropolradruhr | Wittener Str. / Wilhelmplatz,metropolradruhr | Wolfsee,metropolradruhr | Yitzhak-Rabin-Platz,metropolradruhr | Zoo,metropolradruhr | Zoom-Erlebniswelt,nbici | Paseo Anelier,nbici | Plaza De Toros,nbici | Universidad Pública de Navarra,nbici | Universidad de Navarra,nbici | Vuelta del Castillo,sz-bike | Alaunstraße,sz-bike | Albertplatz,sz-bike | Alexander-Puschkin-Platz,sz-bike | Altenberger Platz,sz-bike | Alter katholischer Friedhof,sz-bike | Altleubitz,sz-bike | Altmarkt / Seestraße,sz-bike | Altpieschen,sz-bike | An der Sächsischen Staatskanzlei,sz-bike | Andreas-Pfitzmann-Bau,sz-bike | Andreas-Schubert-Bau / Zellescher Weg,sz-bike | Archivstr. / Wigardstr.,sz-bike | August-Bebel-Str. / hinter dem Haus 83 rechts,sz-bike | Barbarossaplatz,sz-bike | Bautest,sz-bike | Bautzner Straße / Rothenburger Straße,sz-bike | Beherbergungsschiff (Pöppelmann),sz-bike | Bergmannstraße / Wormser Straße,sz-bike | Bergstr./Zellescher Weg (Fritz-Foerster-Platz),sz-bike | Best Western Hotel Quintessenz-Forum,sz-bike | Bf. Dresden-Neustadt,sz-bike | Bhf. Mitte - Weißeritzstraße,sz-bike | Bischofsplatz (S-Bahn),sz-bike | Bischofsweg / Kamenzer Str.,sz-bike | Blockhaus / Augustusbrücke,sz-bike | Blüherstr. / Hygienemuseum,sz-bike | Bonhoeffer Platz,sz-bike | Btf. Gruna,sz-bike | Buchenstr. / Hechtstr.,sz-bike | Budapester Straße,sz-bike | Bönischplatz / Konsum,sz-bike | Bünaustraße,sz-bike | Chemnitzer Straße,sz-bike | Comeniusplatz,sz-bike | Conertplatz,sz-bike | Cottaer Straße (Haltestelle),sz-bike | DDV-Stadion,sz-bike | DVB Endpunkt Coschütz,sz-bike | DVB Endpunkt Hellerau,sz-bike | DVB Endpunkt Laubegast,sz-bike | DVB Endpunkt Pillnitz,sz-bike | DVB Endpunkt Prohlis,sz-bike | DVB Trachenberger Straße,sz-bike | Dresden Thalia (Dr.-Külz-Ring/Prager Str.),sz-bike | Ebertplatz,sz-bike | Eisenacher Straße,sz-bike | Elbepark Dresden,sz-bike | Enderstr. / Seidnitz-Center,sz-bike | Fetscherplatz,sz-bike | Frauenkirche Dresden,sz-bike | Friedensstraße/Conradstr.,sz-bike | Gläserne Manufaktur,sz-bike | Goldener Reiter,sz-bike | Großer Garten / Lennéstraße,sz-bike | Großer Garten / Winterbergstraße,sz-bike | Gutenbergstraße,sz-bike | Güntzplatz,sz-bike | HTW Dresden / Friedrich List Platz 1,sz-bike | HTW Dresden / Schnorrstraße,sz-bike | Haltepunkt Plauen,sz-bike | Haltepunkt Trachau,sz-bike | Hauptbahnhof,sz-bike | Hebbelplatz,sz-bike | Hempelbau /Mommsenstr. / Bergstr.,sz-bike | Hepkestraße,sz-bike | Hettnerstr.,sz-bike | Hochschulstr./Reichenbachstraße,sz-bike | Holbeinstraße,sz-bike | Holzhofgasse,sz-bike | Hotel Smetana,sz-bike | Hotel Wyndham Garden Dresden,sz-bike | Hp. Dresden-Reick,sz-bike | Hubertusplatz,sz-bike | Händelallee,sz-bike | Hüblerplatz,sz-bike | Hülsse-Bau Eingang Süd,sz-bike | IPRO Consult,sz-bike | Ibis Hotel Königstein / Prager Straße,sz-bike | Jorge-Gomondai-Platz,sz-bike | Jugendgästehaus Maternistr. 22,sz-bike | Kaditz / Am Vorwerksfeld,sz-bike | Kesselsdorfer Str. / Reisewitzer Str.,sz-bike | Kino im Dach,sz-bike | Kleinzschachwitz - Endhaltestelle DVB,sz-bike | Koblenzer Straße,sz-bike | Kreuzkirche,sz-bike | Kulturpalast,sz-bike | Königsbrücker Platz,sz-bike | Körnerplatz / Friedrich-Wieck-Straße,sz-bike | Langer Weg / Niedersedlitzer Str.,sz-bike | Leubnitzer Straße,sz-bike | Lingnerallee Cityherberge,sz-bike | Louisenstraße,sz-bike | Lukasstr. / Hochschulstr.,sz-bike | Malterstraße (Haltestelle),sz-bike | Manitiusstraße,sz-bike | Markthalle Dresden,sz-bike | Marschnerstr. / Holbeinstr.,sz-bike | Martin-Luther-Platz (Kirche),sz-bike | Messe Dresden,sz-bike | Mosenstraße,sz-bike | Münchner Platz / George-Bähr-Str.,sz-bike | NH-Hotel / Hansa Str. 43,sz-bike | Niederwaldplatz,sz-bike | Nossener Brücke,sz-bike | Nöthnitzer Straße,sz-bike | Nürnberger Ei,sz-bike | Palaisplatz,sz-bike | Panometer,sz-bike | Park Inn,sz-bike | Parkhotel Weißer Hirsch,sz-bike | Pfotenhauer Straße,sz-bike | Pirnaischer Platz,sz-bike | Plauen / Nöthnitzer Straße,sz-bike | Pohlandplatz,sz-bike | Postplatz / Staatsschauspiel Dresden,sz-bike | Prager Str. / Mc Donalds,sz-bike | Rathaus Plauen,sz-bike | Reichenbachstr. / Fritz-Löffler-Str.,sz-bike | Reichenbachstraße / Gutzkowstraße (Wohnheim),sz-bike | Ringhotel Residenz Alt Dresden,sz-bike | Rothermundstr. / Zwinglistr.,sz-bike | Räcknitzhöhe,sz-bike | Schauburg,sz-bike | Schillergalerie,sz-bike | Seminargebäude / Zellescher Weg,sz-bike | St.-Benno-Gymnasium,sz-bike | Stadtteilzentrum Straßburger Platz,sz-bike | Stauffenbergallee,sz-bike | Strehlener Platz/Ackermannstr. 1A,sz-bike | Strehlener Str. / Immatrikulationsamt,sz-bike | Stresemannplatz,sz-bike | Sächsische Dampfschifffahrt,sz-bike | Sächsische Landesbibliothek,sz-bike | Sächsische Zeitung / Haus der Presse,sz-bike | Südhöhe,sz-bike | TU Dresden Hörsaalzentrum,sz-bike | Tatzberg,sz-bike | Teplitzer Str. / Reichenbachstr.,sz-bike | Theaterplatz / Semperoper,sz-bike | Toeplerbau / Binderbau,sz-bike | Tolkewitzer Str. / Frida-Markt,sz-bike | Tzschirnerplatz,sz-bike | Uniklinikum,sz-bike | Vapiano / Prager Str.,sz-bike | Waldpark,sz-bike | Waldschlösschen,sz-bike | Wasaplatz,sz-bike | Weberplatz,sz-bike | Wiener Str. / Gerhart-Hauptmann-Str.,sz-bike | Wohnheim Gret-Palucca.Straße / Lenneplatz,sz-bike | World-Trade-Center,sz-bike | Wormserstraße,sz-bike | Wundtstr. / Zellescher Weg,sz-bike | Zellescher Weg,sz-bike | Zoo,villo | 001 - LEOPOLD II,villo | 002 - ELOY/ELOY,villo | 003 - PORTE DE FLANDRE / VLAAMSEPOORT,villo | 004 - JARDIN AUX FLEURS / BLOEMENHOF,villo | 005 - BOURSE / BEURS (FERMÉE POUR TRAVAUX VOIRIE),villo | 006 - GARE CENTRALE/CENTRAAL STATION,villo | 007 - PARC / PARK,villo | 008 - ARTS-LOI / KUNST-WET(DÉMONTÉE POUR TRAVAUX)),villo | 009 - ANNEESSENS,villo | 010 - CHAPELLE / KAPEL,villo | 011 - SABLON / ZAVEL,villo | 013 - LEMONNIER,villo | 014 - PORTE DE NAMUR / NAAMSEPOORT,villo | 015 - MONTGOMERY,villo | 016 - LOUISE / LOUIZA,villo | 017 - COMTE DE FLANDRE/GRAAF VAN VLAANDEREN,villo | 018 - GUTENBERG / GUTENBERG,villo | 019 - PLACE MORICHAR/MORICHARPLEIN,villo | 020 - PALAIS ROYAL / KONINKLIJK PALEIS,villo | 021 - DE BROUCKERE,villo | 022 - JACQMAIN,villo | 023 - AGORA / AGORA,villo | 024 - ROGIER / ROGIER,villo | 025 - PORTE D'ANDERLECHT,villo | 026 - VAN LINT,villo | 027 - SQUARE ALBERT I / ALBERT I SQUARE,villo | 028 - CLEMENCEAU / CLEMENCEAU,villo | 029 - BAUDOUIN / BOUDEWIJN,villo | 030 - LAEKEN / LAKEN,villo | 031 - MUSEE DE LA BD / STRIPMUSEUM,villo | 032 - DANSAERT,villo | 033 - MORT SUBITE,villo | 034 - FONTAINAS,villo | 036 - PLACE ST JEAN / SINT-JANSPLEIN,villo | 037 - POELAERT / POELAERT,villo | 038 - JEU DE BALLE / VOSSENPLEIN,villo | 039 - HOTEL DES MONNAIES / MUNTHOTEL,villo | 040 - PORTE DE HAL / HALLEPOORT (FERMÉE FOIRE DU M,villo | 041 - SAINT-ROCH/SINT-ROCHUS,villo | 042 - PORTE DE NINOVE /NINOOFSEPOORT,villo | 043 - JOSEPH II / JOZEF II,villo | 044 - CHARLEMAGNE / KAREL DE GROTE,villo | 045 - STEPHANIE/STEFANIA,villo | 046 - ALBERTINE / ALBERTINA,villo | 047 - LES QUAIS / KAAIEN,villo | 048 - CONGRES,villo | 049 - WILLEBROECK/WILLEBROEK,villo | 050 - RIBAUCOURT,villo | 051 - MIDI FONSNY/ZUID FONSNY,villo | 052 - SAINCTELETTE,villo | 053 - GARE DU MIDI / ZUIDSTATION,villo | 054 - TOUR ET TAXIS/THURN &TAXIS,villo | 055 - BOTANIQUE/KRUIDTUIN,villo | 056 - ARCHIMEDE / ARCHIMEDES,villo | 057 - MADOU/MADOU,villo | 058 - GARE DU NORD / NOORDSTATION,villo | 059 - PLACE ST-JOSSE/ST-JOOSTPLEIN,villo | 060 - ST-LAZARE/ST LAZARUS,villo | 061 - MAELBEEK / MAALBEEK,villo | 062 - CORTENBERGH / KORTENBERG,villo | 063 - JULES CESAR,villo | 064 - VETERINAIRES,villo | 065 - PARVIS DE ST GILLES,villo | 066 - SCHUMAN,villo | 067 - PARC CINQUANTENAIRE / JUBELPARK,villo | 068 - JEAN REY,villo | 069 - LESBROUSSART,villo | 070 - AURORE/DAGERAAD,villo | 071 - LEGRAND,villo | 072 - ULB SOLBOSCH / VUB  SOLBOSCH,villo | 073 - VLEURGAT,villo | 074 - PLACE LOIX/LOIXPLEIN,villo | 075 - GENERAL BARON/GENERAAL BARON,villo | 076 - PLACE VAN MEENEN/VAN MEENENPLEIN,villo | 077 - PAUL JANSON,villo | 078 - DUC PETIAUX,villo | 079 - LOI / WET,villo | 080 - CERES,villo | 081 - PONT BOCKSTAEL/BRUG BOCKSTAEL,villo | 082 - PANNENHUIS,villo | 083 - SIMONIS,villo | 084 - STE ANNE/SINT-ANNA,villo | 085 - ETANGS NOIRS/ZWARTE VIJVERS,villo | 086 - MAISON COMMUNALE DE JETTE GEMEENTEHUIS,villo | 087 - MIROIR/SPIEGEL,villo | 088 - WOESTE,villo | 089 - ATHENEE DE JETTE/ATHENEUM VAN JETTE,villo | 090 - BROUSTIN,villo | 091 - BELGICA,villo | 092 - LENOIR,villo | 093 - CLOVIS,villo | 094 - DUCHESSE DE BRABANT/HERTOGIN VAN BRABANT,villo | 095 - PLACE BOCKSTAEL/BOCKSTAELPLAATS,villo | 096 - HOTEL PRESIDENT,villo | 097 - KARREVELD,villo | 098 - CIMETIERE/KERKHOF,villo | 099 - JUBILE,villo | 100 - GARE DE LUXEMBOURG/LUXEMBURGSTATION,villo | 101 - ZELLIK,villo | 102 - MUSEUM/MUSEUM,villo | 105 - DE HENNIN,villo | 106 - GERMOIR/MOUTERIJ,villo | 107 - DEFACQZ,villo | 108 - FLAGEY,villo | 109 - CHATELAIN/KASTELEIN,villo | 110 - RODIN,villo | 111 - ETANGS MELLAERTS VIJVERS,villo | 112 - PAGE/EDELKNAAP,villo | 113 - ABBAYE DE LA CAMBRE / ABDIJ TER KAMEREN,villo | 114 - SAISONS/JAARGETIJDEN,villo | 115 - PETITE SUISSE/KLEIN ZWITSERLAND,villo | 116 - ULB PLAINE,villo | 117 - CIMETIERE D'IXELLES/BEGRAAFPLAATS VAN ELSENE,villo | 118 - SCHWEITZER,villo | 119 - PAQUOT/PACQUOT,villo | 120 - BLYCKAERTS,villo | 121 - ETANGS / VIJVERS,villo | 122 - GARE D'ETTERBEEK,villo | 123 - BASCULE,villo | 124 - CHARLES GRAUX,villo | 125 - GEORGES BRUGMANN,villo | 126 - FABRY,villo | 127 - GRAY/GRAY,villo | 128 - MUSEE DU TRAM,villo | 130 - ROND POINT DU SOUVERAIN,villo | 131 - JARDIN MASSART,villo | 132 - DEUX CHAUSSEES,villo | 133 - CHÂTEAU/KASTEEL,villo | 134 - BASTOGNE/BASTENAKEN,villo | 135 - PARC LACROIX/LACROIX PARK,villo | 136 - PAVILLON/PAVILJOEN,villo | 137 - MAISON COMMUNALE DE SCHAERBEEK,villo | 138 - HOUFFALIZE,villo | 139 - LIEDTS,villo | 140 - AZALEES/AZALEA,villo | 141 - GARE DU NORD/NOORDSTATION,villo | 142 - BIENFAITEURS/WELDOENERS,villo | 143 - RTL,villo | 144 - SAINTE-MARIE/SINTE-MARIA,villo | 145 - COTEAUX/WIJNHEUVELEN,villo | 146 - LEOPOLD III/LEOPOLD III,villo | 147 - EMILE MAX LYCEE/LYCEUM EMILE MAX,villo | 148 - GARE MEISER/MEISER STATION,villo | 149 - JULES LEBRUN,villo | 150 - MEISER/MEISER,villo | 151 - LOUVAIN 488-494/LEUVEN 488-494,villo | 152 - PLACE DAILLY/DAILLYPLEIN,villo | 153 - SQUARE ARMAND STEURS,villo | 154 - PLASKY/PLASKY,villo | 155 - LES MARRONNIERS,villo | 156 - JAMBLINE DE MEUX/JAMBLINNE DE MEUX (FERMÉE),villo | 157 - HELIOTROPES/HELIOTROPEN,villo | 158 - VAN YSENDIJCK,villo | 159 - MASUI,villo | 160 - ELISA,villo | 161 - DEMOLDER,villo | 163 - CHAZAL/CHAZAL,villo | 164 - KENNIS,villo | 165 - CIMETIERE DE JETTE / KERKHOF JETTE,villo | 166 - GC ESSEGEM,villo | 167 - CHARLES V/KAREL V,villo | 168 - HOPITAL FRANÇAIS/FRANS HOSPITAAL,villo | 169 - GEORGES EEKHOUD,villo | 170 - RIGA,villo | 171 - PISCINE LOUIS NAMECHE ZWEMBAD,villo | 172 - AEROPOLIS,villo | 173 - BICHON,villo | 174 - MENNEKENS/MENNEKENS,villo | 175 - BEEKANT,villo | 176 - COLONEL BOURG/KOLONEL BOURG,villo | 177 - CHASSEURS ARDENNAIS/ARDENSE JAGERS,villo | 178 - DIAMANT/DIAMANT,villo | 179 - CELTES/KELTEN,villo | 180 - JOURDAN,villo | 181 - LOUIS TITZ,villo | 182 - BOILEAU,villo | 183 - LA CHASSE/JACHT,villo | 184 - PHILIPPE BAUCQ,villo | 185 - PERE DE DEKEN/PATER DE DEKEN,villo | 186 - GENOT,villo | 187 - ARSENAL/ARSENAAL,villo | 188 - OSSEGHEM,villo | 189 - PLACE VAN MEYEL/VAN MEYELPLEIN,villo | 190 - TERDELT,villo | 191 - ARTAN,villo | 192 - AUBERGE DE JEUNESSE,villo | 193 - GARE DE L'OUEST,villo | 194 - STUYVENBERG,villo | 195 - WESTLAND SHOPPING,villo | 196 - PRINCE DE LIEGE / PRINS VAN LUIK,villo | 197 - DE SMET,villo | 198 - SCHEUT,villo | 199 - HENRI REY,villo | 200 - VETERANS COLONIAUX / KOLONIALE VETERANEN,villo | 201 - PETERBOS,villo | 202 - AUMALE,villo | 203 - DEMOSTHENE,villo | 204 - DUPUIS,villo | 205 - DE LINDE,villo | 206 - SAINT-GUIDON / SINT GUIDO,villo | 207 - BIESTEBROECK / BIESTEBROEK,villo | 208 - MELBA,villo | 209 - VEEWEYDE / VEEWEIDE,villo | 210 - MARIUS RENARD,villo | 211 - METRO CERIA (FERMÉE-TRAVAUX),villo | 212 - THEO LAMBERT,villo | 213 - LA ROUE / HET RAD,villo | 214 - CAMPUS CERIA / CAMPUS VAN CERIA,villo | 215 - CUREGHEM / KUREGEM,villo | 216 - ARISTIDE BRIAND,villo | 217 - BIZET,villo | 218 - DELACROIX,villo | 219 - VAN HELLEMONT,villo | 220 - LUTHER KING,villo | 221 - CURIE,villo | 222 - MERCKX,villo | 223 - WIELS,villo | 224 - ROCHEFORT,villo | 225 - PLACE ALBERT PLEIN,villo | 226 - UNION/UNIE,villo | 227 - PATINAGE,villo | 228 - ALTITUDE CENT / HOOGTE HONDERD,villo | 229 - ZAMAN FOREST NATIONAL/ZAMAN VORST NATIONAAL,villo | 230 - BERKENDAEL / BERKENDAAL,villo | 231 - KERSBEEK,villo | 232 - DOMAINE / DOMEIN,villo | 233 - PARC DUDEN / DUDEN PARK,villo | 234 - ST DENIS / ST DENIJS,villo | 235 - FOREST NATIONAL / VORST NATIONAAL,villo | 236-MAISON COMMUNALE DE FOREST/VORST GEMEENTEHUIS,villo | 237 - PARVIS ST ANTOINE,villo | 238 - UNION SAINT-GILLOISE / SINT-GILLIS UNIE,villo | 239 - DARWIN,villo | 240 - VANDERKINDERE,villo | 241 - STATUAIRES/BEELDHOUWWERK,villo | 242 - MAISON COMMUNALE D'UCCLE/UKKEL GEMEENTEHUIS,villo | 243 - RONDPOINT CHURCHILL/ROTONDE CHURCHILL,villo | 244 - BOIS DE LA CAMBRE,villo | 245 - HAMOIR,villo | 246 - GATTI DE GAMOND,villo | 247 - STALLE,villo | 248 - PRINCE DE LIGNE / PRINCE LIJN,villo | 249 - SAINT-JOB/SINT-JOB,villo | 250 - SAINTE-ELISABETH,villo | 251 - PAOLA,villo | 252 - BEMPT,villo | 253 - REINE FABIOLA / KONINGIN FABIOLA,villo | 254 - BASILIQUE / BASILIEK,villo | 255 - SACRE-COEUR DE GANSHOREN (FERMÉE - TRAVAUX),villo | 256 - VAN OVERBEKE,villo | 257 - PL MARGHERITE D'AUTRICHE / MARGARETHA VAN OO,villo | 258 - LIBERTE,villo | 259 - NOVILLE,villo | 260 - TRITON,villo | 261 - CONSCIENCE,villo | 262 - PLACE DE LA PAIX/VREDEPLAIN,villo | 263 - MAISON COMMUNALE D'EVERE,villo | 264 - NOTRE DAME/ONZE LIEVE VROUW,villo | 265 - EVERE SHOPPING,villo | 266 - GARE BORDET STATION,villo | 267 - GENEVE,villo | 268 - DUNANT,villo | 269 - CICERON,villo | 270 - DE PADUWA,villo | 271 - DUBOIS,villo | 272 - SCHEUTBOS,villo | 273 - TAMARIS,villo | 274 - CORHAY,villo | 275 - VERSAILLES,villo | 276 - CROIX DE GUERRES / OORLOGSKRUISEN,villo | 277 - VAN PRAET,villo | 278 - STADE / STADIUM,villo | 279 - HOUBA BRUGMANN,villo | 280 - HEYSEL / HEISEL,villo | 281 - ATOMIUM,villo | 282 - CENTENAIRE / EEUWFEEST,villo | 283 - PISCINE / ZWEMBAD,villo | 284 - CLAESSENS,villo | 285 - COGHEN,villo | 286 - BENS,villo | 287 - FLOREAL (FERMÉE - TRAVAUX STIB),villo | 288 - HOUZEAU,villo | 289 - SQUARE GEORGES MARLOWSQUARE,villo | 290 - GARE DE CALEVOET / KALEVOET STATION,villo | 291 - DECROLY,villo | 292 - RITTWEGER,villo | 293 - KEYM,villo | 294 - WIENER,villo | 295 - COIN DU BALAI,villo | 296 - GARE DE BOITSFORT,villo | 297 - TEN REUKEN,villo | 298 - HALL DES SPORTS,villo | 299 - SAINT-ADRIEN,villo | 300 - GARE DE BOONDAELSTATION,villo | 301 - MARIE-JOSE,villo | 303 - VIEUX TILLEUL,villo | 304 - ARAUCARIA,villo | 305 - PETER BENOIT,villo | 306 - HEMBEEK,villo | 307 - KAREL BOGAERT,villo | 308 - TIVOLI,villo | 309 - SQUARE DU CENTENAIRE,villo | 310 - SAINT-VINCENT / SINT-VINCENTIUS,villo | 311 - DELTA,villo | 312 - CENTRE CULTUREL / CULTUREEL CENTRUM,villo | 313 - DEMEY,villo | 314 - HERRMANN DEBROUX,villo | 315 - SACRE COEUR AUDERGHEM/HEILIGE HART OUDERGHEM,villo | 317 - GEYSKENS,villo | 318 - CARDINAL MERCIER / KARDINAAL MERCIER,villo | 319 - ANCIENNE BARRIERE/OUDE AFSPANNING,villo | 320 - UZ BRUSSEL,villo | 321 - SACRE-CŒUR DE/HEILIGE HART VAN JETTE,villo | 322 - PARC DU ROI BAUDOUIN / BOUDEWIJNPARK,villo | 323 - CARENE,villo | 324 - THOMAS BALIS,villo | 325 - HANKAR,villo | 326 - ADEPS,villo | 327 - SIBELGA,villo | 328 - HEYDENBERG,villo | 329 - ROODEBEEK,villo | 330 - VANDERVELDE,villo | 331 - GEORGES HENRI,villo | 332 - VERGOTE,villo | 333 - TRACTEBEL,villo | 334 - MARCEL THIRY,villo | 335 - THIRY,villo | 336 - KRAAINEM,villo | 338 - UCL,villo | 339 - MEUDON,villo | 340 - TOMBERG,villo | 342 - MAISON COMMUNALE DE BERCHEM ST AGHATE,villo | 343 - VANDENDRIESCH,villo | 344 - BETHLEEM,villo | 345 - 3 TILLEULS,villo | 346 - RECHERCHE,villo | 347 - ERASME,villo | 348 - HANSEN-SOULIE,villo | 349 - FONSNY,villo | 350 - VERHEYLEWEGHEN,villo | 351 - ULB,villo | 352 - ROUGE-CLOÎTRE / ROOD-KLOOSTER,villo | 353 - BEAULIEU,villo | 354 - TRIOMPHE / TRIOMF,villo | 355 - PARNASSE,villo | 356 - CENTRE SPORTIF,villo | 357 - AVIATION,villo | 358 - MADOUX,villo | 359 - JCDECAUX,villo | 360 - STOCKEL/STOKKEL,villo | 362 - GARE BERCHEM ST AGATHE/ST AGATA BERCHEM,villo | 364 - DOCKS BRUXSEL,vélOstan'lib | 00001 - DOMINICAINS - FOURRIER (CB),vélOstan'lib | 00002 - PLACE DE LA CARRIERE (CB),vélOstan'lib | 00003 - PLACE DE DOMBASLE (CB),vélOstan'lib | 00004 - MARCHE CENTRAL (CB),vélOstan'lib | 00005 - PLACE COLONEL DRIANT (CB),vélOstan'lib | 00006 - LES 2 RIVES (CB),vélOstan'lib | 00008 - COURS LEOPOLD - SAINT MICHEL (CB),vélOstan'lib | 00009 - PLACE BARROIS (CB),vélOstan'lib | 00010 - GARE THIERS (CB),vélOstan'lib | 00011 - MAZAGRAN - FOCH (CB),vélOstan'lib | 00012 - ST SEBASTIEN - ST THIEBAUT (CB),vélOstan'lib | 00014 - FAC DE LETTRES (CB),vélOstan'lib | 00015 - PORT STE CATHERINE,vélOstan'lib | 00016 - PORTE DE LA CRAFFE (CB),vélOstan'lib | 00017 - CONSERVATOIRE - MANUFACTURE,vélOstan'lib | 00018 - GARE SAINT LEON (CB),vélOstan'lib | 00019 - COMMANDERIE - CHALNOT,vélOstan'lib | 00020 - PLACE DES VOSGES,vélOstan'lib | 00021 - HOPITAL CENTRAL (CB),vélOstan'lib | 00022 - HOPITAL ST JULIEN,vélOstan'lib | 00023 - PROMENADE DES CANAUX,vélOstan'lib | 00025 - PLACE COMMANDERIE,vélOstan'lib | 00026 - BAUDRICOURT HAUSSONVILLE,vélOstan'lib | 00027 - NANCY THERMAL (CB),vélOstan'lib | 00028 - MARCHÉ D'HAUSSONVILLE,vélOstan'lib | 00029 - VÉLODRÔME (CB),Łódzki Rower Publiczny - Orlen | PKN Orlen - Aleja Grzegorza Palki,Łódzki Rower Publiczny - Orlen | PKN Orlen - Brzezińska,Łódzki Rower Publiczny - Orlen | PKN Orlen - Rokicińska,Łódzki Rower Publiczny - Orlen | PKN Orlen - Strykowska,Łódzki Rower Publiczny - Orlen | PKN Orlen - Św. Teresy,Łódzki Rower Publiczny | 11 Listopada - pętla MPK,"Łódzki Rower Publiczny | Biblioteka, Kopernika/ Gdańska",Łódzki Rower Publiczny | Dell Bike Zone,Łódzki Rower Publiczny | Dworzec Łódź Fabryczna / Knychalskiego,Łódzki Rower Publiczny | Dworzec Łódź Fabryczna / ul. POW,Łódzki Rower Publiczny | Dworzec Łódź Widzew,Łódzki Rower Publiczny | Dworzec Łódź Żabieniec,Łódzki Rower Publiczny | Długosza / Kasprzaka,Łódzki Rower Publiczny | Długosza / Ossowskiego,Łódzki Rower Publiczny | Franciszkańska - Wydział Sztuk Wizualnych ASP,Łódzki Rower Publiczny | Gdańska / Więckowskiego,Łódzki Rower Publiczny | Hydro,Łódzki Rower Publiczny | Inflancka / Łagiewnicka,Łódzki Rower Publiczny | Jaracza / Sterlinga,Łódzki Rower Publiczny | Julianowska / Żarnowcowa,Łódzki Rower Publiczny | Kilińskiego / Rewolucji 1905 r.,Łódzki Rower Publiczny | Kopcińskiego / Wydział Prawa UŁ,Łódzki Rower Publiczny | Lumumby / Styrska,Łódzki Rower Publiczny | Lutomierska / Gnieźnieńska,Łódzki Rower Publiczny | Mickiewicza / Łąkowa,Łódzki Rower Publiczny | Mickiewicza / Żeromskiego,Łódzki Rower Publiczny | Narutowicza / Kilińskiego,Łódzki Rower Publiczny | Narutowicza / Kopcińskiego,Łódzki Rower Publiczny | Narutowicza / Matejki,Łódzki Rower Publiczny | Narutowicza / Muszyńskiego,Łódzki Rower Publiczny | Narutowicza / Pl. Dąbrowskiego,Łódzki Rower Publiczny | Narutowicza / Uniwersytecka,Łódzki Rower Publiczny | Ossowskiego / Augustyniaka,Łódzki Rower Publiczny | P&G Gillette,Łódzki Rower Publiczny | POW – Wydział Ek.-Soc. UŁ,Łódzki Rower Publiczny | Paderewskiego / Ciołkowskiego,Łódzki Rower Publiczny | Parkowa / Inżynierska,Łódzki Rower Publiczny | Piotrkowska - Centrum Przesiadkowe,Łódzki Rower Publiczny | Piotrkowska - OFF Piotrkowska Center,Łódzki Rower Publiczny | Piotrkowska / 6 Sierpnia,Łódzki Rower Publiczny | Piotrkowska / Al.Schillera,Łódzki Rower Publiczny | Piotrkowska / Jaracza,Łódzki Rower Publiczny | Piotrkowska / Milionowa,Łódzki Rower Publiczny | Piotrkowska / Piłsudskiego,Łódzki Rower Publiczny | Piotrkowska / Pl. Reymonta,Łódzki Rower Publiczny | Piotrkowska / Radwańska,Łódzki Rower Publiczny | Piotrkowska / Sieradzka,Łódzki Rower Publiczny | Piotrkowska / Tuwima,Łódzki Rower Publiczny | Piotrkowska / Tymienieckiego,Łódzki Rower Publiczny | Piotrkowska / Zielona,Łódzki Rower Publiczny | Piotrkowska / Żwirki,Łódzki Rower Publiczny | Piłsudskiego / Kilińskiego,Łódzki Rower Publiczny | Piłsudskiego / Sienkiewicza,Łódzki Rower Publiczny | Piłsudskiego / Targowa,Łódzki Rower Publiczny | Piłsudskiego / Wysoka,Łódzki Rower Publiczny | Piłsudskiego / Śmigłego-Rydza,Łódzki Rower Publiczny | Plac Wolności,Łódzki Rower Publiczny | Pojezierska / Zgierska,Łódzki Rower Publiczny | Politechniki - EXPO,Łódzki Rower Publiczny | Politechniki - Kampus A PŁ,Łódzki Rower Publiczny | Politechniki - Kampus C PŁ,Łódzki Rower Publiczny | Politechniki / Cieszyńska,Łódzki Rower Publiczny | Politechniki / Piękna,Łódzki Rower Publiczny | Politechniki / Wróblewskiego,Łódzki Rower Publiczny | Pomorska - CKD,Łódzki Rower Publiczny | Pomorska / Kilińskiego,Łódzki Rower Publiczny | Pomorska / Lumumby,Łódzki Rower Publiczny | Pomorska / Matejki,Łódzki Rower Publiczny | Pomorska / Sterlinga,Łódzki Rower Publiczny | Pomorska / Wierzbowa,Łódzki Rower Publiczny | Przędzalniana / Tymienieckiego,Łódzki Rower Publiczny | Radwańska / Stefanowskiego - Kampus A PŁ,Łódzki Rower Publiczny | Rondo Inwalidów,Łódzki Rower Publiczny | Rondo Lotników Lwowskich,Łódzki Rower Publiczny | Rzgowska / Bednarska,Łódzki Rower Publiczny | Rzgowska / Dąbrowskiego,Łódzki Rower Publiczny | Rzgowska / Łączna,Łódzki Rower Publiczny | Sienkiewicza / Al.Schillera,Łódzki Rower Publiczny | Sienkiewicza / Narutowicza,Łódzki Rower Publiczny | Sienkiewicza / Tuwima,Łódzki Rower Publiczny | Sienkiewicza / Wigury,Łódzki Rower Publiczny | Smugowa / PKS Dworzec Północny,Łódzki Rower Publiczny | Sporna / Boya Żeleńskiego,Łódzki Rower Publiczny | Stacja Portowa,Łódzki Rower Publiczny | Stefanowskiego / Skorupki - Kampus B PŁ,Łódzki Rower Publiczny | Struga / Gdańska,Łódzki Rower Publiczny | Targowa / Fabryczna,Łódzki Rower Publiczny | Wojska Polskiego / Chryzantem,Łódzki Rower Publiczny | Wojska Polskiego / Głowackiego,Łódzki Rower Publiczny | Wojska Polskiego / Sporna,Łódzki Rower Publiczny | Wólczańska / Czerwona - Kampus B PŁ,Łódzki Rower Publiczny | Wólczańska / Stefanowskiego - Rektorat PŁ,Łódzki Rower Publiczny | Włókniarzy-Legionów,Łódzki Rower Publiczny | Zachodnia - Manufaktura,Łódzki Rower Publiczny | Zachodnia / Legionów,Łódzki Rower Publiczny | Zachodnia / Limanowskiego,Łódzki Rower Publiczny | Zachodnia / Lutomierska,Łódzki Rower Publiczny | Zachodnia / Zielona,Łódzki Rower Publiczny | Zgierska / Adwokacka,Łódzki Rower Publiczny | Zgierska / Dolna,Łódzki Rower Publiczny | Zgierska / Limanowskiego,Łódzki Rower Publiczny | Zgierska / Stary Rynek,Łódzki Rower Publiczny | Zielona / Mała - Pl. Barlickiego,Łódzki Rower Publiczny | al. Piłsudskiego - Urząd Stanu Cywilnego,Łódzki Rower Publiczny | al. Piłsudskiego / ul. Niciarniana,Łódzki Rower Publiczny | al. Wyszyńskiego / ul. Armii Krajowej,Łódzki Rower Publiczny | al. Wyszyńskiego pętla MPK,Łódzki Rower Publiczny | al. Włókniarzy - Akademia Muzyczna,Łódzki Rower Publiczny | al. Włókniarzy / Rondo Korfantego,Łódzki Rower Publiczny | ul. Aleksandrowska / ul. Bielicowa,Łódzki Rower Publiczny | ul. Aleksandrowska / ul. Traktorowa,Łódzki Rower Publiczny | ul. Bandurskiego / ul. Karolewska,Łódzki Rower Publiczny | ul. Bratysławska / ul. Wileńska,Łódzki Rower Publiczny | ul. Bratysławska / ul. Wróblewskiego,Łódzki Rower Publiczny | ul. Chmielowskiego / ul. Adwentowicza,Łódzki Rower Publiczny | ul. Drewnowska 88,Łódzki Rower Publiczny | ul. Inflancka / ul. Zagajnikowa,Łódzki Rower Publiczny | ul. Kilińskiego / Park im. Sienkiewicza,Łódzki Rower Publiczny | ul. Kilińskiego / ul. Nawrot,Łódzki Rower Publiczny | ul. Kilińskiego / ul. Przybyszewskiego,Łódzki Rower Publiczny | ul. Kilińskiego / ul. Tylna,Łódzki Rower Publiczny | ul. Kilińskiego / ul. Zarzewska,Łódzki Rower Publiczny | ul. Kopcińskiego / ul. Nawrot,Łódzki Rower Publiczny | ul. Kopernika / ul. Łąkowa,Łódzki Rower Publiczny | ul. Lutomierska / ul. Klonowa,Łódzki Rower Publiczny | ul. Mackiewicza / ul. Olsztyńska,Łódzki Rower Publiczny | ul. Marysińska / ul. Górnicza,Łódzki Rower Publiczny | ul. Pogonowskiego / ul. 6 Sierpnia,Łódzki Rower Publiczny | ul. Pojezierska / Sierakowskiego,Łódzki Rower Publiczny | ul. Przybyszewskiego / ul. Ozorkowska,Łódzki Rower Publiczny | ul. Puszkina / ul. Wujaka,Łódzki Rower Publiczny | ul. Rajdowa / SP 41,Łódzki Rower Publiczny | ul. Rokicińska / Bartoka,Łódzki Rower Publiczny | ul. Rzgowska / ul. Dachowa,Łódzki Rower Publiczny | ul. Struga / ul. Żeligowskiego,Łódzki Rower Publiczny | ul. Strycharska / ul. Granitowa,Łódzki Rower Publiczny | ul. Tatrzańska / ul. Felińskiego,Łódzki Rower Publiczny | ul. Traktorowa / ul. Rojna,Łódzki Rower Publiczny | ul. Wielkopolska / ul. Turoszowska,Łódzki Rower Publiczny | ul. Wileńska / ul. Grodzieńska,Łódzki Rower Publiczny | ul. Wyszyńskiego / ul. Retkińska,Łódzki Rower Publiczny | ul. Zgierska / ul. Liściasta,Łódzki Rower Publiczny | ul. Zgierska / ul. Pstrągowa,Łódzki Rower Publiczny | ul. Zgierska / ul. Świtezianki,Łódzki Rower Publiczny | ul. Łagiewnicka / ul. Sowińskiego,Łódzki Rower Publiczny | ul. Łęczycka / ul. Poznańska,Łódzki Rower Publiczny | Łagiewnicka / Dolna,Łódzki Rower Publiczny | Łagiewnicka / Stefana,Łódzki Rower Publiczny | Łódź Kaliska - PKP,Łódzki Rower Publiczny | Łódź Kaliska - PKS,Łódzki Rower Publiczny | Śmigłego Rydza / Dąbrowskiego,Łódzki Rower Publiczny | Śmigłego Rydza / Przybyszewskiego,Łódzki Rower Publiczny | Śmigłego Rydza / Przędzalniana,Łódzki Rower Publiczny | Żeligowskiego / 1 Maja,Łódzki Rower Publiczny | Żeligowskiego / Zielona,Łódzki Rower Publiczny | Żeromskiego / Kopernika,Żyrardowski Rower Miejski | Aqua,Żyrardowski Rower Miejski | Dworzec PKP,Żyrardowski Rower Miejski | Nad Zalewem,Żyrardowski Rower Miejski | Park Seniora,Żyrardowski Rower Miejski | Towarowa,Żyrardowski Rower Miejski | Urząd Miasta
7,,,,,,,,,,,,,,,,,,,,,,,,,,,,,,,,,,,,,,,,,,,,,,,,,,,,,,,,,,,,,,,,,,,,,,,,,,,,,,,,,,,,,,,,,,,,,,,,,,,,,,,,,,,,,,,,,,,,,,,,,,,,,,,,,,,,,,,,,,,,,,,,,,,,,,,,,,,,,,,,,,,,,,,,,,,,,,,,,,,,,,,,,,,,,,,,,,,,,,,,,,,,,,,,,,,,,,,,,,,,,,,,,,,,,,,,,,,,,,,,,,,,,,,,,,,,,,,,,,,,,,,,,,,,,,,,,,,,,,,,,,,,,,,,,,,,,,,,,,,,,,,,,,,,,,,,,,,,,,,,,,,,,,,,,,,,,,,,,,,,,,,,,,,,,,,,,,,,,,,,,,,,,,,,,,,,,,,,,,,,,,,,,,,,,,,,,,,,,,,,,,,,,,,,,,,,,,,,,,,,,,,,,,,,,,,,,,,,,,,,,,,,,,,,,,,,,,,,,,,,,,,,,,,,,,,,,,,,,,,,,,,,,,,,,,,,,,,,,,,,,,,,,,,,,,,,,,,,,,,,,,,,,,,,,,,,,,,,,,,,,,,,,,,,,,,,,,,,,,,,,,,,,,,,,,,,,,,,,,,,,,,,,,17.0,,,,,,,,,,,12.0,,,,,,,,,15.0,,,,,,11.0,,,,,,,,,11.0,,,,,,,,,11.0,,,,,3.0,,,6.0,,,,,,,,,,,,,,,,,,,,,,,,,,,,,,,,,,,,,,,,,,,,,,,,,,,,,,,,,,,,,,,,,,,,,,,,,,,,,,,,,,,,,,,,,,,,,,,,,,,,,,,,,,,,,,,,,,,,,,,,,,,,,,,,,,,,,,,,,,,,,,,,,,,,,,,,,,,,,,,,,,,,,,,,,,,,,,,,,,,,,,,,,,,,,,,,,,,,,,,,,,,,,,,,,,,,,,,,,,,,,,,,,,,,,,,,,,,,,,,,,,,,,,,,,,,,,,,,,,,,,,,,,,,,,,,,,,,,,,,,,,,,,,,,,,,,,,,,,,,,,,,,,,,,,,,,,,,,,,,,,,,,,,,,,,,,,,,,,,,,,,,,,,,,,,,,,,,,,,,,,,,,,,,,,,,,,,,,,,,,,,,,,,,,,,,,,,,,,,,,,,,,,,,,,,,,,,,,,,,,,,,,,,,,,,,,,,,,,,,,,,,,,,,,,,,,,,,,,,,,,,,,,,,,,,,,,,,,,,,,,,,,,,,,,,,,,,,,,,,,,,,,,,,,,,,,,,,,,,,,,,,,,,,,,,,,,,,,,,,,,,,,,,,,,,,,,,,,,,,,,,,,,,,,,,,,,,,,,,,,,,,,,,,,,,,,,,,,,,,,,,,,,,,,,,,,,,,,,,,,,,,,,,,,,,,,,,,,,,,,,,,,,,,,,,,,,,,,,,,,,,,,,,,,,,,,,,,,,,,,,,,,,,,,,,,,,,,,,,,,,,,,,,,,,,,,,,,,,,,,,,,,,,,,,,,,,,,,,,,,,,,,,,,,,,,,,,,,,,,,,,,,,,,,,,,,,,,,,,,,,,,,,,,,,,,,,,,,,,,,,,,,,,,,,,,,,,,,,,,,,,,,,,,,,,,,,,,,,,,,,,,,,,,,,,,,,,,,,,,,,,,,,,,,,,,,,,,,,,,,,,,,,,,,,,,,,,,,,,,,,,,,,,,,,,,,,,,,,,,,,,,,,,,,,,,,,,,,,,,,,,,,,,,,,,,,,,,,,,,,,,,,,,,,,,,,,,,,,,,,,,,,,,,,,,,,,,,,,,,,,,,,,,,,,,,,,,,,,,,,,,,,,,,,,,,,,,,,,,,,,,,,,,,,,,,,,,,,,,,,,,,,,,,,,,,,,,,,,,,,,,,,,,,,,,,,,,,,,,,,,,,,,,,,,,,,,,,,,,,,,,,,,,,,,,,,,,,,,,,,,,,,,,,,,,,,,,,,,,,,,,,,,,,,,,,,,,,,,,,,,,,,,,,,,,,,,,,,,,,,,,,,,,,,,,,,,,,,,,,,,,,,,,,,,,,,,,,,,,,,,,,,,,,,,,,,,,,,,,,,,,,,,,,,,,,,,,,,,,,,,,,,,,,,,,,,,,,,,,,,,,,,,,,,,,,,,,,,,,,,,,,,,,,,,,,,,,,,,,,,,,,,,,,,,,,,,,,,,,,,,,,,,,,,,,,,,,,,,,,,,,,,,,,,,,,,,,,,,,,,,,,,,,,,,,,,,,,,,,,,,,,,,,,,,,,,,,,,,,,,,,,,,,,,,,,,,,,,,,,,,,,,,,,,,,,,,,,,,,,,,,,,,,,,,,,,,,,,,,,,,,,,,,,,,,,,,,,,,,,,,,,,,,,,,,,,,,,,,,,,,,,,,,,,,,,,,,,,,,,,,,,,,,,,,,,,,,,,,,,,,,,,,,,,,,,,,,,,,,,,,,,,,,,,,,,,,,,,,,,,,,,,,,,,,,,,,,,,,,,,,,,,,,,,,,,,,,,,,,,,,,,,,,,,,,,,,,,,,,,,,,,,,,,,,,,,,,,,,,,,,,,,,,,,,,,,,,,,,,,,,,,,,,,,,,,,,,,,,,,,,,,,,,,,,,,,,,,,,,,,,,,,,,,,,,,,,,,,,,,,,,,,,,,,,,,,,,,,,,,,,,,,,,,,,,,,,,,,,,,,,,,,,,,,,,,,,,,,,,,,,,,,,,,,,,,,,,,,,,,,,,,,,,,,,,,,,,,,,,,,,,,,,,,,,,,,,,,,,,,,,,,,,,,,,,,,,,,,,,,,,,,,,,,,,,,,,,,,,,,,,,,,,,,,,,,,,,,,,,,,,,,,,,,,,,,,,,,,,,,,,,,,,,,,,,,,,,,,,,,,,,,,,,,,,,,,,,,,,,,,,,,,,,,,,,,,,,,,,,,,,,,,,,,,,,,,,,,,,,,,,,,,,,,,,,,,,,,,,,,,,,,,,,,,,,,,,,,,,,,,,,,,,,,,,,,,,,,,,,,,,,,,,,,,,,,,,,,,,,,,,,,,,,,,,,,,,,,,,,,,,,,,,,,,,,,,,,,,,,,,,,,,,,,,,,,,,,,,,,,,,,,,,,,,,,,,,,,,,,,,,,,,,,,,,,,,,,,,,,,,,,,,,,,,,,,,,,,,,,,,,,,,,,,,,,,,,,,,,,,,,,,,,,,,,,,,,,,,,,,,,,,,,,,,,,,,,,,,,,,,,,,,,,,,,,,,,,,,,,,,,,,,,,,,,,,,,,,,,,,,,,,,,,,,,,,,,,,,,,,,,,,,,,,,,,,,,,,,,,,,,,,,,,,,,,,,,,,,,,,,,,,,,,,,,,,,,,,,,,,,,,,,,,,,,,,,,,,,,,,,,,,,,,,,,,,,,,,,,,,,,,,,,,,,,,,,,,,,,,,,,,,,,,,,,,,,,,,,,,,,,,,,,,,,,,,,,,,,,,,,,,,,,,,,,,,,,,,,,,,,,,,,,,,,,,,,,,,,,,,,,,,,,,,,,,,,,,,,,,,,,,,,,,,,,,,,,,,,,,,,,,,,,,,,,,,,,,,,,,,,,,,,,,,,,,,,,,,,,,,,,,,,,,,,,,,,,,,,,,,,,,,,,,,,,,,,,,,,,,,,,,,,,,,,,,,,,,,,,,,,,,,,,,,,,,,,,,,,,,,,,,,,,,,,,,,,,,,,,,,,,,,,,,,,,,,,,,,,,,,,,,,,,,,,,,,,,,,,,,,,,,,,,,,,,,,,,,,,,,,,,,,,,,,,,,,,,,,,,,,,,,,,,,,,,,,,,,,,,,,,,,,,,,,,,,,,,,,,,,,,,,,,,,,,,,,,,,,,,,,,,,,,,,,,,,,,,,,,,,,,,,,,,,,,,,,,,,,,,,,,,,,,,,,,,,,,,,,,,,,,,,,,,,,,,,,,,,,,,,,,,,,,,,,,,,,,,,,,,,,,,,,,,,,,,,,,,,,,,,,,,,,,,,,,,,,,,,,,,,,,,,,,,,,,,,,,,,,,,,,,,,,,,,,,,,,,,,,,,,,,,,,,,,,,,,,,,,,,,,,,,,,,,,,,,,,,,,,,,,,,,,,,,,,,,,,,,,,,,,,,,,,,,,,,,,,,,,,,,,,,,,,,,,,,,,,,,,,,,,,,,,,,,,,,,,,,,,,,,,,,,,,,,,,,,,,,,,,,,,,,,,,,,,,,,,,,,,,,,,,,,,,,,,,,,,,,,,,,,,,,,,,,,,,,,,,,,,,,,,,,,,,,,,,,,,,,,,,,,,,,,,,,,,,,,,,,,,,,,,,,,,,,,,,,,,,,,,,,,,,,,,,,,,,,,,,,,,,,,,,,,,,,,,,,,,,,,,,,,,,,,,,,,,,,,,,,,,,,,,,,,,,,,,,,,,,,,,,,,,,,,,,,,,,,,,,,,,,,,,,,,,,,,,,,,,,,,,,,,,,,,,,,,,,,,,,,,,,,,,,,,,,,,,,,,,,,,,,,,,,,,,,,,,,,,,,,,,,,,,,,,,,,,,,,,,,,,,,,,,,,,,,,,,,,,,,,,,,,,,,,,,,,,,,,,,,,,,,,,,,,,,,,,,,,,,,,,,,,,,,,,,,,,,,,,,,,,,,,,,,,,,,,,,,,,,,,,,,,,,,,,,,,,,,,,,,,,,,,,,,,,,,,,,,,,,,,,,,,,,,,,,,,,,,,,,,,,,,,,,,,,,,,,,,,,,,,,,,,,,,,,,,,,,,,,,,,,,,,,,,,,,,,,,,,,,,,,,,,,,,,,,,,,,,,,,,,,,,,,,,,,,,,,,,,,,,,,,,,,,,,,,,,,,,,,,,,,,,,,,,,,,,,,,,,,,,,,,,,,,,,,,,,,,,,,,,,,,,,,,,,,,,,,,,,,,,,,,,,,,,,,,,,,,,,,,,,,,,,,,,,,,,,,,,,,,,,,,,,,,,,,,,,,,,,,,,,,,,,,,,,,,,,,,,,,,,,,,,,,,,,,,,,,,,,,,,,,,,,,,,,,,,,,,,,,,,,,,,,,,,,,,,,,,,,,,,,,,,,,,,,,,,,,,,,,,,,,,,,,,,,,,,,,,,,,,,,,,,,,,,,,,,,,,,,,,,,,,,,,,,,,,,,,,,,,,,,,,,,,,,,,,,,,,,,,,,,,,,,,,,,,,,,,,,,,,,,,,,,,,,,,,,,,,,,,,,,,,,,,,,,,,,,,,,,,,,,,,,,,,,,,,,,,,,,,,,,,,,,,,,,,,,,,,,,,,,,,,,,,,,,,,,,,,,,,,,,,,,,,,,,,,,,,,,,,,,,,,,,,,,,,,,,,,,,,,,,,,,,,,,,,,,,,,,,,,,,,,,,,,,,,,,,,,,,,,,,,,,,,,,,,,,,,,,,,,,,,,,,,,,,,,,,,,,,,,,,,,,,,,,,,,,,,,,,,,,,,,,,,,,,,,,,,,,,,,,,,,,,,,,,,,,,,,,,,,,,,,,,,,,,,,,,,,,,,,,,,,,,,,,,,,,,,,,,,,,,,,,,,,,,,,,,,,,,,,,,,,,,,,,,,,,,,,,,,,,,,,,,,,,,,,,,,,,,,,,,,,,,,,,,,,,,,,,,,,,,,,,,,,,,,,,,,,,,,,,,,,,,,,,,,,,,,,,,,,,,,,,,,,,,,,,,,,,,,,,,,,,,,,,,,,,,,,,,,,,,,,,,,,,,,,,,,,,,,,,,,,,,,,,,,,,,,,,,,,,,,,,,,,,,,,,,,,,,,,,,,,,,,,,,,,,,,,,,,,,,,,,,,,,,,,,,,,,,,,,,,,,,,,,,,,,,,,,,,,,,,,,,,,,,,,,,,,,,,,,,,,,,,,,,,,,,,,,,,,,,,,,,,,,,,,,,,,,,,,,,,,,,,,,,,,,,,,,,,,,,,,,,,,,,,,,,,,,,,,,,,,,,,,,,,,,,,,,,,,,,,,,,,,,,,,,,,,,,,,,,,,,,,,,,,,,,,,,,,,,,,,,,,,,,,,,,,,,,,,,,,,,,,,,,,,,,,,,,,,,,,,,,,,,,,,,,,,,,,,,,,,,,,,,,,,,,,,,,,,,,,,,,,,,,,,,,,,,,,,,,,,,,,,,,,,,,,,,,,,,,,,,,,,,,,,,,,,,,,,,,,,,,,,,,,,,,,,,,,,,,,,,,,,,,,,,,,,,,,,,,,,,,,,,,,,,,,,,,,,,,,,,,,,,,,,,,,,,,,,,,,,,,,,,,,,,,,,,,,,,,,,,,,,,,,,,,,,,,,,,,,,,,,,,,,,,,,,,,,,,,,,,,,,,,,,,,,,,,,,,,,,,,,,,,,,,,,,,,,,,,,,,,,,,,,,,,,,,,,,,,,,,,,,,,,,,,,,,,,,,,,,,,,,,,,,,,,,,,,,,,,,,,,,,,,,,,,,,,,,,,,,,,,,,,,,,,,,,,,,,,,,,,,,,,,,,,,,,,,,,,,,,,,,,,,,,,,,,,,,,,,,,,,,,,,,,,,,,,,,,,,,,,,,,,,,,,,,,,,,,,,,,,,,,,,,,,,,,,,,,,,,,,,,,,,,,,,,,,,,,,,,,,,,,,,,,,,,,,,,,,,,,,,,,,,,,,,,,,,,,,,,,,,,,,,,,,,,,,,,,,,,,,,,,,,,,,,,,,,,,,,,,,,,,,,,,,,,,,,,,,,,,,,,,,,,,,,,,,,,,,,,,,,,,,,,,,,,,,,,,,,,,,,,,,,,,,,,,,,,,,,,,,,,,,,,,,,,,,,,,,,,,,,,,,,,,,,,,,,,,,,,,,,,,,,,,,,,,,,,,,,,,,,,,,,,,,,,,,,,,,,,,,,,,,,,,,,,,,,,,,,,,,,,,,,,,,,,,,,,,,,,,,,,,,,,,,,,,,,,,,,,,,,,,,,,,,,,,,,,,,,,,,,,,,,,,,,,,,,,,,,,,,,,,,,,,,,,,,,,,,,,,,,,,,,,,,,,,,,,,,,,,,,,,,,,,,,,,,,,,,,,,,,,,,,,,,,,,,,,,,,,,,,,,,,,,,,,,,,,,,,,,,,,,,,,,,,,,,,,,,,,,,,,,,,,,,,,,,,,,,,,,,,,,,,,,,,,,,,,,,,,,,,,,,,,,,,,,,,,,,,,,,,,,,,,,,,,,,,,,,,,,,,,,,,,,,,,,,,,,,,,,,,,,,,,,,,,,,,,,,,,,,,,,,,,,,,,,,,,,,,,,,,,,,,,,,,,,,,,,,,,,,,,,,,,,,,,,,,,,,,,,,,,,,,,,,,,,,,,,,,,,,,,,,,,,,,,,,,,,,,,,,,,,,,,,,,,,,,,,,,,,,,,,,,,,,,,,,,,,,,,,,,,,,,,,,,,,,,,,,,,,,,,,,,,,,,,,,,,,,,,,,,,,,,,,,,,,,,,,,,,,,,,,,,,,,,,,,,,,,,,,,,,,,,,,,,,,,,,,,,,,,,,,,,,,,,,,,,,,,,,,,,,,,,,,,,,,,,,,,,,,,,,,,,,,,,,,,,,,,,,,,,,,,,,,,,,,,,,,,,,,,,,,,,,,,,,,,,,,,,,,,,,,,,,,,,,,,,,,,,,,,,,,,,,,,,,,,,,,,,,,,,,,,,,,,,,,,,,,,,,,,,,,,,,,,,,,,,,,,,,,,,,,,,,,,,,,,,,,,,,,,,,,,,,,,,,,,,,,,,,,,,,,,,,,,,,,,,,,,,,,,,,,,,,,,,,,,,,,,,,,,,,,,,,,,,,,,,,,,,,,,,,,,,,,,,,,,,,,,,,,,,,,,,,,,,,,,,,,,,,,,,,,,,,,,,,,,,,,,,,,,,,,,,,,,,,,,,,,,,,,,,,,,,,,,,,,,,,,,,,,,,,,,,,,,,,,,,,,,,,,,,,,,,,,,,,,,,,,,,,,,,,,,,,,,,,,,,,,,,,,,,,,,,,,,,,,,,,,,,,,,,,,,,,,,,,,,,,,,,,,,,,,,,,,,,,,,,,,,,,,,,,,,,,,,,,,,,,,,,,,,,,,,,,,,,,,,,,,,,,,,,,,,,,,,,,,,,,,,,,,,,,,,,,,,,,,,,,,,,,,,,,,,,,,,,,,,,,,,,,,,,,,,,,,,,,,,,,,,,,,,,,,,,,,,,,,,,,,,,,,,,,,,,,,,,,,,,,,,,,,,,,,,,,,,,,,,,,,,,,,,,,,,,,,,,,,,,,,,,,,,,,,,,,,,,,,,,,,,,,,,,,,,,,,,,,,,,,,,,,,,,,,,,,,,,,,,,,,,,,,,,,,,,,,,,,,,,,,,,,,,,,,,,,,,,,,,,,,,,,,,,,,,,,,,,,,,,,,,,,,,,,,,,,,,,,,,,,,,,,,,,,,,,,,,,,,,,,,,,,,,,,,,,,,,,,,,,,,,,,,,,,,,,,,,,,,,,,,,,,,,,,,,,,,,,,,,,,,,,,,,,,,,,,,,,,,,,,,,,,,,,,,,,,,,,,,,,,,,,,,,,,,,,,,,,,,,,,,,,,,,,,,,,,,,,,,,,,,,,,,,,,,,,,,,,,,,,,,,,,,,,,,,,,,,,,,,,,,,,,,,,,,,,,,,,,,,,,,,,,,,,,,,,,,,,,,,,,,,,,,,,,,,,,,,,,,,,,,,,,,,,,,,,,,,,,,,,,,,,,,,,,,,,,,,,,,,,,,,,,,,,,,,,,,,,,,,,,,,,,,,,,,,,,,,,,,,,,,,,,,,,,,,,,,,,,,,,,,,,,,,,,,,,,,,,,,,,,,,,,,,,,,,,,,,,,,,,,,,,,,,,,,,,,,,,,,,,,,,,,,,,,,,,,,,,,,,,,,,,,,,,,,,,,,,,,,,,,,,,,,,,,,,,,,,,,,,,,,,,,,,,,,,,,,,,,,,,,,,,,,,,,,,,,,,,,,,,,,,,,,,,,,,,,,,,,,,,,,,,,,,,,,,,,,,,,,,,,,,,,,,,,,,,,,,,,,,,,,,,,,,,,,,,,,,,,,,,,,,,,,,,,,,,,,,,,,,,,,,,,,,,,,,,,,,,,,,,,,,,,,,,,,,,,,,,,,,,,,,,,,,,,,,,,,,,,,,,,,,,,,,,,,,,,,,,,,,,,,,,,,,,,,,,,,,,,,,,,,,,,,,,,,,,,,,,,,,,,,,,,,,,,,,,,,,,,,,,,,,,,,,,,,,,,,,,,,,,,,,,,,,,,,,,,,,,,,,,,,,,,,,,,,,,,,,,,,,,,,,,,,,,,,,,,,,,,,,,,,,,,,,,,,,,,,,,,,,,,,,,,,,,,,,,,,,,,,,,,,,,,,,,,,,,,,,,,,,,,,,,,,,,,,,,,,,,,,,,,,,,,,,,,,,,,,,,,,,,,,,,,,,,,,,,,,,,,,,,,,,,,,,,,,,,,,,,,,,,,,,,,,,,,,,,,,,,,,,,,,,,,,,,,,,,,,,,,,,,,,,,,,,,,,,,,,,,,,,,,,,,,,,,,,,,,,,,,,,,,,,,,,,,,,,,,,,,,,,,,,,,,,,,,,,,,,,,,,,,,,,,,,,,,,,,,,,,,,,,,,,,,,,,,,,,,,,,,,,,,,,,,,,,,,,,,,,,,,,,,,,,,,,,,,,,,,,,,,,,,,,,,,,,,,,,,,,,,,,,,,,,,,,,,,,,,,,,,,,,,,,,,,,,,,,,,,,,,,,,,,,,,,,,,,,,,,,,,,,,,,,,,,,,,,,,,,,,,,,,,,,,,,,,,,,,,,,,,,,,,,,,,,,,,,,,,,,,,,,,,,,,,,,,,,,,,,,,,,,,,,,,,,,,,,,,,,,,,,,,,,,,,,,,,,,,,,,,,,,,,,,,,,,,,,,,,,,,,,,,,,,,,,,,,,,,,,,,,,,,,,,,,,,,,,,,,,,,,,,,,,,,,,,,,,,,,,,,,,,,,,,,,,,,,,,,,,,,,,,,,,,,,,,,,,,,,,,,,,,,,,,,,,,,,,,,,,,,,,,,,,,,,,,,,,,,,,,,,,,,,,,,,,,,,,,,,,,,,,,,,,,,,,,,,,,,,,,,,,,,,,,,,,,,,,,,,,,,,,,,,,,,,,,,,,,,,,,,,,,,,,,,,,,,,,,,,,,,,,,,,,,,,,,,,,,,,,,,,,,,,,,,,,,,,,,,,,,,,,,,,,,,,,,,,,,,,,,,,,,,,,,,,,,,,,,,,,,,,,,,,,,,,,,,,,,,,,,,,,,,,,,,,,,,,,,,,,,,,,,,,,,,,,,,,,,,,,,,,,,,,,,,,,,,,,,,,,,,,,,,,,,,,,,,,,,,,,,,,,,,,,,,,,,,,,,,,,,,,,,,,,,,,,,,,,,,,,,,,,,,,,,,,,,,,,,,,,,,,,,,,,,,,,,,,,,,,,,,,,,,,,,,,,,,,,,,,,,,,,,,,,,,,,,,,,,,,,,,,,,,,,,,,,,,,,,,,,,,,,,,,,,,,,,,,,,,,,,,,,,,,,,,,,,,,,,,,,,,,,,,,,,,,,,,,,,,,,,,,,,,,,,,,,,,,,,,,,,,,,,,,,,,,,,,,,,,,,,,,,,,,,,,,,,,,,,,,,,,,,,,,,,,,,,,,,,,,,,,,,,,,,,,,,,,,,,,,,,,,,,,,,,,,,,,,,,,,,,,,,,,,,,,,,,,,,,,,,,,,,,,,,,,,,,,,,,,,,,,,,,,,,,,,,,,,,,,,,,,,,,,,,,,,,,,,,,,,,,,,,,,,,,,,,,,,,,,,,,,,,,,,,,,,,,,,,,,,,,,,,,,,,,,,,,,,,,,,,,,,,,,,,,,,,,,,,,,,,,,,,,,,,,,,,,,,,,,,,,,,,,,,,,,,,,,,,,,,,,,,,,,,,,,,,,,,,,,,,,,,,,,,,,,,,,,,,,,,,,,,,,,,,,,,,,,,,,,,,,,,,,,,,,,,,,,,,,,,,,,,,,,,,,,,,,,,,,,,,,,,,,,,,,,,,,,,,,,,,,,,,,,,,,,,,,,,,,,,,,,,,,,,,,,,,,,,,,,,,,,,,,,,,,,,,,,,,,,,,,,,,,,,,,,,,,,,,,,,,,,,,,,,,,,,,,,,,,,,,,,,,,,,,,,,,,,,,,,,,,,,,,,,,,,,,,,,,,,,,,,,,,,,,,,,,,,,,,,,,,,,,,,,,,,,,,,,,,,,,,,,,,,,,,,,,,,,,,,,,,,,,,,,,,,,,,,,,,,,,,,,,,,,,,,,,,,,,,,,,,,,,,,,,,,,,,,,,,,,,,,,,,,,,,,,,,,,,,,,,,,,,,,,,,,,,,,,,,,,,,,,,,,,,,,,,,,,,,,,,,,,,,,,,,,,,,,,,,,,,,,,,,,,,,,,,,,,,,,,,,,,,,,,,,,,,,,,,,,,,,,,,,,,,,,,,,,,,,,,,,,,,,,,,,,,,,,,,,,,,,,,,,,,,,,,,,,,,,,,,,,,,,,,,,,,,,,,,,,,,,,,,,,,,,,,,,,,,,,,,,,,,,,,,,,,,,,,,,,,,,,,,,,,,,,,,,,,,,,,,,,,,,,,,,,,,,,,,,,,,,,,,,,,,,,,,,,,,,,,,,,,,,,,,,,,,,,,,,,,,,,,,,,,,,,,,,,,,,,,,,,,,,,,,,,,,,,,,,,,,,,,,,,,,,,,,,,,,,,,,,,,,,,,,,,,,,,,,,,,,,,,,,,,,,,,,,,,,,,,,,,,,,,,,,,,,,,,,,,,,,,,,,,,,,,,,,,,,,,,,,,,,,,,,,,,,,,,,,,,,,,,,,,,,,,,,,,,,,,,,,,,,,,,,,,,,,,,,,,,,,,,,,,,,,,,,,,,,,,,,,,,,,,,,,,,,,,,,,,,,,,,,,,,,,,,,,,,,,,,,,,,,,,,,,,,,,,,,,,,,,,,,,,,,,,,,,,,,,,,,,,,,,,,,,,,,,,,,,,,,,,,,,,,,,,,,,,,,,,,,,,,,,,,,,,,,,,,,,,,,,,,,,,,,,,,,,,,,,,,,,,,,,,,,,,,,,,,,,,,,,,,,,,,,,,,,,,,,,,,,,,,,,,,,,,,,,,,,,,,,,,,,,,,,,,,,,,,,,,,,,,,,,,,,,,,,,,,,,,,,,,,,,,,,,,,,,,,,,,,,,,,,,,,,,,,,,,,,,,,,,,,,,,,,,,,,,,,,,,,,,,,,,,,,,,,,,,,,,,,,,,,,,,,,,,,,,,,,,,,,,,,,,,,,,,,,,,,,,,,,,,,,,,,,,,,,,,,,,,,,,,,,,,,,,,,,,,,,,,,,,,,,,,,,,,,,,,,,,,,,,,,,,,,,,,,,,,,,,,,,,,,,,,,,,,,,,,,,,,,,,,,,,,,,,,,,,,,,,,,,,,,,,,,,,,,,,,,,,,,,,,,,,,,,,,,,,,,,,,,,,,,,,,,,,,,,,,,,,,,,,,,,,,,,,,,,,,,,,,,,,,,,,,,,,,,,,,,,,,,,,,,,,,,,,,,,,,,,,,,,,,,,,,,,,,,,,,,,,,,,,,,,,,,,,,,,,,,,,,,,,,,,,,,,,,,,,,,,,,,,,,,,,,,,,,,,,,,,,,,,,,,,,,,,,,,,,,,,,,,,,,,,,,,,,,,,,,,,,,,,,,,,,,,,,,,,,,,,,,,,,,,,,,,,,,,,,,,,,,,,,,,,,,,,,,,,,,,,,,,,,,,,,,,,,,,,,,,,,,,,,,,,,,,,,,,,,,,,,,,,,,,,,,,,,,,,,,,,,,,,,,,,,,,,,,,,,,,,,,,,,,,,,,,,,,,,,,,,,,,,,,,,,,,,,,,,,,,,,,,,,,,,,,,,,,,,,,,,,,,,,,,,,,,,,,,,,,,,,,,,,,,,,,,,,,,,,,,,,,,,,,,,,,,,,,,,,,,,,,,,,,,,,,,,,,,,,,,,,,,,,,,,,,,,,,,,,,,,,,,,,,,,,,,,,,,,,,,,,,,,,,,,,,,,,,,,,,,,,,,,,,,,,,,,,,,,,,,,,,,,,,,,,,,,,,,,,,,,,,,,,,,,,,,,,,,,,,,,,,,,,,,,,,,,,,,,,,,,,,,,,,,,,,,,,,,,,,,,,,,,,,,,,,,,,,,,,,,,,,,,,,,,,,,,,,,,,,,,,,,,,,,,,,,,,,,,,,,,,,,,,,,,,,,,,,,,,,,,,,,,,,,,,,,,,,,,,,,,,,,,,,,,,,,,,,,,,,,,,,,,,,,,,,,,,,,,,,,,,,,,,,,,,,,,,,,,,,,,,,,,,,,,,,,,,,,,,,,,,,,,,,,,,,,,,,,,,,,,,,,,,,,,,,,,,,,,,,,,,,,,,,,,,,,,,,,,,,,,,,,,,,,,,,,,,,,,,,,,,,,,,,,,,,,,,,,,,,,,,,,,,,,,,,,,,,,,,,,,,,,,,,,,,,,,,,,,,,,,,,,,,,,,,,,,,,,,,,,,,,,,,,,,,,,,,,,,,,,,,,,,,,,,,,,,,,,,,,,,,,,,,,,,,,,,,,,,,,,,,,,,,,,,,,,,,,,,,,,,,,,,,,,,,,,,,,,,,,,,,,,,,,,,,,,,,,,,,,,,,,,,,,,,,,,,,,,,,,,,,,,,,,,,,,,,,,,,,,,,,,,,,,,,,,,,,,,,,,,,,,,,,,,,,,,,,,,,,,,,,,,,,,,,,,,,,,,,,,,,,,,,,,,,,,,,,,,,,,,,,,,,,,,,,,,,,,,,,,,,,,,,,,,,,,,,,,,,,,,,,,,,,,,,,,,,,,,,,,,,,,,,,,,,,,,,,,,,,,,,,,,,,,,,,,,,,,,,,,,,,,,,,,,,,,,,,,,,,,,,,,,,,,,,,,,,,,,,,,,,,,,,,,,,,,,,,,,,,,,,,,,,,,,,,,,,,,,,,,,,,,,,,,,,,,,,,,,,,,,,,,,,,,,,,,,,,,,,,,,,,,,,,,,,,,,,,,,,,,,,,,,,,,,,,,,,,,,,,,,,,,,,,,,,,,,,,,,,,,,,,,,,,,,,,,,,,,,,,,,,,,,,,,,,,,,,,,,,,,,,,,,,,,,,,,,,,,,,,,,,,,,,,,,,,,,,,,,,,,,,,,,,,,,,,,,,,,,,,,,,,,,,,,,,,,,,,,,,,,,,,,,,,,,,,,,,,,,,,,,,,,,,,,,,,,,,,,,,,,,,,,,,,,,,,,,,,,,,,,,,,,,,,,,,,,,,,,,,,,,,,,,,,,,,,,,,,,,,,,,,,,,,,,,,,,,,,,,,,,,,,,,,,,,,,,,,,,,,,,,,,,,,,,,,,,,,,,,,,,,,,,,,,,,,,,,,,,,,,,,,,,,,,,,,,,,,,,,,,,,,,,,,,,,,,,,,,,,,,,,,,,,,,,,,,,,,,,,,,,,,,,,,,,,,,,,,,,,,,,,,,,,,,,,,,,,,,,,,,,,,,,,,,,,,,,,,,,,,,,,,,,,,,,,,,,,,,,,,,,,,,,,,,,,,,,,,,,,,,,,,,,,,,,,,,,,,,,,,,,,,,,,,,,,,,,,,,,,,,,,,,,,,,,,,,,,,,,,,,,,,,,,,,,,,,,,,,,,,,,,,,,,,,,,,,,,,,,,,,,,,,,,,,,,,,,,,,,,,,,,,,,,,,,,,,,,,,,,,,,,,,,,,,,,,,,,,,,,,,,,,,,,,,,,,,,,,,,,,,,,,,,,,,,,,,,,,,,,,,,,,,,,,,,,,,,,,,,,,,,,,,,,,,,,,,,,,,,,,,,,,,,,,,,,,,,,,,,,,,,,,,,,,,,,,,,,,,,,,,,,,,,,,,,,,,,,,,,,,,,,,,,,,,,,,,,,,,,,,,,,,,,,,,,,,,,,,,,,,,,,,,,,,,,,,,,,,,,,,,,,,,,,,,,,,,,,,,,,,,,,,,,,,,,,,,,,,,,,,,,,,,,,,,,,,,,,,,,,,,,,,,,,,,,,,,,,,,,,,,,,,,,,,,,,,,,,,,,,,,,,,,,,,,,,,,,,,,,,,,,,,,,,,,,,,,,,,,,,,,,,,,,,,,,,,,,,,,,,,,,,,,,,,,,,,,,,,,,,,,,,,,,,,,,,,,,,,,,,,,,,,,,,,,,,,,,,,,,,,,,,,,,,,,,,,,,,,,,,,,,,,,,,,,,,,,,,,,,,,,,,,,,,,,,,,,,,,,,,,,,,,,,,,,,,,,,,,,,,,,,,,,,,,,,,,,,,,,,,,,,,,,,,,,,,,,,,,,,,,,,,,,,,,,,,,,,,,,,,,,,,,,,,,,,,,,,,,,,,,,,,,,,,,,,,,,,,,,,,,,,,,,,,,,,,,,,,,,,,,,,,,,,,,,,,,,,,,,,,,,,,,,,,,,,,,,,,,,,,,,,,,,,,,,,,,,,,,,,,,,,,,,,,,,,,,,,,,,,,,,,,,,,,,,,,,,,,,,,,,,,,,,,,,,,,,,,,,,,,,,,,,,,,,,,,,,,,,,,,,,,,,,,,,,,,,,,,,,,,,,,,,,,,,,,,,,,,,,,,,,,,,,,,,,,,,,,,,,,,,,,,,,,,,,,,,,,,,,,,,,,,,,,,,,,,,,,,,,,,,,,,,,,,,,,,,,,,,,,,,,,,,,,,,,,,,,,,,,,,,,,,,,,,,,,,,,,,,,,,,,,,,,,,,,,,,,,,,,,,,,,,,,,,,,,,,,,,,,,,,,,,,,,,,,,,,,,,,,,,,,,,,,,,,,,,,,,,,,,,,,,,,,,,,,,,,,,,,,,,,,,,,,,,,,,,,,,,,,,,,,,,,,,,,,,,,,,,,,,,,,,,,,,,,,,,,,,,,,,,,,,,,,,,,,,,,,,,,,,,,,,,,,,,,,,,,,,,,,,,,,,,,,,,,,,,,,,,,,,,,,,,,,,,,,,,,,,,,,,,,,,,,,,,,,,,,,,,,,,,,,,,,,,,,,,,,,,,,,,,,,,,,,,,,,,,,,,,,,,,,,,,,,,,,,,,,,,,,,,,,,,,,,,,,,,,,,,,,,,,,,,,,,,,,,,,,,,,,,,,,,,,,,,,,,,,,,,,,,,,,,,,,,,,,,,,,,,,,,,,,,,,,,,,,,,,,,,,,,,,,,,,,,,,,,,,,,,,,,,,,,,,,,,,,,,,,,,,,,,,,,,,,,,,,,,,,,,,,,,,,,,,,,,,,,,,,,,,,,,,,,,,,,,,,,,,,,,,,,,,,,,,,,,,,,,,,,,,,,,,,,,,,,,,,,,,,,,,,,,,,,,,,,,,,,,,,,,,,,,,,,,,,,,,,,,,,,,,,,,,,,,,,,,,,,,,,,,,,,,,,,,,,,,,,,,,,,,,,,,,,,,,,,,,,,,,,,,,,,,,,,,,,,,,,,,,,,,,,,,,,,,,,,,,,,,,,,,,,,,,,,,,,,,,,,,,,,,,,,,,,,,,,,,,,,,,,,,,,,,,,,,,,,,,,,,,,,,,,,,,,,,,,,,,,,,,,,,,,,,,,,,,,,,,,,,,,,,,,,,,,,,,,,,,,,,,,,,,,,,,,,,,,,,,,,,,,,,,,,,,,,,,,,,,,,,,,,,,,,,,,,,,,,,,,,,,,,,,,,,,,,,,,,,,,,,,,,,,,,,,,,,,,,,,,,,,,,,,,,,,,,,,,,,,,,,,,,,,,,,,,,,,,,,,,,,,,,,,,,,,,,,,,,,,,,,,,,,,,,,,,,,,,,,,,,,,,,,,,,,,,,,,,,,,,,,,,,,,,,,,,,,,,,,,,,,,,,,,,,,,,,,,,,,,,,,,,,,,,,,,,,,,,,,,,,,,,,,,,,,,,,,,,,,,,,,,,,,,,,,,,,,,,,,,,,,,,,,,,,,,,,,,,,,,,,,,,,,,,,,,,,,,,,,,,,,,,,,,,,,,,,,,,,,,,,,,,,,,,,,,,,,,,,,,,,,,,,,,,,,,,,,,,,,,,,,,,,,,,,,,,,,,,,,,,,,,,,,,,,,,,,,,,,,,,,,,,,,,,,,,,,,,,,,,,,,,,,,,,,,,,,,,,,,,,,,,,,,,,,,,,,,,,,,,,,,,,,,,,,,,,,,,,,,,,,,,,,,,,,,,,,,,,,,,,,,,,,,,,,,,,,,,,,,,,,,,,,,,,,,,,,,,,,,,,,,,,,,,,,,,,,,,,,,,,,,,,,,,,,,,,,,,,,,,,,,,,,,,,,,,,,,,,,,,,,,,,,,,,,,,,,,,,,,,,,,,,,,,,,,,,,,,,,,,,,,,,,,,,,,,,,,,,,,,,,,,,,,,,,,,,,,,,,,,,,,,,,,,,,,,,,,,,,,,,,,,,,,,,,,,,,,,,,,,,,,,,,,,,,,,,,,,,,,,,,,,,,,,,,,,,,,,,,,,,,,,,,,,,,,,,,,,,,,,,,,,,,,,,,,,,,,,,,,,,,,,,,,,,,,,,,,,,,,,,,,,,,,,,,,,,,,,,,,,,,,,,,,,,,,,,,,,,,,,,,,,,,,,,,,,,,,,,,,,,,,,,,,,,,,,,,,,,,,,,,,,,,,,,,,,,,,,,,,,,,,,,,,,,,,,,,,,,,,,,,,,,,,,,,,,,,,,,,,,,,,,,,,,,,,,,,,,,,,,,,,,,,,,,,,,,,,,,,,,,,,,,,,,,,,,,,,,,,,,,,,,,,,,,,,,,,,,,,,,,,,,,,,,,,,,,,,,,,,,,,,,,,,,,,,,,,,,,,,,,,,,,,,,,,,,,,,,,,,,,,,,,,,,,,,,,,,,,,,,,,,,,,,,,,,,,,,,,,,,,,,,,,,,,,,,,,,,,,,,,,,,,,,,,,,,,,,,,,,,,,,,,,,,,,,,,,,,,,,,,,,,,,,,,,,,,,,,,,,,,,,,,,,,,,,,,,,,,,,,,,,,,,,,,,,,,,,,,,,,,,,,,,,,,,,,,,,,,,,,,,,,,,,,,,,,,,,,,,,,,,,,,,,,,,,,,,,,,,,,,,,,,,,,,,,,,,,,,,,,,,,,,,,,,,,,,,,,,,,,,,,,,,,,,,,,,,,,,,,,,,,,,,,,,,,,,,,,,,,,,,,,,,,,,,,,,,,,,,,,,,,,,,,,,,,,,,,,,,,,,,,,,,,,,,,,,,,,,,,,,,,,,,,,,,,,,,,,,,,,,,,,,,,,,,,,,,,,,,,,,,,,,,,,,,,,,,,,,,,,,,,,,,,,,,,,,,,,,,,,,,,,,,,,,,,,,,,,,,,,,,,,,,,,,,,,,,,,,,,,,,,,,,,,,,,,,,,,,,,,,,,,,,,,,,,,,,,,,,,,,,,,,,,,,,,,,,,,,,,,,,,,,,,,,,,,,,,,,,,,,,,,,,,,,,,,,,,,,,,,,,,,,,,,,,,,,,,,,,,,,,,,,,,,,,,,,,,,,,,,,,,,,,,,,,,,,,,,,,,,,,,,,,,,,,,,,,,,,,,,,,,,,,,,,,,,,,,,,,,,,,,,,,,,,,,,,,,,,,,,,,,,,,,,,,,,,,,,,,,,,,,,,,,,,,,,,,,,,,,,,,,,,,,,,,,,,,,,,,,,,,,,,,,,,,,,,,,,,,,,,,,,,,,,,,,,,,,,,,,,,,,,,,,,,,,,,,,,,,,,,,,,,,,,,,,,,,,,,,,,,,,,,,,,,,,,,,,,,,,,,,,,,,,,,,,,,,,,,,,,,,,,,,,,,,,,,,,,,,,,,,,,,,,,,,,,,,,,,,,,,,,,,,,,,,,,,,,,,,,,,,,,,,,,,,,,,,,,,,,,,,,,,,,,,,,,,,,,,,,,,,,,,,,,,,,,,,,,,,,,,,,,,,,,,,,,,,,,,,,,,,,,,,,,,,,,,,,,,,,,,,,,,,,,,,,,,,,,,,,,,,,,,,,,,,,,,,,,,,,,,,,,,,,,,,,,,,,,,,,,,,,,,,,,,,,,,,,,,,,,,,,,,,,,,,,,,,,,,,,,,,,,,,,,,,,,,,,,,,,,,,,,,,,,,,,,,,,,,,,,,,,,,,,,,,,,,,,,,,,,,,,,,,,,,,,,,,,,,,,,,,,,,,,,,,,,,,,,,,,,,,,,,,,,,,,,,,,,,,,,,,,,,,,,,,,,,,,,,,,,,,,,,,,,,,,,,,,,,,,,,,,,,,,,,,,,,,,,,,,,,,,,,,,,,,,,,,,,,,,,,,,,,,,,,,,,,,,,,,,,,,,,,,,,,,,,,,,,,,,,,,,,,,,,,,,,,,,,,,,,,,,,,,,,,,,,,,,,,,,,,,,,,,,,,,,,,,,,,,,,,,,,,,,,,,,,,,,,,,,,,,,,,,,,,,,,,,,,,,,,,,,,,,,,,,,,,,,,,,,,,,,,,,,,,,,,,,,,,,,,,,,,,,,,,,,,,,,,,,,,,,,,,,,,,,,,,,,,,,,,,,,,,,,,,,,,,,,,,,,,,,,,,,,,,,,,,,,,,,,,,,,,,,,,,,,,,,,,,,,,,,,,,,,,,,,,,,,,,,,,,,,,,,,,,,,,,,,,,,,,,,,,,,,,,,,,,,,,,,,,,,,,,,,,,,,,,,,,,,,,,,,,,,,,,,,,,,,,,,,,,,,,,,,,,,,,,,,,,,,,,,,,,,,,,,,,,,,,,,,,,,,,,,,,,,,,,,,,,,,,,,,,,,,,,,,,,,,,,,,,,,,,,,,,,,,,,,,,,,,,,,,,,,,,,,,,,,,,,,,,,,,,,,,,,,,,,,,,,,,,,,,,,,,,,,,,,,,,,,,,,,,,,,,,,,,,,,,,,,,,,,,,,,,,,,,,,,,,,,,,,,,,,,,,,,,,,,,,,,,,,,,,,,,,,,,,,,,,,,,,,,,,,,,,,,,,,,,,,,,,,,,,,,,,,,,,,,,,,,,,,,,,,,,,,,,,,,,,,,,,,,,,,,,,,,,,,,,,,,,,,,,,,,,,,,,,,,,,,,,,,,,,,,,,,,,,,,,,,,,,,,,,,,,,,,,,,,,,,,,,,,,,,,,,,,,,,,,,,,,,,,,,,,,,,,,,,,,,,,,,,,,,,,,,,,,,,,,,,,,,,,,,,,,,,,,,,,,,,,,,,,,,,,,,,,,,,,,,,,,,,,,,,,,,,,,,,,,,,,,,,,,,,,,,,,,,,,,,,,,,,,,,,,,,,,,,,,,,,,,,,,,,,,,,,,,,,,,,,,,,,,,,,,,,,,,,,,,,,,,,,,,,,,,,,,,,,,,,,,,,,,,,,,,,,,,,,,,,,,,,,,,,,,,,,,,,,,,,,,,,,,,,,,,,,,,,,,,,,,,,,,,,,,,,,,,,,,,,,,,,,,,,,,,,,,,,,,,,,,,,,,,,,,,,,,,,,,,,,,,,,,,,,,,,,,,,,,,,,,,,,,,,,,,,,,,,,,,,,,,,,,,,,,,,,,,,,,,,,,,,,,,,,,,,,,,,,,,,,,,,,,,,,,,,,,,,,,,,,,,,,,,,,,,,,,,,,,,,,,,,,,,,,,,,,,,,,,,,,,,,,,,,,,,,,,,,,,,,,,,,,,,,,,,,,,,,,,,,,,,,,,,,,,,,,,,,,,,,,,,,,,,,,,,,,,,,,,,,,,,,,,,,,,,,,,,,,,,,,,,,,,,,,,,,,,,,,,,,,,,,,,,,,,,,,,,,,,,,,,,,,,,,,,,,,,,,,,,,,,,,,,,,,,,,,,,,,,,,,,,,,,,,,,,,,,,,,,,,,,,,,,,,,,,,,,,,,,,,,,,,,,,,,,,,,,,,,,,,,,,,,,,,,,,,,,,,,,,,,,,,,,,,,,,,,,,,,,,,,,,,,,,,,,,,,,,,,,,,,,,,,,,,,,,,,,,,,,,,,,,,,,,,,,,,,,,,,,,,,,,,,,,,,,,,,,,,,,,,,,,,,,,,,,,,,,,,,,,,,,,,,,,,,,,,,,,,,,,,,,,,,,,,,,,,,,,,,,,,,,,,,,,,,,,,,,,,,,,,,,,,,,,,,,,,,,,,,,,,,,,,,,,,,,,,,,,,,,,,,,,,,,,,,,,,,,,,,,,,,,,,,,,,,,,,,,,,,,,,,,,,,,,,,,,,,,,,,,,,,,,,,,,,,,,,,,,,,,,,,,,,,,,,,,,,,,,,,,,,,,,,,,,,,,,,,,,,,,,,,,,,,,,,,,,,,,,,,,,,,,,,,,,,,,,,,,,,,,,,,,,,,,,,,,,,,,,,,,,,,,,,,,,,,,,,,,,,,,,,,,,,,,,,,,,,,,,,,,,,,,,,,,,,,,,,,,,,,,,,,,,,,,,,,,,,,,,,,,,,,,,,,,,,,,,,,,,,,,,,,,,,,,,,,,,,,,,,,,,,,,,,,,,,,,,,,,,,,,,,,,,,,,,,,,,,,,,,,,,,,,,,,,,,,,,,,,,,,,,,,,,,,,,,,,,,,,,,,,,,,,,,,,,,,,,,,,,,,,,,,,,,,,,,,,,,,,,,,,,,,,,,,,,,,,,,,,,,,,,,,,,,,,,,,,,,,,,,,,,,,,,,,,,,,,,,,,,,,,,,,,,,,,,,,,,,,,,,,,,,,,,,,,,,,,,,,,,,,,,,,,,,,,,,,,,,,,,,,,,,,,,,,,,,,,,,,,,,,,,,,,,,,,,,,,,,,,,,,,,,,,,,,,,,,,,,,,,,,,,,,,,,,,,,,,,,,,,,,,,,,,,,,,,,,,,,,,,,,,,,,,,,,,,,,,,,,,,,,,,,,,,,,,,,,,,,,,,,,,,,,,,,,,,,,,,,,,,,,,,,,,,,,,,,,,,,,,,,,,,,,,,,,,,,,,,,,,,,,,,,,,,,,,,,,,,,,,,,,,,,,,,,,,,,,,,,,,,,,,,,,,,,,,,,,,,,,,,,,,,,,,,,,,,,,,,,,,,,,,,,,,,,,,,,,,,,,,,,,,,,,,,,,,,,,,,,,,,,,,,,,,,,,,,,,,,,,,,,,,,,,,,,,,,,,,,,,,,,,,,,,,,,,,,,,,,,,,,,,,,,,,,,,,,,,,,,,,,,,,,,,,,,,,,,,,,,,,,,,,,,,,,,,,,,,,,,,,,,,,,,,,,,,,,,,,,,,,,,,,,,,,,,,,,,,,,,,,,,,,,,,,,,,,,,,,,,,,,,,,,,,,,,,,,,,,,,,,,,,,,,,,,,,,,,,,,,,,,,,,,,,,,,,,,,,,,,,,,,,,,,,,,,,,,,,,,,,,,,,,,,,,,,,,,,,,,,,,,,,,,,,,,,,,,,,,,,,,,,,,,,,,,,,,,,,,,,,,,,,,,,,,,,,,,,,,,,,,,,,,,,,,,,,,,,,,,,,,,,,,,,,,,,,,,,,,,,,,,,,,,,,,,,,,,,,,,,,,,,,,,,,,,,,,,,,,,,,,,,,,,,,,,,,,,,,,,,,,,,,,,,,,,,,,,,,,,,,,,,,,,,,,,,,,,,,,,,,,,,,,,,,,,,,,,,,,,,,,,,,,,,,,,,,,,,,,,,,,,,,,,,,,,,,,,,,,,,,,,,,,,,,,,,,,,,,,,,,,,,,,,,,,,,,,,,,,,,,,,,,,,,,,,,,,,,,,,,,,,,,,,,,,,,,,,,,,,,,,,,,,,,,,,,,,,,,,,,,,,,,,,,,,,,,,,,,,,,,,,,,,,,,,,,,,,,,,,,,,,,,,,,,,,,,,,,,,,,,,,,,,,,,,,,,,,,,,,,,,,,,,,,,,,,,,,,,,,,,,,,,,,,,,,,,,,,,,,,,,,,,,,,,,,,,,,,,,,,,,,,,,,,,,,,,,,,,,,,,,,,,,,,,,,,,,,,,,,,,,,,,,,,,,,,,,,,,,,,,,,,,,,,,,,,,,,,,,,,,,,,,,,,,,,,,,,,,,,,,,,,,,,,,,,,,,,,,,,,,,,,,,,,,,,,,,,,,,,,,,,,,,,,,,,,,,,,,,,,,,,,,,,,,,,,,,,,,,,,,,,,,,,,,,,,,,,,,,,,,,,,,,,,,,,,,,,,,,,,,,,,,,,,,,,,,,,,,,,,,,,,,,,,,,,,,,,,,,,,,,,,,,,,,,,,,,,,,,,,,,,,,,,,,,,,,,,,,,,,,,,,,,,,,,,,,,,,,,,,,,,,,,,,,,,,,,,,,,,,,,,,,,,,,,,,,,,,,,,,,,,,,,,,,,,,,,,,,,,,,,,,,,,,,,,,,,,,,,,,,,,,,,,,,,,,,,,,,,,,,,,,,,,,,,,,,,,,,,,,,,,,,,,,,,,,,,,,,,,,,,,,,,,,,,,,,,,,,,,,,,,,,,,,,,,,,,,,,,,,,,,,,,,,,,,,,,,,,,,,,,,,,,,,,,,,,,,,,,,,,,,,,,,,,,,,,,,,,,,,,,,,,,,,,,,,,,,,,,,,,,,,,,,,,,,,,,,,,,,,,,,,,,,,,,,,,,,,,,,,,,,,,,,,,,,,,,,,,,,,,,,,,,,,,,,,,,,,,,,,,,,,,,,,,,,,,,,,,,,,,,,,,,,,,,,,,,,,,,,,,,,,,,,,,,,,,,,,,,,,,,,,,,,,,,,,,,,,,,,,,,,,,,,,,,,,,,,,,,,,,,,,,,,,,,,,,,,,,,,,,,,,,,,,,,,,,,,,,,,,,,,,,,,,,,,,,,,,,,,,,,,,,,,,,,,,,,,,,,,,,,,,,,,,,,,,,,,,,,,,,,,,,,,,,,,,,,,,,,,,,,,,,,,,,,,,,,,,,,,,,,,,,,,,,,,,,,,,,,,,,,,,,,,,,,,,,,,,,,,,,,,,,,,,,,,,,,,,,,,,,,,,,,,,,,,,,,,,,,,,,,,,,,,,,,,,,,,,,,,,,,,,,,,,,,,,,,,,,,,,,,,,,,,,,,,,,,,,,,,,,,,,,,,,,,,,,,,,,,,,,,,,,,,,,,,,,,,,,,,,,,,,,,,,,,,,,,,,,,,,,,,,,,,,,,,,,,,,,,,,,,,,,,,,,,,,,,,,,,,,,,,,,,,,,,,,,,,,,,,,,,,,,,,,,,,,,,,,,,,,,,,,,,,,,,,,,,,,,,,,,,,,,,,,,,,,,,,,,,,,,,,,,,,,,,,,,,,,,,,,,,,,,,,,,,,,,,,,,,,,,,,,,,,,,,,,,,,,,,,,,,,,,,,,,,,,,,,,,,,,,,,,,,,,,,,,,,,,,,,,,,,,,,,,,,,,,,,,,,,,,,,,,,,,,,,,,,,,,,,,,,,,,,,,,,,,,,,,,,,,,,,,,,,,,,,,,,,,,,,,,,,,,,,,,,,,,,,,,,,,,,,,,,,,,,,,,,,,,,,,,,,,,,,,,,,,,,,,,,,,,,,,,,,,,,,,,,,,,,,,,,,,,,,,,,,,,,,,,,,,,,,,,,,,,,,,,,,,,,,,,,,,,,,,,,,,,,,,,,,,,,,,,,,,,,,,,,,,,,,,,,,,,,,,,,,,,,,,,,,,,,,,,,,,,,,,,,,,,,,,,,,,,,,,,,,,,,,,,,,,,,,,,,,,,,,,,,,,,,,,,,,,,,,,,,,,,,,,,,,,,,,,,,,,,,,,,,,,,,,,,,,,,,,,,,,,,,,,,,,,,,,,,,,,,,,,,,,,,,,,,,,,,,,,,,,,,,,,,,,,,,,,,,,,,,,,,,,,,,,,,,,,,,,,,,,,,,,,,,,,,,,,,,,,,,,,,,,,,,,,,,,,,,,,,,,,,,,,,,,,,,,,,,,,,,,,,,,,,,,,,,,,,,,,,,,,,,,,,,,,,,,,,,,,,,,,,,,,,,,,,,,,,,,,,,,,,,,,,,,,,,,,,,,,,,,,,,,,,,,,,,,,,,,,,,,,,,,,,,,,,,,,,,,,,,,,,,,,,,,,,,,,,,,,,,,,,,,,,,,,,,,,,,,,,,,,,,,,,,,,,,,,,,,,,,,,,,,,,,,,,,,,,,,,,,,,,,,,,,,,,,,,,,,,,,,,,,,,,,,,,,,,,,,,,,,,,,,,,,,,,,,,,,,,,,,,,,,,,,,,,,,,,,,,,,,,,,,,,,,,,,,,,,,,,,,,,,,,,,,,,,,,,,,,,,,,,,,,,,,,,,,,,,,,,,,,,,,,,,,,,,,,,,,,,,,,,,,,,,,,,,,,,,,,,,,,,,,,,,,,,,,,,,,,,,,,,,,,,,,,,,,,,,,,,,,,,,,,,,,,,,,,,,,,,,,,,,,,,,,,,,,,,,,,,,,,,,,,,,,,,,,,,,,,,,,,,,,,,,,,,,,,,,,,,,,,,,,,,,,,,,,,,,,,,,,,,,,,,,,,,,,,,,,,,,,,,,,,,,,,,,,,,,,,,,,,,,,,,,,,,,,,,,,,,,,,,,,,,,,,,,,,,,,,,,,,,,,,,,,,,,,,,,,,,,,,,,,,,,,,,,,,,,,,,,,,,,,,,,,,,,,,,,,,,,,,,,,,,,,,,,,,,,,,,,,,,,,,,,,,,,,,,,,,,,,,,,,,,,,,,,,,,,,,,,,,,,,,,,,,,,,,,,,,,,,,,,,,,,,,,,,,,,,,,,,,,,,,,,,,,,,,,,,,,,,,,,,,,,,,,,,,,,,,,,,,,,,,,,,,,,,,,,,,,,,,,,,,,,,,,,,,,,,,,,,,,,,,,,,,,,,,,,,,,,,,,,,,,,,,,,,,,,,,,,,,,,,,,,,,,,,,,,,,,,,,,,,,,,,,,,,,,,,,,,,,,,,,,,,,,,,,,,,,,,,,,,,,,,,,,,,,,,,,,,,,,,,,,,,,,,,,,,,,,,,,,,,,,,,,,,,,,,,,,,,,,,,,,,,,,,,,,,,,,,,,,,,,,,,,,,,,,,,,,,,,,,,,,,,,,,,,,,,,,,,,,,,,,,,,,,,,,,,,,,,,,,,,,,,,,,,,,,,,,,,,,,,,,,,,,,,,,,,,,,,,,,,,,,,,,,,,,,,,,,,,,,,,,,,,,,,,,,,,,,,,,,,,,,,,,,,,,,,,,,,,,,,,,,,,,,,,,,,,,,,,,,,,,,,,,,,,,,,,,,,,,,,,,,,,,,,,,,,,,,,,,,,,,,,,,,,,,,,,,,,,,,,,,,,,,,,,,,,,,,,,,,,,,,,,,,,,,,,,,,,,,,,,,,,,,,,,,,,,,,,,,,,,,,,,,,,,,,,,,,,,,,,,,,,,,,,,,,,,,,,,,,,,,,,,,,,,,,,,,,,,,,,,,,,,,,,,,,,,,,,,,,,,,,,,,,,,,,,,,,,,,,,,,,,,,,,,,,,,,,,,,,,,,,,,,,,,,,,,,,,,,,,,,,,,,,,,,,,,,,,,,,,,,,,,,,,,,,,,,,,,,,,,,,,,,,,,,,,,,,,,,,,,,,,,,,,,,,,,,,,,,,,,,,,,,,,,,,,,,,,,,,,,,,,,,,,,,,,,,,,,,,,,,,,,,,,,,,,,,,,,,,,,,,,,,,,,,,,,,,,,,,,,,,,,,,,,,,,,,,,,,,,,,,,,,,,,,,,,,,,,,,,,,,,,,,,,,,,,,,,,,,,,,,,,,,,,,,,,,,,,,,,,,,,,,,,,,,,,,,,,,,,,,,,,,,,,,,,,,,,,,,,,,,,,,,,,,,,,,,,,,,,,,,,,,,,,,,,,,,,,,,
8,3.0,5.0,5.0,5.0,4.0,7.0,3.0,5.0,5.0,4.0,4.0,2.0,2.0,5.0,5.0,22.0,6.0,5.0,5.0,5.0,7.0,2.0,7.0,0.0,2.0,7.0,5.0,4.0,6.0,1.0,4.0,4.0,5.0,11.0,5.0,5.0,5.0,2.0,6.0,6.0,4.0,5.0,4.0,4.0,3.0,4.0,10.0,6.0,2.0,2.0,4.0,2.0,3.0,0.0,3.0,6.0,0.0,3.0,0.0,0.0,0.0,0.0,0.0,0.0,0.0,0.0,0.0,0.0,0.0,0.0,0.0,0.0,0.0,0.0,0.0,0.0,0.0,0.0,0.0,,,,,,,,,0.0,0.0,0.0,0.0,0.0,10.0,,,,,,,,,,,,,,,,,,,,,1.0,5.0,6.0,4.0,5.0,2.0,5.0,3.0,14.0,4.0,5.0,6.0,15.0,2.0,3.0,8.0,5.0,9.0,3.0,10.0,4.0,9.0,3.0,9.0,5.0,6.0,3.0,2.0,2.0,0.0,5.0,4.0,7.0,11.0,8.0,8.0,5.0,5.0,8.0,0.0,4.0,3.0,7.0,3.0,5.0,7.0,1.0,4.0,3.0,15.0,0.0,5.0,5.0,5.0,5.0,4.0,3.0,8.0,11.0,11.0,2.0,7.0,7.0,4.0,7.0,5.0,2.0,5.0,3.0,0.0,11.0,5.0,6.0,4.0,4.0,2.0,4.0,4.0,4.0,7.0,7.0,3.0,4.0,1.0,7.0,12.0,5.0,5.0,1.0,7.0,3.0,5.0,2.0,4.0,2.0,3.0,4.0,3.0,4.0,9.0,7.0,0.0,14.0,11.0,8.0,0.0,1.0,5.0,11.0,4.0,6.0,0.0,1.0,8.0,2.0,8.0,7.0,7.0,0.0,3.0,2.0,8.0,8.0,10.0,1.0,5.0,3.0,5.0,11.0,0.0,3.0,8.0,7.0,3.0,15.0,0.0,5.0,1.0,9.0,13.0,1.0,4.0,4.0,10.0,3.0,13.0,4.0,0.0,10.0,2.0,4.0,8.0,2.0,5.0,11.0,0.0,4.0,5.0,4.0,7.0,9.0,8.0,7.0,5.0,2.0,11.0,7.0,5.0,12.0,7.0,12.0,4.0,5.0,10.0,4.0,10.0,11.0,10.0,5.0,10.0,3.0,4.0,2.0,5.0,8.0,1.0,3.0,3.0,3.0,0.0,2.0,4.0,2.0,3.0,3.0,2.0,8.0,,,,,,,,,,,,,,,,,,,,,,,,,,,,,,,,,,,,,,,,,,,,,,,,,,,,,,,,,,,,,,,,,1.0,1.0,2.0,4.0,1.0,2.0,0.0,1.0,2.0,0.0,3.0,2.0,8.0,0.0,5.0,2.0,2.0,9.0,0.0,3.0,2.0,3.0,1.0,0.0,0.0,2.0,0.0,0.0,1.0,3.0,0.0,3.0,0.0,0.0,0.0,0.0,1.0,0.0,0.0,1.0,1.0,3.0,4.0,3.0,4.0,0.0,2.0,1.0,8.0,3.0,6.0,0.0,0.0,1.0,5.0,6.0,7.0,1.0,6.0,9.0,11.0,1.0,9.0,4.0,9.0,2.0,3.0,5.0,4.0,10.0,10.0,19.0,12.0,3.0,5.0,2.0,15.0,0.0,5.0,9.0,1.0,5.0,5.0,2.0,4.0,6.0,1.0,1.0,2.0,0.0,4.0,2.0,4.0,0.0,3.0,1.0,1.0,1.0,2.0,1.0,0.0,0.0,2.0,4.0,1.0,4.0,5.0,3.0,3.0,0.0,4.0,6.0,5.0,3.0,4.0,5.0,7.0,1.0,2.0,5.0,0.0,1.0,6.0,4.0,6.0,10.0,11.0,0.0,0.0,1.0,13.0,20.0,1.0,2.0,3.0,1.0,2.0,6.0,1.0,8.0,4.0,3.0,6.0,2.0,2.0,8.0,8.0,5.0,8.0,1.0,,,,,,2.0,0.0,2.0,6.0,5.0,1.0,4.0,1.0,6.0,1.0,6.0,3.0,4.0,1.0,2.0,2.0,2.0,,,,,,,,,,,,,,,,,,,,,,,,,,,,,,,,,,13.0,12.0,9.0,6.0,3.0,,,8.0,9.0,15.0,21.0,5.0,9.0,,,,19.0,,,,,,,,,11.0,,,,,,,,10.0,6.0,,,12.0,7.0,12.0,19.0,,16.0,13.0,,0.0,12.0,4.0,,12.0,,,15.0,24.0,24.0,,,10.0,,12.0,6.0,14.0,22.0,17.0,6.0,,,,,,,,,,,,,,,,,,,,,,,,,,,,,,,,,,,,,,,,,,,,,,,,,,,,,,,,,,,,,,,,,,,,,,,,,,8.0,7.0,2.0,1.0,1.0,7.0,10.0,1.0,2.0,13.0,3.0,0.0,6.0,4.0,4.0,0.0,4.0,1.0,1.0,7.0,3.0,6.0,10.0,3.0,6.0,2.0,4.0,4.0,4.0,5.0,3.0,0.0,0.0,4.0,5.0,3.0,2.0,2.0,7.0,3.0,3.0,7.0,6.0,3.0,9.0,13.0,9.0,8.0,8.0,7.0,7.0,10.0,9.0,13.0,6.0,4.0,11.0,11.0,5.0,14.0,6.0,3.0,12.0,11.0,11.0,6.0,5.0,5.0,5.0,8.0,6.0,7.0,8.0,5.0,8.0,0.0,4.0,5.0,4.0,7.0,2.0,5.0,10.0,5.0,3.0,5.0,11.0,9.0,7.0,7.0,12.0,6.0,9.0,7.0,6.0,7.0,11.0,3.0,5.0,6.0,8.0,0.0,5.0,4.0,6.0,7.0,4.0,4.0,5.0,5.0,5.0,5.0,5.0,8.0,4.0,6.0,8.0,3.0,13.0,5.0,3.0,2.0,3.0,5.0,3.0,8.0,6.0,9.0,6.0,8.0,9.0,7.0,4.0,10.0,6.0,6.0,7.0,8.0,6.0,3.0,15.0,4.0,0.0,4.0,3.0,22.0,6.0,15.0,0.0,9.0,12.0,6.0,2.0,9.0,3.0,22.0,27.0,3.0,8.0,19.0,6.0,5.0,2.0,3.0,6.0,21.0,13.0,21.0,20.0,21.0,11.0,16.0,10.0,22.0,2.0,5.0,23.0,13.0,12.0,3.0,0.0,1.0,2.0,0.0,3.0,7.0,3.0,0.0,23.0,5.0,13.0,8.0,1.0,1.0,18.0,14.0,3.0,3.0,15.0,2.0,11.0,18.0,2.0,13.0,4.0,4.0,2.0,2.0,5.0,3.0,2.0,7.0,2.0,0.0,6.0,15.0,18.0,14.0,12.0,15.0,1.0,1.0,21.0,23.0,0.0,14.0,10.0,5.0,10.0,9.0,5.0,4.0,0.0,18.0,7.0,7.0,7.0,21.0,9.0,18.0,9.0,3.0,5.0,5.0,1.0,7.0,10.0,12.0,3.0,11.0,8.0,11.0,11.0,2.0,9.0,4.0,1.0,10.0,7.0,14.0,8.0,8.0,1.0,2.0,2.0,0.0,18.0,2.0,5.0,0.0,4.0,7.0,0.0,24.0,4.0,9.0,9.0,1.0,0.0,8.0,1.0,11.0,8.0,8.0,6.0,0.0,2.0,1.0,6.0,18.0,16.0,7.0,12.0,4.0,9.0,11.0,1.0,0.0,9.0,0.0,1.0,4.0,4.0,1.0,7.0,23.0,5.0,5.0,15.0,3.0,3.0,5.0,19.0,1.0,12.0,4.0,8.0,2.0,22.0,12.0,0.0,14.0,12.0,1.0,11.0,16.0,15.0,5.0,11.0,15.0,0.0,3.0,3.0,3.0,4.0,0.0,1.0,1.0,3.0,1.0,2.0,5.0,1.0,0.0,3.0,6.0,2.0,2.0,0.0,1.0,7.0,6.0,2.0,3.0,2.0,1.0,2.0,2.0,0.0,0.0,2.0,3.0,1.0,4.0,3.0,3.0,1.0,1.0,1.0,0.0,4.0,0.0,4.0,1.0,1.0,1.0,2.0,0.0,2.0,2.0,0.0,1.0,1.0,0.0,4.0,2.0,0.0,5.0,7.0,2.0,2.0,2.0,3.0,2.0,4.0,0.0,2.0,3.0,1.0,1.0,1.0,0.0,0.0,1.0,3.0,0.0,3.0,2.0,10.0,1.0,3.0,11.0,4.0,0.0,0.0,0.0,2.0,6.0,6.0,9.0,12.0,2.0,1.0,2.0,3.0,6.0,2.0,8.0,3.0,0.0,8.0,6.0,0.0,2.0,0.0,5.0,2.0,15.0,8.0,9.0,5.0,2.0,2.0,1.0,1.0,5.0,14.0,2.0,0.0,1.0,5.0,6.0,2.0,5.0,7.0,1.0,4.0,11.0,1.0,5.0,6.0,8.0,7.0,1.0,6.0,8.0,1.0,9.0,4.0,7.0,4.0,3.0,0.0,11.0,2.0,3.0,4.0,1.0,1.0,0.0,0.0,4.0,9.0,0.0,8.0,0.0,1.0,5.0,2.0,5.0,4.0,2.0,10.0,2.0,15.0,0.0,3.0,1.0,1.0,2.0,12.0,1.0,4.0,7.0,0.0,5.0,3.0,5.0,12.0,6.0,9.0,10.0,6.0,10.0,10.0,13.0,15.0,1.0,1.0,7.0,7.0,15.0,2.0,5.0,10.0,7.0,4.0,7.0,10.0,1.0,7.0,2.0,6.0,7.0,8.0,2.0,4.0,6.0,5.0,9.0,10.0,5.0,5.0,7.0,0.0,4.0,6.0,10.0,9.0,8.0,8.0,9.0,12.0,1.0,4.0,2.0,11.0,1.0,9.0,5.0,4.0,2.0,0.0,1.0,0.0,0.0,0.0,0.0,0.0,0.0,0.0,0.0,7.0,0.0,0.0,0.0,2.0,0.0,0.0,0.0,0.0,0.0,1.0,0.0,1.0,0.0,0.0,10.0,0.0,0.0,0.0,3.0,0.0,0.0,0.0,3.0,0.0,2.0,0.0,4.0,2.0,3.0,4.0,3.0,0.0,1.0,5.0,3.0,0.0,0.0,0.0,0.0,3.0,0.0,0.0,0.0,0.0,0.0,2.0,0.0,0.0,0.0,0.0,0.0,4.0,2.0,0.0,0.0,0.0,0.0,0.0,0.0,5.0,3.0,0.0,0.0,0.0,0.0,0.0,2.0,9.0,6.0,0.0,3.0,3.0,0.0,0.0,0.0,0.0,0.0,0.0,0.0,0.0,0.0,0.0,0.0,0.0,4.0,0.0,1.0,0.0,0.0,0.0,0.0,0.0,0.0,0.0,0.0,2.0,0.0,0.0,0.0,0.0,0.0,0.0,0.0,0.0,0.0,0.0,6.0,0.0,0.0,0.0,0.0,0.0,0.0,0.0,0.0,0.0,5.0,0.0,4.0,0.0,2.0,0.0,0.0,4.0,0.0,0.0,0.0,0.0,0.0,0.0,0.0,0.0,1.0,2.0,0.0,0.0,0.0,0.0,0.0,0.0,0.0,1.0,1.0,0.0,0.0,2.0,0.0,0.0,3.0,0.0,0.0,1.0,3.0,4.0,0.0,0.0,0.0,3.0,0.0,0.0,0.0,1.8333333333333333,4.0,0.0,0.0,0.0,0.0,0.0,3.0,2.3333333333333335,0.0,2.0,0.0,1.0,0.0,2.0,3.0,1.0,1.0,6.0,2.0,0.0,0.0,0.0,0.0,0.0,0.0,0.0,0.0,0.0,0.0,0.0,0.0,0.0,0.0,3.0,0.0,0.0,0.0,0.0,1.0,0.0,0.0,0.0,0.0,0.0,0.0,0.0,0.0,0.0,1.0,2.0,2.0,0.0,0.0,0.0,2.0,0.0,0.0,3.0,0.0,0.0,0.0,0.0,0.0,0.0,0.0,0.0,0.0,0.0,0.0,0.0,0.0,0.0,0.0,0.0,0.0,0.0,4.0,0.0,0.0,0.0,3.0,0.0,2.0,1.5,4.0,0.0,0.0,0.0,0.0,0.0,7.0,0.0,0.0,1.0,2.0,0.0,0.0,3.0,0.0,0.0,0.0,0.0,5.0,0.0,0.0,4.0,0.0,0.0,20.0,4.0,15.0,14.0,15.0,13.0,1.0,2.0,11.0,4.0,7.0,12.0,0.0,1.0,21.0,2.0,0.0,0.0,6.0,1.0,0.0,2.0,0.0,3.0,6.0,8.0,23.0,18.0,2.0,17.0,21.0,0.0,2.0,1.0,3.0,26.0,19.0,14.0,2.0,7.0,12.0,34.0,7.0,21.0,11.0,16.0,6.0,13.0,10.0,3.0,7.0,23.0,16.0,0.0,19.0,18.0,19.0,21.0,23.0,10.0,0.0,21.0,16.0,13.0,23.0,24.0,22.0,21.0,13.0,25.0,3.0,8.0,31.0,28.0,18.0,24.0,19.0,2.0,10.0,7.0,18.0,22.0,33.0,39.0,11.0,8.0,13.0,19.0,23.0,0.0,25.0,3.0,0.0,39.0,4.0,8.0,24.0,0.0,1.0,7.0,1.0,1.0,6.0,9.0,1.0,0.0,0.0,1.0,0.0,18.0,5.0,0.0,0.0,0.0,0.0,24.0,8.0,23.0,11.0,22.0,30.0,19.0,11.0,0.0,1.0,2.0,27.0,6.0,21.0,6.0,6.0,2.0,1.0,2.0,2.0,2.0,18.0,8.0,0.0,0.0,0.0,1.0,0.0,0.0,1.0,2.0,25.0,0.0,1.0,20.0,0.0,2.0,5.0,6.0,4.0,8.0,4.0,8.0,0.0,9.0,12.0,8.0,0.0,1.0,3.0,8.0,5.0,16.0,6.0,0.0,2.0,0.0,1.0,0.0,11.0,1.0,9.0,6.0,1.0,9.0,13.0,1.0,4.0,13.0,2.0,12.0,7.0,12.0,3.0,14.0,3.0,10.0,15.0,16.0,1.0,2.0,0.0,1.0,1.0,1.0,1.0,4.0,0.0,0.0,0.0,14.0,0.0,15.0,16.0,0.0,5.0,5.0,0.0,0.0,0.0,0.0,3.0,0.0,1.0,0.0,15.0,17.0,1.0,6.0,2.0,3.0,3.0,9.0,6.0,5.0,1.0,0.0,0.0,16.0,24.0,13.0,1.0,0.0,0.0,0.0,11.0,22.0,0.0,4.0,25.0,1.0,0.0,1.0,16.0,2.0,17.0,2.0,17.0,19.0,17.0,8.0,8.0,17.0,5.0,20.0,13.0,14.0,11.0,27.0,8.0,8.0,16.0,16.0,27.0,21.0,24.0,24.0,30.0,16.0,17.0,31.0,10.0,8.0,28.0,28.0,0.0,2.0,1.0,,14.0,21.0,16.0,13.0,29.0,4.0,21.0,30.0,2.0,2.0,11.0,7.0,18.0,2.0,11.0,3.0,6.0,25.0,19.0,27.0,18.0,10.0,13.0,18.0,11.0,2.0,2.0,17.0,2.0,1.0,12.0,40.0,16.0,7.0,8.0,26.0,12.0,31.0,21.0,25.0,1.0,1.0,28.0,23.0,5.0,32.0,0.0,30.0,35.0,21.0,0.0,20.0,18.0,31.0,14.0,2.0,5.0,11.0,22.0,22.0,4.0,3.0,2.0,0.0,16.0,16.0,4.0,22.0,16.0,3.0,50.0,21.0,15.0,18.0,18.0,21.0,4.0,0.0,4.0,6.0,17.0,10.0,18.0,8.0,6.0,19.0,17.0,25.0,26.0,19.0,19.0,18.0,19.0,14.0,3.0,22.0,18.0,3.0,7.0,8.0,11.0,5.0,3.0,2.0,22.0,14.0,14.0,1.0,2.0,1.0,0.0,21.0,0.0,1.0,13.0,0.0,0.0,13.0,14.0,7.0,5.0,3.0,4.0,3.0,1.0,0.0,0.0,0.0,0.0,0.0,0.0,0.0,,0.0,,,0.0,0.0,0.0,0.0,0.0,10.0,4.0,3.0,3.0,9.0,6.0,6.0,7.0,5.0,4.0,2.0,3.0,5.0,3.0,3.0,1.0,10.0,6.0,2.0,8.0,5.0,6.0,14.0,10.0,6.0,7.0,20.0,8.0,8.0,10.0,6.0,8.0,7.0,5.0,1.0,6.0,17.0,4.0,5.0,7.0,4.0,5.0,1.0,7.0,11.0,3.0,25.0,9.0,6.0,12.0,7.0,10.0,7.0,6.0,5.0,5.0,2.0,7.0,6.0,0.0,5.0,6.0,8.0,6.0,6.0,14.0,2.0,6.0,11.0,6.0,2.0,10.0,21.0,12.0,14.0,7.0,13.0,27.0,26.0,5.0,10.0,16.0,6.0,2.0,7.0,13.0,10.0,9.0,17.0,6.0,5.0,8.0,4.0,16.0,6.0,12.0,0.0,3.0,5.0,6.0,14.0,2.0,8.0,10.0,7.0,10.0,6.0,3.0,1.0,0.0,24.0,2.0,5.0,12.0,1.0,4.0,0.0,9.0,7.0,4.0,5.0,3.0,2.0,3.0,8.0,13.0,29.0,15.0,18.0,10.0,0.0,3.0,0.0,12.0,13.0,8.0,9.0,12.0,0.0,1.0,5.0,5.0,9.0,12.0,5.0,10.0,5.0,1.0,10.0,4.0,0.0,10.0,3.0,6.0,11.0,0.0,5.0,0.0,3.0,2.0,2.0,3.0,2.0,2.0,3.0,0.0,0.0,4.0,0.0,2.0,4.0,8.0,1.0,1.0,4.0,9.0,1.0,5.0,7.0,6.0,7.0,3.0,1.0,8.0,5.0,5.0,2.0,10.0,,2.0,5.0,7.0,12.0,10.0,2.0,10.0,9.0,13.0,14.0,11.0,20.0,5.0,11.0,2.0,4.0,3.0,12.0,2.0,7.0,18.0,2.0,16.0,1.0,33.0,10.0,0.0,2.0,11.0,0.0,6.0,9.0,2.0,64.0,6.0,3.0,10.0,9.0,2.0,4.0,10.0,1.0,6.0,17.0,2.0,2.0,3.0,10.0,1.0,2.0,0.0,7.0,,29.0,5.0,2.0,1.0,16.0,4.0,4.0,14.0,3.0,0.0,7.0,22.0,9.0,1.0,9.0,11.0,3.0,3.0,5.0,2.0,23.0,1.0,12.0,13.0,7.0,3.0,3.0,13.0,1.0,1.0,2.0,3.0,3.0,20.0,14.0,2.0,,2.0,5.0,5.0,17.0,2.0,2.0,16.0,4.0,1.0,9.0,11.0,13.0,11.0,17.0,3.0,17.0,3.0,14.0,4.0,5.0,3.0,1.0,11.0,13.0,7.0,7.0,6.0,3.0,7.0,3.0,8.0,4.0,8.0,,19.0,0.0,6.0,8.0,9.0,12.0,9.0,9.0,15.0,15.0,12.0,19.0,17.0,16.0,3.0,8.0,3.0,2.0,8.0,3.0,5.0,17.0,14.0,17.0,9.0,2.0,4.0,1.0,12.0,4.0,13.0,5.0,17.0,2.0,42.0,25.0,19.0,12.0,17.0,9.0,5.0,2.0,12.0,2.0,2.0,0.0,11.0,10.0,7.0,19.0,8.0,1.0,21.0,17.0,10.0,14.0,10.0,22.0,6.0,7.0,10.0,9.0,10.0,15.0,10.0,9.0,0.0,9.0,25.0,13.0,7.0,12.0,2.0,5.0,19.0,8.0,4.0,14.0,8.0,4.0,1.0,3.0,2.0,17.0,8.0,16.0,19.0,12.0,7.0,3.0,5.0,13.0,10.0,1.0,5.0,8.0,9.0,10.0,,22.0,13.0,5.0,18.0,14.0,1.0,6.0,13.0,13.0,2.0,4.0,8.0,12.0,3.0,10.0,10.0,9.0,,14.0,12.0,13.0,4.0,3.0,8.0,12.0,6.0,10.0,14.0,16.0,9.0,1.0,12.0,13.0,6.0,6.0,1.0,0.0,7.0,1.0,7.0,21.0,10.0,6.0,2.0,3.0,,12.0,16.0,2.0,15.0,6.0,3.0,10.0,12.0,10.0,2.0,14.0,0.0,12.0,3.0,1.0,9.0,1.0,13.0,12.0,6.0,5.0,4.0,9.0,4.0,12.0,13.0,8.0,17.0,2.0,19.0,18.0,16.0,9.0,5.0,16.0,8.0,13.0,8.0,2.0,9.0,12.0,4.0,16.0,1.0,24.0,13.0,2.0,2.0,9.0,19.0,13.0,12.0,14.0,4.0,19.0,16.0,5.0,12.0,1.0,15.0,23.0,18.0,10.0,2.0,4.0,22.0,2.0,11.0,17.0,2.0,6.0,8.0,17.0,10.0,13.0,1.0,4.0,2.0,12.0,15.0,,23.0,14.0,7.0,2.0,2.0,2.0,13.0,3.0,2.0,1.0,7.0,,5.0,1.0,3.0,9.0,13.0,4.0,4.0,10.0,7.0,13.0,11.0,12.0,17.0,10.0,25.0,6.0,5.0,7.0,3.0,2.0,2.0,8.0,6.0,6.0,11.0,5.0,21.0,0.0,3.0,1.0,6.0,11.0,3.0,3.0,1.0,2.0,4.0,9.0,13.0,17.0,14.0,,3.0,8.0,14.0,1.0,0.0,8.0,14.0,4.0,18.0,2.0,11.0,18.0,2.0,8.0,5.0,15.0,10.0,15.0,2.0,9.0,2.0,13.0,6.0,7.0,1.0,17.0,15.0,,7.0,4.0,10.0,3.0,5.0,0.0,10.0,23.0,0.0,28.0,3.0,8.0,4.0,4.0,4.0,21.0,4.0,8.0,1.0,6.0,2.0,1.0,0.0,0.0,5.0,2.0,9.0,8.0,1.0,9.0,8.0,6.0,8.0,,,,,,,,,,,,,,,,,,,,,,,,,,,,,,,,,,,,,,,,,,,,,,,,,,,,,,,,,,,,,,,,,,,,,,,5.0,15.0,5.0,5.0,15.0,8.0,6.0,23.0,5.0,3.0,7.0,6.0,25.0,15.0,13.0,5.0,5.0,2.0,5.0,13.0,29.0,9.0,10.0,15.0,9.0,8.0,15.0,1.0,14.0,5.0,9.0,8.0,5.0,19.0,20.0,9.0,14.0,1.0,21.0,15.0,11.0,4.0,12.0,18.0,0.0,13.0,12.0,11.0,1.0,5.0,5.0,20.0,5.0,26.0,11.0,16.0,8.0,10.0,19.0,14.0,0.0,17.0,13.0,10.0,6.0,16.0,9.0,8.0,9.0,5.0,12.0,21.0,16.0,18.0,11.0,15.0,13.0,14.0,8.0,20.0,17.0,4.0,12.0,8.0,6.0,3.0,28.0,4.0,11.0,4.0,9.0,2.0,15.0,12.0,16.0,27.0,8.0,22.0,12.0,17.0,15.0,17.0,7.0,13.0,20.0,11.0,10.0,11.0,3.0,14.0,21.0,18.0,10.0,12.0,7.0,9.0,2.0,10.0,10.0,11.0,10.0,13.0,27.0,4.0,9.0,7.0,16.0,5.0,9.0,11.0,10.0,14.0,1.0,2.0,19.0,15.0,2.0,2.0,20.0,25.0,31.0,10.0,9.0,11.0,10.0,2.0,11.0,10.0,15.0,7.0,8.0,2.0,22.0,17.0,17.0,1.0,5.0,5.0,8.0,15.0,14.0,10.0,9.0,13.0,12.0,4.0,18.0,6.0,3.0,23.0,14.0,14.0,13.0,18.0,3.0,0.0,21.0,20.0,22.0,5.0,3.0,23.0,11.0,8.0,18.0,2.0,19.0,15.0,12.0,6.0,12.0,5.0,34.0,17.0,13.0,8.0,9.0,8.0,14.0,7.0,10.0,13.0,13.0,7.0,10.0,20.0,10.0,2.0,18.0,24.0,15.0,15.0,15.0,9.0,10.0,9.0,18.0,13.0,21.0,5.0,18.0,7.0,10.0,9.0,10.0,2.0,13.0,23.0,15.0,22.0,3.0,11.0,7.0,13.0,7.0,14.0,7.0,3.0,7.0,8.0,20.0,19.0,9.0,12.0,15.0,9.0,9.0,10.0,9.0,5.0,11.0,14.0,15.0,12.0,12.0,16.0,11.0,14.0,15.0,12.0,15.0,15.0,3.0,9.0,8.0,8.0,7.0,12.0,1.0,9.0,9.0,6.0,16.0,24.0,11.0,11.0,15.0,12.0,13.0,14.0,12.0,12.0,9.0,4.0,17.0,5.0,18.0,11.0,9.0,15.0,5.0,8.0,6.0,14.0,17.0,11.0,13.0,7.0,2.0,19.0,0.0,3.0,0.0,13.0,10.0,8.0,17.0,15.0,15.0,13.0,7.0,1.0,10.0,4.0,0.0,4.0,15.0,10.0,17.0,19.0,11.0,4.0,13.0,14.0,20.0,11.0,11.0,20.0,2.0,5.0,,,,,,,,3.0,26.0,8.0,12.0,16.0,11.0,2.0,14.0,13.0,8.0,3.0,6.0,4.0,8.0,5.0,5.0,3.0,8.0,10.0,2.0,8.0,7.0,10.0,12.0,5.0,7.0,7.0,15.0,20.0,19.0,4.0,13.0,13.0,8.0,12.0,12.0,2.0,6.0,10.0,14.0,4.0,17.0,8.0,12.0,12.0,7.0,10.0,14.0,10.0,11.0,11.0,10.0,11.0,14.0,8.0,13.0,22.0,1.0,6.0,10.0,13.0,19.0,3.0,0.0,1.0,3.0,12.0,12.0,6.0,11.0,3.0,11.0,5.0,12.0,11.0,7.0,12.0,20.0,20.0,19.0,0.0,7.0,2.0,12.0,1.0,8.0,5.0,8.0,16.0,8.0,2.0,8.0,15.0,11.0,15.0,8.0,7.0,13.0,4.0,3.0,7.0,7.0,1.0,11.0,3.0,3.0,7.0,12.0,12.0,3.0,7.0,5.0,2.0,5.0,3.0,1.0,9.0,7.0,7.0,8.0,13.0,2.0,12.0,10.0,2.0,2.0,10.0,3.0,9.0,8.0,1.0,4.0,1.0,2.0,9.0,1.0,2.0,13.0,1.0,0.0,3.0,5.0,3.0,3.0,1.0,4.0,3.0,1.0,15.0,6.0,1.0,3.0,9.0,10.0,11.0,2.0,5.0,7.0,12.0,10.0,3.0,10.0,2.0,2.0,9.0,11.0,3.0,5.0,9.0,13.0,9.0,1.0,1.0,6.0,13.0,13.0,12.0,5.0,12.0,12.0,5.0,0.0,12.0,4.0,6.0,8.0,4.0,3.0,5.0,2.0,2.0,1.0,27.0,2.0,0.0,11.0,9.0,8.0,6.0,1.0,0.0,3.0,6.0,8.0,3.0,10.0,4.0,1.0,6.0,12.0,13.0,13.0,0.0,28.0,13.0,2.0,2.0,7.0,5.0,1.0,2.0,2.0,2.0,5.0,2.0,9.0,8.0,10.0,18.0,2.0,2.0,6.0,2.0,12.0,1.0,3.0,7.0,4.0,12.0,11.0,3.0,1.0,2.0,19.0,5.0,3.0,2.0,6.0,4.0,20.0,2.0,2.0,9.0,9.0,4.0,6.0,2.0,7.0,5.0,4.0,7.0,7.0,2.0,5.0,3.0,8.0,4.0,6.0,4.0,10.0,4.0,1.0,2.0,4.0,1.0,6.0,1.0,5.0,2.0,10.0,7.0,1.0,4.0,3.0,9.0,6.0,16.0,4.0,8.0,7.0,7.0,8.0,13.0,13.0,3.0,8.0,9.0,13.0,7.0,9.0,7.0,7.0,14.0,3.0,2.0,15.0,12.0,4.0,18.0,11.0,12.0,2.0,2.0,4.0,4.0,2.0,10.0,7.0,3.0,4.0,5.0,6.0,4.0,1.0,2.0,16.0,2.0,3.0,2.0,4.0,2.0,0.0,0.0,4.0,2.0,5.0,19.0,9.0,0.0,3.0,38.0,3.0,9.0,7.0,9.0,1.0,4.0,7.0,6.0,5.0,1.0,4.0,8.0,8.0,8.0,3.0,1.0,6.0,9.0,3.0,3.0,4.0,29.0,9.0,8.0,8.0,4.0,3.0,3.0,7.0,8.0,2.0,9.0,3.0,5.0,6.0,5.0,3.0,5.0,3.0,4.0,4.0,3.0,3.0,2.0,6.0,9.0,13.0,2.0,12.0,3.0,5.0,3.0,9.0,1.0,14.0,14.0,8.0,4.0,10.0,5.0,4.0,1.0,4.0,2.0,6.0,4.0,7.0,6.0,4.0,6.0,6.0,6.0,3.0,6.0,5.0,6.0,5.0,5.0,8.0,11.0,5.0,5.0,5.0,5.0,30.0,3.0,2.0,3.0,3.0,0.0,3.0,2.0,2.0,3.0,3.0,3.0,10.0,4.0,3.0,3.0,8.0,5.0,8.0,3.0,8.0,5.0,2.0,8.0,8.0,4.0,3.0,5.0,7.0,4.0,7.0,2.0,2.0,11.0,15.0,11.0,15.0,9.0,11.0,4.0,2.0,8.0,12.0,10.0,7.0,8.0,15.0,18.0,10.0,4.0,11.0,9.0,10.0,13.0,11.0,14.0,13.0,13.0,10.0,25.0,3.0,15.0,20.0,13.0,10.0,8.0,13.0,10.0,6.0,6.0,3.0,6.0,6.0,8.0,9.0,6.0,7.0,5.0,13.0,10.0,3.0,11.0,10.0,2.0,7.0,7.0,3.0,19.0,11.0,6.0,3.0,14.0,1.0,5.0,3.0,4.0,3.0,10.0,6.0,2.0,3.0,4.0,3.0,3.0,5.0,6.0,4.0,5.0,3.0,3.0,2.0,4.0,4.0,4.0,3.0,5.0,7.0,6.0,3.0,4.0,3.0,3.0,2.0,3.0,5.0,6.0,3.0,4.0,4.0,4.0,4.0,4.0,3.0,8.0,5.0,8.0,9.0,7.0,5.0,4.0,6.0,1.0,10.0,9.0,10.0,10.0,10.0,16.0,5.0,14.0,13.0,5.0,5.0,4.0,13.0,3.0,10.0,5.0,3.0,7.0,7.0,1.0,7.0,3.0,4.0,4.0,4.0,5.0,5.0,6.0,6.0,8.0,7.0,8.0,6.0,7.0,5.0,3.0,11.0,13.0,6.0,16.0,8.0,5.0,8.0,9.0,11.0,6.0,4.0,13.0,7.0,12.0,8.0,10.0,11.0,12.0,4.0,5.0,4.0,8.0,6.0,7.0,14.0,5.0,7.0,10.0,7.0,4.0,5.0,11.0,10.0,7.0,10.0,9.0,10.0,9.0,8.0,7.0,13.0,5.0,2.0,14.0,21.0,2.0,8.0,7.0,14.0,5.0,12.0,15.0,7.0,7.0,8.0,6.0,3.0,17.0,10.0,9.0,12.0,8.0,7.0,8.0,6.0,8.0,11.0,5.0,14.0,9.0,6.0,6.0,11.0,8.0,8.0,5.0,12.0,5.0,9.0,7.0,1.0,12.0,12.0,7.0,7.0,10.0,9.0,8.0,11.0,9.0,12.0,8.0,9.0,3.0,11.0,9.0,4.0,1.0,7.0,13.0,3.0,13.0,9.0,9.0,6.0,3.0,4.0,14.0,5.0,5.0,4.0,9.0,4.0,15.0,10.0,5.0,7.0,2.0,10.0,8.0,7.0,9.0,13.0,12.0,7.0,7.0,15.0,18.0,12.0,6.0,11.0,6.0,16.0,9.0,12.0,4.0,7.0,5.0,17.0,15.0,6.0,3.0,10.0,7.0,8.0,10.0,6.0,9.0,10.0,5.0,11.0,7.0,7.0,5.0,6.0,8.0,9.0,1.0,5.0,9.0,5.0,7.0,5.0,9.0,6.0,3.0,2.0,7.0,6.0,7.0,6.0,13.0,4.0,3.0,8.0,10.0,12.0,8.0,7.0,5.0,10.0,8.0,10.0,8.0,3.0,8.0,5.0,5.0,8.0,8.0,6.0,8.0,6.0,4.0,3.0,7.0,,,,,,,,,,,,,,,,,,,,,,,,,,,,,,,,,,,,,,,,,,,,,,,,,,,,,,,,,,,,,,,,,,,,,,,,,,,,,,,,,,,,,,,,,,,,,,,,,,,,,,,,,,,,,,,,,,,,,,,,,,,,,,,,,,,,,,,,,,,,,,,,,,,,,,,,,,,,,,,,,,,9.0,21.0,7.0,19.0,10.0,27.0,13.0,22.0,14.0,37.0,12.0,8.0,16.0,12.0,3.0,12.0,15.0,11.0,29.0,14.0,6.0,17.0,25.0,12.0,11.0,18.0,1.0,0.0,8.0,3.0,5.0,11.0,6.0,9.0,14.0,12.0,2.0,14.0,2.0,9.0,9.0,1.0,17.0,10.0,19.0,20.0,10.0,5.0,7.0,14.0,,9.0,19.0,26.0,8.0,13.0,12.0,14.0,13.0,16.0,3.0,9.0,8.0,22.0,2.0,12.0,17.0,27.0,15.0,15.0,19.0,15.0,7.0,22.0,3.0,22.0,25.0,7.0,5.0,22.0,22.0,29.0,10.0,17.0,16.0,19.0,8.0,4.0,14.0,5.0,1.0,2.0,0.0,1.0,5.0,4.0,3.0,9.0,14.0,10.0,10.0,12.0,11.0,8.0,12.0,21.0,0.0,2.0,4.0,14.0,23.0,25.0,8.0,8.0,10.0,15.0,7.0,1.0,1.0,0.0,9.0,22.0,21.0,6.0,14.0,1.0,7.0,6.0,16.0,22.0,24.0,19.0,8.0,6.0,18.0,19.0,1.0,4.0,4.0,9.0,8.0,17.0,14.0,11.0,14.0,0.0,14.0,13.0,14.0,8.0,18.0,15.0,9.0,19.0,15.0,25.0,8.0,16.0,14.0,30.0,15.0,23.0,5.0,3.0,20.0,21.0,19.0,11.0,15.0,13.0,11.0,7.0,17.0,14.0,6.0,1.0,9.0,18.0,26.0,19.0,0.0,14.0,1.0,2.0,24.0,15.0,6.0,11.0,10.0,0.0,6.0,20.0,14.0,11.0,9.0,2.0,21.0,0.0,10.0,11.0,14.0,5.0,10.0,24.0,5.0,10.0,1.0,7.0,15.0,2.0,0.0,3.0,6.0,17.0,12.0,16.0,9.0,14.0,7.0,8.0,12.0,5.0,14.0,12.0,9.0,21.0,20.0,18.0,13.0,1.0,20.0,9.0,13.0,11.0,19.0,19.0,15.0,13.0,14.0,3.0,8.0,12.0,16.0,25.0,5.0,17.0,8.0,1.0,3.0,3.0,6.0,0.0,2.0,9.0,10.0,5.0,12.0,22.0,10.0,19.0,0.0,5.0,8.0,27.0,13.0,13.0,15.0,7.0,0.0,2.0,0.0,2.0,14.0,0.0,0.0,2.0,8.0,16.0,16.0,9.0,0.0,14.0,17.0,18.0,17.0,11.0,2.0,4.0,14.0,12.0,14.0,1.0,14.0,0.0,13.0,0.0,1.0,8.0,5.0,5.0,11.0,8.0,2.0,6.0,1.0,7.0,4.0,11.0,14.0,15.0,13.0,1.0,8.0,1.0,13.0,18.0,16.0,23.0,19.0,11.0,13.0,2.0,8.0,0.0,0.0,0.0,19.0,6.0,0.0,3.0,13.0,13.0,20.0,19.0,1.0,8.0,5.0,2.0,0.0,11.0,12.0,9.0,0.0,24.0,3.0,0.0,9.0,7.0,14.0,17.0,17.0,11.0,19.0,0.0,15.0,12.0,3.0,4.0,20.0,9.0,17.0,31.0,22.0,6.0,0.0,44.0,14.0,2.0,17.0,7.0,16.0,11.0,11.0,8.0,20.0,11.0,23.0,8.0,0.0,4.0,1.0,11.0,16.0,2.0,11.0,5.0,12.0,8.0,23.0,9.0,14.0,27.0,11.0,4.0,8.0,0.0,11.0,6.0,20.0,17.0,3.0,1.0,1.0,11.0,6.0,16.0,11.0,17.0,15.0,22.0,11.0,16.0,17.0,2.0,2.0,6.0,1.0,15.0,13.0,1.0,0.0,22.0,1.0,0.0,17.0,19.0,14.0,19.0,16.0,0.0,0.0,3.0,13.0,19.0,20.0,9.0,,0.0,9.0,5.0,22.0,15.0,3.0,2.0,31.0,7.0,12.0,4.0,1.0,0.0,0.0,26.0,8.0,3.0,13.0,10.0,0.0,3.0,16.0,1.0,0.0,13.0,1.0,13.0,4.0,0.0,1.0,0.0,13.0,5.0,0.0,14.0,2.0,13.0,6.0,9.0,2.0,8.0,18.0,13.0,19.0,27.0,10.0,11.0,6.0,0.0,0.0,0.0,1.0,3.0,16.0,13.0,15.0,12.0,10.0,5.0,8.0,1.0,14.0,14.0,12.0,9.0,19.0,9.0,0.0,4.0,16.0,3.0,2.0,0.0,5.0,21.0,9.0,6.0,9.0,23.0,11.0,19.0,2.0,9.0,12.0,8.0,9.0,12.0,13.0,15.0,15.0,25.0,15.0,23.0,13.0,18.0,19.0,11.0,15.0,24.0,18.0,9.0,1.0,0.0,23.0,11.0,13.0,18.0,20.0,11.0,18.0,12.0,15.0,0.0,0.0,7.0,0.0,10.0,12.0,1.0,14.0,6.0,10.0,21.0,5.0,10.0,26.0,13.0,18.0,6.0,6.0,9.0,5.0,3.0,19.0,15.0,12.0,1.0,15.0,19.0,15.0,0.0,7.0,0.0,4.0,2.0,17.0,8.0,0.0,0.0,1.0,14.0,14.0,18.0,7.0,12.0,10.0,11.0,9.0,8.0,9.0,1.0,12.0,21.0,7.0,12.0,15.0,11.0,7.0,0.0,0.0,8.0,17.0,11.0,9.0,8.0,25.0,20.0,10.0,9.0,4.0,0.0,0.0,0.0,14.0,16.0,3.0,11.0,10.0,0.0,6.0,10.0,13.0,8.0,10.0,9.0,12.0,7.0,6.0,19.0,12.0,3.0,12.0,6.0,11.0,13.0,6.0,6.0,10.0,20.0,14.0,10.0,13.0,7.0,5.0,0.0,4.0,21.0,8.0,8.0,8.0,6.0,8.0,10.0,14.0,9.0,0.0,14.0,7.0,2.0,6.0,1.0,7.0,0.0,9.0,10.0,6.0,19.0,20.0,0.0,0.0,11.0,6.0,9.0,2.0,7.0,9.0,13.0,1.0,10.0,11.0,10.0,8.0,12.0,14.0,5.0,7.0,9.0,4.0,14.0,11.0,9.0,21.0,4.0,12.0,13.0,20.0,16.0,19.0,7.0,7.0,15.0,7.0,19.0,15.0,11.0,12.0,20.0,11.0,13.0,15.0,15.0,17.0,11.0,8.0,21.0,7.0,23.0,12.0,20.0,4.0,8.0,12.0,9.0,20.0,20.0,12.0,15.0,9.0,5.0,7.0,0.0,13.0,6.0,14.0,0.0,7.0,6.0,14.0,18.0,5.0,23.0,20.0,12.0,0.0,8.0,10.0,6.0,3.0,3.0,14.0,12.0,0.0,0.0,8.0,15.0,1.0,7.0,7.0,5.0,1.0,5.0,6.0,7.0,0.0,5.0,13.0,17.0,7.0,4.0,11.0,6.0,0.0,15.0,11.0,0.0,0.0,7.0,5.0,10.0,9.0,0.0,0.0,0.0,0.0,1.0,1.0,0.0,3.0,5.0,8.0,3.0,12.0,13.0,10.0,7.0,0.0,8.0,13.0,22.0,1.0,17.0,18.0,13.0,1.0,2.0,17.0,15.0,14.0,7.0,12.0,5.0,4.0,7.0,2.0,0.0,12.0,6.0,4.0,5.0,6.0,0.0,6.0,15.0,5.0,9.0,7.0,12.0,12.0,12.0,1.0,0.0,21.0,17.0,1.0,5.0,14.0,6.0,18.0,6.0,2.0,0.0,1.0,9.0,10.0,9.0,3.0,18.0,2.0,1.0,13.0,15.0,18.0,13.0,6.0,3.0,5.0,0.0,8.0,21.0,12.0,6.0,30.0,14.0,1.0,5.0,0.0,10.0,11.0,3.0,17.0,16.0,10.0,4.0,0.0,1.0,0.0,7.0,15.0,0.0,6.0,0.0,0.0,12.0,1.0,1.0,14.0,6.0,11.0,3.0,9.0,11.0,3.0,8.0,12.0,0.0,0.0,12.0,17.0,4.0,13.0,8.0,18.0,2.0,0.0,1.0,2.0,7.0,10.0,17.0,10.0,1.0,15.0,17.0,0.0,19.0,0.0,4.0,14.0,11.0,19.0,10.0,14.0,4.0,11.0,5.0,0.0,3.0,12.0,11.0,1.0,14.0,9.0,7.0,7.0,7.0,3.0,7.0,35.0,5.0,3.0,3.0,5.0,4.0,14.0,1.0,1.0,0.0,1.0,6.0,11.0,25.0,1.0,1.0,7.0,18.0,12.0,9.0,0.0,12.0,2.0,0.0,11.0,0.0,0.0,9.0,7.0,3.0,18.0,10.0,8.0,11.0,11.0,13.0,1.0,0.0,3.0,18.0,5.0,2.0,10.0,0.0,12.0,15.0,3.0,6.0,15.0,14.0,9.0,1.0,4.0,2.0,14.0,7.0,1.0,12.0,12.0,9.0,7.0,5.0,0.0,8.0,3.0,9.0,0.0,16.0,15.0,0.0,12.0,15.0,17.0,1.0,11.0,13.0,13.0,7.0,2.0,21.0,16.0,14.0,22.0,0.0,10.0,14.0,12.0,10.0,14.0,9.0,1.0,22.0,0.0,7.0,0.0,1.0,35.0,16.0,13.0,1.0,0.0,0.0,0.0,0.0,0.0,2.0,5.0,3.0,3.0,1.0,0.0,3.0,1.0,0.0,1.0,10.0,0.0,4.0,0.0,1.0,6.0,0.0,5.0,0.0,0.0,0.0,0.0,0.0,0.0,5.0,1.0,0.0,0.0,0.0,0.0,0.0,4.0,1.0,1.0,1.0,0.0,0.0,2.0,0.0,0.0,0.0,1.0,2.0,3.0,2.0,4.0,3.0,0.0,1.0,0.0,3.0,2.0,0.0,0.0,0.0,0.0,1.0,0.0,0.0,2.0,2.0,0.0,1.0,0.0,0.0,2.0,0.0,2.0,2.0,0.0,0.0,0.0,0.0,0.0,1.0,0.0,3.0,0.0,1.0,4.0,2.0,0.0,0.0,0.0,0.0,0.0,0.0,3.0,1.0,1.0,1.0,0.0,0.0,3.0,8.0,12.0,1.0,3.0,2.0,1.0,3.0,6.0,9.0,2.0,3.0,10.0,13.0,11.0,9.0,6.0,2.0,5.0,4.0,11.0,9.0,8.0,7.0,7.0,9.0,1.0,0.0,3.0,1.0,4.0,4.0,8.0,4.0,8.0,0.0,9.0,13.0,9.0,5.0,7.0,6.0,2.0,9.0,0.0,1.0,3.0,3.0,2.0,2.0,4.0,3.0,4.0,6.0,5.0,2.0,2.0,8.0,3.0,5.0,3.0,5.0,2.0,1.0,5.0,1.0,2.0,6.0,3.0,3.0,5.0,4.0,1.0,3.0,8.0,6.0,3.0,5.0,7.0,1.0,3.0,10.0,3.0,4.0,5.0,4.0,0.0,3.0,5.0,5.0,4.0,0.0,1.0,8.0,0.0,0.0,4.0,3.0,4.0,5.0,2.0,0.0,3.0,2.0,3.0,6.0,7.0,1.0,2.0,4.0,4.0,0.0,2.0,2.0,4.0,0.0,0.0,2.0,7.0,6.0,7.0,5.0,2.0,2.0,4.0,9.0,3.0,3.0,3.0,2.0,2.0,5.0,6.0,6.0,6.0,4.0,0.0,5.0,3.0,5.0,4.0,4.0,4.0,0.0,3.0,2.0,11.0,3.0,7.0,14.0,5.0,11.0,7.0,6.0,3.0,3.0,3.0,4.0,4.0,2.0,12.0,7.0,3.0,6.0,0.0,1.0,8.0,3.0,3.0,0.0,2.0,7.0,0.0,1.0,1.0,1.0,3.0,2.0,0.0,0.0,2.0,0.0,2.0,7.0,1.0,1.0,6.0,0.0,0.0,0.0,0.0,0.0,4.0,8.0,11.0,6.0,5.0,4.0,5.0,4.0,6.0,8.0,4.0,6.0,5.0,6.0,3.0,4.0,9.0,8.0,4.0,6.0,7.0,6.0,4.0,7.0,8.0,5.0,7.0,4.0,12.0,3.0,13.0,5.0,7.0,7.0,5.0,5.0,5.0,3.0,9.0,3.0,7.0,4.0,5.0,10.0,6.0,2.0,2.0,9.0,6.0,5.0,13.0,4.0,2.0,3.0,6.0,4.0,6.0,8.0,8.0,5.0,5.0,6.0,2.0,7.0,7.0,3.0,6.0,6.0,2.0,3.0,10.0,4.0,2.0,7.0,14.0,6.0,8.0,2.0,11.0,2.0,3.0,6.0,8.0,2.0,6.0,3.0,4.0,7.0,5.0,2.0,5.0,5.0,11.0,5.0,5.0,6.0,6.0,8.0,5.0,3.0,3.0,2.0,4.0,2.0,6.0,7.0,5.0,5.0,6.0,7.0,4.0,3.0,4.0,5.0,4.0,5.0,0.0,0.0,4.0,4.0,5.0,5.0,5.0,5.0,5.0,5.0,4.0,4.0,5.0,5.0,5.0,5.0,4.0,3.0,3.0,5.0,4.0,5.0,5.0,0.0,4.0,5.0,5.0,3.0,3.0,3.0,4.0,5.0,0.0,7.0,0.0,1.0,5.0,0.0,4.0,8.0,8.0,0.0,12.0,1.0,7.0,0.0,14.0,0.0,1.0,1.0,0.0,0.0,0.0,7.0,2.0,1.0,6.0,0.0,1.0,5.0,7.0,3.0,9.0,10.0,0.0,1.0,10.0,5.0,6.0,0.0,0.0,16.0,9.0,1.0,14.0,1.0,7.0,16.0,4.0,1.0,4.0,0.0,0.0,1.0,12.0,0.0,1.0,1.0,3.0,0.0,19.0,0.0,2.0,0.0,12.0,0.0,0.0,8.0,0.0,0.0,0.0,3.0,1.0,0.0,6.0,0.0,0.0,4.0,2.0,0.0,0.0,0.0,3.0,15.0,1.0,3.0,0.0,4.0,2.0,6.0,0.0,2.0,0.0,0.0,0.0,0.0,0.0,2.0,7.0,10.0,4.0,0.0,3.0,13.0,14.0,3.0,4.0,3.0,12.0,6.0,4.0,6.0,3.0,6.0,16.0,10.0,5.0,9.0,8.0,3.0,2.0,3.0,3.0,4.0,2.0,0.0,0.0,1.0,13.0,8.0,0.0,1.0,0.0,4.0,18.0,1.0,0.0,13.0,1.0,3.0,6.0,3.0,9.0,1.0,3.0,5.0,7.0,6.0,2.0,7.0,5.0,6.0,12.0,9.0,12.0,1.0,0.0,10.0,4.0,3.0,7.0,7.0,1.0,9.0,0.0,6.0,18.0,3.0,11.0,6.0,9.0,1.0,4.0,8.0,1.0,10.0,15.0,4.0,7.0,11.0,5.0,5.0,6.0,12.0,4.0,12.0,1.0,14.0,8.0,10.0,13.0,4.0,7.0,9.0,7.0,4.0,8.0,8.0,6.0,1.0,14.0,2.0,7.0,12.0,3.0,7.0,13.0,8.0,9.0,14.0,9.0,3.0,4.0,11.0,12.0,8.0,13.0,2.0,4.0,11.0,7.0,8.0,7.0,9.0,21.0,17.0,0.0,7.0,2.0,21.0,8.0,2.0,6.0,3.0,1.0,16.0,9.0,0.0,39.0,0.0,23.0,1.0,16.0,6.0,9.0,15.0,24.0,17.0,0.0,0.0,1.0,25.0,0.0,12.0,11.0,6.0,1.0,0.0,0.0,0.0,0.0,0.0,14.0,25.0,1.0,0.0,1.0,8.0,16.0,22.0,18.0,2.0,18.0,14.0,10.0,9.0,2.0,9.0,7.0,0.0,3.0,0.0,0.0,5.0,3.0,10.0,10.0,20.0,0.0,3.0,2.0,5.0,3.0,9.0,4.0,33.0,14.0,13.0,0.0,11.0,1.0,4.0,18.0,2.0,2.0,20.0,7.0,6.0,6.0,9.0,1.0,15.0,19.0,4.0,8.0,9.0,8.0,4.0,0.0,21.0,0.0,6.0,12.0,11.0,1.0,14.0,27.0,0.0,18.0,4.0,11.0,2.0,11.0,1.0,0.0,8.0,0.0,0.0,12.0,6.0,1.0,0.0,33.0,2.0,1.0,5.0,15.0,1.0,15.0,5.0,11.0,8.0,16.0,0.0,1.0,18.0,0.0,0.0,8.0,19.0,0.0,14.0,11.0,18.0,21.0,23.0,24.0,0.0,2.0,4.0,19.0,14.0,5.0,8.0,0.0,5.0,19.0,0.0,0.0,22.0,7.0,15.0,11.0,15.0,4.0,1.0,7.0,8.0,0.0,0.0,0.0,15.0,0.0,0.0,2.0,2.0,18.0,15.0,0.0,12.0,11.0,0.0,22.0,11.0,24.0,0.0,12.0,1.0,10.0,13.0,11.0,3.0,1.0,17.0,11.0,0.0,5.0,2.0,11.0,7.0,0.0,3.0,12.0,6.0,12.0,9.0,12.0,11.0,14.0,7.0,22.0,14.0,14.0,12.0,21.0,3.0,1.0,5.0,2.0,1.0,2.0,20.0,11.0,4.0,0.0,27.0,7.0,7.0,2.0,7.0,0.0,9.0,0.0,17.0,6.0,0.0,21.0,21.0,1.0,0.0,1.0,3.0,27.0,21.0,15.0,6.0,13.0,12.0,16.5,9.0,7.0,5.0,0.0,27.0,12.0,3.0,1.0,25.0,2.0,23.0,3.0,9.0,20.0,38.0,0.0,0.0,0.0,13.0,18.0,15.0,1.0,0.0,6.0,5.0,10.0,23.0,25.0,16.0,38.0,12.0,6.0,14.0,7.0,0.0,9.0,1.0,4.0,15.0,0.0,0.5,8.0,19.0,9.0,3.0,6.0,6.0,41.0,25.0,5.0,18.0,0.0,23.0,5.0,24.0,1.0,0.0,23.0,7.0,14.0,37.0,23.0,0.0,0.0,0.0,0.0,2.0,1.0,8.0,0.0,4.0,0.0,38.0,29.0,2.0,1.0,0.0,1.0,0.0,2.0,12.0,6.0,0.0,1.0,0.0,11.0,0.0,10.0,10.0,1.0,22.0,13.0,10.0,4.0,4.0,0.0,39.0,8.0,12.0,11.0,30.0,4.0,0.0,10.0,0.0,0.0,0.0,0.0,10.0,30.0,20.0,22.0,25.0,30.0,0.0,0.0,14.0,17.0,2.0,20.0,0.0,9.0,12.0,4.0,6.0,3.0,6.0,22.0,15.0,10.0,1.0,0.0,0.0,1.0,8.0,0.0,32.0,19.0,2.0,10.0,30.0,15.0,14.0,10.0,0.0,12.0,0.0,0.0,4.0,14.0,1.0,0.0,12.0,0.0,2.0,0.0,0.0,4.0,0.0,2.0,0.0,0.0,1.0,0.0,1.0,0.0,1.0,0.0,1.0,3.0,0.0,1.0,0.0,1.0,1.0,2.0,0.0,1.0,1.0,2.0,0.0,0.0,1.0,1.0,1.0,0.0,0.0,0.0,0.0,0.0,3.0,1.0,2.0,1.0,2.0,0.0,0.0,2.0,1.0,2.0,1.0,1.0,0.0,0.0,2.0,2.0,0.0,1.0,0.0,1.0,0.0,0.0,0.0,0.0,2.0,0.0,0.0,2.0,2.0,1.0,12.0,12.0,8.0,4.0,4.0,19.0,8.0,7.0,4.0,18.0,10.0,8.0,19.0,7.0,7.0,9.0,23.0,10.0,5.0,0.0,1.0,4.0,1.0,15.0,5.0,10.0,9.0,9.0,6.0,5.0,0.0,1.0,9.0,33.0,10.0,5.0,6.0,8.0,9.0,3.0,3.0,13.0,17.0,10.0,11.0,6.0,5.0,7.0,17.0,0.0,0.0,4.0,0.0,3.0,4.0,3.0,1.0,4.0,3.0,4.0,4.0,3.0,13.0,0.0,3.0,6.0,5.0,0.0,2.0,1.0,0.0,19.0,19.0,26.0,15.0,11.0,15.0,22.0,12.0,7.0,6.0,23.0,9.0,5.0,31.0,5.0,19.0,9.0,0.0,8.0,0.0,1.0,16.0,17.0,20.0,0.0,13.0,14.0,0.0,0.0,17.0,14.0,5.0,0.0,16.0,6.0,11.0,12.0,19.0,2.0,1.0,1.0,9.0,18.0,1.0,14.0,9.0,0.0,23.0,13.0,8.0,6.0,16.0,0.0,1.0,2.0,14.0,3.0,8.0,0.0,0.0,0.0,12.0,2.0,11.0,0.0,7.0,0.0,9.0,0.0,9.0,1.0,0.0,6.0,1.0,0.0,0.0,8.0,15.0,10.0,6.0,1.0,10.0,14.0,8.0,13.0,1.0,0.0,4.0,13.0,1.0,0.0,1.0,0.0,5.0,2.0,2.0,2.0,16.0,0.0,2.0,2.0,6.0,14.0,8.0,6.0,13.0,11.0,12.0,7.0,4.0,6.0,3.0,6.0,11.0,9.0,21.0,14.0,12.0,2.0,15.0,2.0,10.0,6.0,5.0,1.0,11.0,3.0,7.0,8.0,11.0,9.0,0.0,3.0,1.0,0.0,21.0,10.0,5.0,15.0,1.0,17.0,13.0,9.0,6.0,7.0,16.0,5.0,6.0,4.0,6.0,13.0,,5.0,12.0,4.0,8.0,5.0,14.0,0.0,7.0,10.0,1.0,5.0,3.0,2.0,11.0,9.0,6.0,7.0,7.0,10.0,5.0,9.0,9.0,10.0,5.0,5.0,9.0,7.0,8.0,13.0,14.0,9.0,6.0,7.0,6.0,6.0,10.0,11.0,7.0,5.0,5.0,5.0,6.0,13.0,13.0,15.0,11.0,7.0,8.0,5.0,10.0,7.0,11.0,8.0,0.0,2.0,0.0,0.0,22.0,8.0,3.0,9.0,3.0,2.0,16.0,18.0,4.0,7.0,1.0,6.0,3.0,4.0,2.0,6.0,21.0,10.0,11.0,6.0,13.0,6.0,15.0,4.0,5.0,7.0,4.0,3.0,9.0,3.0,8.0,0.0,6.0,12.0,5.0,2.0,13.0,2.0,6.0,7.0,13.0,8.0,5.0,8.0,13.0,7.0,5.0,3.0,11.0,2.0,2.0,0.0,17.0,7.0,3.0,4.0,0.0,4.0,7.0,8.0,2.0,2.0,7.0,7.0,14.0,10.0,6.0,10.0,12.0,8.0,1.0,3.0,10.0,5.0,5.0,9.0,4.0,12.0,8.0,13.0,5.0,0.0,12.0,11.0,8.0,12.0,12.0,9.0,4.0,6.0,4.0,3.0,4.0,0.0,8.0,4.0,4.0,6.0,4.0,12.0,9.0,4.0,8.0,14.0,0.0,11.0,3.0,1.0,6.0,6.0,5.0,5.0,14.0,5.0,11.0,8.0,7.0,7.0,5.0,4.0,10.0,9.0,5.0,13.0,9.0,15.0,7.0,4.0,19.0,10.0,4.0,9.0,16.0,5.0,8.0,9.0,12.0,10.0,3.0,0.0,23.0,18.0,11.0,5.0,13.0,10.0,6.0,9.0,8.0,3.0,15.0,8.0,7.0,6.0,18.0,17.0,4.0,1.0,10.0,6.0,1.0,10.0,4.0,0.0,7.0,12.0,8.0,8.0,13.0,3.0,7.0,9.0,11.0,6.0,5.0,8.0,15.0,13.0,7.0,6.0,3.0,14.0,1.0,6.0,10.0,13.0,5.0,4.0,19.0,7.0,1.0,13.0,18.0,3.0,8.0,14.0,13.0,0.0,17.0,5.0,4.0,12.0,1.0,2.0,9.0,6.0,9.0,9.0,11.0,7.0,12.0,5.0,6.0,15.0,9.0,8.0,7.0,3.0,12.0,6.0,8.0,13.0,5.0,10.0,9.0,6.0,13.0,11.0,3.0,7.0,12.0,11.0,11.0,7.0,6.0,6.0,8.0,7.0,7.0,6.0,1.0,7.0,0.0,7.0,19.0,15.0,8.0,2.0,12.0,2.0,7.0,5.0,3.0,3.0,11.0,10.0,5.0,14.0,19.0,7.0,14.0,7.0,8.0,6.0,6.0,4.0,4.0,14.0,13.0,6.0,11.0,11.0,4.0,7.0,8.0,9.0,5.0,5.0,7.0,0.0,11.0,7.0,5.0,7.0,17.0,12.0,1.0,8.0,10.0,7.0,5.0,9.0,10.0,5.0,5.0,8.0,3.0,3.0,6.0,5.0,0.0,5.0,4.0,5.0,4.0,13.0,0.0,8.0,8.0,2.0,7.0,7.0,6.0,2.0,11.0,13.0,4.0,1.0,5.0,3.0,10.0,9.0,7.0,6.0,4.0,8.0,6.0,1.0,11.0,7.0,2.0,1.0,12.0,7.0,1.0,5.0,12.0,15.0,16.0,14.0,2.0,7.0,11.0,1.0,7.0,0.0,0.0,0.0,0.0,0.0,0.0,0.0,0.0,1.0,0.0,3.0,4.0,0.0,4.0,3.0,2.0,4.0,8.0,5.0,10.0,3.0,2.0,7.0,4.0,16.0,9.0,5.0,4.0,3.0,3.0,2.0,5.0,2.0,4.0,5.0,2.0,3.0,5.0,2.0,3.0,4.0,8.0,,,,,,,,,,,,,,,,,,,,,,,,,,,,,,,,,,,,,,,,,,,,,,,,,,,,,,,,,,,,,,,,,,,,,,,,,,,,,,,,,,,,,,,,,,4.0,2.0,1.0,1.0,3.0,4.0,2.0,5.0,4.0,2.0,1.0,9.0,4.0,7.0,4.0,3.0,3.0,4.0,6.0,4.0,6.0,5.0,6.0,11.0,6.0,6.0,5.0,4.0,4.0,7.0,5.0,6.0,4.0,3.0,0.0,14.0,0.0,1.0,8.0,7.0,0.0,0.0,1.0,6.0,0.0,0.0,0.0,10.0,4.0,8.0,1.0,3.0,0.0,5.0,3.0,3.0,3.0,0.0,0.0,0.0,2.0,0.0,3.0,9.0,4.0,14.0,6.0,0.0,0.0,10.0,,,,,,,,,,4.0,8.0,5.0,4.0,8.0,8.0,3.0,3.0,3.0,10.0,4.0,8.0,6.0,8.0,6.0,7.0,7.0,8.0,6.0,5.0,9.0,6.0,8.0,9.0,12.0,5.0,7.0,6.0,6.0,2.0,5.0,2.0,5.0,6.0,8.0,7.0,7.0,11.0,4.0,7.0,10.0,9.0,8.0,4.0,6.0,5.0,8.0,3.0,5.0,5.0,10.0,3.0,6.0,13.0,11.0,7.0,3.0,,,,,,,,,,,,,,,,,,,,,,,,,,,,,,,,,,,,,,,,,,,,,,,,,,,,,,,,,,,,,,,,,,,,,,,,,,,,,,,,,,,,,,,,,,,,,,,,,,,,,,,,,,,,,,,,,,,,,,,,,,,,,,,,,,,,,,,,,,,,,,,,,,,,24.0,33.0,54.0,5.0,5.0,27.0,4.0,51.0,25.0,15.0,8.0,16.0,18.0,3.0,9.0,34.0,21.0,16.0,12.0,47.0,22.0,21.0,5.0,21.0,36.0,33.0,18.0,13.0,4.0,24.0,17.0,20.0,16.0,7.0,5.0,20.0,8.0,21.0,19.0,23.0,1.0,17.0,18.0,22.0,16.0,12.0,9.0,3.0,6.0,25.0,22.0,24.0,20.0,5.0,2.0,0.0,3.0,17.0,27.0,7.0,13.0,2.0,15.0,19.0,17.0,21.0,20.0,9.0,3.0,17.0,16.0,29.0,0.0,9.0,3.0,17.0,23.0,29.0,13.0,25.0,5.0,7.0,6.0,17.0,0.0,13.0,16.0,29.0,28.0,8.0,4.0,4.0,22.0,2.0,10.0,12.0,14.0,15.0,24.0,10.0,13.0,6.0,23.0,0.0,5.0,6.0,1.0,4.0,4.0,1.0,14.0,8.0,5.0,4.0,0.0,2.0,22.0,3.0,2.0,0.0,3.0,0.0,22.0,22.0,12.0,2.0,0.0,1.0,15.0,17.0,20.0,21.0,25.0,30.0,5.0,22.0,9.0,15.0,20.0,10.0,3.0,33.0,8.0,15.0,10.0,10.0,14.0,23.0,6.0,28.0,32.0,18.0,23.0,29.0,7.0,19.0,15.0,28.0,27.0,5.0,26.0,11.0,4.0,21.0,30.0,12.0,8.0,0.0,30.0,7.0,12.0,1.0,1.0,16.0,18.0,27.0,17.0,2.0,19.0,14.0,10.0,0.0,2.0,22.0,0.0,8.0,1.0,1.0,0.0,1.0,0.0,1.0,2.0,1.0,0.0,0.0,1.0,14.0,25.0,13.0,21.0,11.0,12.0,10.0,4.0,22.0,9.0,3.0,9.0,15.0,14.0,8.0,21.0,14.0,32.0,24.0,17.0,23.0,27.0,9.0,25.0,4.0,18.0,29.0,24.0,12.0,15.0,16.0,21.0,36.0,2.0,46.0,26.0,21.0,41.0,38.0,38.0,27.0,0.0,4.0,33.0,9.0,20.0,0.0,5.0,19.0,10.0,16.0,1.0,36.0,18.0,25.0,19.0,27.0,6.0,19.0,16.0,10.0,17.0,19.0,21.0,27.0,20.0,6.0,58.0,20.0,1.0,1.0,19.0,14.0,3.0,25.0,8.0,22.0,6.0,12.0,15.0,10.0,15.0,19.0,9.0,12.0,28.0,15.0,10.0,1.0,7.0,29.0,17.0,25.0,12.0,0.0,11.0,27.0,1.0,7.0,10.0,16.0,13.0,12.0,12.0,8.0,1.0,22.0,11.0,20.0,23.0,9.0,60.0,25.0,13.0,29.0,24.0,27.0,23.0,22.0,41.0,18.0,44.0,22.0,25.0,22.0,31.0,30.0,23.0,31.0,21.0,27.0,12.0,3.0,22.0,14.0,44.0,11.0,7.0,7.0,0.0,12.0,21.0,24.0,25.0,50.0,55.0,15.0,1.0,16.0,0.0,3.0,20.0,1.0,6.0,16.0,1.0,44.0,1.0,31.0,1.0,27.0,3.0,1.0,1.0,1.0,21.0,1.0,0.0,2.0,1.0,35.0,17.0,1.0,1.0,0.0,,0.0,5.0,3.0,0.0,53.0,23.0,10.0,4.0,2.0,1.0,4.0,0.0,14.0,2.0,10.0,15.0,11.0,0.0,0.0,4.0,7.0,8.0,33.0,14.0,26.0,0.0,4.0,13.0,37.0,4.0,9.0,21.0,27.0,28.0,0.0,31.0,8.0,2.0,4.0,21.0,4.0,0.0,9.0,14.0,6.0,52.0,8.0,22.0,8.0,1.0,27.0,24.0,4.0,24.0,12.0,37.0,33.0,35.0,18.0,2.0,7.0,4.0,5.0,1.0,2.0,8.0,13.0,16.0,8.0,8.0,11.0,0.0,6.0,19.0,2.0,2.0,15.0,4.0,2.0,3.0,1.0,12.0,10.0,14.0,18.0,1.0,29.0,6.0,15.0,11.0,9.0,9.0,1.0,0.0,7.0,19.0,2.0,1.0,0.0,3.0,16.0,3.0,17.0,13.0,23.0,29.0,11.0,19.0,17.0,2.0,22.0,16.0,1.0,17.0,39.0,32.0,49.0,20.0,22.0,19.0,12.0,1.0,4.0,2.0,17.0,0.0,7.0,14.0,9.0,10.0,0.0,26.0,45.0,22.0,22.0,22.0,5.0,18.0,14.0,14.0,5.0,10.0,12.0,10.0,1.0,12.0,6.0,5.0,2.0,35.0,31.0,22.0,30.0,21.0,8.0,20.0,1.0,12.0,17.0,12.0,17.0,20.0,5.0,28.0,25.0,18.0,8.0,7.0,2.0,4.0,12.0,2.0,18.0,2.0,1.0,21.0,21.0,7.0,3.0,5.0,29.0,2.0,0.0,21.0,16.0,23.0,0.0,17.0,14.0,15.0,12.0,6.0,29.0,16.0,14.0,2.0,2.0,5.0,4.0,1.0,21.0,9.0,4.0,6.0,10.0,5.0,12.0,5.0,7.0,6.0,9.0,2.0,27.0,3.0,1.0,10.0,21.0,11.0,16.0,9.0,22.0,0.0,23.0,42.0,4.0,0.0,0.0,3.0,16.0,19.0,28.0,1.0,20.0,8.0,15.0,13.0,4.0,17.0,5.0,6.0,15.0,2.0,6.0,3.0,0.0,2.0,13.0,42.0,12.0,0.0,0.0,18.0,4.0,2.0,12.0,24.0,23.0,19.0,7.0,0.0,23.0,20.0,6.0,21.0,0.0,5.0,2.0,9.0,3.0,16.0,9.0,9.0,4.0,19.0,15.0,38.0,15.0,40.0,26.0,17.0,23.0,5.0,0.0,38.0,1.0,14.0,12.0,2.0,9.0,11.0,3.0,24.0,9.0,24.0,8.0,21.0,2.0,10.0,3.0,22.0,23.0,9.0,13.0,1.0,8.0,5.0,5.0,25.0,46.0,0.0,29.0,0.0,5.0,16.0,10.0,14.0,31.0,19.0,13.0,9.0,16.0,22.0,39.0,17.0,31.0,26.0,13.0,10.0,3.0,3.0,6.0,18.0,10.0,15.0,26.0,2.0,22.0,2.0,8.0,22.0,20.0,9.0,18.0,27.0,22.0,19.0,15.0,1.0,0.0,6.0,19.0,27.0,5.0,31.0,56.0,13.0,17.0,19.0,2.0,1.0,0.0,6.0,7.0,2.0,0.0,0.0,26.0,2.0,1.0,0.0,3.0,0.0,60.0,1.0,42.0,51.0,0.0,7.0,7.0,10.0,0.0,2.0,41.0,1.0,12.0,26.0,1.0,16.0,20.0,1.0,40.0,41.0,32.0,31.0,0.0,1.0,0.0,20.0,39.0,6.0,6.0,21.0,0.0,0.0,25.0,0.0,22.0,69.0,24.0,39.0,30.0,20.0,16.0,29.0,17.0,30.0,17.0,17.0,28.0,14.0,28.0,9.0,2.0,1.0,2.0,13.0,23.0,7.0,21.0,23.0,0.0,0.0,2.0,1.0,3.0,4.0,13.0,2.0,5.0,9.0,4.0,45.0,9.0,15.0,1.0,26.0,12.0,17.0,18.0,1.0,20.0,12.0,17.0,21.0,6.0,33.0,7.0,13.0,35.0,17.0,6.0,0.0,5.0,14.0,0.0,8.0,2.0,5.0,5.0,1.0,5.0,0.0,7.0,9.0,4.0,0.0,16.0,9.0,9.0,7.0,2.0,3.0,7.0,47.0,10.0,1.0,5.0,2.0,5.0,1.0,3.0,9.0,0.0,13.0,15.0,13.0,0.0,0.0,10.0,36.0,2.0,0.0,1.0,9.0,16.0,19.0,8.0,2.0,12.0,18.0,12.0,13.0,0.0,3.0,12.0,13.0,0.0,23.0,0.0,4.0,5.0,18.0,11.0,11.0,19.0,12.0,4.0,7.0,0.0,0.0,2.0,14.0,12.0,9.0,16.0,7.0,3.0,1.0,20.0,3.0,2.0,0.0,0.0,29.0,2.0,0.0,6.0,15.0,3.0,12.0,5.0,17.0,0.0,39.0,0.0,11.0,8.0,1.0,4.0,13.0,1.0,2.0,20.0,0.0,12.0,9.0,15.0,6.0,38.0,10.0,1.0,2.0,4.0,11.0,28.0,0.0,10.0,5.0,13.0,1.0,10.0,12.0,1.0,4.0,1.0,9.0,21.0,5.0,17.0,6.0,7.0,26.0,7.0,25.0,3.0,8.0,0.0,16.0,12.0,14.0,7.0,4.0,9.0,7.0,1.0,24.0,16.0,3.0,1.0,5.0,11.0,1.0,3.0,13.0,7.0,0.0,11.0,10.0,0.0,14.0,1.0,11.0,2.0,0.0,21.0,11.0,7.0,2.0,9.0,13.0,12.0,2.0,6.0,3.0,0.0,5.0,0.0,10.0,8.0,8.0,1.0,8.0,0.0,25.0,38.0,14.0,4.0,14.0,10.0,8.0,8.0,8.0,14.0,22.0,1.0,2.0,11.0,1.0,8.0,4.0,27.0,0.0,5.0,33.0,20.0,8.0,19.0,1.0,10.0,29.0,15.0,3.0,1.0,6.0,14.0,40.0,1.0,4.0,4.0,4.0,7.0,16.0,13.0,5.0,8.0,34.0,10.0,5.0,46.0,0.0,16.0,0.0,7.0,1.0,5.0,0.0,1.0,3.0,10.0,16.0,8.0,32.0,6.0,1.0,16.0,9.0,9.0,22.0,13.0,1.0,0.0,2.0,22.0,6.0,9.0,0.0,16.0,21.0,3.0,0.0,9.0,30.0,16.0,8.0,10.0,17.0,9.0,14.0,1.0,0.0,5.0,2.0,14.0,1.0,1.0,24.0,0.0,1.0,8.0,2.0,10.0,2.0,10.0,3.0,17.0,10.0,3.0,0.0,9.0,25.0,3.0,1.0,1.0,13.0,24.0,0.0,2.0,10.0,9.0,0.0,48.0,8.0,29.0,0.0,4.0,7.0,5.0,4.0,1.0,2.0,8.0,13.0,11.0,11.0,1.0,1.0,1.0,3.0,12.0,20.0,28.0,17.0,3.0,18.0,3.0,18.0,5.0,10.0,3.0,14.0,19.0,7.0,1.0,0.0,15.0,0.0,11.0,2.0,89.0,1.0,14.0,0.0,11.0,4.0,9.0,22.0,5.0,6.0,14.0,13.0,1.0,10.0,0.0,7.0,3.0,5.0,2.0,11.0,57.0,14.0,21.0,5.0,9.0,0.0,0.0,0.0,9.0,6.0,8.0,8.0,10.0,14.0,6.0,7.0,18.0,2.0,10.0,16.0,23.0,3.0,8.0,1.0,1.0,19.0,19.0,0.0,7.0,1.0,6.0,19.0,17.0,12.0,8.0,0.0,0.0,0.0,0.0,0.0,18.0,9.0,1.0,5.0,10.0,7.0,4.0,4.0,4.0,17.0,12.0,2.0,1.0,13.0,1.0,53.0,14.0,6.0,8.0,20.0,18.0,6.0,7.0,37.0,2.0,19.0,6.0,15.0,10.0,18.0,13.0,0.0,0.0,4.0,5.0,4.0,1.0,2.0,12.0,17.0,1.0,8.0,11.0,2.0,3.0,5.0,7.0,10.0,6.0,14.0,1.0,7.0,4.0,1.0,3.0,4.0,8.0,8.0,15.0,11.0,16.0,20.0,4.0,10.0,0.0,7.0,15.0,14.0,14.0,14.0,9.0,10.0,9.0,14.0,1.0,1.0,5.0,12.0,9.0,0.0,11.0,4.0,10.0,3.0,14.0,18.0,6.0,15.0,16.0,11.0,29.0,16.0,9.0,21.0,0.0,12.0,17.0,19.0,23.0,12.0,24.0,17.0,20.0,7.0,28.0,9.0,16.0,8.0,22.0,18.0,25.0,17.0,12.0,18.0,13.0,6.0,7.0,2.0,1.0,17.0,2.0,2.0,14.0,11.0,3.0,10.0,24.0,0.0,5.0,4.0,3.0,6.0,0.0,5.0,18.0,16.0,10.0,21.0,1.0,11.0,3.0,14.0,3.0,1.0,1.0,0.0,16.0,0.0,4.0,0.0,9.0,11.0,18.0,2.0,0.0,9.0,2.0,5.0,7.0,14.0,13.0,6.0,10.0,6.0,16.0,16.0,20.0,2.0,15.0,0.0,2.0,7.0,2.0,11.0,13.0,15.0,5.0,3.0,19.0,8.0,0.0,9.0,7.0,15.0,23.0,0.0,15.0,20.0,12.0,12.0,13.0,15.0,14.0,7.0,11.0,10.0,27.0,15.0,13.0,7.0,17.0,14.0,8.0,17.0,9.0,3.0,17.0,0.0,2.0,12.0,15.0,2.0,20.0,18.0,16.0,27.0,1.0,8.0,0.0,0.0,22.0,3.0,1.0,7.0,6.0,16.0,15.0,0.0,9.0,13.0,1.0,5.0,13.0,1.0,16.0,12.0,20.0,15.0,9.0,15.0,5.0,24.0,7.0,5.0,19.0,16.0,15.0,20.0,7.0,19.0,13.0,2.0,14.0,7.0,6.0,5.0,20.0,10.0,7.0,4.0,22.0,0.0,24.0,2.0,0.0,15.0,10.0,23.0,12.0,12.0,18.0,14.0,2.0,26.0,18.0,15.0,17.0,11.0,2.0,14.0,2.0,0.0,1.0,4.0,16.0,7.0,15.0,0.0,0.0,5.0,16.0,23.0,19.0,6.0,19.0,6.0,0.0,13.0,3.0,4.0,12.0,17.0,19.0,24.0,13.0,13.0,28.0,0.0,17.0,17.0,0.0,20.0,6.0,4.0,4.0,0.0,22.0,2.0,3.0,13.0,4.0,13.0,27.0,21.0,17.0,13.0,0.0,0.0,0.0,0.0,14.0,10.0,12.0,7.0,11.0,9.0,0.0,8.0,5.0,11.0,3.0,1.0,7.0,8.0,13.0,4.0,2.0,4.0,3.0,13.0,0.0,6.0,11.0,8.0,9.0,1.0,3.0,9.0,13.0,14.0,7.0,4.0,14.0,15.0,18.0,5.0,10.0,17.0,15.0,13.0,6.0,11.0,2.0,12.0,11.0,8.0,0.0,9.0,5.0,6.0,,,,,,,,6.0,8.0,9.0,5.0,6.0,9.0,13.0,7.0,3.0,5.0,6.0,4.0,6.0,4.0,11.0,6.0,6.0,7.0,7.0,5.0,5.0,5.0,5.0,4.0,9.0,9.0,13.0,7.0,5.0,5.0,8.0,7.0,8.0,6.0,3.0,9.0,5.0,4.0,6.0,7.0,7.0,8.0,6.0,8.0,5.0,4.0,6.0,8.0,7.0,9.0,8.0,8.0,5.0,6.0,6.0,5.0,4.0,5.0,5.0,11.0,10.0,4.0,7.0,4.0,4.0,6.0,6.0,6.0,8.0,5.0,6.0,8.0,11.0,8.0,4.0,9.0,2.0,10.0,14.0,3.0,11.0,7.0,8.0,14.0,4.0,7.0,3.0,4.0,8.0,6.0,12.0,9.0,5.0,5.0,3.0,7.0,9.0,5.0,9.0,7.0,4.0,0.0,0.0,1.0,1.0,2.0,2.0,2.0,0.0,1.0,0.0,0.0,0.0,3.0,0.0,0.0,2.0,0.0,0.0,4.0,3.0,9.0,11.0,6.0,9.0,5.0,5.0,5.0,4.0,0.0,12.0,11.0,0.0,19.0,4.0,3.0,17.0,0.0,14.0,5.0,7.0,12.0,1.0,7.0,11.0,2.0,1.0,17.0,4.0,7.0,0.0,6.0,11.0,6.0,9.0,2.0,9.0,8.0,8.0,7.0,5.0,0.0,16.0,13.0,9.0,8.0,8.0,8.0,6.0,9.0,5.0,7.0,16.0,8.0,13.0,7.0,4.0,8.0,6.0,8.0,2.0,12.0,5.0,9.0,11.0,6.0,1.0,3.0,11.0,6.0,4.0,19.0,5.0,8.0,7.0,9.0,0.0,8.0,13.0,,1.0,7.0,3.0,5.0,1.0,5.0,13.0,2.0,3.0,10.0,8.0,9.0,4.0,12.0,3.0,11.0,0.0,0.0,0.0,0.0,0.0,0.0,0.0,0.0,0.0,12.0,3.0,10.0,10.0,9.0,16.0,17.0,8.0,12.0,17.0,0.0,11.0,2.0,9.0,9.0,12.0,7.0,3.0,13.0,5.0,7.0,8.0,11.0,8.0,7.0,8.0,7.0,6.0,4.0,3.0,1.0,,8.0,5.0,0.0,4.0,12.0,0.0,0.0,0.0,0.0,0.0,0.0,0.0,0.0,0.0,0.0,0.0,0.0,0.0,0.0,0.0,0.0,0.0,0.0,0.0,0.0,0.0,20.0,16.0,1.0,2.0,0.0,0.0,0.0,1.0,4.0,0.0,0.0,0.0,0.0,0.0,1.0,0.0,5.0,0.0,0.0,1.0,2.0,0.0,1.0,2.0,0.0,0.0,0.0,0.0,0.0,,,,,,,,,,,,,,,,,,,,3.0,8.0,8.0,8.0,3.0,4.0,13.0,4.0,5.0,5.0,2.0,6.0,6.0,9.0,7.0,5.0,4.0,8.0,7.0,8.0,5.0,7.0,5.0,5.0,0.0,4.0,6.0,7.0,12.0,3.0,3.0,5.0,4.0,9.0,4.0,9.0,3.0,5.0,0.0,8.0,5.0,5.0,8.0,6.0,5.0,6.0,9.0,6.0,6.0,10.0,4.0,6.0,3.0,7.0,9.0,5.0,4.0,7.0,4.0,13.0,9.0,6.0,6.0,3.0,3.0,6.0,13.0,11.0,1.0,6.0,7.0,9.0,0.0,13.0,12.0,4.0,6.0,8.0,4.0,6.0,5.0,20.0,2.0,4.0,2.0,8.0,11.0,10.0,9.0,15.0,7.0,2.0,5.0,9.0,11.0,7.0,5.0,9.0,7.0,4.0,9.0,6.0,7.0,2.0,4.0,11.0,2.0,10.0,6.0,9.0,1.0,7.0,13.0,11.0,11.0,4.0,5.0,4.0,3.0,6.0,6.0,10.0,10.0,2.0,6.0,2.0,3.0,3.0,6.0,7.0,9.0,18.0,1.0,5.0,3.0,5.0,6.0,6.0,3.0,4.0,5.0,5.0,3.0,3.0,5.0,8.0,6.0,4.0,6.0,5.0,2.0,6.0,7.0,7.0,4.0,7.0,8.0,4.0,2.0,8.0,1.0,1.0,0.0,8.0,11.0,6.0,7.0,21.0,0.0,6.0,6.0,6.0,1.0,4.0,4.0,11.0,11.0,15.0,10.0,10.0,4.0,14.0,13.0,2.0,9.0,4.0,19.0,15.0,4.0,3.0,3.0,11.0,5.0,6.0,1.0,6.0,11.0,4.0,12.0,4.0,0.0,16.0,18.0,3.0,23.0,11.0,3.0,13.0,18.0,13.0,21.0,28.0,7.0,15.0,19.0,4.0,4.0,9.0,10.0,6.0,10.0,15.0,14.0,13.0,1.0,4.0,10.0,10.0,13.0,8.0,10.0,8.0,4.0,8.0,12.0,8.0,11.0,36.0,0.0,0.0,29.0,21.0,0.0,15.0,1.0,3.0,3.0,2.0,1.0,3.0,11.0,3.0,12.0,7.0,2.0,3.0,0.0,1.0,2.0,5.0,11.0,3.0,3.0,6.0,4.0,4.0,10.0,14.0,21.0,15.0,13.0,13.0,16.0,8.0,2.0,8.0,21.0,34.0,7.0,18.0,1.0,10.0,8.0,17.0,6.0,7.0,18.0,7.0,8.0,4.0,18.0,14.0,6.0,12.0,14.0,15.0,14.0,7.0,17.0,2.0,20.0,0.0,0.0,0.0,27.0,10.0,0.0,9.0,5.0,8.0,1.0,4.0,8.0,10.0,8.0,2.0,4.0,4.0,0.0,12.0,1.0,5.0,7.0,7.0,16.0,8.0,6.0,5.0,9.0,15.0,14.0,18.0,5.0,9.0,15.0,6.0,3.0,16.0,22.0,4.0,15.0,0.0,15.0,0.0,1.0,1.0,0.0,1.0,4.0,5.0,1.0,4.0,3.0,5.0,2.0,0.0,10.0,13.0,4.0,1.0,5.0,2.0,9.0,3.0,3.0,4.0,4.0,9.0,5.0,0.0,11.0,6.0,13.0,6.0,6.0,3.0,4.0,15.0,8.0,6.0,4.0,4.0,19.0,10.0,0.0,1.0,23.0,2.0,1.0,1.0,1.0,2.0,0.0,9.0,4.0,1.0,1.0,13.0,15.0,8.0,3.0,3.0,9.0,3.0,3.0,4.0,7.0,5.0,4.0,5.0,9.0,1.0,1.0,2.0,20.0,3.0,1.0,0.0,2.0,11.0,13.0,13.0,5.0,0.0,18.0,5.0,2.0,14.0,14.0,7.0,4.0,14.0,2.0,0.0,4.0,8.0,6.0,4.0,1.0,3.0,8.0,5.0,6.0,4.0,12.0,10.0,11.0,5.0,4.0,8.0,4.0,7.0,8.0,4.0,7.0,18.0,12.0,3.0,2.0,10.0,2.0,2.0,3.0,0.0,0.0,2.0,0.0,12.0,4.0,2.0,16.0,18.0,23.0,1.0,7.0,18.0,14.0,13.0,14.0,19.0,4.0,2.0,3.0,15.0,8.0,0.0,11.0,3.0,4.0,17.0,2.0,7.0,13.0,9.0,15.0,11.0,7.0,5.0,14.0,18.0,11.0,5.0,14.0,11.0,10.0,13.0,14.0,9.0,5.0,18.0,10.0,10.0,14.0,19.0,7.0,0.0,5.0,5.0,11.0,3.0,4.0,7.0,22.0,6.0,5.0,6.0,3.0,0.0,8.0,3.0,26.0,5.0,19.0,22.0,1.0,3.0,1.0,0.0,2.0,0.0,6.0,0.0,0.0,3.0,0.0,6.0,4.0,8.0,5.0,15.0,14.0,10.0,13.0,10.0,13.0,11.0,0.0,3.0,4.0,1.0,13.0,2.0,13.0,3.0,4.0,3.0,10.0,8.0,2.0,5.0,0.0,0.0,14.0,9.0,1.0,0.0,3.0,2.0,1.0,4.0,5.0,14.0,22.0,3.0,9.0,2.0,6.0,5.0,9.0,7.0,2.0,5.0,13.0,7.0,3.0,3.0,13.0,5.0,17.0,3.0,0.0,1.0,6.0,7.0,1.0,15.0,3.0,9.0,1.0,9.0,1.0,8.0,9.0,7.0,5.0,1.0,5.0,4.0,0.0,8.0,2.0,14.0,14.0,14.0,4.0,11.0,0.0,2.0,0.0,25.0,19.0,17.0,10.0,24.0,15.0,7.0,4.0,20.0,5.0,13.0,18.0,6.0,3.0,3.0,6.0,17.0,10.0,2.0,6.0,13.0,6.0,2.0,13.0,10.0,2.0,13.0,17.0,17.0,19.0,11.0,12.0,6.0,2.0,11.0,9.0,2.0,4.0,5.0,0.0,3.0,3.0,1.0,2.0,1.0,1.0,3.0,1.0,7.0,0.0,1.0,15.0,2.0,9.0,5.0,3.0,5.0,1.0,7.0,5.0,27.0,4.0,4.0,12.0,10.0,6.0,1.0,0.0,10.0,8.0,2.0,2.0,33.0,3.0,4.0,16.0,2.0,8.0,4.0,22.0,3.0,3.0,11.0,0.0,1.0,8.0,1.0,6.0,7.0,2.0,18.0,15.0,0.0,3.0,15.0,0.0,7.0,3.0,0.0,4.0,10.0,13.0,6.0,3.0,9.0,17.0,7.0,2.0,7.0,18.0,15.0,12.0,10.0,21.0,8.0,1.0,16.0,19.0,5.0,8.0,7.0,14.0,8.0,1.0,11.0,13.0,16.0,10.0,15.0,1.0,5.0,6.0,7.0,1.0,0.0,3.0,0.0,4.0,3.0,0.0,0.0,0.0,0.0,0.0,2.0,1.0,0.0,4.25,10.0,1.0,7.0,0.0,0.0,2.0,2.0,1.0,1.0,3.0,1.0,1.0,1.0,2.0,4.0,6.0,2.0,0.0,2.0,0.0,0.0,2.0,0.0,0.0,3.0,0.0,1.0,4.0,1.0,0.0,3.0,4.0,5.0,50.0,50.0,30.0,30.0,40.0,10.0,7.0,2.0,7.0,11.0,15.0,5.0,14.0,22.0,33.0,11.0,8.0,18.0,15.0,11.0,5.0,18.0,0.0,11.0,9.0,12.0,28.0,11.0,3.0,4.0,10.0,13.0,14.0,15.0,5.0,7.0,5.0,4.0,20.0,15.0,6.0,5.0,17.0,10.0,14.0,7.0,10.0,21.0,14.0,16.0,6.0,8.0,16.0,18.0,16.0,9.0,10.0,16.0,17.0,15.0,15.0,17.0,15.0,15.0,18.0,0.0,5.0,22.0,17.0,19.0,14.0,18.0,14.0,22.0,21.0,6.0,5.0,12.0,14.0,8.0,14.0,12.0,14.0,10.0,26.0,30.0,10.0,11.0,1.0,21.0,15.0,17.0,4.0,28.0,6.0,11.0,4.0,16.0,10.0,11.0,11.0,11.0,13.0,8.0,0.0,3.0,7.0,0.0,1.0,22.0,5.0,13.0,4.0,5.0,2.0,6.0,13.0,6.0,0.0,4.0,20.0,5.0,14.0,20.0,20.0,24.0,5.0,5.0,5.0,24.0,0.0,8.0,7.0,16.0,6.0,2.0,3.0,3.0,3.0,3.0,3.0,5.0,4.0,9.0,5.0,6.0,5.0,7.0,4.0,5.0,5.0,6.0,8.0,3.0,9.0,15.0,0.0,5.0,5.0,4.0,3.0,10.0,3.0,21.0,5.0,6.0,2.0,0.0,25.0,20.0,18.0,10.0,15.0,11.0,26.0,5.0,21.0,29.0,31.0,32.0,31.0,30.0,25.0,2.0,28.0,32.0,31.0,31.0,31.0,28.0,14.0,19.0,14.0,5.0,10.0,33.0,20.0,9.0,3.0,4.0,10.0,6.0,3.0,16.0,8.0,28.0,3.0,8.0,14.0,12.0,14.0,25.0,23.0,12.0,11.0,29.0,11.0,3.0,3.0,3.0,4.0,4.0,4.0,5.0,6.0,7.0,3.0,10.0,6.0,14.0,2.0,7.0,4.0,5.0,18.0,13.0,8.0,13.0,12.0,15.0,3.0,16.0,4.0,6.0,5.0,7.0,18.0,6.0,7.0,6.0,6.0,4.0,4.0,4.0,14.0,1.0,15.0,20.0,19.0,15.0,26.0,12.0,7.0,8.0,6.0,4.0,4.0,5.0,20.0,11.0,17.0,3.0,9.0,4.0,7.0,4.0,11.0,4.0,11.0,6.0,4.0,3.0,10.0,2.0,6.0,4.0,0.0,4.0,2.0,8.0,5.0,5.0,4.0,4.0,4.0,14.0,9.0,4.0,13.0,7.0,9.0,12.0,12.0,7.0,6.0,12.0,27.0,4.0,4.0,7.0,5.0,9.0,5.0,6.0,5.0,5.0,14.0,12.0,6.0,13.0,11.0,5.0,10.0,15.0,5.0,5.0,13.0,24.0,13.0,5.0,7.0,11.0,15.0,27.0,5.0,3.0,13.0,14.0,15.0,14.0,3.0,0.0,1.0,4.0,7.0,4.0,4.0,3.0,6.0,10.0,12.0,9.0,12.0,12.0,15.0,30.0,12.0,9.0,11.0,13.0,9.0,7.0,4.0,14.0,8.0,5.0,14.0,9.0,0.0,7.0,8.0,23.0,12.0,21.0,1.0,19.0,4.0,3.0,3.0,3.0,3.0,3.0,8.0,2.0,3.0,3.0,3.0,15.0,11.0,6.0,10.0,6.0,6.0,6.0,7.0,4.0,5.0,1.0,7.0,10.0,14.0,8.0,4.0,5.0,0.0,19.0,11.0,3.0,10.0,13.0,6.0,12.0,16.0,4.0,18.0,24.0,10.0,1.0,10.0,12.0,16.0,6.0,9.0,7.0,5.0,14.0,20.0,15.0,17.0,0.0,12.0,9.0,15.0,17.0,4.0,1.0,18.0,20.0,11.0,6.0,21.0,9.0,15.0,7.0,9.0,7.0,5.0,2.0,14.0,9.0,10.0,8.0,6.0,12.0,4.0,17.0,15.0,3.0,10.0,7.0,18.0,10.0,6.0,6.0,4.0,4.0,5.0,9.0,17.0,9.0,13.0,5.0,17.0,15.0,19.0,19.0,6.0,3.0,3.0,3.0,4.0,4.0,9.0,3.0,10.0,1.0,0.0,2.0,0.0,1.0,2.0,0.0,3.0,1.0,1.0,1.0,0.0,0.0,2.0,0.0,1.0,2.0,0.0,0.0,0.0,4.0,0.0,1.0,0.0,0.0,0.0,2.0,17.0,1.0,0.0,0.0,0.0,3.0,1.0,0.0,2.0,0.0,0.0,3.0,0.0,3.0,0.0,0.0,0.0,0.0,0.0,0.0,1.0,15.0,0.0,4.0,1.0,5.0,0.0,0.0,0.0,1.0,1.0,0.0,1.0,0.0,0.0,1.0,2.0,2.0,9.0,0.0,0.0,0.0,0.0,1.0,3.0,0.0,5.0,4.0,8.0,0.0,1.0,0.0,1.0,1.0,1.0,3.0,0.0,0.0,2.0,2.0,3.0,0.0,8.0,5.0,4.0,22.0,1.0,1.0,2.0,3.0,0.0,1.0,0.0,0.0,3.0,22.0,3.0,1.0,1.0,19.0,1.0,0.0,1.0,0.0,0.0,0.0,0.0,3.0,2.0,3.0,0.0,10.0,1.0,0.0,2.0,0.0,0.0,0.0,0.0,1.0,1.0,3.0,8.0,0.0,0.0,11.0,0.0,2.0,1.0,2.0,7.0,4.0,5.0,0.0,0.0,5.0,0.0,18.0,0.0,6.0,1.0,3.0,3.0,2.0,0.0,1.0,8.0,1.0,3.0,0.0,1.0,2.0,0.0,0.0,0.0,1.0,0.0,2.0,0.0,1.0,0.0,0.0,5.0,0.0,1.0,2.0,0.0,0.0,1.0,1.0,6.0,3.0,0.0,0.0,13.0,5.0,0.0,10.0,2.0,0.0,2.0,3.0,0.0,0.0,0.0,3.0,3.0,3.0,4.0,3.0,12.0,9.0,15.0,1.0,10.0,8.0,4.0,8.0,11.0,3.0,3.0,6.0,6.0,3.0,7.0,3.0,2.0,11.0,4.0,8.0,12.0,0.0,7.0,1.0,6.0,2.0,8.0,13.0,2.0,2.0,1.0,3.0,3.0,1.0,12.0,10.0,1.0,0.0,0.0,3.0,0.0,4.0,4.0,3.0,0.0,0.0,0.0,4.0,8.0,2.0,3.0,1.0,2.0,3.0,1.0,1.0,7.0,0.0,8.0,3.0,1.0,1.0,0.0,3.0,2.0,7.0,9.0,5.0,0.0,5.0,16.0,8.0,9.0,3.0,3.0,5.0,7.0,2.0,1.0,1.0,6.0,10.0,5.0,0.0,6.0,16.0,9.0,12.0,11.0,4.0,2.0,0.0,3.0,3.0,1.0,0.0,0.0,0.0,4.0,0.0,2.0,3.0,15.0,0.0,15.0,14.0,3.0,6.0,8.0,16.0,0.0,16.0,3.0,2.0,18.0,5.0,0.0,6.0,7.0,16.0,6.0,5.0,11.0,6.0,2.0,1.0,1.0,0.0,2.0,9.0,6.0,0.0,2.0,0.0,0.0,0.0,13.0,2.0,12.0,2.0,5.0,2.0,3.0,0.0,0.0,5.0,3.0,2.0,3.0,13.0,10.0,5.0,6.0,13.0,0.0,0.0,1.0,7.0,4.0,13.0,4.0,0.0,0.0,0.0,9.0,9.0,2.0,1.0,1.0,12.0,0.0,3.0,4.0,0.0,0.0,0.0,0.0,8.0,8.0,5.0,3.0,7.0,4.0,1.0,0.0,4.0,2.0,19.0,1.0,0.0,1.0,3.0,10.0,0.0,2.0,0.0,1.0,1.0,4.0,3.0,1.0,9.0,5.0,7.0,3.0,3.0,7.0,10.0,9.0,7.0,11.0,10.0,11.0,10.0,6.0,10.0,0.0,0.0,0.0,0.0,0.0,0.0,0.0,0.0,0.0,0.0,0.0,3.0,0.0,13.0,2.0,14.0,3.0,6.0,1.0,1.0,12.0,13.0,2.0,8.0,7.0,1.0,8.0,3.0,4.0,14.0,2.0,6.0,7.0,0.0,6.0,5.0,0.0,12.0,1.0,10.0,3.0,2.0,3.0,4.0,3.0,5.0,0.0,19.0,0.0,0.0,8.0,13.0,6.0,3.0,6.0,17.0,1.0,2.0,17.0,3.0,14.0,5.0,2.0,3.0,12.0,0.0,7.0,16.0,3.0,17.0,1.0,0.0,1.0,0.0,19.0,2.0,1.0,2.0,16.0,1.0,6.0,7.0,17.0,11.0,2.0,0.0,11.0,1.0,16.0,7.0,5.0,3.0,4.0,3.0,3.0,0.0,8.0,0.0,3.0,6.0,7.0,0.0,0.0,23.0,15.0,23.0,1.0,7.0,19.0,0.0,1.0,2.0,6.0,6.0,1.0,2.0,8.0,1.0,0.0,0.0,2.0,14.0,7.0,1.0,12.0,0.0,3.0,0.0,16.0,0.0,0.0,4.0,7.0,1.0,1.0,2.0,1.0,0.0,0.0,3.0,3.0,5.0,0.0,3.0,4.0,0.0,10.0,9.0,0.0,15.0,5.0,22.0,2.0,4.0,6.0,4.0,0.0,3.0,7.0,3.0,0.0,0.0,6.0,14.0,6.0,10.0,8.0,0.0,7.0,6.0,10.0,0.0,1.0,1.0,6.0,7.0,6.0,3.0,3.0,0.0,11.0,0.0,14.0,0.0,1.0,22.0,5.0,3.0,2.0,5.0,22.0,19.0,0.0,9.0,7.0,4.0,2.0,13.0,4.0,7.0,0.0,0.0,0.0,16.0,0.0,13.0,0.0,0.0,23.0,0.0,3.0,13.0,15.0,5.0,18.0,20.0,9.0,5.0,4.0,9.0,1.0,0.0,3.0,0.0,1.0,1.0,2.0,1.0,12.0,0.0,14.0,11.0,3.0,2.0,3.0,17.0,7.0,2.0,0.0,6.0,15.0,15.0,3.0,4.0,2.0,12.0,6.0,12.0,0.0,9.0,0.0,2.0,1.0,0.0,12.0,0.0,2.0,7.0,14.0,22.0,16.0,0.0,15.0,1.0,8.0,3.0,5.0,5.0,7.0,8.0,6.0,11.0,1.0,3.0,0.0,4.0,3.0,1.0,0.0,12.0,3.0,1.0,4.0,3.0,0.0,2.0,0.0,0.0,6.0,9.0,0.0,3.0,3.0,10.0,15.0,0.0,2.0,4.0,2.0,1.0,0.0,0.0,0.0,3.0,0.0,1.0,7.0,1.0,0.0,3.0,7.0,1.0,14.0,5.0,1.0,1.0,14.0,16.0,18.0,1.0,0.0,3.0,6.0,5.0,0.0,1.0,1.0,0.0,4.0,0.0,3.0,3.0,24.0,0.0,2.0,3.0,14.0,8.0,0.0,2.0,2.0,13.0,8.0,8.0,0.0,2.0,2.0,5.0,0.0,5.0,19.0,4.0,2.0,3.0,5.0,7.0,1.0,1.0,0.0,9.0,4.0,11.0,3.0,1.0,14.0,4.0,2.0,2.0,24.0,4.0,19.0,19.0,6.0,5.0,0.0,2.0,15.0,4.0,15.0,3.0,1.0,11.0,2.0,5.0,8.0,6.0,6.0,13.0,4.0,5.0,8.0,6.0,5.0,6.0,5.0,3.0,12.0,8.0,6.0,6.0,6.0,5.0,9.0,8.0,0.0,11.0,6.0,5.0,7.0,6.0,5.0,8.0,4.0,4.0,14.0,9.0,6.0,8.0,6.0,8.0,15.0,10.0,10.0,4.0,5.0,6.0,5.0,4.0,,,,,,,,,,,,,,,,,,,,,,,,,,,,,,,,,,,,,,,,,,,,,,,,,,0.0,5.0,1.0,0.0,0.0,0.0,2.0,0.0,0.0,4.0,0.0,5.0,0.0,0.0,0.0,5.0,0.0,0.0,1.0,0.0,2.0,1.0,0.0,1.0,2.0,0.0,4.0,1.0,4.0,2.0,0.0,4.0,1.0,1.0,3.0,1.0,0.0,0.0,2.0,1.0,0.0,0.0,0.0,13.0,3.0,5.0,0.0,8.0,0.0,0.0,5.0,9.0,0.0,0.0,0.0,0.0,0.0,8.0,7.0,4.0,0.0,0.0,0.0,2.0,0.0,0.0,9.0,9.0,11.0,0.0,0.0,0.0,0.0,5.0,5.0,18.0,3.0,6.0,4.0,0.0,0.0,6.0,5.0,0.0,0.0,0.0,1.0,0.0,,0.0,0.0,4.0,0.0,0.0,0.0,0.0,0.0,5.0,0.0,0.0,0.0,0.0,2.0,0.0,5.0,3.0,9.0,1.0,0.0,2.0,3.0,0.0,8.0,0.0,0.0,0.0,0.0,0.0,1.0,8.0,6.0,4.0,0.0,0.0,0.0,0.0,0.0,14.0,0.0,6.0,3.0,0.0,0.0,6.0,1.0,0.0,14.0,0.0,0.0,6.0,0.0,8.0,12.0,10.0,11.0,4.0,12.0,9.0,11.0,13.0,7.0,9.0,14.0,11.0,4.0,0.0,10.0,14.0,9.0,11.0,5.0,3.0,11.0,9.0,9.0,5.0,6.0,11.0,12.0,11.0,14.0,22.0,11.0,14.0,,,,,,,,,,,,,0.0,0.0,0.0,2.0,2.0,0.0,0.0,2.0,2.0,0.0,0.0,0.0,6.0,1.0,8.0,9.0,11.0,4.0,6.0,1.0,1.0,2.0,4.0,12.0,7.0,4.0,0.0,0.0,6.0,0.0,0.0,5.0,0.0,1.0,5.0,6.0,16.0,9.0,13.0,10.0,0.0,7.0,11.0,2.0,0.0,3.0,4.0,2.0,13.0,19.0,4.0,0.0,11.0,4.0,11.0,10.0,5.0,2.0,9.0,11.0,4.0,2.0,4.0,1.0,17.0,2.0,2.0,3.0,0.0,3.0,0.0,5.0,16.0,7.0,4.0,9.0,5.0,2.0,7.0,5.0,11.0,8.0,7.0,3.0,2.0,1.0,5.0,2.0,18.0,,,,,,,,,,,,,,,,2.0,8.0,8.0,6.0,0.0,1.0,4.0,7.0,3.0,6.0,4.0,7.0,1.0,0.0,0.0,1.0,1.0,0.0,8.0,3.0,6.0,1.0,1.0,0.0,0.0,0.0,6.0,9.0,,,,,,,,,,,,,,,,,,,,,,,,,,2.0,4.0,4.0,1.0,4.0,5.0,1.0,0.0,11.0,5.0,7.0,3.0,8.0,12.0,14.0,7.0,7.0,8.0,1.0,1.0,0.0,0.0,0.0,0.0,3.0,1.0,4.0,2.0,0.0,2.0,3.0,4.0,1.0,4.0,4.0,2.0,5.0,7.0,3.0,2.0,0.0,1.0,0.0,0.0,0.0,2.0,0.0,1.0,3.0,2.0,3.0,1.0,1.0,2.0,6.0,1.0,4.0,0.0,1.0,4.0,5.0,0.0,0.0,1.0,4.0,1.0,1.0,7.0,0.0,7.0,5.0,5.0,1.0,2.0,8.0,5.0,0.0,1.0,0.0,6.0,1.0,2.0,3.0,5.0,6.0,2.0,10.0,9.0,3.0,0.0,1.0,4.0,0.0,2.0,0.0,0.0,4.0,1.0,2.0,1.0,5.0,5.0,0.0,0.0,7.0,4.0,5.0,10.0,6.0,2.0,3.0,6.0,5.0,3.0,11.0,3.0,3.0,7.0,7.0,5.0,11.0,7.0,5.0,5.0,6.0,5.0,4.0,5.0,11.0,8.0,8.0,3.0,5.0,6.0,0.0,6.0,7.0,9.0,6.0,2.0,13.0,12.0,8.0,2.0,10.0,4.0,9.0,6.0,5.0,7.0,7.0,4.0,9.0,3.0,1.0,8.0,,,,,,,,,,,,,,,,,,,,,,,,,,,,,,,,,,,,,,,,,,,,,,,,,,,,,,,,,,,,,,,,,,,,,,,,,,,,,,,,,,,,,,,,,,,,,,,,,,,,,,,,,,,,,,,,6.0,8.0,6.0,5.0,10.0,5.0,3.0,5.0,3.0,7.0,5.0,7.0,4.0,5.0,5.0,6.0,5.0,6.0,4.0,3.0,3.0,5.0,2.0,5.0,4.0,4.0,2.0,5.0,3.0,4.0,7.0,1.0,3.0,0.0,6.0,2.0,3.0,3.0,3.0,5.0,5.0,4.0,2.0,2.0,5.0,6.0,3.0,3.0,4.0,0.0,7.0,5.0,3.0,2.0,10.0,4.0,8.0,3.0,6.0,6.0,6.0,3.0,4.0,4.0,1.0,4.0,6.0,4.0,6.0,7.0,4.0,4.0,4.0,8.0,5.0,5.0,3.0,10.0,3.0,11.0,5.0,2.0,1.0,7.0,2.0,4.0,4.0,5.0,3.0,4.0,10.0,7.0,7.0,4.0,7.0,11.0,6.0,5.0,6.0,2.0,0.0,7.0,13.0,8.0,0.0,2.0,1.0,3.0,5.0,3.0,5.0,7.0,8.0,3.0,3.0,6.0,6.0,10.0,4.0,6.0,4.0,3.0,0.0,3.0,8.0,5.0,8.0,6.0,3.0,14.0,9.0,0.0,6.0,6.0,6.0,4.0,6.0,9.0,7.0,2.0,5.0,4.0,8.0,5.0,5.0,8.0,6.0,7.0,2.0,10.0,4.0,5.0,8.0,6.0,1.0,5.0,2.0,6.0,14.0,10.0,10.0,4.0,8.0,9.0,4.0,0.0,12.0,1.0,11.0,10.0,15.0,13.0,13.0,10.0,0.0,4.0,9.0,6.0,1.0,5.0,13.0,8.0,5.0,18.0,1.0,10.0,9.0,11.0,4.0,12.0,16.0,2.0,0.0,18.0,17.0,22.0,4.0,18.0,2.0,7.0,23.0,21.0,5.0,4.0,16.0,15.0,7.0,20.0,4.0,4.0,12.0,4.0,8.0,20.0,6.0,19.0,13.0,15.0,9.0,1.0,7.0,8.0,3.0,4.0,6.0,6.0,5.0,6.0,3.0,2.0,4.0,3.0,21.0,5.0,2.0,4.0,4.0,17.0,13.0,4.0,16.0,11.0,15.0,2.0,19.0,4.0,10.0,1.0,9.0,4.0,9.0,9.0,4.0,2.0,1.0,10.0,5.0,17.0,13.0,8.0,9.0,10.0,26.0,20.0,12.0,14.0,14.0,3.0,11.0,9.0,16.0,13.0,18.0,9.0,13.0,13.0,2.0,3.0,34.0,11.0,8.0,9.0,20.0,5.0,5.0,7.0,18.0,0.0,6.0,22.0,9.0,4.0,10.0,0.0,0.0,9.0,2.0,4.0,4.0,6.0,4.0,2.0,4.0,11.0,9.0,6.0,8.0,2.0,8.0,2.0,7.0,2.0,1.0,8.0,4.0,10.0,6.0,9.0,0.0,4.0,5.0,10.0,2.0,10.0,0.0,3.0,16.0,2.0,1.0,4.0,9.0,0.0,1.0,0.0,2.0,1.0,3.0,7.0,1.0,5.0,5.0,1.0,6.0,0.0,0.0,0.0,0.0,1.0,1.0,0.0,0.0,0.0,,,,,,,,,,,,,,,,,,,,,,,,,,,,,,,,,,,,,,,,,,,,,,,,,,,,,,,,,,,,,,,,,,,,0.0,0.0,0.0,0.0,,,,,,,,,,,1.0,0.0,2.0,0.0,0.0,1.0,0.0,2.0,1.0,1.0,0.0,1.0,2.0,0.0,1.0,1.0,1.0,0.0,0.0,3.0,,,,,,,,,,,,,,,,,,,,,,,,,,,,,,,,,,,,,,,,,,,,,,,,,,,,,,,,,,,,,,,,,,,,,,,,,,,,,,,,,,,,,,,,,,,,,,,,,,,,,,,,,,,,,,,,,,,,,,,,,,,,,,,,,,,,,,,,,,,,,,,,,,,,,,,,,,,,,,,,,,,,,,,,,,,,,,,,,,,,,,,,,,,,,,,,,,,,,,,,,,,,,,,,,,,,,,,,,,,,,,,,,,,,,,,,,,,,,,,,,,,,,,,,,,,,,,,,,,,,,,,,,,,,,,,,,,,,,,,,,,,,,,,,9.0,4.0,8.0,9.0,5.0,6.0,8.0,6.0,4.0,2.0,8.0,7.0,0.0,4.0,9.0,4.0,5.0,13.0,3.0,16.0,16.0,8.0,13.0,13.0,5.0,12.0,6.0,10.0,3.0,3.0,9.0,6.0,6.0,14.0,5.0,4.0,1.0,4.0,5.0,4.0,6.0,8.0,5.0,7.0,12.0,5.0,6.0,8.0,8.0,8.0,8.0,6.0,0.0,12.0,10.0,0.0,1.0,0.0,1.0,9.0,11.0,8.0,6.0,0.0,1.0,0.0,1.0,12.0,1.0,8.0,2.0,4.0,6.0,4.0,10.0,18.0,3.0,2.0,1.0,8.0,8.0,13.0,8.0,7.0,1.0,1.0,4.0,2.0,3.0,3.0,7.0,6.0,1.0,2.0,6.0,6.0,6.0,1.0,6.0,12.0,1.0,7.0,1.0,3.0,1.0,10.0,6.0,10.0,10.0,6.0,11.0,2.0,12.0,4.0,6.0,7.0,1.0,12.0,10.0,2.0,5.0,13.0,0.0,6.0,0.0,1.0,13.0,11.0,8.0,6.0,5.0,15.0,5.0,9.0,12.0,10.0,2.0,5.0,9.0,7.0,9.0,9.0,6.0,7.0,12.0,6.0,9.0,9.0,10.0,7.0,11.0,4.0,3.0,7.0,14.0,9.0,4.0,9.0,2.0,4.0,2.0,3.0,9.0,8.0,6.0,8.0,4.0,3.0,6.0,0.0,3.0,5.0,9.0,4.0,9.0,11.0,1.0,11.0,11.0,7.0,9.0,7.0,4.0,4.0,7.0,6.0,4.0,6.0,6.0,6.0,12.0,5.0,9.0,9.0,12.0,7.0,10.0,4.0,6.0,8.0,8.0,4.0,4.0,7.0,4.0,0.0,0.0,0.0,0.0,0.0,13.0,17.0,8.0,2.0,4.0,6.0,10.0,35.0,25.0,12.0,3.0,7.0,11.0,20.0,10.0,7.0,10.0,1.0,9.0,7.0,9.0,7.0,6.0,14.0,7.0,7.0,5.0,0.0,12.0,2.0,5.0,6.0,8.0,6.0,6.0,4.0,3.0,8.0,5.0,14.0,7.0,6.0,5.0,4.0,0.0,7.0,9.0,8.0,5.0,4.0,13.0,3.0,8.0,4.0,2.0,2.0,3.0,3.0,6.0,1.0,3.0,3.0,9.0,21.0,12.0,2.0,11.0,10.0,15.0,7.0,10.0,3.0,6.0,6.0,9.0,3.0,1.0,2.0,1.0,8.0,3.0,9.0,3.0,4.0,1.0,6.0,5.0,7.0,5.0,5.0,8.0,7.0,6.0,8.0,5.0,5.0,1.0,8.0,2.0,6.0,6.0,5.0,8.0,12.0,17.0,12.0,8.0,5.0,10.0,14.0,12.0,19.0,7.0,8.0,4.0,3.0,11.0,10.0,14.0,8.0,19.0,8.0,6.0,12.0,5.0,8.0,11.0,15.0,8.0,9.0,8.0,,7.0,5.0,8.0,0.0,1.0,4.0,7.0,7.0,6.0,14.0,4.0,16.0,3.0,6.0,3.0,0.0,9.0,5.0,12.0,3.0,0.0,3.0,6.0,8.0,4.0,2.0,1.0,1.0,0.0,0.0,0.0,0.0,0.0,1.0,6.0,0.0,3.0,0.0,8.0,1.0,8.0,10.0,7.0,15.0,19.0,15.0,14.0,9.0,13.0,14.0,14.0,16.0,12.0,7.0,8.0,8.0,0.0,3.0,1.0,9.0,9.0,7.0,5.0,12.0,5.0,16.0,17.0,11.0,6.0,1.0,8.0,4.0,16.0,18.0,7.0,7.0,4.0,18.0,12.0,7.0,11.0,7.0,21.0,9.0,7.0,12.0,0.0,7.0,7.0,8.0,17.0,9.0,10.0,10.0,12.0,13.0,1.0,4.0,5.0,7.0,6.0,2.0,5.0,8.0,7.0,8.0,10.0,4.0,3.0,2.0,4.0,9.0,0.0,5.0,5.0,12.0,0.0,6.0,3.0,0.0,12.0,0.0,3.0,8.0,14.0,6.0,6.0,7.0,1.0,7.0,10.0,3.0,1.0,2.0,1.0,5.0,0.0,2.0,0.0,3.0,6.0,1.0,1.0,2.0,4.0,5.0,1.0,6.0,8.0,7.0,10.0,10.0,9.0,13.0,22.0,6.0,8.0,,,,,,,,,,,,,,,,,,,,,,,,,,,,,,,,,,,,,,,,,,,,,,,,,,,,,,,,,,,,,,,,,,,,,,,,,,,,,,,,,,,,,,,,,,,,,,,,,,,,,,,,,,,,,,,,,,,,,,,,,,,,,,,,,,,,,,,,,,,,,,,,,13.0,6.0,6.0,0.0,1.0,9.0,0.0,9.0,10.0,10.0,10.0,6.0,6.0,1.0,14.0,13.0,3.0,6.0,5.0,1.0,14.0,7.0,12.0,3.0,10.0,1.0,8.0,8.0,8.0,19.0,6.0,18.0,3.0,22.0,12.0,5.0,9.0,6.0,13.0,12.0,6.0,11.0,2.0,14.0,7.0,7.0,5.0,3.0,15.0,9.0,8.0,2.0,2.0,4.0,3.0,3.0,1.0,0.0,0.0,9.0,0.0,0.0,0.0,1.0,0.0,0.0,0.0,0.0,18.0,4.0,8.0,7.0,7.0,12.0,24.0,9.0,12.0,5.0,7.0,2.0,25.0,6.0,2.0,5.0,12.0,2.0,16.0,22.0,13.0,3.0,12.0,13.0,9.0,3.0,18.0,12.0,4.0,7.0,6.0,7.0,0.0,10.0,8.0,3.0,14.0,11.0,23.0,0.0,7.0,1.0,3.0,2.0,3.0,10.0,2.0,2.0,5.0,6.0,6.0,7.0,10.0,13.0,10.0,17.0,9.0,6.0,7.0,12.0,11.0,12.0,8.0,7.0,14.0,10.0,9.0,1.0,5.0,11.0,13.0,11.0,7.0,8.0,11.0,8.0,7.0,13.0,14.0,13.0,10.0,7.0,0.0,4.0,6.0,9.0,14.0,12.0,10.0,9.0,9.0,11.0,10.0,7.0,11.0,1.0,3.0,9.0,3.0,13.0,10.0,8.0,6.0,12.0,11.0,3.0,9.0,2.0,9.0,9.0,7.0,8.0,7.0,6.0,11.0,12.0,8.0,26.0,2.0,13.0,15.0,5.0,11.0,6.0,6.0,8.0,11.0,16.0,16.0,9.0,9.0,4.0,14.0,8.0,3.0,11.0,8.0,12.0,14.0,5.0,18.0,9.0,13.0,12.0,9.0,5.0,5.0,4.0,10.0,23.0,15.0,1.0,5.0,5.0,7.0,11.0,10.0,10.0,7.0,7.0,4.0,6.0,7.0,5.0,8.0,16.0,9.0,8.0,4.0,15.0,5.0,7.0,7.0,18.0,6.0,2.0,2.0,7.0,7.0,6.0,8.0,2.0,8.0,7.0,5.0,3.0,13.0,4.0,8.0,6.0,3.0,5.0,14.0,4.0,3.0,12.0,6.0,7.0,0.0,4.5,10.0,6.0,1.0,0.0,1.0,5.0,1.0,0.0,3.0,5.0,4.0,5.0,0.0,3.0,3.0,14.0,0.0,8.0,4.0,5.0,6.0,0.0,0.0,0.0,0.0,1.0,0.0,3.0,2.0,0.0,1.0,4.0,3.0,2.0,0.0,0.0,4.0,3.0,0.0,2.0,1.0,0.0,0.0,0.0,4.0,0.0,3.0,0.0,0.0,4.0,0.0,5.0,2.0,4.0,4.0,2.0,7.0,6.0,3.0,4.0,5.0,0.0,0.0,3.0,4.0,4.0,0.0,4.0,5.0,1.0,4.0,0.0,0.0,0.0,0.0,0.0,0.0,0.0,0.0,0.0,0.0,0.0,0.0,0.0,0.0,0.0,1.0,0.0,0.0,6.0,0.0,5.0,2.0,4.0,4.0,2.0,5.0,0.0,2.0,0.0,4.0,2.0,3.0,2.0,3.0,0.0,1.0,0.0,0.0,0.0,0.0,0.0,0.0,0.0,2.0,0.0,0.0,2.0,0.0,2.0,12.0,8.0,12.0,16.0,20.0,7.0,8.0,13.0,3.0,18.0,0.0,9.0,1.0,1.0,22.0,6.0,2.0,1.0,4.0,4.0,9.0,12.0,12.0,23.0,5.0,7.0,10.0,3.0,2.0,11.0,14.0,13.0,13.0,11.0,5.0,19.0,13.0,13.0,13.0,19.0,5.0,54.0,7.0,7.0,19.0,1.0,1.0,8.0,0.0,4.0,7.0,5.0,8.0,11.0,14.0,17.0,5.0,4.0,7.0,13.0,19.0,0.0,15.0,19.0,16.0,17.0,17.0,8.0,16.0,1.0,4.0,11.0,12.0,15.0,4.0,9.0,2.0,7.0,3.0,4.0,12.0,15.0,4.0,6.0,3.0,0.0,6.0,5.0,1.0,10.0,6.0,5.0,9.0,18.0,4.0,3.0,14.0,5.0,11.0,1.0,18.0,16.0,4.0,15.0,4.0,1.0,2.0,2.0,3.0,8.0,5.0,9.0,6.0,9.0,22.0,15.0,14.0,5.0,10.0,0.0,2.0,11.0,6.0,13.0,11.0,9.0,0.0,12.0,2.0,5.0,1.0,11.0,8.0,1.0,2.0,0.0,17.0,2.0,7.0,13.0,7.0,11.0,9.0,13.0,8.0,13.0,11.0,3.0,1.0,9.0,6.0,11.0,6.0,27.0,10.0,5.0,0.0,3.0,5.0,2.0,12.0,1.0,4.0,2.0,3.0,9.0,3.0,9.0,5.0,11.0,7.0,6.0,2.0,8.0,4.0,8.0,3.0,6.0,12.0,15.0,10.0,9.0,12.0,10.0,12.0,9.0,6.0,1.0,4.0,1.0,0.0,0.0,0.0,0.0,0.0,0.0,0.0,0.0,0.0,0.0,0.0,0.0,0.0,0.0,0.0,0.0,0.0,0.0,0.0,0.0,0.0,0.0,0.0,0.0,0.0,0.0,0.0,0.0,0.0,0.0,0.0,0.0,0.0,0.0,0.0,0.0,0.0,0.0,0.0,0.0,0.0,0.0,0.0,0.0,0.0,0.0,0.0,0.0,0.0,0.0,0.0,0.0,0.0,0.0,0.0,0.0,0.0,0.0,0.0,0.0,0.0,3.0,1.0,0.0,0.0,4.0,0.0,1.0,0.0,0.0,0.0,4.0,0.0,0.0,0.0,0.0,0.0,0.0,0.0,0.0,0.0,0.0,0.0,0.0,0.0,0.0,0.0,0.0,0.0,0.0,0.0,0.0,0.0,0.0,0.0,0.0,0.0,0.0,0.0,0.0,0.0,0.0,0.0,0.0,0.0,0.0,0.0,0.0,1.0,5.0,0.0,0.0,,0.0,0.0,5.0,5.0,,5.0,5.0,4.0,,5.0,0.0,,,,0.0,,1.0,4.0,,,,,,1.0,1.0,1.0,0.0,0.0,,,,,,,,,,,,,,,,5.0,,,,,,,,,,,,,,,,3.0,,,5.0,1.0,,,,,,5.0,,5.0,,,,5.0,0.0,,,,,,,,,,0.0,0.0,,3.0,5.0,,,5.0,5.0,5.0,3.0,5.0,4.0,3.0,,5.0,,4.0,,5.0,,,0.0,0.0,,,2.0,,0.0,,,,5.0,3.0,2.0,1.0,,4.0,,,,1.0,5.0,,,,,5.0,,2.0,,,5.0,,0.0,,,,,,,,,,,0.0,5.0,2.0,,,3.0,1.0,,,,,,,,,5.0,,,,,,,,,,,,,,,,,,,,0.0,0.0,5.0,,1.0,,,,,4.0,,,,,,4.0,,0.0,2.0,,,4.0,,1.0,,,,,,1.0,,,,,,,,,,,,,,,,,,,,5.0,3.0,,,,,,,,,,,,,,,,,,,,,5.0,,,,,,,,,,,,,,,,,,,5.0,,,,,,,5.0,,,,,4.0,,,,,,,,,,,0.0,,,,,,5.0,,0.0,0.0,4.0,1.0,1.0,3.0,5.0,3.0,,,,1.0,,2.0,0.0,,1.0,,,2.0,3.0,5.0,1.0,0.0,,5.0,,,5.0,,,,0.0,5.0,,5.0,,,,,,,5.0,,,,,,4.0,0.0,,4.0,5.0,,,5.0,4.0,0.0,,,,,,,,0.0,,,1.0,,,,,,,0.0,1.0,,0.0,,,,,,,,3.0,,,1.0,3.0,2.0,,,,,0.0,,,,,,,,,,,,,,,,,,,,,,5.0,,2.0,,,,,,,,,,,,,,2.0,1.0,,,,,,,5.0,,5.0,3.0,0.0,0.0,4.0,0.0,,,,,1.0,5.0,,0.0,4.0,5.0,0.0,,,5.0,,3.0,,4.0,5.0,0.0,,1.0,0.0,0.0,0.0,0.0,,5.0,3.0,4.0,4.0,0.0,5.0,,,,,,,,,,,,,5.0,5.0,5.0,,5.0,,3.0,5.0,,,,5.0,5.0,,,,,5.0,4.0,3.0,,,,,,,,,,4.0,,,,,,2.0,,,,,,3.0,,,,,,,,,,,,,,,,,,,,,,5.0,,0.0,,0.0,,0.0,,,1.0,5.0,5.0,1.0,5.0,,5.0,4.0,0.0,,1.0,0.0,,,,,,,,,,,,3.0,,,,3.0,5.0,,,,,,,,,,,,,,,2.0,,,,,5.0,4.0,5.0,5.0,,,,,,,,,,,,4.0,,,5.0,5.0,5.0,4.0,5.0,3.0,3.0,5.0,2.0,3.0,2.0,2.0,2.0,5.0,5.0,4.0,2.0,2.0,3.0,2.0,0.0,0.0,5.0,5.0,,,1.0,,5.0,5.0,,5.0,,,,,5.0,4.0,4.0,,5.0,,0.0,0.0,,5.0,,5.0,,0.0,0.0,4.0,,,,4.0,5.0,,,,2.0,,4.0,5.0,,,,4.0,2.0,2.0,3.0,,,,4.0,3.0,1.0,,0.0,,0.0,,,,,,,,0.0,,4.0,,5.0,1.0,2.0,5.0,,,,,5.0,5.0,,,5.0,5.0,2.0,,,5.0,5.0,5.0,5.0,1.0,,,,,,1.0,,0.0,1.0,4.0,5.0,,,,,,,,5.0,3.0,,,,2.0,0.0,,,,,,,,,5.0,,,,,0.0,3.0,1.0,0.0,0.0,1.0,1.0,,,,0.0,,,5.0,0.0,,,,2.0,3.0,,0.0,,5.0,0.0,3.0,5.0,,,3.0,3.0,,,0.0,,,,,,,,0.0,0.0,5.0,5.0,3.0,5.0,1.0,1.0,0.0,4.0,4.0,5.0,5.0,,0.0,2.0,,0.0,,0.0,,,,4.0,,,,5.0,,,,,,,,0.0,,,,0.0,,5.0,0.0,3.0,,,,0.0,,,1.0,2.0,,,0.0,1.0,0.0,0.0,0.0,0.0,0.0,0.0,0.0,0.0,,,5.0,5.0,,0.0,,,,,2.0,,,1.0,,,,,,,,,,,,,5.0,,,,,,3.0,,,,,,,,3.0,,3.0,,,5.0,4.0,4.0,0.0,5.0,,,,0.0,0.0,,4.0,,,4.0,,0.0,5.0,2.0,2.0,1.0,5.0,1.0,,,,,,,,,,,,,,,5.0,,,,,,4.0,,,,,,5.0,5.0,5.0,3.0,,5.0,,,,,5.0,,,,5.0,5.0,0.0,0.0,,,0.0,,0.0,,,,,,,1.0,,,0.0,,,,,,,5.0,,,,,,,,0.0,,,,,,,,4.0,3.0,4.0,,,,,,1.0,,,,3.0,,,,,,,,,,,,,,,,,,,,,,,,,,,,,,,,,,,0.0,0.0,0.0,0.0,1.0,,,,,5.0,5.0,5.0,0.0,,,3.0,,5.0,,,,,,,1.0,,,,4.0,,,,,,,,,,,,,,2.0,,,,,,,,3.0,2.0,,,,,,5.0,0.0,,,5.0,5.0,3.0,2.0,1.0,,5.0,1.0,5.0,4.0,,,1.0,,,0.0,,,5.0,,4.0,,,,,5.0,,,,,,,,,,2.0,,,,,,,,,,2.0,,,4.0,4.0,,,1.0,4.0,5.0,,,,,,,,,,4.0,4.0,0.0,,,,5.0,,,3.0,5.0,5.0,5.0,5.0,0.0,1.0,3.0,5.0,4.0,5.0,3.0,2.0,5.0,5.0,3.0,5.0,5.0,5.0,4.0,5.0,4.0,4.0,5.0,4.0,3.0,2.0,,,,2.0,,,0.0,5.0,4.0,3.0,5.0,,,,5.0,,,,,3.0,5.0,4.0,,,,3.0,,,,,,,0.0,,,,,,5.0,,,,,,,,,,,,4.0,5.0,,,,,,,4.0,3.0,,,,,,,,,,,,,3.0,,,,0.0,,,,,5.0,,,,,,,0.0,,,,4.0,5.0,5.0,5.0,3.0,4.0,3.0,5.0,0.0,5.0,,3.0,0.0,,,,,,,,,,,,,,,,,,,,,,,,,,,,,,,,,,,,,0.0,0.0,0.0,0.0,0.0,0.0,0.0,0.0,,,5.0,,,,,,,5.0,5.0,0.0,,,,,,,,,,,,,,,,5.0,2.0,,,,,,,,5.0,,,2.0,,,,,5.0,,,,2.0,,1.0,4.0,1.0,2.0,5.0,,0.0,5.0,,1.0,,,4.0,,,5.0,,3.0,,5.0,5.0,,,,2.0,,,,,,,,3.0,5.0,5.0,3.0,,,,,,,,,,,,5.0,,,,3.0,,,3.0,5.0,5.0,5.0,5.0,2.0,1.0,5.0,5.0,5.0,5.0,5.0,2.0,,,,,,,2.0,5.0,,3.0,3.0,5.0,5.0,,2.0,,,,,,,0.0,,,,,,,,,,,,,,,,,,,,5.0,5.0,,,,,,,,,,,,,,,,,,,,,,,,,,,,0.0,0.0,0.0,0.0,,,,,,,,,,,,,,,,,,,,,,,,,,,,,3.0,5.0,6.0,1.0,0.0,3.0,0.0,5.0,4.0,0.0,0.0,0.0,0.0,0.0,0.0,0.0,0.0,0.0,0.0,0.0,0.0,0.0,8.0,0.0,0.0,0.0,0.0,0.0,0.0,0.0,5.0,9.0,6.0,0.0,0.0,0.0,0.0,0.0,0.0,2.0,1.0,2.5714285714285716,0.0,0.0,3.0,0.0,1.5,7.0,3.0,6.0,6.0,0.0,1.0,1.0,1.0,8.0,6.0,5.0,6.0,0.0,0.0,0.0,0.0,0.0,4.0,0.0,2.0,0.0,3.0,0.0,0.0,5.0,0.0,7.0,5.0,1.0,7.0,0.0,1.5,0.0,0.0,0.0,0.0,7.0,0.0,6.0,4.0,4.0,0.0,3.0,0.0,0.0,2.0,3.0,3.0,4.0,0.0,1.0,3.0,2.5,2.0,0.0,9.0,1.6666666666666667,0.0,0.0,4.0,0.0,1.0,0.0,3.0,10.0,0.0,6.0,4.0,7.0,0.0,0.0,0.0,4.0,0.0,5.0,5.0,7.0,0.0,6.0,7.0,0.0,4.0,0.0,1.0,0.0,0.0,5.0,2.0,0.0,0.0,12.0,0.0,1.0,2.0,0.0,0.0,5.0,0.0,0.0,2.0,2.0,0.0,6.0,0.0,0.0,1.0,1.0,0.0,0.0,2.5,1.0,0.0,1.0,2.0,0.0,7.0,0.0,4.0,0.0,2.0,0.0,0.0,0.0,1.0,0.0,5.0,0.0,3.0,0.0,0.0,2.0,2.0,5.0,5.0,7.0,5.0,0.0,3.0,6.0,6.0,3.0,0.0,4.0,0.0,0.0,2.0,1.0,0.0,0.0,6.0,3.0,7.0,1.0,5.0,0.0,3.0,3.0,6.0,0.0,0.0,0.0,7.0,5.0,0.0,2.0,0.0,0.0,1.0,6.0,6.0,2.0,0.0,2.0,9.0,5.0,0.0,0.0,2.0,0.0,0.0,1.5,5.0,0.0,0.0,2.0,3.0,0.0,0.0,3.0,8.0,0.0,0.0,5.0,2.0,4.0,0.0,5.0,1.5,7.0,0.0,6.0,2.0,2.0,4.0,2.0,10.0,0.0,4.0,0.0,7.0,4.0,0.0,2.0,0.0,0.0,3.0,2.0,4.0,1.0,0.0,4.0,6.0,0.0,0.0,2.0,0.0,0.0,0.0,0.0,6.0,3.0,0.0,0.0,2.0,3.0,1.5,0.0,0.0,0.0,3.0,1.0,1.0,2.0,,,,,,,,,,,,,,,,,,,,,,21.0,8.0,19.0,4.0,3.0,3.0,8.0,5.0,6.0,3.0,4.0,7.0,4.0,6.0,10.0,3.0,5.0,7.0,9.0,10.0,10.0,10.0,14.0,4.0,5.0,13.0,4.0,5.0,6.0,1.0,8.0,5.0,3.0,16.0,8.0,0.0,17.0,2.0,13.0,3.0,9.0,2.0,16.0,6.0,3.0,16.0,3.0,4.0,16.0,9.0,5.0,14.0,8.0,14.0,20.0,5.0,3.0,4.0,3.0,3.0,5.0,3.0,5.0,5.0,3.0,3.0,2.0,5.5,8.0,6.0,6.0,6.0,16.0,2.0,2.0,3.0,4.0,7.0,2.0,8.0,12.0,18.0,9.0,4.0,15.0,7.0,5.0,4.0,3.0,4.0,1.0,3.0,4.0,4.0,9.0,8.0,14.0,10.0,2.0,9.0,16.0,3.0,9.0,9.0,6.0,2.0,12.0,9.0,5.0,5.0,7.0,4.0,6.0,4.0,9.0,7.0,12.0,7.0,12.0,17.0,7.0,8.0,8.0,5.0,11.0,3.0,8.0,6.0,3.0,15.0,1.0,7.0,3.0,6.0,5.0,3.0,6.0,11.0,0.0,3.0,0.0,0.0,3.0,0.0,4.0,0.0,0.0,1.0,3.0,1.0,5.0,3.0,3.0,3.0,,,,,0.0,0.0,0.0,0.0,0.0,0.0,0.0,0.0,0.0,,,,,,,,,,,,,1.0,1.0,,,,,,,0.0,0.0,0.0,3.0,1.0,1.0,5.0,0.0,,,,,,,,,,,,,,,,,,,,,,,,,,,,,,,,,,,,,,,,,,,,,,,,,,,,,,,,,,,,,,,,,,,,,,,5.0,8.0,5.0,0.0,3.0,2.0,2.0,11.0,2.0,3.0,2.0,4.0,4.0,2.0,5.0,4.0,1.0,1.0,0.0,1.0,2.0,6.0,5.0,5.0,0.0,1.0,2.0,3.0,0.0,2.0,1.0,1.0,4.0,5.0,3.0,3.0,4.0,2.0,4.0,0.0,0.0,2.0,4.0,7.0,2.0,3.0,5.0,5.0,0.0,5.0,2.0,4.0,1.0,8.0,7.0,3.0,1.0,2.0,1.0,2.0,1.0,1.0,1.0,4.0,1.0,1.0,2.0,1.0,1.0,0.0,0.0,3.0,0.0,0.0,1.0,2.0,0.0,1.0,3.0,2.0,0.0,5.0,4.0,4.0,6.0,1.0,3.0,3.0,2.0,0.0,2.0,3.0,2.0,5.0,4.0,3.0,4.0,2.0,3.0,2.0,1.0,0.0,4.0,1.0,2.0,2.0,0.0,1.0,0.0,4.0,3.0,1.0,1.0,3.0,3.0,7.0,6.0,4.0,0.0,3.0,7.0,3.0,3.0,4.0,1.0,4.0,3.0,0.0,0.0,1.0,0.0,0.0,0.0,0.0,0.0,0.0,0.0,0.0,0.0,0.0,0.0,0.0,0.0,0.0,0.0,0.0,0.0,0.0,0.0,0.0,0.0,0.0,0.0,0.0,0.0,0.0,0.0,0.0,0.0,0.0,1.0,0.0,0.0,0.0,0.0,0.0,0.0,0.0,1.0,5.0,1.0,0.0,0.0,0.0,0.0,0.0,,,,,,,,,,,,,,,,,,,,,,,,,,,,,,,,,,,,,,,,,,,,,,,,,,,,,,,,,,,,,,,,,,,,,,,,,,,,,,,,,,,,,,,,,,,,,,,,,,,,,,,,,,,,,,,,,,,,,,,,,,,,,,,,,,,,,,,,,,,,,,,,,,,,,,,,2.0,12.0,4.0,4.0,1.0,6.0,6.0,2.0,4.0,4.0,1.0,0.0,2.0,8.0,3.0,2.0,3.0,3.0,4.0,4.0,4.0,4.0,7.0,0.0,4.0,0.0,3.0,6.0,4.0,2.0,3.0,7.0,9.0,8.0,7.0,10.0,15.0,7.0,7.0,10.0,4.0,8.0,6.0,7.0,9.0,5.0,14.0,17.0,5.0,6.0,10.0,8.0,15.0,13.0,13.0,11.0,6.0,16.0,10.0,6.0,5.0,12.0,4.0,17.0,5.0,12.0,7.0,5.0,11.0,14.0,6.0,12.0,13.0,8.0,10.0,13.0,12.0,7.0,5.0,4.0,9.0,6.0,10.0,13.0,12.0,8.0,7.0,7.0,5.0,9.0,8.0,6.0,13.0,10.0,6.0,0.0,0.0,0.0,0.0,0.0,0.0,0.0,0.0,0.0,,,,,,,,,,,,,,,,,,,,,,,,,,,,,,,,,,,,,,,,,,,19.0,35.0,5.0,2.0,45.0,2.0,10.0,8.0,11.0,5.0,6.0,5.0,10.0,1.0,24.0,22.0,0.0,5.0,0.0,17.0,18.0,3.0,2.0,31.0,27.0,11.0,16.0,0.0,0.0,20.0,0.0,0.0,0.0,20.0,1.0,43.0,0.0,21.0,3.0,5.0,26.0,21.0,19.0,1.0,25.0,15.0,23.0,4.0,1.0,15.0,31.0,1.0,11.0,1.0,12.0,26.0,1.0,42.0,28.0,2.0,0.0,8.0,2.0,2.0,1.0,5.0,0.0,6.0,9.0,7.0,1.0,20.0,1.0,0.0,18.0,2.0,10.0,14.0,4.0,17.0,49.0,17.0,17.0,2.0,0.0,32.0,2.0,0.0,0.0,8.0,18.0,5.0,2.0,32.0,11.0,1.0,7.0,2.0,31.0,15.0,30.0,13.0,0.0,39.0,14.0,6.0,0.0,15.0,6.0,31.0,23.0,0.0,0.0,7.0,19.0,24.0,0.0,0.0,6.0,23.0,7.0,6.0,10.0,20.0,4.0,3.0,0.0,53.0,1.0,11.0,0.0,1.0,15.0,8.0,20.0,21.0,27.0,8.0,1.0,3.0,2.0,4.0,2.0,16.0,1.0,3.0,9.0,18.0,8.0,2.0,12.0,3.0,0.0,1.0,1.0,22.0,20.0,9.0,29.0,16.0,0.0,0.0,0.0,1.0,2.0,23.0,5.0,19.0,7.0,3.0,34.0,15.0,9.0,11.0,5.0,3.0,7.0,16.0,8.0,7.0,15.0,22.0,9.0,13.0,3.0,5.0,2.0,10.0,30.0,11.0,14.0,0.0,16.0,11.0,4.0,3.0,10.0,4.0,9.0,4.0,3.0,0.0,0.0,3.0,2.0,6.0,0.0,8.0,12.0,21.0,0.0,21.0,18.0,3.0,3.0,0.0,4.0,19.0,2.0,1.0,8.0,7.0,17.0,9.0,2.0,11.0,21.0,15.0,9.0,1.0,16.0,21.0,14.0,6.0,4.0,28.0,1.0,3.0,0.0,9.0,7.0,19.0,8.0,20.0,17.0,0.0,3.0,7.0,25.0,0.0,0.0,10.0,17.0,20.0,5.0,0.0,0.0,4.0,4.0,9.0,0.0,1.0,2.0,8.0,0.0,3.0,12.0,18.0,13.0,0.0,20.0,10.0,2.0,12.0,15.0,0.0,17.0,8.0,24.0,6.0,2.0,2.0,0.0,24.0,45.0,0.0,14.0,15.0,32.0,6.0,12.0,7.0,10.0,25.0,12.0,1.0,5.0,17.0,7.0,6.0,2.0,3.0,1.0,8.0,17.0,15.0,15.0,3.0,1.0,15.0,15.0,15.0,0.0,3.0,0.0,8.0,8.0,30.0,0.0,2.0,7.0,16.0,12.0,18.0,3.0,7.0,24.0,17.0,5.0,2.0,1.0,0.0,27.0,5.0,9.0,9.0,14.0,23.0,2.0,28.0,7.0,0.0,8.0,6.0,19.0,0.0,8.0,1.0,16.0,1.0,7.0,7.0,11.0,9.0,16.0,2.0,24.0,17.0,0.0,8.0,10.0,9.0,22.0,32.0,12.0,11.0,0.0,14.0,7.0,23.0,1.0,16.0,11.0,21.0,38.0,1.0,6.0,0.0,8.0,16.0,1.0,9.0,8.0,6.0,4.0,19.0,3.0,2.0,6.0,10.0,1.0,24.0,25.0,5.0,17.0,17.0,1.0,22.0,21.0,1.0,6.0,0.0,3.0,11.0,19.0,19.0,28.0,12.0,3.0,7.0,13.0,6.0,0.0,0.0,8.0,0.0,3.0,7.0,12.0,4.0,25.0,0.0,0.0,0.0,0.0,4.0,21.0,12.0,4.0,1.0,2.0,0.0,12.0,0.0,32.0,0.0,0.0,3.0,3.0,1.0,14.0,18.0,21.0,1.0,4.0,12.0,0.0,0.0,0.0,11.0,0.0,1.0,17.0,20.0,3.0,9.0,2.0,5.0,15.0,19.0,2.0,2.0,0.0,2.0,0.0,0.0,19.0,2.0,12.0,14.0,5.0,4.0,1.0,35.0,8.0,2.0,0.0,2.0,28.0,0.0,19.0,6.0,0.0,7.0,4.0,1.0,0.0,17.0,2.0,8.0,1.0,16.0,16.0,21.0,10.0,16.0,0.0,23.0,21.0,9.0,0.0,31.0,18.0,0.0,0.0,1.0,5.0,4.0,1.0,12.0,8.0,10.0,5.0,0.0,0.0,1.0,11.0,4.0,0.0,2.0,4.0,3.0,20.0,0.0,22.0,35.0,0.0,1.0,0.0,2.0,0.0,2.0,16.0,1.0,16.0,7.0,11.0,0.0,30.0,0.0,11.0,11.0,0.0,1.0,13.0,0.0,14.0,1.0,12.0,0.0,0.0,23.0,0.0,24.0,26.0,4.0,23.0,0.0,2.0,1.0,12.0,21.0,17.0,7.0,18.0,0.0,9.0,15.0,16.0,16.0,9.0,10.0,9.0,0.0,3.0,16.0,6.0,11.0,1.0,0.0,21.0,0.0,2.0,14.0,3.0,0.0,9.0,25.0,2.0,2.0,9.0,0.0,18.0,19.0,8.0,16.0,0.0,0.0,25.0,0.0,0.0,0.0,18.0,12.0,1.0,7.0,4.0,11.0,5.0,0.0,0.0,13.0,22.0,6.0,4.0,1.0,5.0,0.0,31.0,0.0,24.0,2.0,6.0,6.0,1.0,0.0,,21.0,2.0,0.0,1.0,1.0,0.0,3.0,0.0,23.0,0.0,15.0,25.0,20.0,0.0,1.0,0.0,1.0,11.0,0.0,9.0,0.0,0.0,6.0,3.0,8.0,6.0,4.0,4.0,8.0,19.0,1.0,6.0,0.0,18.0,11.0,1.0,6.0,19.0,2.0,0.0,17.0,10.0,6.0,4.0,4.0,26.0,2.0,1.0,2.0,0.0,0.0,2.0,12.0,0.0,0.0,2.0,2.0,7.0,4.0,5.0,40.0,22.0,9.0,0.0,0.0,0.0,17.0,9.0,6.0,0.0,4.0,8.0,8.0,1.0,1.0,23.0,20.0,12.0,7.0,17.0,0.0,16.0,0.0,7.0,17.0,15.0,6.0,19.0,10.0,7.0,0.0,8.0,2.0,0.0,7.0,0.0,14.0,20.0,1.0,9.0,0.0,1.0,30.0,1.0,3.0,23.0,0.0,7.0,0.0,22.0,2.0,27.0,0.0,3.0,8.0,1.0,9.0,26.0,7.0,21.0,23.0,1.0,21.0,9.0,0.0,20.0,26.0,0.0,13.0,18.0,18.0,35.0,15.0,5.0,15.0,23.0,6.0,19.0,3.0,17.0,3.0,0.0,1.0,20.0,2.0,16.0,,,,,,,,,,,,,,,,,,,,,,,,,,,,,,,,,,,,,,,,,2.0,3.0,1.0,4.0,0.0,5.0,2.0,0.0,0.0,2.0,1.0,0.0,0.0,0.0,0.0,0.0,0.0,0.0,0.0,0.0,4.0,2.0,2.0,0.0,3.0,0.0,4.0,3.0,0.0,0.0,3.0,8.0,15.0,10.0,20.0,8.0,1.0,18.0,17.0,0.0,9.0,13.0,2.0,13.0,1.0,4.0,3.0,1.0,6.0,3.0,6.0,15.0,6.0,0.0,16.0,7.0,13.0,13.0,12.0,3.0,2.0,5.0,3.0,9.0,4.0,4.0,5.0,1.0,1.0,27.0,2.0,0.0,2.0,7.0,0.0,0.0,2.0,1.0,4.0,0.0,2.0,20.0,16.0,1.0,13.0,7.0,7.0,4.0,7.0,7.0,17.0,13.0,20.0,7.0,0.0,0.0,16.0,2.0,6.0,22.0,5.0,7.0,11.0,3.0,13.0,15.0,14.0,0.0,5.0,17.0,15.0,3.0,2.0,19.0,19.0,4.0,27.0,5.0,5.0,4.0,0.0,8.0,0.0,3.0,2.0,4.0,10.0,15.0,32.0,6.0,40.0,17.0,20.0,7.0,17.0,4.0,8.0,15.0,15.0,19.0,9.0,1.0,9.0,25.0,13.0,5.0,13.0,18.0,6.0,15.0,13.0,19.0,20.0,20.0,15.0,22.0,10.0,12.0,10.0,18.0,18.0,19.0,14.0,8.0,12.0,15.0,20.0,10.0,15.0,3.0,16.0,10.0,12.0,19.0,11.0,17.0,4.0,0.0,0.0,3.0,1.0,5.0,24.0,10.0,13.0,17.0,9.0,8.0,14.0,4.0,12.0,3.0,0.0,15.0,12.0,8.0,4.0,19.0,8.0,7.0,9.0,9.0,6.0,17.0,4.0,2.0,13.0,1.0,12.0,2.0,14.0,15.0,17.0,13.0,15.0,18.0,15.0,7.0,6.0,5.0,4.0,3.0,16.0,15.0,17.0,12.0,18.0,16.0,10.0,12.0,6.0,11.0,14.0,7.0,9.0,12.0,12.0,2.0,5.0,1.0,11.0,12.0,5.0,8.0,13.0,0.0,15.0,14.0,6.0,4.0,7.0,2.0,5.0,6.0,0.0,6.0,14.0,15.0,15.0,7.0,7.0,0.0,1.0,4.0,0.0,14.0,12.0,18.0,9.0,12.0,13.0,8.0,29.0,14.0,11.0,13.0,4.0,1.0,8.0,6.0,7.0,1.0,8.0,13.0,24.0,16.0,0.0,0.0,0.0,0.0,0.0,0.0,0.0,0.0,0.0,0.0,0.0,0.0,0.0,0.0,0.0,0.0,0.0,0.0,0.0,0.0,0.0,0.0,0.0,0.0,0.0,0.0,0.0,0.0,0.0,0.0,0.0,0.0,0.0,0.0,0.0,0.0,0.0,0.0,0.0,0.0,0.0,0.0,0.0,0.0,0.0,0.0,0.0,0.0,0.0,0.0,0.0,0.0,0.0,0.0,0.0,0.0,0.0,5.0,1.0,5.0,1.0,0.0,2.0,2.0,1.0,5.0,3.0,2.0,5.0,5.0,2.0,0.0,1.0,5.0,1.0,1.0,3.0,1.0,3.0,3.0,2.0,4.0,1.0,,,,,,,,,,,,,,,,,,,,,,,,,,,,,,,,,,,,,,,,,,,,,,,,,,,,,,,,,,,,,,,,,,,,,,,,,,,,,,,,,,,,,,,,,,,,,,,,,,,,,,,,,,,,,,,,,,,,,,,,1.0,13.0,7.0,9.0,1.0,,1.0,3.0,2.0,0.0,3.0,5.0,5.0,4.0,3.0,1.0,8.0,1.0,11.0,5.0,4.0,14.0,16.0,4.0,6.0,10.0,1.0,2.0,4.0,1.0,2.0,4.0,1.0,7.0,8.0,2.0,6.0,1.0,0.0,4.0,5.0,13.0,4.0,5.0,1.0,2.0,4.0,4.0,8.0,4.0,6.0,2.0,1.0,4.0,3.0,1.0,0.0,0.0,2.0,19.0,1.0,5.0,2.0,2.0,3.0,1.0,2.0,3.0,1.0,2.0,3.0,9.0,2.0,0.0,2.0,0.0,0.0,2.0,4.0,2.0,6.0,1.0,3.0,2.0,6.0,5.0,1.0,9.0,2.0,3.0,3.0,4.0,1.0,7.0,0.0,9.0,5.0,5.0,2.0,0.0,1.0,2.0,0.0,1.0,5.0,0.0,0.0,5.0,7.0,2.0,1.0,0.0,2.0,10.0,7.0,0.0,6.0,7.0,5.0,0.0,2.0,4.0,6.0,3.0,2.0,1.0,2.0,3.0,0.0,7.0,6.0,7.0,6.0,6.0,1.0,3.0,4.0,2.0,1.0,7.0,4.0,3.0,3.0,5.0,10.0,0.0,0.0,0.0,1.0,0.0,,,,,,,,,,5.0,6.0,6.0,5.0,4.0,2.0,6.0,8.0,0.0,2.0,5.0,7.0,9.0,3.0,8.0,9.0,4.0,2.0,1.0,5.0,1.0,0.0,1.0,3.0,,,,,,,,,,,,,,,,,,,,,,,,,,,,,,,,,,,,,,,,,,,3.0,3.0,5.0,3.0,5.0,5.0,5.0,4.0,5.0,5.0,3.0,5.0,4.0,5.0,4.0,3.0,4.0,5.0,5.0,4.0,1.0,5.0,5.0,5.0,5.0,5.0,5.0,3.0,3.0,4.0,5.0,2.0,5.0,5.0,5.0,5.0,2.0,5.0,5.0,5.0,5.0,2.0,7.0,17.0,4.0,0.0,18.0,0.0,0.0,0.0,17.0,8.0,9.0,0.0,0.0,1.0,5.0,7.0,1.0,0.0,7.0,0.0,21.0,40.0,32.0,11.0,20.0,0.0,1.0,0.0,1.0,3.0,0.0,1.0,0.0,24.0,0.0,17.0,4.0,14.0,12.0,15.0,4.0,1.0,17.0,20.0,0.0,20.0,17.0,1.0,27.0,22.0,9.0,9.0,0.0,14.0,4.0,0.0,22.0,19.0,26.0,40.0,2.0,3.0,8.0,1.0,1.0,0.0,1.0,3.0,31.0,27.0,10.0,,,,,,,,,,,,,,,,,,,,,,,,,,,,,,,,,,,3.0,0.0,3.0,3.0,2.0,3.0,0.0,0.0,0.0,4.0,3.0,2.0,2.0,2.0,2.0,3.0,2.0,0.0,7.0,2.0,3.0,5.0,2.0,17.0,2.0,46.0,7.0,2.0,0.0,0.0,2.0,5.0,4.0,0.0,0.0,0.0,0.0,1.0,2.0,2.0,1.0,3.0,1.0,0.0,1.0,0.0,0.0,1.0,0.0,0.0,0.0,1.0,1.0,1.0,0.0,1.0,1.0,1.0,0.0,0.0,1.0,1.0,1.0,1.0,2.0,1.0,0.0,0.0,1.0,0.0,2.0,2.0,0.0,1.0,5.0,1.0,1.0,1.0,1.0,1.0,2.0,1.0,0.0,0.0,1.0,0.0,1.0,2.0,1.0,1.0,1.0,0.0,3.0,1.0,0.0,0.0,1.0,1.0,1.0,1.0,0.0,1.0,0.0,0.0,1.0,0.0,1.0,0.0,0.0,1.0,0.0,1.0,1.0,1.0,1.0,1.0,2.0,0.0,4.0,3.0,2.0,3.0,0.0,7.0,0.0,4.0,1.0,9.0,0.0,2.0,1.0,0.0,0.0,0.0,0.0,1.0,0.0,1.0,1.0,0.0,0.0,0.0,2.0,1.0,1.0,4.0,1.0,1.0,2.0,2.0,7.0,0.0,2.0,0.0,0.0,2.0,4.0,0.0,2.0,1.0,1.0,1.0,2.0,1.0,2.0,0.0,7.0,2.0,0.0,0.0,1.0,1.0,0.0,2.0,2.0,0.0,1.0,4.0,3.0,0.0,0.0,9.0,7.0,1.0,0.0,0.0,0.0,0.0,1.0,1.0,1.0,4.0,0.0,0.0,0.0,2.0,0.0,1.0,0.0,0.0,1.0,0.0,0.0,0.0,0.0,4.0,0.0,2.0,1.0,1.0,2.0,1.0,11.0,1.0,0.0,0.0,0.0,0.0,0.0,2.0,1.0,2.0,4.0,0.0,0.0,4.0,0.0,10.0,0.0,0.0,0.0,0.0,0.0,0.0,2.0,1.0,0.0,7.0,0.0,0.0,5.0,0.0,3.0,0.0,0.0,0.0,1.0,0.0,0.0,0.0,0.0,0.0,0.0,0.0,7.0,4.0,1.0,2.0,7.0,1.0,5.0,2.0,9.0,2.0,2.0,3.0,2.0,3.0,5.0,5.0,4.0,5.0,2.0,4.0,2.0,2.0,3.0,3.0,4.0,5.0,4.0,2.0,6.0,3.0,2.0,19.0,13.0,7.0,3.0,13.0,15.0,14.0,7.0,6.0,3.0,23.0,9.0,11.0,13.0,9.0,9.0,8.0,,,,,,,,,,2.0,2.0,3.0,3.0,0.0,3.0,3.0,0.0,9.0,1.0,4.0,6.0,0.0,6.0,2.0,1.0,1.0,5.0,3.0,0.0,5.0,3.0,1.0,5.0,4.0,6.0,5.0,3.0,5.0,13.0,2.0,2.0,2.0,1.0,3.0,3.0,6.0,3.0,6.0,3.0,3.0,5.0,4.0,0.0,2.0,9.0,0.0,0.0,1.0,0.0,7.0,0.0,5.0,2.0,5.0,5.0,5.0,5.0,4.0,0.0,5.0,5.0,2.0,5.0,0.0,5.0,5.0,5.0,5.0,5.0,5.0,5.0,3.0,5.0,4.0,4.0,0.0,4.0,4.0,5.0,5.0,5.0,3.0,5.0,5.0,5.0,5.0,1.0,5.0,5.0,5.0,3.0,5.0,4.0,4.0,2.0,4.0,5.0,5.0,5.0,5.0,4.0,5.0,5.0,4.0,5.0,2.0,4.0,4.0,4.0,5.0,5.0,5.0,5.0,5.0,4.0,5.0,4.0,5.0,4.0,5.0,4.0,5.0,5.0,4.0,5.0,4.0,5.0,5.0,5.0,5.0,5.0,4.0,5.0,4.0,5.0,5.0,4.0,5.0,5.0,4.0,4.0,5.0,3.0,5.0,3.0,5.0,5.0,5.0,5.0,4.0,5.0,5.0,5.0,4.0,5.0,5.0,4.0,5.0,2.0,5.0,4.0,3.0,5.0,4.0,5.0,5.0,5.0,5.0,4.0,0.0,5.0,0.0,0.0,0.0,0.0,,,,,,,,,,,,4.0,7.0,5.0,7.0,7.0,10.0,15.0,37.0,10.0,10.0,20.0,19.0,24.0,13.0,13.0,11.0,29.0,16.0,28.0,9.0,10.0,7.0,5.0,19.0,3.0,8.0,17.0,13.0,32.0,14.0,9.0,4.0,16.0,7.0,0.0,21.0,21.0,1.0,15.0,3.0,11.0,2.0,8.0,6.0,1.0,10.0,12.0,3.0,17.0,5.0,0.0,13.0,2.0,18.0,23.0,13.0,6.0,19.0,14.0,17.0,12.0,14.0,7.0,11.0,3.0,12.0,10.0,5.0,6.0,12.0,7.0,3.0,16.0,5.0,7.0,3.0,5.0,14.0,17.0,22.0,3.0,8.0,7.0,15.0,5.0,16.0,12.0,19.0,18.0,24.0,6.0,3.0,27.0,14.0,25.0,26.0,6.0,12.0,15.0,17.0,14.0,12.0,24.0,12.0,17.0,20.0,5.0,11.0,15.0,11.0,1.0,8.0,25.0,29.0,8.0,31.0,16.0,17.0,19.0,11.0,4.0,26.0,2.0,9.0,19.0,26.0,14.0,16.0,16.0,1.0,1.0,10.0,0.0,20.0,15.0,6.0,21.0,33.0,6.0,0.0,13.0,25.0,16.0,16.0,18.0,1.0,6.0,13.0,3.0,12.0,1.0,11.0,8.0,8.0,8.0,7.0,24.0,18.0,10.0,11.0,2.0,17.0,6.0,20.0,4.0,6.0,11.0,2.0,20.0,11.0,18.0,18.0,11.0,1.0,6.0,1.0,30.0,15.0,2.0,14.0,12.0,16.0,18.0,13.0,18.0,37.0,17.0,4.0,2.0,12.0,4.0,9.0,16.0,2.0,21.0,11.0,7.0,13.0,2.0,11.0,15.0,16.0,17.0,14.0,11.0,8.0,1.0,3.0,11.0,8.0,0.0,14.0,14.0,12.0,7.0,10.0,2.0,2.0,8.0,21.0,15.0,12.0,11.0,7.0,9.0,1.0,6.0,36.0,25.0,6.0,19.0,19.0,14.0,1.0,20.0,5.0,6.0,16.0,11.0,10.0,20.0,22.0,0.0,9.0,1.0,42.0,0.0,18.0,13.0,26.0,21.0,16.0,6.0,11.0,7.0,1.0,34.0,28.0,29.0,30.0,14.0,25.0,5.0,13.0,8.0,6.0,20.0,4.0,11.0,9.0,9.0,4.0,12.0,21.0,23.0,11.0,5.0,10.0,15.0,3.0,7.0,12.0,12.0,8.0,10.0,12.0,16.0,3.0,4.0,1.0,7.0,10.0,1.0,11.0,6.0,21.0,17.0,10.0,2.0,10.0,21.0,7.0,7.0,15.0,4.0,14.0,16.0,9.0,23.0,6.0,14.0,17.0,10.0,6.0,25.0,21.0,19.0,8.0,19.0,6.0,13.0,10.0,4.0,4.0,9.0,21.0,22.0,17.0,13.0,9.0,2.0,12.0,5.0,14.0,2.0,9.0,24.0,13.0,2.0,12.0,17.0,10.0,5.0,1.0,1.0,3.0,2.0,1.0,5.0,1.0,0.0,0.0,0.0,0.0,1.0,3.0,1.0,2.0,4.0,0.0,1.0,0.0,0.0,0.0,1.0,1.0,0.0,0.0,5.0,1.0,0.0,1.0,5.0,2.0,4.0,4.0,5.0,5.0,1.0,0.0,0.0,1.0,0.0,3.0,0.0,4.0,4.0,0.0,2.0,0.0,0.0,1.0,1.0,2.0,0.0,1.0,0.0,0.0,1.0,0.0,3.0,1.0,2.0,0.0,0.0,5.0,1.0,2.0,0.0,0.0,1.0,5.0,1.0,0.0,0.0,0.0,0.0,1.0,0.0,1.0,2.0,1.0,3.0,1.0,4.0,0.0,0.0,0.0,0.0,0.0,0.0,5.0,2.0,0.0,0.0,0.0,1.0,2.0,2.0,1.0,0.0,3.0,1.0,3.0,2.0,1.0,0.0,0.0,0.0,1.0,5.0,0.0,3.0,1.0,0.0,0.0,4.0,5.0,,5.0,1.0,0.0,1.0,2.0,3.0,3.0,2.0,,,,,,,,,,,,1.0,,,3.0,1.0,0.0,,,6.0,,7.0,,,,,,,,3.0,0.0,,3.0,,,2.0,,,2.0,,3.0,,,,,,,,,,1.0,,,9.0,1.0,,,,,,,,,,4.0,,8.0,3.0,,,4.0,4.0,0.0,,,,,6.0,,1.0,,,,,0.0,0.0,,,3.0,0.0,2.0,0.0,2.0,2.0,,,,,3.0,2.0,5.0,5.0,1.0,6.0,15.0,4.0,1.0,3.0,3.0,7.0,0.0,13.0,0.0,,,4.0,7.0,3.0,,,,,,,,,1.0,,,,1.0,,5.0,,6.0,,,4.0,2.0,,,,,,4.0,11.0,0.0,,,9.0,2.0,,,,,,12.0,,,,5.0,0.0,4.0,,,,3.0,13.0,2.0,,,,,,,,7.0,,,,2.0,,,,,0.0,3.0,5.0,12.0,9.0,10.0,3.0,10.0,19.0,14.0,19.0,18.0,24.0,14.0,15.0,17.0,15.0,22.0,7.0,9.0,2.0,1.0,16.0,5.0,3.0,8.0,13.0,20.0,13.0,1.0,7.0,3.0,2.0,6.0,8.0,8.0,6.0,1.0,7.0,0.0,16.0,8.0,3.0,10.0,9.0,14.0,15.0,18.0,3.0,11.0,4.0,10.0,13.0,11.0,17.0,14.0,4.0,5.0,21.0,23.0,13.0,1.0,3.0,4.0,13.0,0.0,2.0,12.0,19.0,17.0,3.0,14.0,28.0,4.0,5.0,14.0,16.0,28.0,28.0,24.0,6.0,4.0,6.0,0.0,7.0,13.0,20.0,3.0,0.0,3.0,20.0,8.0,1.0,14.0,0.0,5.0,0.0,12.0,11.0,5.0,0.0,4.0,3.0,2.0,2.0,12.0,3.0,4.0,12.0,24.0,5.0,5.0,13.0,12.0,10.0,28.0,3.0,11.0,10.0,1.0,3.0,8.0,8.0,1.0,15.0,1.0,16.0,4.0,12.0,9.0,15.0,14.0,10.0,8.0,10.0,12.0,8.0,11.0,5.0,11.0,7.0,3.0,9.0,0.0,4.0,7.0,6.0,3.0,3.0,1.0,2.0,11.0,6.0,11.0,6.0,25.0,13.0,17.0,7.0,18.0,11.0,12.0,6.0,9.0,7.0,18.0,8.0,6.0,0.0,1.0,9.0,8.0,9.0,2.0,3.0,3.0,17.0,10.0,9.0,10.0,15.0,0.0,13.0,15.0,0.0,9.0,5.0,1.0,19.0,9.0,18.0,12.0,2.0,4.0,20.0,10.0,9.0,10.0,10.0,4.0,1.0,4.0,7.0,5.0,4.0,0.0,17.0,20.0,1.0,5.0,15.0,7.0,3.0,18.0,3.0,10.0,14.0,11.0,10.0,13.0,14.0,6.0,6.0,9.0,11.0,10.0,11.0,20.0,4.0,19.0,8.0,16.0,2.0,4.0,6.0,4.0,1.0,0.0,0.0,13.0,6.0,2.0,1.0,14.0,4.0,2.0,8.0,1.0,0.0,10.0,6.0,12.0,4.0,2.0,8.0,12.0,10.0,8.0,6.0,5.0,8.0,8.0,9.0,4.0,3.0,5.0,15.0,3.0,12.0,13.0,17.0,17.0,14.0,7.0,19.0,11.0,9.0,11.0,7.0,10.0,12.0,24.0,12.0,6.0,11.0,7.0,6.0,9.0,6.0,11.0,7.0,10.0,8.0,13.0,9.0,13.0,5.0,11.0,7.0,11.0,7.0,9.0,0.0,0.0,0.0,0.0,0.0,0.0,16.0,0.0,0.0,2.0,6.0,2.0,11.0,23.0,7.0,2.0,5.0,1.0,1.0,7.0,20.0,15.0,2.0,10.0,11.0,1.0,3.0,12.0,9.0,8.0,16.0,14.0,12.0,6.0,2.0,10.0,5.0,0.0,1.0,0.0,14.0,14.0,12.0,17.0,5.0,19.0,1.0,10.0,6.0,5.0,0.0,2.0,3.0,25.0,20.0,10.0,3.0,4.0,6.0,1.0,1.0,5.0,7.0,2.0,19.0,13.0,9.0,29.0,0.0,4.0,4.0,12.0,0.0,14.0,6.0,1.0,1.0,3.0,1.0,11.0,5.0,1.0,6.0,1.0,2.0,25.0,8.0,5.0,2.0,5.0,3.0,1.0,3.0,10.0,1.0,5.0,0.0,4.0,8.0,14.0,44.0,24.0,34.0,10.0,32.0,4.0,0.0,19.0,5.0,9.0,5.0,0.0,26.0,11.0,13.0,28.0,9.0,16.0,15.0,1.0,2.0,0.0,4.0,9.0,5.0,9.0,3.0,2.0,4.0,4.0,2.0,3.0,1.0,1.0,5.0,2.0,15.0,33.0,6.0,4.0,2.0,17.0,0.0,1.0,19.0,0.0,0.0,15.0,3.0,3.0,17.0,46.0,7.0,17.0,7.0,4.0,2.0,3.0,0.0,1.0,3.0,3.0,4.0,4.0,27.0,24.0,1.0,4.0,3.0,10.0,2.0,8.0,2.0,8.0,7.0,6.0,0.0,6.0,22.0,1.0,21.0,6.0,13.0,2.0,3.0,9.0,13.0,18.0,4.0,4.0,2.0,20.0,9.0,0.0,0.0,19.0,2.0,2.0,6.0,4.0,6.0,2.0,2.0,4.0,5.0,10.0,0.0,4.0,7.0,5.0,5.0,5.0,15.0,12.0,4.0,1.0,6.0,6.0,1.0,21.0,8.0,11.0,4.0,2.0,4.0,0.0,25.0,12.0,3.0,4.0,28.0,9.0,2.0,25.0,19.0,5.0,28.0,3.0,2.0,1.0,4.0,5.0,8.5,17.0,5.0,5.0,20.0,1.0,2.0,6.0,13.0,0.0,6.0,2.0,11.0,19.0,5.0,3.0,8.0,3.0,0.0,2.0,13.0,40.0,11.0,15.0,4.0,4.0,11.0,27.0,3.0,7.0,4.0,3.0,7.0,28.0,0.0,5.0,3.0,12.0,2.0,3.0,16.0,7.0,0.0,0.0,28.0,5.0,2.0,10.0,4.0,8.0,5.0,1.0,1.0,0.0,9.0,7.0,33.0,1.0,3.0,4.0,6.0,2.0,5.0,9.0,4.0,12.0,3.0,18.0,10.0,0.0,1.0,4.0,8.0,17.0,0.0,2.0,13.0,7.0,3.0,1.0,1.0,5.0,2.0,1.0,0.0,5.0,12.0,2.0,1.0,1.0,6.0,14.0,5.0,6.0,5.0,12.0,10.0,5.0,4.0,4.0,2.0,21.0,9.0,2.0,12.0,20.0,0.0,1.0,2.0,37.0,0.0,7.0,0.0,28.0,2.0,11.0,1.0,1.0,12.0,4.0,4.0,2.0,6.0,0.0,10.0,9.0,12.0,5.0,4.0,6.0,12.0,3.0,4.0,14.0,3.0,5.0,17.0,30.0,5.0,13.0,23.0,6.0,48.0,5.0,2.0,4.0,3.0,8.0,2.0,2.0,2.0,19.0,7.0,0.0,7.0,1.0,6.0,19.0,27.0,7.0,2.0,20.0,3.0,14.0,2.0,3.0,20.0,10.0,8.0,1.0,11.0,9.0,2.0,3.0,22.0,15.0,5.0,6.0,0.0,3.0,6.0,9.0,10.0,9.0,6.0,3.0,7.0,13.0,0.0,14.0,18.0,2.0,16.0,0.0,8.0,16.0,6.0,22.0,10.0,27.0,8.0,19.0,4.0,24.0,7.0,11.0,26.0,3.0,0.0,7.0,13.0,2.0,15.0,6.0,7.0,8.0,34.0,36.0,46.0,9.0,25.0,3.0,4.0,17.0,3.0,2.0,5.0,6.0,0.0,6.0,6.0,5.0,1.0,7.0,3.0,4.0,1.0,5.0,1.0,7.0,10.0,8.0,6.0,15.0,0.0,2.0,17.0,9.0,6.0,3.0,3.0,13.0,7.0,14.0,8.0,8.0,6.0,7.0,8.0,3.0,17.0,5.0,6.0,5.0,14.0,12.0,15.0,1.0,5.0,0.0,3.0,10.0,0.0,5.0,0.0,5.0,6.0,16.0,6.0,5.0,6.0,16.0,11.0,5.0,1.0,8.0,21.0,10.0,21.0,2.0,10.0,12.0,3.0,4.0,11.0,11.0,0.0,5.0,2.0,11.0,3.0,0.0,12.0,11.0,7.0,0.0,21.0,49.0,11.0,15.0,10.0,7.625,12.0,1.0,8.0,6.0,4.0,3.0,5.0,8.0,6.0,8.0,4.0,1.0,5.0,6.0,8.0,0.0,9.0,3.0,10.0,4.0,1.0,16.0,3.0,1.0,11.0,0.0,9.0,8.0,4.0,3.0,5.0,8.0,7.0,4.0,4.0,25.0,4.0,3.0,0.0,1.0,9.0,3.0,0.0,3.0,15.0,3.0,1.0,6.0,13.0,1.0,4.0,7.0,3.0,2.0,1.0,5.0,11.0,4.0,12.0,13.0,1.0,0.0,3.0,8.0,1.0,15.0,3.0,9.0,7.0,1.0,5.0,8.0,11.0,0.0,6.0,4.0,0.0,1.0,1.0,0.0,6.0,4.0,9.0,2.0,9.0,26.0,24.0,29.0,25.0,6.0,12.0,0.0,3.0,24.0,8.0,6.0,1.0,14.0,3.0,3.0,6.0,6.0,8.0,1.0,4.0,28.0,2.0,9.0,3.0,7.0,6.0,12.0,4.0,2.0,2.0,1.0,2.0,0.0,1.0,13.0,15.0,9.0,16.0,10.0,0.0,5.0,5.0,31.0,3.0,13.0,4.0,19.0,26.0,2.0,1.0,3.0,1.0,5.0,12.0,11.0,3.0,6.0,8.0,6.0,31.0,3.0,0.0,7.0,25.0,15.0,13.0,2.0,1.0,0.0,24.0,3.0,0.0,6.0,14.0,4.0,0.0,3.0,3.0,5.0,1.0,13.0,1.0,20.0,2.0,2.0,7.0,10.0,12.0,4.0,19.0,10.0,4.0,2.0,7.0,5.0,2.0,4.0,10.0,1.0,3.0,1.0,4.0,18.0,1.0,18.0,18.0,12.0,15.0,9.0,10.0,21.0,42.0,5.0,1.0,6.0,6.0,11.0,11.0,6.0,1.0,2.0,13.0,21.0,7.0,4.0,7.0,2.0,5.0,5.0,1.0,14.0,1.0,2.0,27.0,9.0,13.0,6.0,4.0,9.0,31.0,32.0,3.0,10.0,8.0,11.0,6.0,10.0,0.0,12.0,18.0,4.0,11.0,1.0,0.0,34.0,1.0,11.0,2.0,9.0,9.0,4.0,2.0,11.0,14.0,10.0,6.0,5.0,10.0,13.0,1.0,2.0,7.0,3.0,0.0,7.0,18.0,8.0,16.0,6.0,3.0,11.0,8.0,1.0,8.0,22.0,3.0,2.0,14.0,7.0,6.0,2.0,7.0,11.0,1.0,14.0,1.0,14.0,21.0,2.0,0.0,3.0,6.0,1.0,3.0,1.0,3.0,3.0,2.0,6.0,16.0,10.0,16.0,6.0,8.0,0.0,4.0,4.0,5.0,6.0,17.0,9.0,3.0,22.0,10.0,11.0,10.0,4.0,2.0,5.0,1.0,3.0,2.0,0.0,9.0,5.0,17.0,46.0,4.0,4.0,6.0,21.0,41.0,3.0,38.0,14.0,10.0,9.0,5.0,2.0,1.0,4.0,2.0,7.0,12.0,5.0,13.0,0.0,5.0,8.0,15.0,11.0,3.0,15.0,2.0,8.0,18.0,14.0,25.0,13.0,11.0,9.0,18.0,6.0,4.0,7.0,3.0,4.0,10.0,12.0,19.0,7.0,3.0,2.0,16.0,16.0,2.0,6.0,2.0,3.0,8.0,9.0,5.0,12.0,16.0,2.0,4.0,21.0,10.0,3.0,7.0,0.0,13.0,4.0,5.0,22.0,16.0,2.0,10.0,8.0,5.0,3.0,7.0,10.0,38.0,15.0,9.0,12.0,19.0,6.0,4.0,23.0,1.0,5.5,4.0,0.0,6.0,2.0,11.0,8.0,5.0,13.0,6.0,3.0,9.0,13.0,23.0,3.0,2.0,18.0,7.0,2.0,0.0,2.0,1.0,0.0,4.5,6.0,4.0,15.0,4.0,8.0,7.0,25.0,23.0,11.0,15.0,4.0,8.0,0.0,6.0,0.0,11.0,36.0,22.0,6.0,6.0,23.0,0.0,8.0,14.0,21.0,6.0,19.0,3.0,0.0,17.0,0.0,16.0,14.0,10.0,8.0,27.0,3.0,11.0,4.0,34.0,52.0,5.0,5.0,2.0,8.0,6.0,4.0,3.0,9.0,26.0,24.0,1.0,28.0,16.0,1.0,5.0,7.0,13.0,15.0,14.0,16.0,5.0,15.0,24.0,2.0,4.0,4.0,4.0,7.0,5.0,0.0,16.0,1.0,10.0,0.0,19.0,11.0,14.0,3.0,2.0,5.0,0.0,32.0,3.0,0.0,12.0,1.0,23.0,0.0,33.0,24.0,7.0,24.0,0.0,11.0,1.0,22.0,17.0,4.0,3.0,5.0,3.0,2.0,1.0,1.0,2.0,4.0,0.0,26.0,41.0,22.0,2.0,5.0,0.0,3.0,5.0,11.0,3.0,5.0,4.0,5.0,24.0,5.0,7.0,2.0,3.0,21.0,1.0,6.0,16.0,24.0,6.0,4.0,7.0,4.0,9.0,11.0,6.0,7.0,16.0,5.0,12.0,15.0,11.0,3.0,0.0,2.0,4.0,24.0,7.0,4.0,26.0,1.0,19.0,1.0,6.0,12.0,8.0,2.0,3.0,21.0,31.0,5.0,15.0,2.0,3.0,4.0,34.0,22.0,9.0,11.0,0.0,14.0,8.0,6.0,0.0,1.0,4.0,4.0,0.0,5.0,9.0,5.0,3.0,2.0,5.0,5.0,0.0,0.0,3.0,4.0,10.0,16.0,5.0,8.0,15.0,11.0,7.0,4.0,26.0,19.0,11.0,4.0,10.0,8.0,18.0,14.0,2.0,1.0,0.0,9.0,4.0,2.0,7.0,6.0,7.0,2.0,0.0,12.0,8.0,2.0,2.0,6.0,5.0,1.0,7.0,3.0,3.0,6.0,3.0,8.0,9.0,6.0,4.0,6.0,18.0,2.0,0.0,9.0,7.0,2.0,8.0,2.0,7.0,22.0,0.0,25.0,12.0,3.0,4.0,13.0,2.0,6.0,0.0,21.0,1.0,1.0,3.0,8.0,0.0,3.0,1.0,2.0,0.0,1.0,1.0,3.0,1.0,1.0,2.0,2.0,1.0,0.0,4.0,5.0,0.0,18.0,1.0,0.0,4.0,1.0,11.0,3.0,10.0,25.0,0.0,0.0,0.0,17.0,6.0,19.0,32.0,1.0,1.0,4.0,4.0,5.0,26.0,2.0,2.0,6.0,8.0,16.0,0.0,4.0,10.0,5.0,2.0,1.0,4.0,3.0,5.0,4.0,17.0,11.0,31.0,6.0,6.0,0.0,20.0,22.0,14.0,12.0,5.0,17.0,16.0,1.0,6.0,23.0,6.0,9.0,17.0,11.0,17.0,15.0,4.0,14.0,9.0,0.0,1.0,0.0,15.0,0.0,0.0,11.0,21.0,2.0,7.0,4.0,2.0,5.0,2.0,4.0,5.0,5.0,20.0,2.0,3.0,3.0,29.0,0.0,4.0,2.0,5.0,9.0,24.0,8.0,23.0,1.0,0.0,6.0,1.0,23.0,27.0,13.0,14.0,1.0,19.0,9.0,35.0,14.0,1.0,16.0,29.0,11.0,11.0,8.0,4.0,14.0,21.0,21.0,15.0,12.0,11.0,35.0,12.0,11.0,32.0,6.0,15.0,1.0,1.0,19.0,11.0,20.0,18.0,26.0,14.0,9.0,24.0,4.0,3.0,16.0,1.0,8.0,25.0,20.0,6.0,11.0,23.0,11.0,13.0,19.0,3.0,10.0,13.0,19.0,9.0,7.0,22.0,23.0,1.0,10.0,18.0,12.0,9.0,10.0,18.0,1.0,9.0,8.0,5.0,14.0,0.0,20.0,21.0,7.0,3.0,1.0,15.0,11.0,27.0,17.0,17.0,22.0,36.0,7.0,11.0,3.0,14.0,1.0,1.0,3.0,23.0,6.0,9.0,8.0,6.0,14.0,10.0,3.0,8.0,21.0,4.0,2.0,7.0,14.0,1.0,6.0,18.0,24.0,7.0,5.0,7.0,1.0,6.0,3.0,9.0,8.0,6.0,13.0,1.0,12.0,5.0,10.0,0.0,26.0,4.0,18.0,9.0,20.0,24.0,35.0,0.0,23.0,12.0,5.0,15.0,8.0,12.0,11.0,14.0,5.0,7.0,9.0,32.0,17.0,19.0,10.0,24.0,22.0,5.0,19.0,6.0,27.0,10.0,22.0,20.0,7.0,6.0,10.0,28.0,1.0,10.0,13.0,20.0,18.0,11.0,4.0,3.0,23.0,15.0,2.0,12.0,8.0,3.0,28.0,9.0,10.0,11.0,13.0,28.0,20.0,15.0,20.0,19.0,9.0,5.0,1.0,21.0,22.0,19.0,21.0,3.0,1.0,1.0,26.0,14.0,9.0,12.0,8.0,0.0,19.0,26.0,21.0,25.0,13.0,16.0,7.0,9.0,14.0,1.0,1.0,12.0,9.0,15.0,13.0,10.0,25.0,23.0,9.0,11.0,19.0,14.0,24.0,2.0,6.0,6.0,20.0,8.0,9.0,6.0,16.0,4.0,26.0,11.0,11.0,7.0,5.0,5.0,7.0,10.0,14.0,7.0,19.0,9.0,13.0,16.0,19.0,16.0,8.0,20.0,16.0,4.0,19.0,10.0,10.0,11.0,2.0,13.0,7.0,17.0,5.0,16.0,24.0,9.0,10.0,4.0,6.0,8.0,6.0,22.0,5.0,12.0,19.0,12.0,22.0,9.0,11.0,10.0,8.0,7.0,6.0,2.0,25.0,9.0,19.0,28.0,14.0,16.0,26.0,18.0,21.0,20.0,8.0,12.0,6.0,4.0,22.0,21.0,20.0,6.0,3.0,7.0,2.0,10.0,5.0,7.0,8.0,3.0,5.0,6.0,7.0,10.0,10.0,8.0,5.0,7.0,11.0,17.0,13.0,4.0,8.0,8.0,15.0,13.0,8.0,4.0,8.0,6.0,8.0,7.0,6.0,5.0,5.0,11.0,7.0,5.0,2.0,6.0,6.0,1.0,7.0,1.0,0.0,7.0,1.0,1.0,4.0,0.0,4.0,8.0,0.0,4.0,13.0,22.0,2.0,13.0,11.0,12.0,11.0,9.0,9.0,12.0,13.0,1.0,10.0,14.0,5.0,1.0,18.0,15.0,2.0,3.0,0.0,0.0,13.0,8.0,6.0,0.0,11.0,4.0,8.0,4.0,0.0,7.0,7.0,9.0,13.0,4.0,0.0,10.0,14.0,4.0,4.0,0.0,4.0,4.0,8.0,12.0,7.0,14.0,1.0,5.0,7.0,5.0,4.0,4.0,5.0,4.0,7.0,6.0,4.0,4.0,0.0,4.0,7.0,3.0,3.0,15.0,10.0,6.0,14.0,3.0,9.0,7.0,1.0,7.0,7.0,0.0,,6.0,10.0,12.0,0.0,1.0,3.0,1.0,3.0,4.0,0.0,2.0,1.0,3.0,2.0,9.0,1.0,4.0,6.0,9.0,7.0,3.0,2.0,2.0,3.0,10.0,14.0,28.0,14.0,2.0,4.0,5.0,9.0,15.0,18.0,8.0,4.0,5.0,,6.0,11.0,,14.0,0.0,10.0,11.0,2.0,17.0,3.0,4.0,10.0,5.0,8.0,16.0,15.0,15.0,16.0,9.0,13.0,8.0,5.0,10.0,4.0,11.0,18.0,11.0,8.0,2.0,12.0,5.0,1.0,7.0,8.0,10.0,23.0,4.0,13.0,1.0,2.0,27.0,2.0,3.0,7.0,14.0,14.0,1.0,6.0,7.0,12.0,1.0,7.0,16.0,10.0,16.0,5.0,8.0,3.0,17.0,10.0,10.0,11.0,10.0,8.0,6.0,20.0,14.0,9.0,1.0,9.0,11.0,8.0,12.0,6.0,14.0,6.0,12.0,6.0,,4.0,,7.0,15.0,19.0,10.0,13.0,10.0,2.0,17.0,5.0,8.0,11.0,11.0,17.0,2.0,4.0,10.0,1.0,9.0,7.0,11.0,13.0,7.0,14.0,3.0,17.0,0.0,14.0,17.0,13.0,13.0,10.0,3.0,12.0,11.0,4.0,0.0,11.0,1.0,5.0,8.0,8.0,5.0,0.0,2.0,16.0,7.0,6.0,5.0,23.0,16.0,18.0,9.0,5.0,1.0,1.0,3.0,14.0,9.0,11.0,11.0,12.0,0.0,3.0,0.0,9.0,11.0,5.0,11.0,5.0,11.0,5.0,10.0,10.0,5.0,0.0,6.0,5.0,5.0,1.0,8.0,9.0,2.0,5.0,3.0,7.0,5.0,1.0,4.0,2.0,3.0,5.0,0.0,9.0,6.0,10.0,0.0,6.0,4.0,5.0,4.0,6.0,4.0,0.0,3.0,4.0,7.0,7.0,5.0,3.0,5.0,2.0,4.0,4.0,3.0,4.0,1.0,2.0,16.0,7.0,7.0,17.0,5.0,1.0,0.0,7.0,5.0,2.0,12.0,16.0,2.0,2.0,15.0,10.0,9.0,9.0,9.0,10.0,7.0,16.0,5.0,14.0,4.0,5.0,18.0,24.0,20.0,3.0,8.0,1.0,11.0,0.0,0.0,12.0,11.0,0.0,0.0,8.0,8.0,18.0,2.0,8.0,13.0,5.0,8.0,10.0,9.0,4.0,5.0,7.0,0.0,14.0,8.0,7.0,6.0,1.0,2.0,0.0,5.0,7.0,7.0,4.0,7.0,0.0,0.0,7.0,6.0,0.0,15.0,4.0,1.0,6.0,6.0,6.0,2.0,8.0,1.0,13.0,13.0,15.0,1.0,15.0,9.0,4.0,9.0,6.0,10.0,10.0,6.0,3.0,11.0,6.0,3.0,5.0,9.0,14.0,3.0,9.0,9.0,4.0,9.0,9.0,11.0,11.0,19.0,0.0,6.0,13.0,5.0,3.0,5.0,0.0,6.0,6.0,9.0,11.0,3.0,8.0,14.0,4.0,9.0,4.0,3.0,5.0,3.0,9.0,9.0,5.0,9.0,4.0,12.0,12.0,6.0,11.0,22.0,5.0,10.0,12.0,4.0,8.0,2.0,6.0,6.0,2.0,2.0,11.0,9.0,10.0,3.0,5.0,8.0,3.0,10.0,1.0,5.0,5.0,3.0,2.0,2.0,6.0,7.0,8.0,3.0,8.0,11.0,8.0,8.0,0.0,4.0,2.0,0.0,0.0,11.0,5.0,13.0,0.0,21.0,30.0,0.0,4.0,3.0,1.0,0.0,0.0,17.0,0.0,1.0,0.0,0.0,0.0,1.0,19.0,3.0,0.0,0.0,9.0,11.0,3.0,0.0,13.0,4.0,0.0,2.0,2.0,13.0,0.0,11.0,3.0,0.0,22.0,7.0,14.0,16.0,3.0,0.0,7.0,2.0,2.0,1.0,0.0,6.0,2.0,6.0,11.0,2.0,0.0,11.0,3.0,2.0,0.0,2.0,2.0,2.0,2.0,0.0,2.0,1.0,12.0,1.0,0.0,7.0,3.0,6.0,1.0,0.0,0.0,22.0,2.0,0.0,3.0,0.0,3.0,4.0,11.0,1.0,4.0,1.0,0.0,8.0,0.0,2.0,0.0,3.0,7.0,6.0,0.0,5.0,4.0,0.0,18.0,14.0,3.0,5.0,18.0,1.0,23.0,30.0,20.0,16.0,10.0,5.0,9.0,12.0,24.0,11.0,24.0,16.0,20.0,14.0,5.0,25.0,9.0,21.0,9.0,7.0,2.0,7.0,1.0,11.0,18.0,13.0,3.0,2.0,21.0,3.0,5.0,57.0,2.0,1.0,17.0,4.0,1.0,0.0,1.0,1.0,10.0,24.0,16.0,38.0,11.0,1.0,6.0,1.0,0.0,6.0,17.0,1.0,0.0,4.0,0.0,28.0,28.0,4.0,18.0,23.0,0.0,0.0,17.0,16.0,5.0,1.0,14.0,13.0,9.0,0.0,4.0,2.0,2.0,4.0,5.0,3.0,7.0,4.0,3.0,7.0,2.0,2.0,0.0,3.0,8.0,0.0,7.0,2.0,8.0,15.0,12.0,1.0,13.0,6.0,1.0,26.0,5.0,12.0,6.0,8.0,6.0,15.0,8.0,2.0,6.0,2.0,9.0,1.0,10.0,3.0,2.0,9.0,9.0,11.0,10.0,9.0,4.0,0.0,16.0,8.0,11.0,10.0,6.0,4.0,5.0,20.0,23.0,3.0,1.0,0.0,6.0,3.0,9.0,2.0,16.0,6.0,2.0,14.0,20.0,23.0,24.0,14.0,8.0,25.0,29.0,7.0,15.0,0.0,5.0,1.0,4.0,11.0,25.0,4.0,1.0,6.0,1.0,2.0,10.0,18.0,1.0,11.0,0.0,15.0,4.0,5.0,11.0,0.0,0.0,6.0,16.0,9.0,4.0,7.0,0.0,1.0,0.0,2.0,12.0,14.0,24.0,1.0,12.0,3.0,2.0,6.0,5.0,1.0,1.0,0.0,8.0,1.0,4.0,4.0,10.0,0.0,4.0,0.0,0.0,0.0,1.0,5.0,0.0,0.0,0.0,15.0,11.0,0.0,2.0,7.0,0.0,12.0,1.0,7.0,2.0,8.0,0.0,12.0,0.0,11.0,4.0,0.0,5.0,1.0,5.0,7.0,17.0,6.0,6.0,7.0,1.0,13.0,4.0,20.0,13.0,5.0,7.0,6.0,10.0,10.0,0.0,17.0,15.0,11.0,5.0,7.0,0.0,0.0,0.0,17.0,6.0,8.0,7.0,7.0,6.0,6.0,5.0,0.0,8.0,8.0,7.0,5.0,6.0,3.0,2.0,6.0,6.0,3.0,6.0,4.0,7.0,7.0,4.0,7.0,5.0,6.0,11.0,8.0,3.0,10.0,5.0,5.0,6.0,4.0,10.0,8.0,5.0,4.0,4.0,5.0,4.0,7.0,4.0,9.0,7.0,3.0,3.0,8.0,3.0,3.0,5.0,6.0,5.0,6.0,8.0,9.0,5.0,4.0,7.0,6.0,8.0,4.0,6.0,6.0,6.0,5.0,5.0,4.0,5.0,13.0,10.0,3.0,7.0,12.0,14.0,8.0,8.0,0.0,9.0,5.0,5.0,12.0,4.0,4.0,5.0,4.0,0.0,5.0,24.0,13.0,7.0,15.0,4.0,19.0,6.0,11.0,15.0,1.0,2.0,1.0,16.0,3.0,3.0,7.0,13.0,11.0,5.0,14.0,5.0,5.0,20.0,16.0,5.0,13.0,5.0,4.0,9.0,3.0,10.0,5.0,12.0,8.0,7.0,14.0,7.0,2.0,8.0,4.0,11.0,3.0,14.0,12.0,14.0,15.0,10.0,23.0,11.0,7.0,8.0,9.0,6.0,5.0,10.0,15.0,7.0,6.0,12.0,9.0,16.0,10.0,7.0,11.0,9.0,9.0,14.0,13.0,9.0,4.0,10.0,8.0,8.0,14.0,3.0,8.0,17.0,17.0,21.0,19.0,5.0,10.0,12.0,11.0,6.0,5.0,18.0,9.0,16.0,13.0,10.0,7.0,18.0,9.0,14.0,11.0,12.0,12.0,5.0,6.0,9.0,5.0,9.0,6.0,14.0,11.0,11.0,16.0,9.0,16.0,15.0,16.0,17.0,6.0,5.0,11.0,2.0,10.0,10.0,10.0,8.0,18.0,12.0,18.0,9.0,10.0,7.0,9.0,4.0,0.0,11.0,9.0,1.0,7.0,5.0,6.0,10.0,6.0,15.0,17.0,7.0,12.0,8.0,11.0,11.0,6.0,18.0,2.0,10.0,5.0,5.0,5.0,10.0,8.0,16.0,8.0,11.0,6.0,10.0,7.0,14.0,14.0,5.0,2.0,5.0,5.0,6.0,2.0,8.0,8.0,17.0,9.0,10.0,5.0,10.0,11.0,5.0,2.0,5.0,5.0,10.0,5.0,2.0,15.0,11.0,14.0,12.0,11.0,11.0,5.0,10.0,2.0,0.0,4.0,2.0,7.0,7.0,2.0,8.0,14.0,12.0,6.0,4.0,2.0,2.0,3.0,7.0,5.0,14.0,13.0,3.0,0.0,6.0,6.0,7.0,7.0,3.0,11.0,15.0,14.0,6.0,1.0,7.0,12.0,5.0,0.0,3.0,3.0,7.0,7.0,6.0,10.0,13.0,10.0,8.0,13.0,9.0,8.0,11.0,9.0,7.0,9.0,5.0,9.0,4.0,4.0,6.0,9.0,3.0,3.0,6.0,14.0,4.0,7.0,7.0,4.0,10.0,8.0,10.0,6.0,10.0,11.0,3.0,6.0,10.0,10.0,1.0,8.0,6.0,6.0,12.0,16.0,4.0,8.0,5.0,0.0,10.0,9.0,7.0,10.0,2.0,8.0,15.0,2.0,,,,,,,,,,,,,,,,,,,,,,,,,,,,,,,,,,,,,,,,,,,,,,,,,,,,,,,,,,,,,,,,,,,,,,,,,,,,,,,,,,,13.0,12.0,10.0,4.0,0.0,3.0,4.0,1.0,19.0,2.0,4.0,7.0,2.0,16.0,0.0,6.0,2.0,1.0,6.0,13.0,3.0,20.0,4.0,7.0,1.0,8.0,16.0,1.0,12.0,3.0,3.0,3.0,4.0,4.0,0.0,1.0,0.0,7.0,2.0,5.0,7.0,2.0,1.0,8.0,2.0,7.0,55.0,5.0,15.0,1.0,4.0,11.0,12.0,2.0,13.0,7.0,6.0,2.0,1.0,7.0,1.0,0.0,1.0,15.0,6.0,11.0,2.0,7.0,2.0,7.0,0.0,8.0,0.0,4.0,24.0,11.0,8.0,7.0,7.0,7.0,28.0,2.0,0.0,3.0,1.0,1.0,8.0,0.0,2.0,1.0,2.0,2.0,3.0,8.0,18.0,2.0,1.0,18.0,5.0,3.0,17.0,7.0,11.0,1.0,5.0,1.0,7.0,15.0,14.0,27.0,1.0,3.0,6.0,13.0,0.0,4.0,2.0,1.0,0.0,4.0,1.0,13.0,0.0,5.0,1.0,5.0,22.0,0.0,6.0,0.0,5.0,6.0,8.0,6.0,16.0,7.0,17.0,41.0,3.0,2.0,0.0,2.0,11.0,4.0,7.0,13.0,2.0,1.0,7.0,11.0,3.0,11.0,15.0,0.0,9.0,1.0,1.0,4.0,2.0,25.0,2.0,12.0,25.0,5.0,10.0,2.0,16.0,8.0,15.0,0.0,1.0,0.0,0.0,9.0,5.0,1.0,1.0,1.0,6.0,7.0,16.0,3.0,8.0,10.0,5.0,9.0,0.0,9.0,0.0,0.0,4.0,6.0,6.0,32.0,5.0,8.0,5.0,1.0,5.0,1.0,1.0,5.0,6.0,22.0,10.0,9.0,6.0,5.0,10.0,13.0,0.0,12.0,5.0,5.0,7.0,4.0,3.0,13.0,5.0,4.0,25.0,12.0,3.0,0.0,1.0,0.0,2.0,15.0,7.0,4.0,1.0,5.0,1.0,4.0,2.0,0.0,4.0,4.0,4.0,3.0,12.0,4.0,6.0,6.0,2.0,1.0,2.0,11.0,0.0,0.0,1.0,12.0,1.0,0.0,14.0,11.0,5.0,0.0,1.0,9.0,17.0,11.0,0.0,14.0,0.0,0.0,0.0,5.0,2.0,10.0,3.0,10.0,12.0,13.0,1.0,7.0,7.0,12.0,1.0,0.0,0.0,7.0,6.0,0.0,0.0,15.0,7.0,0.0,9.0,5.0,0.0,1.0,8.0,4.0,12.0,7.0,2.0,2.0,1.0,3.0,5.0,2.0,3.0,2.0,3.0,0.0,0.0,11.0,1.0,8.0,4.0,7.0,0.0,3.0,5.0,0.0,10.0,1.0,8.0,1.0,2.0,1.0,16.0,0.0,1.0,13.0,7.0,4.0,4.0,2.0,1.0,0.0,0.0,7.0,5.0,11.0,8.0,5.0,0.0,9.0,3.0,7.0,3.0,4.0,15.0,2.0,0.0,2.0,0.0,0.0,3.0,3.0,4.0,4.0,3.0,5.0,3.0,7.0,28.0,9.0,12.0,13.0,9.0,2.0,1.0,2.0,17.0,11.0,18.0,19.0,3.0,3.0,0.0,1.0,12.0,0.0,1.0,0.0,0.0,1.0,3.0,0.0,0.0,2.0,0.0,2.0,9.0,5.0,0.0,1.0,1.0,1.0,2.0,0.0,1.0,0.0,0.0,1.0,2.0,0.0,3.0,1.0,0.0,2.0,0.0,0.0,0.0,1.0,4.0,0.0,0.0,2.0,1.0,0.0,0.0,1.0,1.0,0.0,3.0,2.0,1.0,1.0,0.0,1.0,0.0,0.0,1.0,1.0,0.0,0.0,1.0,3.0,0.0,3.0,4.0,1.0,0.0,0.0,1.0,1.0,3.0,0.0,2.0,0.0,1.0,0.0,0.0,0.0,1.0,4.0,0.0,1.0,0.0,1.0,,,,,,,,,,,,,,,,,,,,,,,,,,,,,,,,,,,,,,,,,,,,,,,,,1.0,0.0,0.0,0.0,0.0,2.0,0.0,1.0,0.0,2.0,0.0,2.0,0.0,3.0,3.0,0.0,4.0,0.0,1.0,1.0,1.0,3.0,4.0,0.0,0.0,0.0,0.0,4.0,0.0,1.0,3.0,2.0,2.0,1.0,0.0,2.0,4.0,5.0,2.0,3.0,1.0,0.0,2.0,1.0,0.0,2.0,3.0,1.0,2.0,7.0,4.0,6.0,4.0,3.0,0.0,4.0,3.0,2.0,1.0,2.0,1.0,2.0,0.0,1.0,0.0,0.0,0.0,3.0,0.0,1.0,2.0,0.0,2.0,0.0,5.0,2.0,0.0,0.0,1.0,1.0,0.0,0.0,0.0,2.0,1.0,2.0,4.0,3.0,4.0,0.0,0.0,1.0,5.0,2.0,3.0,0.0,2.0,2.0,1.0,0.0,0.0,1.0,0.0,1.0,0.0,0.0,2.0,7.0,3.0,0.0,1.0,0.0,1.0,0.0,10.0,0.0,1.0,2.0,0.0,0.0,0.0,1.0,4.0,0.0,8.0,0.0,0.0,0.0,3.0,3.0,4.0,0.0,5.0,2.0,2.0,3.0,3.0,5.0,3.0,3.0,1.0,1.0,2.0,0.0,0.0,7.0,0.0,0.0,3.0,0.0,3.0,4.0,2.0,1.0,0.0,3.0,2.0,0.0,3.0,0.0,1.0,0.0,2.0,3.0,4.0,1.0,3.0,2.0,3.0,0.0,2.0,1.0,2.0,0.0,0.0,0.0,4.0,1.0,1.0,0.0,0.0,2.0,4.0,1.0,2.0,3.0,2.0,3.0,0.0,2.0,2.0,3.0,0.0,6.0,0.0,1.0,1.0,4.0,1.0,,,,,,,13.0,9.0,8.0,4.0,8.0,2.0,19.0,8.0,12.0,5.0,8.0,6.0,7.0,14.0,15.0,9.0,4.0,18.0,9.0,4.0,4.0,12.0,6.0,26.0,4.0,9.0,8.0,8.0,8.0,11.0,9.0,16.0,13.0,8.0,11.0,8.0,10.0,5.0,8.0,6.0,9.0,9.0,7.0,6.0,9.0,8.0,10.0,7.0,0.0,39.0,0.0,0.0,0.0,0.0,0.0,2.0,21.0,0.0,0.0,21.0,24.0,0.0,39.0,6.0,13.0,5.0,1.0,3.0,29.0,0.0,0.0,0.0,22.0,35.0,34.0,23.0,29.0,17.0,0.0,20.0,0.0,0.0,5.0,37.0,6.0,0.0,7.0,6.0,23.0,10.0,36.0,25.0,8.0,0.0,0.0,24.0,29.0,39.0,0.0,9.0,2.0,0.0,2.0,0.0,9.0,2.0,1.0,0.0,0.0,0.0,3.0,28.0,35.0,3.0,3.0,29.0,36.0,12.0,19.0,0.0,36.0,5.0,0.0,38.0,34.0,2.0,0.0,5.0,3.0,0.0,2.0,1.0,4.0,21.0,8.0,5.0,7.0,0.0,0.0,1.0,40.0,40.0,0.0,0.0,26.0,0.0,0.0,17.0,4.0,3.0,21.0,1.0,0.0,0.0,1.0,35.0,8.0,31.0,8.0,0.0,3.0,3.0,3.0,2.0,3.0,3.0,3.0,1.0,1.0,1.0,4.0,3.0,1.0,0.0,3.0,4.0,3.0,0.0,3.0,0.0,1.0,3.0,1.0,1.0,6.0,4.0,1.0,6.0,1.0,3.0,2.0,2.0,0.0,2.0,1.0,2.0,6.0,0.0,2.0,1.0,3.0,1.0,,,,,,,,,,0.0,0.0,0.0,0.0,0.0,0.0,2.0,2.0,5.0,0.0,0.0,0.0,0.0,0.0,0.0,1.0,0.0,5.0,1.0,0.0,3.0,5.0,2.0,2.0,1.0,0.0,2.0,0.0,1.0,1.0,4.0,4.0,1.0,4.0,1.0,2.0,1.0,3.0,4.0,1.0,1.0,2.0,1.0,3.0,4.0,4.0,0.0,1.0,2.0,2.0,4.0,1.0,2.0,2.0,0.0,5.0,3.0,3.0,0.0,1.0,5.0,5.0,4.5,0.0,2.0,1.0,5.0,4.0,2.0,5.0,2.0,3.0,0.0,2.0,0.0,1.0,0.0,0.0,2.0,2.0,0.0,0.0,3.0,2.0,0.0,2.0,5.0,0.0,4.0,0.0,2.0,3.0,1.0,3.0,1.0,3.0,1.0,3.0,1.0,1.0,0.0,3.0,4.0,2.0,5.0,2.0,2.0,0.0,2.0,4.0,0.0,5.0,3.0,5.0,1.0,5.0,3.0,5.0,5.0,1.0,1.0,1.0,0.0,0.0,0.0,0.0,0.0,0.0,0.0,1.0,3.0,0.0,0.0,0.0,1.0,1.0,1.0,1.0,0.0,0.0,1.0,2.0,3.0,3.0,5.0,2.0,5.0,1.0,1.0,2.0,2.0,1.0,5.0,0.0,2.0,2.0,4.0,0.0,0.0,0.0,1.0,0.0,0.0,3.0,0.0,0.0,0.0,1.0,1.0,1.0,3.0,5.0,1.0,1.0,2.0,3.0,2.0,2.0,1.0,0.0,1.0,4.0,3.0,2.0,0.0,2.0,4.0,2.0,2.0,1.0,1.0,1.0,4.0,5.0,0.0,0.0,3.0,5.0,2.0,0.0,0.0,0.0,3.0,4.0,1.0,0.0,1.0,2.0,0.0,5.0,0.0,0.0,2.0,1.0,5.0,5.0,0.0,1.0,0.0,2.0,3.0,5.0,0.0,0.0,1.0,3.0,2.0,0.0,0.0,0.0,3.0,0.0,1.0,1.0,1.0,2.0,1.0,0.0,0.0,0.0,0.0,3.0,0.0,1.0,3.0,1.5,1.0,0.0,3.0,3.0,3.0,2.0,2.0,1.0,0.0,1.0,0.0,0.0,1.0,1.0,2.0,3.0,5.0,1.0,2.0,0.0,4.0,1.0,3.0,0.0,0.0,3.0,0.0,2.0,5.0,3.0,4.0,3.0,2.0,2.0,0.0,1.0,0.0,0.0,1.0,3.0,0.0,0.0,5.0,2.0,5.0,1.0,1.0,3.0,3.0,1.0,5.0,1.0,3.0,2.0,2.0,0.0,0.0,5.0,5.0,3.0,5.0,1.0,0.0,0.0,3.0,1.0,3.0,5.0,0.0,5.0,3.0,0.0,0.0,5.0,1.0,1.0,2.0,5.0,3.0,3.0,1.0,1.0,4.0,5.0,5.0,1.0,2.0,4.0,4.0,1.0,2.0,3.0,1.0,0.0,0.0,0.0,5.0,2.0,3.0,0.0,5.0,4.0,5.0,1.0,0.0,0.0,0.0,0.0,0.0,0.0,0.0,2.0,1.0,3.0,1.0,3.0,0.0,1.0,2.0,4.0,3.0,0.0,1.0,0.0,0.0,2.0,0.0,1.0,0.0,5.0,0.0,1.0,4.0,4.0,0.0,2.0,0.0,0.0,2.0,0.0,3.0,0.0,2.0,0.0,0.0,1.0,1.0,1.0,0.0,5.0,4.0,2.0,5.0,1.0,0.0,0.0,0.0,0.0,1.0,2.0,2.0,1.0,1.0,1.0,2.0,0.0,0.0,0.0,2.0,2.0,0.0,1.0,1.0,1.0,5.0,2.0,0.0,0.0,5.0,5.0,1.0,2.0,0.0,3.0,1.0,1.0,2.0,2.0,1.0,1.0,0.0,0.0,5.0,1.0,0.0,1.0,3.0,3.0,2.0,1.0,0.0,2.0,1.0,2.0,2.0,0.0,0.0,0.0,4.0,4.0,3.0,1.0,2.0,2.0,0.0,1.0,1.0,5.0,0.0,4.0,0.0,2.0,1.0,0.0,2.0,0.0,2.0,0.0,0.0,0.0,2.0,3.0,0.0,1.0,4.0,1.0,5.0,2.0,1.0,2.0,0.0,3.0,1.0,5.0,3.0,0.0,0.0,4.0,0.0,1.0,5.0,1.0,2.0,5.0,0.0,1.0,4.0,1.0,2.0,1.0,1.0,5.0,0.0,1.0,1.0,4.0,8.0,10.0,9.0,2.0,0.0,12.0,5.0,0.0,9.0,9.0,5.0,19.0,23.0,22.0,14.0,22.0,17.0,4.0,3.0,24.0,18.0,1.0,28.0,0.0,14.0,19.0,17.0,19.0,10.0,16.0,26.0,16.0,7.0,17.0,6.0,7.0,6.0,0.0,12.0,0.0,10.0,17.0,4.0,13.0,3.0,9.0,17.0,16.0,15.0,28.0,32.0,16.0,12.0,6.0,18.0,25.0,24.0,3.0,17.0,19.0,1.0,12.0,17.0,13.0,5.0,17.0,24.0,6.0,6.0,12.0,18.0,12.0,4.0,1.0,17.0,8.0,14.0,6.0,9.0,5.0,8.0,11.0,16.0,9.0,8.0,21.0,5.0,9.0,11.0,15.0,9.0,3.0,10.0,7.0,3.0,5.0,11.0,6.0,11.0,10.0,8.0,16.0,9.0,9.0,3.0,3.0,14.0,3.0,8.0,16.0,4.0,3.0,9.0,13.0,15.0,13.0,18.0,0.0,0.0,12.0,18.0,12.0,0.0,5.0,2.0,1.0,4.0,23.0,17.0,17.0,13.0,6.0,7.0,13.0,5.0,38.0,21.0,14.0,16.0,11.0,10.0,15.0,17.0,15.0,15.0,5.0,2.0,6.0,8.0,0.0,2.0,1.0,7.0,15.0,12.0,19.0,17.0,17.0,9.0,20.0,7.0,7.0,18.0,1.0,8.0,20.0,6.0,7.0,12.0,15.0,5.0,12.0,3.0,12.0,1.0,0.0,0.0,12.0,12.0,14.0,0.0,13.0,1.0,13.0,12.0,22.0,3.0,11.0,15.0,17.0,10.0,8.0,3.0,9.0,20.0,4.0,7.0,18.0,5.0,13.0,9.0,7.0,21.0,8.0,0.0,10.0,8.0,18.0,14.0,14.0,8.0,13.0,8.0,13.0,12.0,17.0,21.0,11.0,5.0,12.0,14.0,5.0,9.0,9.0,8.0,13.0,7.0,6.0,4.0,15.0,14.0,5.0,20.0,10.0,17.0,14.0,9.0,5.0,13.0,9.0,3.0,12.0,6.0,19.0,9.0,9.0,13.0,15.0,0.0,14.0,18.0,7.0,10.0,11.0,10.0,13.0,7.0,9.0,13.0,4.0,16.0,12.0,10.0,11.0,23.0,14.0,12.0,8.0,13.0,15.0,15.0,14.0,9.0,7.0,18.0,2.0,9.0,9.0,11.0,17.0,1.0,14.0,13.0,11.0,8.0,10.0,14.0,0.0,11.0,20.0,10.0,7.0,6.0,5.0,14.0,14.0,10.0,15.0,23.0,6.0,3.0,16.0,15.0,3.0,19.0,12.0,23.0,7.0,12.0,14.0,5.0,11.0,9.0,12.0,7.0,20.0,11.0,12.0,5.0,4.0,6.0,9.0,3.0,19.0,7.0,1.0,7.0,13.0,14.0,12.0,6.0,13.0,4.0,3.0,4.0,3.0,19.0,16.0,13.0,12.0,19.0,9.0,12.0,13.0,15.0,8.0,7.0,6.0,8.0,6.0,12.0,9.0,6.0,1.0,23.0,8.0,1.0,3.0,5.0,4.0,28.0,22.0,5.0,4.0,3.0,4.0,6.0,14.0,13.0,5.0,14.0,0.0,9.0,9.0,8.0,14.0,6.0,17.0,,,,,,,,,,,,,,,,,,,,,,,,,,,,,,,,,,,,,,,,,,,,,,,,,,,,,,,,,,,,,,,,,,,,,,,,,,,,,,,,,,,,,,,,,,,,,,,,,,,,,,,,,,,,,,,,,,,,,,,,,,,,,,,,,,,,,,,,,,,,,,,,,,,,,,,,,,,,,,,,,,
9,3.0,5.0,5.0,5.0,4.0,7.0,3.0,5.0,5.0,4.0,4.0,2.0,2.0,5.0,5.0,22.0,6.0,5.0,5.0,5.0,7.0,2.0,7.0,0.0,2.0,7.0,5.0,4.0,6.0,1.0,4.0,4.0,5.0,11.0,5.0,5.0,5.0,2.0,6.0,6.0,4.0,5.0,4.0,4.0,3.0,4.0,10.0,6.0,2.0,2.0,4.0,2.0,3.0,0.0,3.0,6.0,0.0,3.0,0.0,0.0,0.0,0.0,0.0,0.0,0.0,0.0,0.0,0.0,0.0,0.0,0.0,0.0,0.0,0.0,0.0,0.0,0.0,0.0,0.0,,5.0,5.0,5.0,5.0,5.0,5.0,5.0,0.0,0.0,0.0,0.0,0.0,10.0,0.0,0.0,0.0,0.0,0.0,0.0,0.0,0.0,0.0,0.0,0.0,0.0,0.0,0.0,0.0,0.0,0.0,0.0,0.0,0.0,1.0,5.0,6.0,4.0,5.0,2.0,5.0,3.0,14.0,4.0,5.0,6.0,15.0,2.0,3.0,8.0,5.0,9.0,3.0,10.0,4.0,9.0,3.0,9.0,5.0,6.0,3.0,2.0,2.0,0.0,5.0,4.0,7.0,11.0,8.0,8.0,5.0,5.0,8.0,0.0,4.0,3.0,7.0,3.0,5.0,7.0,1.0,4.0,3.0,15.0,0.0,5.0,5.0,5.0,5.0,4.0,3.0,8.0,11.0,11.0,2.0,7.0,7.0,4.0,7.0,5.0,2.0,5.0,3.0,0.0,11.0,5.0,6.0,4.0,4.0,2.0,4.0,4.0,4.0,7.0,7.0,3.0,4.0,1.0,7.0,12.0,5.0,5.0,1.0,7.0,3.0,5.0,2.0,4.0,2.0,3.0,4.0,3.0,4.0,9.0,7.0,0.0,14.0,11.0,8.0,0.0,1.0,5.0,11.0,4.0,6.0,0.0,1.0,8.0,2.0,8.0,7.0,7.0,0.0,3.0,2.0,8.0,8.0,9.0,1.0,4.0,3.0,5.0,11.0,0.0,3.0,8.0,7.0,3.0,15.0,0.0,5.0,1.0,9.0,13.0,1.0,4.0,4.0,10.0,3.0,13.0,4.0,0.0,11.0,2.0,4.0,8.0,2.0,5.0,11.0,0.0,4.0,5.0,4.0,7.0,9.0,8.0,7.0,5.0,2.0,10.0,7.0,5.0,12.0,7.0,11.0,4.0,5.0,10.0,4.0,10.0,12.0,10.0,5.0,10.0,3.0,4.0,2.0,5.0,5.0,1.0,3.0,2.0,3.0,0.0,2.0,3.0,2.0,3.0,3.0,2.0,8.0,15.0,15.0,7.0,8.0,6.0,6.0,3.0,11.0,4.0,7.0,11.0,9.0,5.0,10.0,15.0,6.0,8.0,6.0,12.0,7.0,10.0,10.0,7.0,9.0,13.0,12.0,14.0,10.0,6.0,16.0,12.0,10.0,11.0,11.0,9.0,3.0,8.0,5.0,13.0,17.0,6.0,13.0,8.0,9.0,6.0,19.0,8.0,9.0,8.0,9.0,7.0,8.0,6.0,11.0,6.0,0.0,3.0,7.0,4.0,17.0,7.0,15.0,1.0,11.0,1.0,1.0,2.0,4.0,1.0,3.0,0.0,1.0,2.0,0.0,3.0,2.0,8.0,0.0,5.0,2.0,2.0,9.0,0.0,3.0,2.0,3.0,1.0,0.0,0.0,2.0,0.0,0.0,1.0,3.0,0.0,3.0,0.0,0.0,0.0,0.0,1.0,0.0,0.0,1.0,1.0,2.0,4.0,3.0,4.0,0.0,2.0,1.0,8.0,3.0,6.0,0.0,0.0,1.0,5.0,6.0,7.0,1.0,6.0,9.0,14.0,1.0,9.0,5.0,9.0,2.0,3.0,5.0,4.0,9.0,10.0,19.0,12.0,3.0,5.0,2.0,15.0,0.0,7.0,9.0,1.0,8.0,5.0,2.0,4.0,6.0,1.0,1.0,2.0,0.0,4.0,2.0,4.0,0.0,3.0,1.0,1.0,1.0,2.0,1.0,0.0,0.0,2.0,4.0,1.0,4.0,5.0,3.0,3.0,0.0,4.0,7.0,5.0,3.0,4.0,5.0,7.0,1.0,2.0,5.0,0.0,1.0,6.0,4.0,6.0,10.0,11.0,0.0,0.0,1.0,13.0,20.0,1.0,2.0,3.0,1.0,2.0,6.0,1.0,8.0,4.0,3.0,7.0,2.0,2.0,8.0,8.0,5.0,8.0,1.0,5.0,5.0,5.0,5.0,5.0,2.0,0.0,2.0,6.0,5.0,1.0,4.0,1.0,6.0,1.0,6.0,3.0,4.0,1.0,2.0,2.0,2.0,,,,,,,,,,,,,,,,,,,,,,,,,,,,,,,,,,,,,,,,,,,,,,,,,,,,,,,,,,,,,,,,,,,,,,,,,,,,,,,,,,,,,,,,,,,,,,,,,,,,2.0,0.0,0.0,9.0,0.0,0.0,0.0,0.0,0.0,1.0,0.0,2.0,7.0,0.0,3.0,0.0,4.0,2.0,0.0,0.0,2.0,5.0,5.0,5.0,1.0,5.0,2.0,0.0,0.0,0.0,5.0,0.0,0.0,2.0,1.0,5.0,5.0,2.0,0.0,5.0,4.0,5.0,2.0,1.0,5.0,4.0,0.0,5.0,1.0,5.0,0.0,0.0,5.0,2.0,3.0,1.0,0.0,2.0,2.0,1.0,2.0,5.0,1.0,5.0,2.0,5.0,5.0,5.0,3.0,5.0,5.0,5.0,8.0,7.0,1.0,1.0,1.0,10.0,10.0,1.0,0.0,15.0,3.0,0.0,6.0,4.0,4.0,0.0,4.0,1.0,1.0,5.0,3.0,6.0,9.0,3.0,6.0,4.0,4.0,4.0,3.0,5.0,3.0,0.0,0.0,4.0,5.0,3.0,1.0,3.0,7.0,3.0,3.0,7.0,6.0,3.0,9.0,13.0,9.0,8.0,8.0,7.0,7.0,10.0,9.0,13.0,6.0,4.0,11.0,11.0,5.0,14.0,6.0,3.0,12.0,11.0,11.0,6.0,5.0,5.0,5.0,8.0,6.0,7.0,8.0,5.0,8.0,0.0,4.0,5.0,4.0,7.0,2.0,5.0,10.0,5.0,3.0,5.0,11.0,9.0,7.0,7.0,12.0,6.0,9.0,7.0,6.0,7.0,11.0,3.0,5.0,6.0,8.0,0.0,5.0,4.0,6.0,7.0,4.0,4.0,5.0,5.0,5.0,5.0,5.0,8.0,4.0,6.0,8.0,3.0,13.0,5.0,3.0,2.0,3.0,5.0,3.0,8.0,6.0,9.0,6.0,8.0,9.0,7.0,4.0,10.0,6.0,6.0,7.0,8.0,6.0,5.0,16.0,4.0,0.0,4.0,5.0,20.0,4.0,16.0,0.0,9.0,13.0,4.0,1.0,14.0,1.0,21.0,29.0,6.0,9.0,21.0,5.0,6.0,1.0,2.0,7.0,21.0,13.0,22.0,21.0,22.0,9.0,14.0,11.0,21.0,6.0,4.0,24.0,11.0,14.0,5.0,0.0,1.0,1.0,1.0,4.0,9.0,1.0,2.0,24.0,5.0,15.0,4.0,1.0,2.0,17.0,17.0,1.0,5.0,18.0,2.0,12.0,18.0,1.0,12.0,1.0,2.0,0.0,2.0,2.0,3.0,0.0,5.0,0.0,1.0,7.0,14.0,21.0,11.0,15.0,17.0,3.0,3.0,21.0,23.0,1.0,15.0,12.0,8.0,8.0,9.0,6.0,5.0,2.0,17.0,6.0,4.0,8.0,17.0,9.0,22.0,6.0,0.0,3.0,5.0,1.0,7.0,11.0,12.0,7.0,10.0,7.0,9.0,8.0,1.0,8.0,5.0,2.0,10.0,7.0,16.0,7.0,6.0,2.0,2.0,1.0,2.0,14.0,2.0,4.0,0.0,5.0,7.0,0.0,16.0,3.0,8.0,9.0,1.0,5.0,6.0,2.0,9.0,4.0,11.0,2.0,1.0,2.0,2.0,9.0,17.0,18.0,6.0,11.0,3.0,8.0,14.0,1.0,0.0,8.0,2.0,3.0,2.0,2.0,0.0,5.0,23.0,6.0,9.0,11.0,2.0,1.0,4.0,20.0,1.0,6.0,4.0,6.0,2.0,22.0,12.0,0.0,14.0,12.0,0.0,11.0,17.0,14.0,4.0,15.0,17.0,1.0,4.0,5.0,4.0,4.0,0.0,1.0,1.0,3.0,3.0,3.0,5.0,3.0,2.0,2.0,4.0,2.0,2.0,0.0,1.0,8.0,5.0,1.0,6.0,2.0,1.0,2.0,2.0,0.0,0.0,0.0,3.0,1.0,3.0,5.0,3.0,1.0,5.0,1.0,1.0,2.0,0.0,4.0,1.0,0.0,0.0,2.0,0.0,2.0,0.0,0.0,1.0,0.0,2.0,1.0,5.0,0.0,6.0,4.0,4.0,2.0,2.0,4.0,2.0,2.0,0.0,2.0,1.0,1.0,3.0,2.0,0.0,1.0,1.0,2.0,0.0,2.0,2.0,6.0,2.0,4.0,4.0,4.0,0.0,0.0,0.0,2.0,6.0,6.0,9.0,13.0,4.0,1.0,1.0,3.0,6.0,2.0,7.0,2.0,0.0,5.0,6.0,0.0,2.0,1.0,4.0,2.0,14.0,4.0,8.0,5.0,2.0,2.0,1.0,1.0,4.0,13.0,1.0,0.0,1.0,5.0,4.0,3.0,5.0,10.0,1.0,1.0,8.0,2.0,6.0,1.0,8.0,5.0,1.0,4.0,9.0,1.0,5.0,4.0,7.0,4.0,2.0,3.0,11.0,2.0,2.0,3.0,0.0,1.0,1.0,1.0,3.0,9.0,0.0,9.0,3.0,1.0,5.0,2.0,3.0,4.0,3.0,8.0,2.0,15.0,2.0,3.0,1.0,2.0,2.0,8.0,,,,,,,,,,,,,,,,,,,,,,,,,,,,,,,,,,,,,,,,,,,,,,,,,,,,,,,,,,,5.0,4.0,2.0,0.0,1.0,0.0,0.0,0.0,0.0,0.0,0.0,0.0,0.0,7.0,0.0,0.0,0.0,1.0,0.0,0.0,0.0,1.0,0.0,2.0,0.0,4.0,0.0,0.0,10.0,0.0,2.0,0.0,2.0,0.0,0.0,0.0,2.0,0.0,2.0,0.0,4.0,2.0,2.0,2.0,3.0,1.0,1.0,5.0,3.0,0.0,0.0,0.0,0.0,3.0,0.0,0.0,0.0,0.0,0.0,2.0,0.0,0.0,0.0,0.0,0.0,4.0,2.0,0.0,0.0,0.0,0.0,0.0,0.0,5.0,3.0,0.0,0.0,0.0,0.0,0.0,2.0,9.0,6.0,0.0,3.0,3.0,0.0,0.0,0.0,0.0,0.0,0.0,0.0,0.0,0.0,0.0,0.0,0.0,4.0,0.0,1.0,0.0,0.0,0.0,0.0,0.0,0.0,0.0,0.0,2.0,0.0,0.0,0.0,0.0,0.0,0.0,0.0,0.0,0.0,0.0,6.0,0.0,0.0,0.0,0.0,0.0,0.0,0.0,0.0,0.0,6.0,0.0,5.0,0.0,2.0,0.0,0.0,3.0,0.0,0.0,0.0,0.0,0.0,0.0,0.0,0.0,1.0,2.0,0.0,0.0,0.0,0.0,0.0,0.0,0.0,1.0,1.0,0.0,0.0,2.0,0.0,0.0,3.0,0.0,0.0,1.0,3.0,4.0,0.0,0.0,0.0,3.0,0.0,1.0,0.0,2.0,4.0,0.0,0.0,0.0,0.0,0.0,3.0,2.3333333333333335,0.0,2.0,0.0,1.0,0.0,2.0,3.0,1.0,1.0,4.0,2.0,0.0,0.0,0.0,0.0,0.0,0.0,0.0,0.0,0.0,0.0,0.0,0.0,0.0,0.0,3.0,0.0,0.0,0.0,0.0,1.0,0.0,0.0,0.0,0.0,0.0,0.0,0.0,0.0,0.0,1.0,2.0,2.0,0.0,0.0,0.0,2.0,0.0,0.0,3.0,0.0,0.0,0.0,0.0,0.0,0.0,0.0,0.0,0.0,0.0,0.0,0.0,0.0,0.0,0.0,0.0,0.0,0.0,4.0,0.0,0.0,0.0,3.0,0.0,2.0,1.5,4.0,0.0,0.0,0.0,0.0,0.0,7.0,0.0,0.0,1.0,2.0,0.0,0.0,5.0,0.0,0.0,0.0,0.0,4.0,0.0,0.0,4.0,0.0,0.0,20.0,27.0,9.0,12.0,15.0,13.0,3.0,2.0,9.0,5.0,3.0,12.0,10.0,16.0,21.0,0.0,4.0,1.0,7.0,11.0,0.0,1.0,0.0,0.0,9.0,9.0,24.0,18.0,6.0,16.0,21.0,2.0,2.0,7.0,0.0,26.0,17.0,18.0,1.0,11.0,12.0,40.0,7.0,16.0,11.0,16.0,10.0,12.0,4.0,4.0,5.0,20.0,17.0,0.0,18.0,20.0,24.0,24.0,22.0,9.0,0.0,27.0,18.0,8.0,25.0,23.0,23.0,24.0,11.0,23.0,4.0,8.0,32.0,25.0,21.0,15.0,25.0,0.0,13.0,9.0,10.0,22.0,33.0,41.0,16.0,6.0,15.0,23.0,27.0,0.0,25.0,7.0,1.0,41.0,0.0,6.0,21.0,2.0,1.0,5.0,2.0,1.0,1.0,24.0,0.0,1.0,0.0,2.0,2.0,17.0,0.0,3.0,1.0,0.0,0.0,24.0,4.0,17.0,10.0,23.0,30.0,18.0,11.0,0.0,0.0,3.0,12.0,4.0,22.0,7.0,6.0,0.0,1.0,1.0,2.0,1.0,22.0,5.0,1.0,1.0,1.0,4.0,0.0,0.0,0.0,4.0,24.0,1.0,0.0,15.0,0.0,3.0,0.0,6.0,7.0,4.0,15.0,1.0,1.0,21.0,19.0,4.0,7.0,1.0,3.0,9.0,3.0,15.0,3.0,0.0,2.0,0.0,2.0,0.0,9.0,1.0,10.0,8.0,0.0,9.0,3.0,1.0,5.0,13.0,3.0,9.0,6.0,12.0,3.0,4.0,3.0,10.0,11.0,14.0,1.0,2.0,0.0,1.0,1.0,0.0,0.0,1.0,0.0,0.0,1.0,21.0,0.0,15.0,16.0,0.0,7.0,1.0,0.0,0.0,0.0,0.0,3.0,0.0,1.0,0.0,16.0,13.0,1.0,5.0,2.0,4.0,3.0,11.0,7.0,5.0,1.0,2.0,0.0,16.0,21.0,15.0,2.0,1.0,0.0,2.0,8.0,23.0,0.0,3.0,25.0,1.0,1.0,0.0,13.0,1.0,15.0,1.0,15.0,18.0,16.0,15.0,6.0,16.0,5.0,20.0,13.0,13.0,10.0,26.0,13.0,10.0,16.0,16.0,11.0,25.0,25.0,27.0,30.0,17.0,17.0,29.0,11.0,5.0,30.0,26.0,1.0,0.0,2.0,,12.0,17.0,17.0,15.0,29.0,3.0,21.0,30.0,2.0,2.0,8.0,1.0,21.0,0.0,2.0,6.0,6.0,28.0,22.0,27.0,20.0,10.0,17.0,17.0,9.0,2.0,1.0,10.0,11.0,0.0,12.0,42.0,17.0,8.0,10.0,27.0,18.0,31.0,22.0,17.0,1.0,0.0,16.0,23.0,6.0,23.0,1.0,28.0,22.0,21.0,1.0,21.0,23.0,30.0,16.0,1.0,3.0,5.0,27.0,20.0,1.0,0.0,3.0,1.0,16.0,16.0,1.0,24.0,20.0,4.0,39.0,21.0,16.0,19.0,20.0,21.0,2.0,1.0,0.0,13.0,19.0,4.0,16.0,10.0,10.0,20.0,19.0,25.0,26.0,17.0,20.0,18.0,20.0,15.0,4.0,18.0,18.0,2.0,3.0,8.0,9.0,0.0,2.0,4.0,25.0,19.0,12.0,0.0,0.0,0.0,0.0,21.0,1.0,2.0,11.0,14.0,8.0,13.0,13.0,4.0,4.0,1.0,3.0,1.0,1.0,0.0,0.0,0.0,0.0,0.0,0.0,0.0,,0.0,,,0.0,0.0,0.0,0.0,0.0,10.0,4.0,1.0,0.0,9.0,7.0,6.0,8.0,4.0,5.0,3.0,0.0,4.0,3.0,4.0,2.0,8.0,5.0,5.0,10.0,5.0,6.0,12.0,12.0,6.0,11.0,18.0,7.0,8.0,10.0,4.0,8.0,8.0,5.0,0.0,7.0,19.0,6.0,6.0,9.0,4.0,5.0,3.0,6.0,11.0,2.0,22.0,9.0,6.0,7.0,6.0,9.0,6.0,7.0,4.0,4.0,4.0,5.0,7.0,0.0,4.0,6.0,7.0,6.0,7.0,18.0,3.0,9.0,20.0,6.0,2.0,10.0,22.0,11.0,16.0,5.0,7.0,30.0,18.0,5.0,9.0,17.0,6.0,1.0,1.0,13.0,10.0,12.0,18.0,6.0,6.0,8.0,6.0,14.0,7.0,7.0,1.0,6.0,4.0,5.0,13.0,9.0,8.0,10.0,2.0,12.0,8.0,3.0,0.0,2.0,27.0,5.0,5.0,9.0,1.0,5.0,5.0,8.0,6.0,4.0,4.0,2.0,2.0,4.0,7.0,13.0,22.0,8.0,18.0,7.0,0.0,3.0,1.0,12.0,10.0,7.0,9.0,13.0,0.0,1.0,5.0,5.0,8.0,12.0,5.0,10.0,5.0,2.0,12.0,3.0,7.0,8.0,3.0,6.0,10.0,0.0,5.0,0.0,3.0,2.0,2.0,3.0,2.0,2.0,3.0,0.0,0.0,4.0,0.0,2.0,4.0,8.0,1.0,1.0,4.0,9.0,1.0,5.0,7.0,6.0,7.0,3.0,1.0,8.0,5.0,5.0,2.0,10.0,,2.0,5.0,7.0,12.0,10.0,2.0,10.0,9.0,13.0,10.0,11.0,20.0,5.0,11.0,2.0,4.0,3.0,12.0,2.0,7.0,18.0,2.0,15.0,1.0,33.0,10.0,3.0,2.0,10.0,2.0,6.0,9.0,2.0,64.0,6.0,3.0,10.0,9.0,1.0,4.0,10.0,1.0,6.0,17.0,2.0,2.0,3.0,10.0,1.0,2.0,0.0,7.0,,29.0,5.0,2.0,1.0,16.0,5.0,4.0,14.0,3.0,0.0,7.0,18.0,9.0,1.0,9.0,11.0,3.0,3.0,6.0,2.0,23.0,1.0,12.0,14.0,7.0,3.0,3.0,11.0,1.0,1.0,2.0,3.0,2.0,20.0,14.0,2.0,,2.0,5.0,5.0,17.0,2.0,2.0,16.0,4.0,1.0,9.0,11.0,13.0,10.0,17.0,3.0,17.0,3.0,14.0,4.0,5.0,3.0,1.0,11.0,13.0,7.0,7.0,6.0,3.0,7.0,3.0,8.0,4.0,7.0,,19.0,0.0,6.0,8.0,9.0,12.0,9.0,9.0,15.0,15.0,12.0,19.0,17.0,16.0,3.0,8.0,5.0,2.0,8.0,3.0,5.0,13.0,14.0,17.0,8.0,2.0,4.0,1.0,12.0,4.0,13.0,5.0,17.0,6.0,42.0,24.0,19.0,12.0,18.0,9.0,5.0,2.0,12.0,3.0,1.0,2.0,9.0,10.0,9.0,19.0,8.0,1.0,21.0,17.0,10.0,14.0,10.0,22.0,6.0,7.0,9.0,9.0,10.0,15.0,10.0,9.0,4.0,7.0,25.0,13.0,7.0,12.0,2.0,5.0,19.0,8.0,4.0,14.0,8.0,4.0,1.0,2.0,2.0,17.0,8.0,16.0,19.0,12.0,7.0,3.0,5.0,13.0,10.0,1.0,5.0,8.0,9.0,10.0,,22.0,13.0,4.0,18.0,13.0,2.0,6.0,13.0,13.0,2.0,5.0,8.0,12.0,3.0,10.0,10.0,8.0,,14.0,12.0,13.0,2.0,3.0,8.0,12.0,6.0,10.0,14.0,16.0,9.0,1.0,12.0,13.0,6.0,6.0,1.0,0.0,7.0,1.0,7.0,20.0,8.0,6.0,2.0,3.0,,12.0,16.0,2.0,15.0,6.0,3.0,10.0,12.0,11.0,2.0,14.0,0.0,12.0,3.0,1.0,9.0,1.0,13.0,12.0,6.0,5.0,4.0,9.0,4.0,12.0,10.0,8.0,17.0,2.0,16.0,15.0,16.0,8.0,5.0,16.0,8.0,13.0,8.0,2.0,9.0,12.0,4.0,16.0,1.0,24.0,13.0,3.0,2.0,9.0,15.0,13.0,12.0,13.0,4.0,19.0,16.0,5.0,12.0,1.0,15.0,23.0,18.0,10.0,2.0,4.0,22.0,1.0,11.0,17.0,2.0,7.0,8.0,17.0,9.0,13.0,1.0,4.0,2.0,12.0,15.0,,21.0,15.0,7.0,2.0,2.0,2.0,13.0,3.0,2.0,1.0,7.0,,5.0,1.0,3.0,9.0,13.0,4.0,4.0,10.0,7.0,13.0,10.0,12.0,16.0,9.0,25.0,7.0,5.0,8.0,4.0,3.0,3.0,8.0,6.0,6.0,11.0,5.0,21.0,0.0,3.0,1.0,6.0,11.0,2.0,3.0,1.0,2.0,4.0,9.0,13.0,17.0,14.0,,3.0,8.0,14.0,1.0,0.0,8.0,13.0,4.0,18.0,2.0,11.0,18.0,3.0,8.0,5.0,15.0,10.0,15.0,2.0,9.0,2.0,15.0,6.0,7.0,1.0,17.0,14.0,,7.0,4.0,10.0,3.0,5.0,1.0,9.0,23.0,0.0,25.0,3.0,8.0,4.0,4.0,4.0,21.0,4.0,8.0,1.0,6.0,2.0,1.0,0.0,0.0,5.0,2.0,9.0,8.0,2.0,9.0,8.0,6.0,8.0,6.0,2.0,1.0,0.0,1.0,1.0,7.0,1.0,2.0,0.0,11.0,0.0,2.0,4.0,2.0,6.0,6.0,2.0,2.0,4.0,2.0,4.0,1.0,2.0,2.0,2.0,0.0,1.0,0.0,1.0,2.0,0.0,11.0,8.0,1.0,0.0,6.0,5.0,9.0,1.0,2.0,2.0,0.0,4.0,0.0,0.0,0.0,3.0,2.0,2.0,2.0,1.0,0.0,3.0,5.0,0.0,2.0,2.0,2.0,1.0,5.0,5.0,4.0,3.0,5.0,1.0,4.0,5.0,3.0,3.0,4.0,16.0,2.0,8.0,16.0,7.0,6.0,26.0,3.0,1.0,6.0,3.0,24.0,15.0,15.0,5.0,5.0,3.0,5.0,12.0,28.0,9.0,8.0,16.0,8.0,7.0,14.0,2.0,21.0,5.0,9.0,8.0,14.0,19.0,20.0,12.0,15.0,1.0,10.0,15.0,11.0,3.0,11.0,18.0,3.0,16.0,12.0,11.0,1.0,4.0,5.0,19.0,7.0,20.0,12.0,16.0,9.0,10.0,18.0,14.0,14.0,17.0,13.0,10.0,5.0,11.0,11.0,7.0,9.0,4.0,12.0,21.0,16.0,18.0,11.0,15.0,13.0,14.0,10.0,20.0,18.0,7.0,15.0,9.0,6.0,2.0,29.0,4.0,10.0,4.0,9.0,1.0,15.0,12.0,15.0,26.0,8.0,21.0,13.0,18.0,15.0,22.0,7.0,12.0,20.0,12.0,10.0,10.0,3.0,16.0,23.0,19.0,11.0,14.0,8.0,7.0,2.0,10.0,11.0,9.0,9.0,12.0,26.0,4.0,6.0,7.0,19.0,5.0,9.0,11.0,10.0,19.0,0.0,2.0,18.0,13.0,2.0,3.0,19.0,26.0,29.0,11.0,9.0,11.0,9.0,13.0,9.0,11.0,14.0,9.0,8.0,12.0,22.0,15.0,18.0,3.0,5.0,5.0,9.0,15.0,13.0,12.0,9.0,14.0,12.0,5.0,19.0,6.0,3.0,24.0,14.0,16.0,13.0,19.0,5.0,2.0,21.0,20.0,22.0,5.0,3.0,21.0,12.0,8.0,14.0,4.0,19.0,12.0,12.0,5.0,13.0,6.0,34.0,17.0,13.0,7.0,7.0,9.0,15.0,7.0,10.0,11.0,13.0,5.0,7.0,18.0,10.0,1.0,19.0,24.0,17.0,15.0,16.0,8.0,10.0,6.0,17.0,15.0,21.0,5.0,23.0,7.0,9.0,9.0,9.0,2.0,15.0,23.0,17.0,22.0,7.0,12.0,8.0,14.0,5.0,15.0,8.0,2.0,6.0,6.0,19.0,19.0,10.0,13.0,18.0,7.0,9.0,12.0,9.0,5.0,12.0,13.0,14.0,13.0,12.0,17.0,11.0,12.0,15.0,11.0,15.0,16.0,3.0,9.0,5.0,7.0,8.0,15.0,6.0,9.0,9.0,7.0,18.0,24.0,11.0,11.0,14.0,14.0,10.0,12.0,14.0,13.0,9.0,3.0,16.0,5.0,17.0,12.0,10.0,15.0,5.0,8.0,7.0,13.0,16.0,10.0,13.0,7.0,2.0,19.0,1.0,5.0,0.0,12.0,7.0,9.0,15.0,15.0,14.0,11.0,7.0,0.0,10.0,4.0,1.0,4.0,15.0,10.0,16.0,18.0,14.0,6.0,13.0,13.0,21.0,10.0,7.0,18.0,4.0,6.0,2.0,0.0,3.0,0.0,0.0,0.0,3.0,3.0,23.0,11.0,12.0,14.0,12.0,1.0,15.0,13.0,0.0,4.0,8.0,1.0,7.0,6.0,2.0,4.0,10.0,11.0,3.0,6.0,7.0,11.0,15.0,3.0,8.0,6.0,15.0,17.0,20.0,3.0,13.0,15.0,12.0,9.0,13.0,1.0,5.0,11.0,14.0,4.0,17.0,8.0,12.0,13.0,8.0,11.0,14.0,11.0,12.0,11.0,10.0,9.0,12.0,7.0,10.0,22.0,0.0,2.0,7.0,11.0,18.0,2.0,0.0,1.0,2.0,12.0,12.0,5.0,11.0,3.0,14.0,5.0,12.0,13.0,8.0,13.0,18.0,19.0,20.0,0.0,4.0,1.0,10.0,1.0,7.0,4.0,6.0,16.0,0.0,2.0,4.0,15.0,12.0,17.0,0.0,7.0,5.0,7.0,3.0,6.0,0.0,0.0,9.0,1.0,3.0,9.0,9.0,11.0,3.0,5.0,0.0,5.0,14.0,15.0,1.0,7.0,9.0,4.0,3.0,8.0,3.0,10.0,7.0,3.0,0.0,11.0,3.0,10.0,9.0,2.0,5.0,1.0,3.0,8.0,1.0,1.0,10.0,1.0,0.0,1.0,5.0,2.0,7.0,3.0,11.0,6.0,1.0,10.0,10.0,6.0,2.0,4.0,0.0,12.0,2.0,2.0,4.0,8.0,8.0,3.0,10.0,5.0,1.0,8.0,10.0,8.0,4.0,7.0,14.0,9.0,2.0,0.0,3.0,9.0,11.0,12.0,5.0,10.0,8.0,5.0,2.0,11.0,1.0,7.0,13.0,6.0,7.0,9.0,0.0,5.0,0.0,28.0,2.0,6.0,14.0,9.0,6.0,4.0,1.0,0.0,4.0,2.0,0.0,4.0,8.0,0.0,0.0,0.0,11.0,4.0,15.0,0.0,27.0,13.0,0.0,1.0,6.0,5.0,1.0,0.0,1.0,3.0,5.0,1.0,7.0,8.0,11.0,16.0,3.0,2.0,3.0,0.0,11.0,1.0,4.0,7.0,2.0,10.0,8.0,3.0,1.0,1.0,17.0,7.0,3.0,1.0,6.0,2.0,20.0,2.0,2.0,1.0,8.0,6.0,6.0,3.0,7.0,3.0,3.0,6.0,8.0,2.0,6.0,1.0,8.0,1.0,2.0,0.0,13.0,4.0,0.0,2.0,4.0,3.0,7.0,0.0,4.0,1.0,10.0,5.0,4.0,6.0,4.0,6.0,16.0,13.0,5.0,5.0,5.0,0.0,8.0,13.0,7.0,1.0,5.0,18.0,13.0,6.0,9.0,3.0,9.0,7.0,5.0,1.0,9.0,16.0,9.0,2.0,12.0,7.0,2.0,2.0,4.0,4.0,0.0,10.0,6.0,3.0,5.0,5.0,6.0,3.0,2.0,0.0,14.0,0.0,2.0,4.0,8.0,5.0,1.0,0.0,3.0,3.0,1.0,19.0,12.0,0.0,0.0,38.0,5.0,8.0,6.0,10.0,1.0,5.0,7.0,6.0,4.0,0.0,2.0,6.0,8.0,10.0,2.0,0.0,5.0,8.0,4.0,5.0,7.0,30.0,10.0,9.0,10.0,3.0,3.0,4.0,6.0,5.0,0.0,7.0,5.0,7.0,6.0,4.0,3.0,9.0,2.0,5.0,6.0,7.0,5.0,3.0,7.0,9.0,15.0,1.0,12.0,3.0,4.0,4.0,7.0,4.0,12.0,13.0,8.0,3.0,10.0,5.0,4.0,1.0,4.0,5.0,6.0,5.0,6.0,6.0,3.0,3.0,6.0,6.0,4.0,7.0,13.0,5.0,5.0,4.0,8.0,9.0,4.0,5.0,3.0,5.0,21.0,3.0,2.0,2.0,4.0,0.0,5.0,3.0,4.0,3.0,3.0,2.0,9.0,6.0,6.0,3.0,9.0,3.0,8.0,3.0,7.0,4.0,5.0,8.0,8.0,3.0,3.0,5.0,8.0,4.0,5.0,3.0,2.0,11.0,12.0,9.0,14.0,9.0,11.0,0.0,3.0,8.0,12.0,10.0,5.0,8.0,15.0,18.0,10.0,4.0,11.0,9.0,9.0,12.0,11.0,13.0,13.0,14.0,10.0,19.0,3.0,13.0,19.0,13.0,10.0,7.0,13.0,10.0,6.0,4.0,3.0,6.0,7.0,7.0,8.0,7.0,6.0,6.0,13.0,10.0,3.0,11.0,11.0,2.0,7.0,6.0,1.0,19.0,11.0,6.0,4.0,14.0,2.0,5.0,6.0,5.0,7.0,8.0,5.0,2.0,3.0,4.0,3.0,3.0,3.0,5.0,4.0,5.0,2.0,4.0,4.0,4.0,4.0,4.0,4.0,5.0,9.0,10.0,3.0,5.0,3.0,3.0,2.0,3.0,5.0,6.0,4.0,4.0,4.0,4.0,4.0,3.0,5.0,8.0,7.0,8.0,9.0,8.0,5.0,4.0,5.0,2.0,10.0,5.0,10.0,10.0,10.0,17.0,5.0,14.0,13.0,5.0,4.0,4.0,13.0,3.0,10.0,5.0,3.0,7.0,7.0,1.0,7.0,3.0,4.0,4.0,4.0,5.0,5.0,6.0,6.0,8.0,7.0,8.0,6.0,7.0,5.0,3.0,11.0,13.0,6.0,16.0,8.0,5.0,8.0,10.0,11.0,6.0,4.0,13.0,7.0,12.0,8.0,10.0,11.0,12.0,4.0,5.0,4.0,8.0,6.0,7.0,14.0,5.0,7.0,10.0,7.0,4.0,5.0,11.0,10.0,7.0,10.0,9.0,10.0,9.0,8.0,7.0,13.0,5.0,2.0,14.0,21.0,2.0,8.0,7.0,14.0,5.0,12.0,15.0,7.0,7.0,8.0,6.0,3.0,17.0,10.0,9.0,12.0,8.0,7.0,8.0,6.0,8.0,11.0,5.0,14.0,9.0,6.0,6.0,11.0,8.0,8.0,5.0,12.0,5.0,9.0,7.0,1.0,12.0,12.0,7.0,7.0,9.0,9.0,8.0,11.0,9.0,12.0,8.0,9.0,2.0,11.0,9.0,4.0,1.0,8.0,13.0,3.0,11.0,9.0,9.0,5.0,3.0,4.0,14.0,5.0,5.0,4.0,9.0,4.0,15.0,10.0,5.0,7.0,2.0,10.0,8.0,7.0,9.0,13.0,12.0,7.0,7.0,15.0,18.0,12.0,6.0,11.0,6.0,16.0,9.0,12.0,4.0,7.0,5.0,17.0,15.0,6.0,3.0,10.0,7.0,8.0,10.0,6.0,9.0,10.0,5.0,11.0,7.0,7.0,5.0,6.0,8.0,9.0,1.0,5.0,9.0,5.0,7.0,5.0,9.0,6.0,3.0,2.0,7.0,6.0,7.0,6.0,13.0,4.0,3.0,8.0,10.0,12.0,8.0,7.0,19.0,10.0,8.0,10.0,8.0,3.0,8.0,5.0,5.0,8.0,8.0,6.0,8.0,6.0,4.0,3.0,7.0,6.0,3.0,10.0,2.0,9.0,0.0,3.0,5.0,4.0,4.0,10.0,12.0,13.0,0.0,5.0,0.0,4.0,6.0,3.0,1.0,7.0,3.0,9.0,2.0,2.0,5.0,10.0,2.0,8.0,5.0,1.0,1.0,2.0,4.0,2.0,1.0,5.0,5.0,4.0,5.0,0.0,5.0,3.0,5.0,3.0,4.0,5.0,5.0,3.0,3.0,5.0,4.0,5.0,0.0,0.0,5.0,2.0,4.0,5.0,0.0,0.0,2.0,4.0,3.0,2.0,1.0,3.0,2.0,5.0,5.0,4.0,5.0,3.0,1.0,5.0,5.0,5.0,5.0,0.0,5.0,1.0,1.0,5.0,5.0,2.0,5.0,5.0,5.0,5.0,0.0,5.0,2.0,2.0,5.0,2.0,2.0,5.0,5.0,5.0,5.0,5.0,5.0,2.0,2.0,5.0,4.0,5.0,5.0,5.0,5.0,5.0,1.0,5.0,3.0,5.0,1.0,5.0,3.0,5.0,5.0,5.0,1.0,4.0,3.0,0.0,1.0,0.0,1.0,2.0,3.0,0.0,5.0,3.0,0.0,6.0,3.0,1.0,0.0,1.0,4.0,0.0,0.0,0.0,8.0,1.0,0.0,3.0,6.0,0.0,1.0,3.0,1.0,3.0,0.0,0.0,0.0,0.0,14.0,0.0,1.0,5.0,2.0,8.0,21.0,7.0,15.0,10.0,27.0,13.0,21.0,14.0,28.0,12.0,8.0,16.0,12.0,3.0,7.0,15.0,11.0,19.0,7.0,6.0,17.0,25.0,11.0,11.0,18.0,1.0,0.0,8.0,3.0,5.0,11.0,6.0,8.0,14.0,9.0,3.0,14.0,2.0,9.0,8.0,2.0,17.0,10.0,18.0,19.0,10.0,5.0,6.0,14.0,,10.0,19.0,25.0,8.0,13.0,11.0,14.0,13.0,16.0,3.0,8.0,8.0,22.0,2.0,12.0,18.0,24.0,15.0,16.0,19.0,16.0,7.0,22.0,3.0,22.0,24.0,7.0,5.0,22.0,22.0,29.0,10.0,17.0,16.0,19.0,8.0,3.0,14.0,6.0,1.0,2.0,0.0,1.0,5.0,4.0,3.0,9.0,14.0,8.0,15.0,12.0,11.0,8.0,12.0,21.0,0.0,2.0,4.0,15.0,22.0,25.0,9.0,8.0,10.0,15.0,7.0,2.0,2.0,0.0,9.0,22.0,22.0,6.0,14.0,1.0,7.0,6.0,16.0,19.0,23.0,18.0,8.0,6.0,18.0,19.0,1.0,5.0,4.0,9.0,8.0,18.0,14.0,11.0,14.0,0.0,14.0,13.0,13.0,7.0,18.0,15.0,9.0,19.0,15.0,25.0,8.0,16.0,14.0,28.0,11.0,23.0,5.0,4.0,20.0,21.0,18.0,11.0,14.0,13.0,11.0,7.0,17.0,12.0,6.0,1.0,10.0,18.0,25.0,19.0,1.0,15.0,1.0,3.0,24.0,15.0,6.0,11.0,11.0,0.0,5.0,20.0,14.0,11.0,9.0,2.0,21.0,1.0,10.0,11.0,14.0,5.0,10.0,23.0,5.0,10.0,1.0,7.0,15.0,2.0,1.0,2.0,6.0,17.0,11.0,15.0,9.0,14.0,7.0,8.0,12.0,4.0,14.0,10.0,9.0,21.0,20.0,17.0,13.0,1.0,19.0,9.0,13.0,11.0,19.0,19.0,15.0,13.0,14.0,3.0,8.0,12.0,14.0,25.0,6.0,17.0,8.0,1.0,3.0,4.0,6.0,1.0,2.0,9.0,10.0,6.0,12.0,21.0,11.0,18.0,0.0,5.0,8.0,25.0,13.0,13.0,15.0,6.0,0.0,2.0,0.0,2.0,14.0,0.0,0.0,3.0,8.0,16.0,14.0,9.0,0.0,14.0,16.0,17.0,18.0,11.0,2.0,4.0,15.0,10.0,15.0,2.0,13.0,0.0,12.0,1.0,1.0,8.0,6.0,5.0,11.0,8.0,2.0,6.0,2.0,7.0,4.0,11.0,13.0,15.0,13.0,1.0,8.0,1.0,13.0,18.0,15.0,21.0,19.0,10.0,12.0,1.0,9.0,0.0,1.0,0.0,20.0,7.0,0.0,3.0,12.0,14.0,21.0,18.0,1.0,8.0,6.0,2.0,0.0,11.0,12.0,9.0,0.0,24.0,4.0,0.0,10.0,7.0,14.0,17.0,17.0,11.0,19.0,0.0,15.0,11.0,1.0,4.0,20.0,9.0,14.0,31.0,22.0,6.0,0.0,44.0,15.0,2.0,17.0,7.0,16.0,11.0,11.0,7.0,20.0,12.0,23.0,8.0,1.0,4.0,3.0,11.0,16.0,4.0,11.0,5.0,12.0,8.0,23.0,9.0,14.0,26.0,11.0,4.0,8.0,1.0,10.0,6.0,20.0,17.0,3.0,3.0,2.0,11.0,6.0,17.0,11.0,17.0,15.0,22.0,11.0,16.0,16.0,3.0,3.0,6.0,1.0,15.0,13.0,2.0,1.0,22.0,1.0,0.0,17.0,18.0,15.0,18.0,16.0,1.0,1.0,3.0,13.0,19.0,20.0,3.0,,0.0,9.0,5.0,22.0,15.0,3.0,2.0,30.0,7.0,12.0,5.0,1.0,0.0,0.0,26.0,8.0,3.0,13.0,10.0,0.0,3.0,16.0,1.0,0.0,14.0,0.0,13.0,5.0,0.0,1.0,0.0,14.0,5.0,0.0,14.0,2.0,11.0,6.0,9.0,2.0,8.0,18.0,13.0,19.0,27.0,10.0,10.0,6.0,0.0,0.0,1.0,0.0,3.0,16.0,13.0,15.0,12.0,10.0,6.0,8.0,1.0,15.0,14.0,12.0,8.0,19.0,9.0,0.0,4.0,16.0,3.0,2.0,0.0,2.0,20.0,9.0,6.0,9.0,16.0,11.0,18.0,2.0,9.0,12.0,8.0,9.0,13.0,12.0,15.0,14.0,23.0,15.0,23.0,13.0,18.0,13.0,11.0,13.0,24.0,17.0,9.0,2.0,0.0,23.0,12.0,13.0,17.0,20.0,11.0,17.0,12.0,15.0,0.0,2.0,7.0,1.0,9.0,12.0,1.0,15.0,6.0,10.0,21.0,4.0,10.0,25.0,13.0,18.0,7.0,7.0,9.0,5.0,5.0,19.0,14.0,12.0,1.0,9.0,13.0,15.0,1.0,7.0,0.0,4.0,2.0,17.0,8.0,2.0,0.0,0.0,14.0,14.0,18.0,7.0,12.0,10.0,11.0,9.0,8.0,9.0,1.0,12.0,22.0,8.0,11.0,15.0,11.0,7.0,1.0,1.0,8.0,17.0,11.0,9.0,8.0,25.0,20.0,11.0,8.0,4.0,0.0,0.0,0.0,18.0,19.0,0.0,12.0,12.0,6.0,4.0,10.0,13.0,8.0,12.0,8.0,11.0,6.0,7.0,20.0,11.0,2.0,14.0,7.0,10.0,13.0,10.0,6.0,9.0,19.0,10.0,10.0,13.0,6.0,3.0,11.0,2.0,13.0,9.0,8.0,8.0,7.0,8.0,10.0,14.0,9.0,1.0,8.0,10.0,0.0,5.0,0.0,8.0,2.0,7.0,9.0,5.0,19.0,12.0,0.0,0.0,11.0,6.0,10.0,0.0,7.0,9.0,14.0,5.0,8.0,14.0,11.0,6.0,11.0,14.0,5.0,8.0,9.0,5.0,16.0,10.0,12.0,21.0,4.0,14.0,11.0,24.0,12.0,19.0,5.0,4.0,16.0,7.0,19.0,15.0,9.0,12.0,21.0,12.0,14.0,14.0,14.0,18.0,8.0,8.0,12.0,8.0,14.0,13.0,19.0,5.0,11.0,10.0,10.0,19.0,21.0,9.0,15.0,9.0,4.0,10.0,1.0,12.0,6.0,14.0,0.0,6.0,4.0,14.0,18.0,5.0,22.0,20.0,12.0,0.0,8.0,10.0,6.0,4.0,3.0,14.0,12.0,0.0,1.0,6.0,15.0,3.0,7.0,7.0,5.0,1.0,5.0,6.0,6.0,0.0,6.0,12.0,16.0,7.0,4.0,11.0,6.0,1.0,15.0,11.0,1.0,0.0,7.0,9.0,10.0,9.0,1.0,0.0,1.0,0.0,1.0,4.0,0.0,2.0,5.0,8.0,3.0,12.0,13.0,10.0,7.0,0.0,9.0,13.0,21.0,1.0,16.0,18.0,13.0,1.0,2.0,17.0,15.0,14.0,8.0,12.0,5.0,4.0,8.0,1.0,2.0,10.0,6.0,3.0,6.0,6.0,0.0,6.0,14.0,4.0,9.0,9.0,12.0,10.0,11.0,0.0,0.0,21.0,14.0,2.0,5.0,14.0,6.0,16.0,6.0,2.0,0.0,1.0,9.0,10.0,10.0,3.0,16.0,1.0,1.0,14.0,15.0,18.0,13.0,6.0,3.0,5.0,0.0,8.0,20.0,12.0,6.0,30.0,14.0,1.0,5.0,0.0,10.0,11.0,3.0,17.0,16.0,10.0,4.0,0.0,2.0,0.0,6.0,14.0,1.0,5.0,0.0,0.0,11.0,1.0,1.0,13.0,6.0,11.0,3.0,9.0,10.0,3.0,8.0,12.0,0.0,0.0,11.0,17.0,4.0,13.0,7.0,18.0,2.0,0.0,1.0,1.0,8.0,10.0,17.0,10.0,4.0,15.0,17.0,0.0,19.0,2.0,4.0,14.0,11.0,19.0,10.0,14.0,4.0,10.0,4.0,1.0,3.0,12.0,12.0,1.0,14.0,9.0,7.0,8.0,7.0,3.0,7.0,35.0,5.0,3.0,3.0,5.0,3.0,14.0,2.0,1.0,0.0,2.0,6.0,11.0,23.0,0.0,1.0,7.0,18.0,12.0,10.0,1.0,12.0,2.0,0.0,11.0,0.0,0.0,9.0,7.0,4.0,19.0,10.0,8.0,10.0,11.0,13.0,2.0,0.0,2.0,17.0,5.0,2.0,10.0,0.0,12.0,15.0,3.0,5.0,15.0,13.0,11.0,1.0,4.0,4.0,14.0,7.0,0.0,12.0,12.0,9.0,7.0,5.0,0.0,8.0,2.0,8.0,0.0,16.0,14.0,0.0,8.0,14.0,17.0,2.0,11.0,13.0,13.0,7.0,2.0,20.0,13.0,13.0,20.0,0.0,10.0,13.0,10.0,9.0,14.0,9.0,1.0,20.0,0.0,9.0,0.0,1.0,35.0,16.0,13.0,1.0,0.0,0.0,0.0,0.0,0.0,2.0,5.0,3.0,3.0,1.0,0.0,3.0,1.0,0.0,1.0,10.0,0.0,4.0,0.0,1.0,6.0,0.0,5.0,0.0,0.0,0.0,0.0,0.0,0.0,5.0,1.0,0.0,0.0,0.0,0.0,0.0,4.0,1.0,1.0,1.0,0.0,0.0,2.0,0.0,0.0,0.0,1.0,2.0,3.0,2.0,4.0,3.0,0.0,1.0,0.0,3.0,2.0,0.0,0.0,0.0,0.0,1.0,0.0,0.0,2.0,2.0,0.0,1.0,0.0,0.0,2.0,0.0,2.0,2.0,0.0,0.0,0.0,0.0,0.0,1.0,0.0,3.0,0.0,1.0,4.0,2.0,0.0,0.0,0.0,0.0,0.0,0.0,3.0,1.0,1.0,1.0,0.0,0.0,3.0,8.0,12.0,1.0,3.0,2.0,1.0,3.0,6.0,9.0,2.0,3.0,10.0,13.0,11.0,9.0,6.0,2.0,5.0,4.0,11.0,9.0,8.0,7.0,7.0,9.0,1.0,0.0,3.0,1.0,4.0,4.0,8.0,4.0,8.0,0.0,9.0,13.0,9.0,5.0,7.0,6.0,2.0,9.0,0.0,1.0,3.0,3.0,2.0,2.0,4.0,3.0,4.0,6.0,5.0,2.0,2.0,8.0,3.0,5.0,3.0,5.0,2.0,1.0,5.0,1.0,2.0,6.0,3.0,3.0,5.0,4.0,1.0,3.0,8.0,6.0,3.0,5.0,7.0,1.0,3.0,10.0,3.0,4.0,5.0,4.0,0.0,3.0,5.0,5.0,4.0,0.0,1.0,8.0,0.0,0.0,4.0,3.0,4.0,5.0,2.0,0.0,3.0,2.0,3.0,6.0,7.0,1.0,2.0,4.0,4.0,0.0,2.0,2.0,4.0,0.0,0.0,2.0,7.0,6.0,7.0,5.0,2.0,2.0,4.0,9.0,3.0,3.0,3.0,2.0,2.0,5.0,6.0,6.0,6.0,4.0,0.0,5.0,3.0,5.0,4.0,4.0,4.0,0.0,3.0,2.0,11.0,3.0,7.0,14.0,5.0,11.0,7.0,6.0,2.0,3.0,3.0,4.0,4.0,2.0,12.0,7.0,3.0,6.0,0.0,1.0,8.0,3.0,3.0,0.0,2.0,7.0,0.0,1.0,1.0,1.0,3.0,2.0,0.0,0.0,2.0,0.0,2.0,7.0,1.0,1.0,6.0,0.0,0.0,0.0,0.0,0.0,4.0,8.0,11.0,6.0,5.0,4.0,5.0,4.0,6.0,8.0,4.0,6.0,5.0,6.0,3.0,4.0,9.0,8.0,4.0,6.0,7.0,6.0,4.0,7.0,8.0,5.0,8.0,4.0,12.0,3.0,13.0,5.0,7.0,6.0,5.0,5.0,5.0,3.0,9.0,3.0,7.0,4.0,5.0,9.0,6.0,2.0,2.0,9.0,6.0,5.0,13.0,4.0,2.0,3.0,6.0,4.0,6.0,8.0,8.0,5.0,5.0,6.0,2.0,7.0,7.0,3.0,6.0,6.0,2.0,3.0,10.0,4.0,2.0,7.0,14.0,6.0,8.0,2.0,11.0,2.0,3.0,6.0,8.0,2.0,6.0,3.0,4.0,7.0,5.0,2.0,5.0,5.0,11.0,7.0,5.0,6.0,6.0,8.0,5.0,3.0,3.0,2.0,4.0,2.0,6.0,7.0,5.0,5.0,7.0,7.0,4.0,3.0,4.0,5.0,4.0,5.0,0.0,0.0,4.0,4.0,5.0,5.0,5.0,5.0,5.0,5.0,4.0,4.0,5.0,5.0,5.0,5.0,4.0,3.0,3.0,5.0,4.0,5.0,5.0,0.0,2.0,4.0,5.0,3.0,3.0,3.0,4.0,5.0,0.0,7.0,0.0,1.0,5.0,0.0,4.0,6.0,8.0,0.0,11.0,1.0,7.0,0.0,14.0,0.0,1.0,1.0,0.0,0.0,0.0,7.0,2.0,1.0,6.0,0.0,2.0,4.0,8.0,3.0,9.0,7.0,0.0,0.0,10.0,4.0,7.0,0.0,0.0,14.0,6.0,0.0,17.0,2.0,8.0,16.0,4.0,1.0,4.0,0.0,0.0,1.0,11.0,0.0,0.0,1.0,7.0,0.0,16.0,0.0,2.0,0.0,12.0,0.0,0.0,8.0,0.0,0.0,0.0,3.0,1.0,0.0,6.0,0.0,0.0,3.0,2.0,0.0,0.0,0.0,4.0,15.0,1.0,10.0,0.0,4.0,2.0,4.0,0.0,2.0,0.0,0.0,0.0,0.0,0.0,2.0,7.0,7.0,4.0,0.0,3.0,8.0,13.0,4.0,6.0,3.0,12.0,6.0,4.0,6.0,4.0,6.0,16.0,10.0,4.0,9.0,8.0,3.0,2.0,3.0,3.0,4.0,2.0,0.0,0.0,3.0,13.0,7.0,0.0,1.0,0.0,4.0,12.0,1.0,0.0,12.0,2.0,3.0,7.0,0.0,9.0,1.0,2.0,4.0,6.0,9.0,2.0,7.0,5.0,6.0,12.0,10.0,12.0,1.0,0.0,10.0,4.0,3.0,5.0,7.0,1.0,11.0,0.0,6.0,17.0,2.0,11.0,6.0,6.0,2.0,3.0,10.0,6.0,11.0,15.0,5.0,6.0,12.0,5.0,6.0,5.0,12.0,4.0,13.0,1.0,14.0,9.0,11.0,13.0,5.0,7.0,7.0,7.0,3.0,8.0,8.0,6.0,1.0,14.0,1.0,5.0,10.0,3.0,7.0,13.0,8.0,10.0,14.0,8.0,3.0,4.0,11.0,12.0,8.0,13.0,0.0,4.0,11.0,6.0,8.0,7.0,9.0,20.0,18.0,1.0,7.0,1.0,18.0,3.0,14.0,7.0,4.0,0.0,18.0,9.0,1.0,39.0,0.0,16.0,0.0,13.0,6.0,12.0,14.0,26.0,19.0,0.0,0.0,7.0,25.0,1.0,11.0,1.0,1.0,0.0,0.0,0.0,0.0,1.0,0.0,12.0,27.0,0.0,0.0,1.0,3.0,13.0,25.0,18.0,0.0,18.0,13.0,5.0,7.0,2.0,12.0,6.0,0.0,3.0,0.0,1.0,5.0,4.0,,11.0,20.0,0.0,3.0,2.0,4.0,2.0,5.0,4.0,35.0,15.0,13.0,0.0,13.0,0.0,0.0,18.0,2.0,0.0,20.0,7.0,5.0,6.0,7.0,0.0,18.0,16.0,7.0,8.0,8.0,12.0,4.0,1.0,18.0,0.0,6.0,12.0,10.0,0.0,10.0,27.0,4.0,18.0,7.0,14.0,11.0,12.0,1.0,0.0,5.0,0.0,0.0,13.0,7.0,0.0,0.0,30.0,10.0,1.0,5.0,13.0,2.0,15.0,2.0,8.0,9.0,14.0,0.0,0.0,17.0,0.0,0.0,6.0,15.0,1.0,15.0,11.0,15.0,21.0,20.0,23.0,0.0,3.0,6.0,19.0,14.0,9.0,4.0,2.0,5.0,15.0,8.0,0.0,19.0,8.0,16.0,7.0,13.0,5.0,0.0,5.0,2.0,1.0,1.0,1.0,15.0,2.0,0.0,1.0,3.0,21.0,14.0,0.0,12.0,13.0,1.0,22.0,8.0,24.0,0.0,11.0,4.0,8.0,14.0,15.0,3.0,1.0,18.0,9.0,0.0,5.0,0.0,11.0,0.0,0.0,1.0,15.0,0.0,9.0,8.0,9.0,11.0,13.0,1.0,23.0,14.0,11.0,10.0,21.0,2.0,1.0,5.0,2.0,1.0,2.0,22.0,11.0,0.0,0.0,25.0,2.0,9.0,2.0,6.0,0.0,5.0,0.0,17.0,7.0,0.0,19.0,20.0,0.0,0.0,4.0,0.0,26.0,18.0,14.0,7.0,13.0,12.0,11.0,11.0,7.0,3.0,0.0,27.0,11.0,3.0,1.0,29.0,0.0,25.0,1.0,9.0,19.0,44.0,1.0,1.0,0.0,10.0,21.0,14.0,2.0,0.0,5.0,5.0,10.0,23.0,13.0,16.0,41.0,11.0,5.0,14.0,11.0,0.0,9.0,0.0,2.0,14.0,2.0,1.5,11.0,20.0,7.0,4.0,1.0,7.0,41.0,28.0,2.0,18.0,1.0,28.0,6.0,24.0,7.0,0.0,23.0,7.0,15.0,38.0,15.0,1.0,1.0,18.0,0.0,3.0,4.0,5.0,0.0,4.0,0.0,42.0,37.0,1.0,0.0,0.0,0.0,3.0,1.0,12.0,1.0,0.0,1.0,0.0,10.0,1.0,9.0,10.0,1.0,19.0,15.0,9.0,5.0,25.0,0.0,37.0,9.0,9.0,11.0,30.0,5.0,0.0,10.0,0.0,0.0,1.0,0.0,12.0,24.0,20.0,22.0,25.0,30.0,0.0,19.0,13.0,17.0,10.0,20.0,0.0,7.0,16.0,5.0,5.0,2.0,5.0,20.0,15.0,9.0,1.0,0.0,0.0,2.0,8.0,4.0,19.0,6.0,3.0,8.0,27.0,15.0,14.0,9.0,1.0,11.0,0.0,1.0,3.0,15.0,0.0,19.0,11.0,0.0,2.0,0.0,0.0,3.0,0.0,2.0,0.0,0.0,0.0,0.0,1.0,0.0,1.0,0.0,1.0,3.0,0.0,1.0,1.0,1.0,0.0,2.0,0.0,1.0,2.0,2.0,0.0,0.0,1.0,1.0,1.0,0.0,0.0,0.0,0.0,1.0,4.0,1.0,2.0,1.0,2.0,0.0,0.0,2.0,1.0,2.0,1.0,1.0,0.0,0.0,1.0,2.0,1.0,1.0,0.0,1.0,0.0,0.0,0.0,0.0,2.0,0.0,0.0,1.0,1.0,1.0,8.0,12.0,8.0,3.0,5.0,18.0,7.0,9.0,7.0,18.0,11.0,9.0,18.0,7.0,7.0,12.0,24.0,11.0,5.0,5.0,7.0,4.0,10.0,11.0,5.0,5.0,8.0,8.0,6.0,4.0,6.0,7.0,10.0,34.0,9.0,13.0,7.0,9.0,10.0,3.0,3.0,12.0,17.0,9.0,10.0,6.0,5.0,5.0,17.0,0.0,0.0,4.0,0.0,2.0,4.0,3.0,2.0,4.0,3.0,4.0,4.0,3.0,15.0,1.0,3.0,6.0,6.0,0.0,2.0,1.0,2.0,19.0,19.0,26.0,12.0,11.0,15.0,22.0,12.0,8.0,6.0,24.0,8.0,5.0,29.0,5.0,18.0,9.0,0.0,10.0,0.0,1.0,16.0,17.0,19.0,1.0,13.0,13.0,0.0,1.0,17.0,18.0,4.0,1.0,16.0,6.0,10.0,12.0,19.0,3.0,1.0,0.0,9.0,18.0,0.0,14.0,9.0,0.0,21.0,12.0,8.0,4.0,15.0,0.0,1.0,2.0,14.0,3.0,6.0,0.0,0.0,0.0,12.0,1.0,10.0,0.0,7.0,0.0,7.0,0.0,9.0,1.0,0.0,6.0,1.0,0.0,0.0,8.0,14.0,9.0,6.0,1.0,10.0,14.0,8.0,13.0,1.0,0.0,3.0,11.0,2.0,0.0,2.0,0.0,5.0,2.0,2.0,2.0,15.0,0.0,2.0,2.0,9.0,14.0,6.0,6.0,13.0,9.0,12.0,6.0,4.0,6.0,6.0,7.0,11.0,9.0,21.0,14.0,11.0,3.0,15.0,3.0,10.0,5.0,5.0,1.0,12.0,3.0,7.0,8.0,11.0,9.0,0.0,3.0,1.0,0.0,21.0,10.0,6.0,15.0,1.0,17.0,13.0,10.0,6.0,7.0,16.0,4.0,5.0,5.0,6.0,13.0,,5.0,12.0,4.0,7.0,4.0,13.0,0.0,4.0,9.0,0.0,5.0,3.0,2.0,11.0,9.0,6.0,7.0,7.0,10.0,5.0,9.0,9.0,10.0,5.0,5.0,9.0,7.0,8.0,13.0,14.0,9.0,6.0,7.0,6.0,6.0,10.0,11.0,6.0,5.0,5.0,4.0,6.0,14.0,13.0,15.0,11.0,7.0,8.0,4.0,10.0,7.0,11.0,8.0,0.0,2.0,0.0,0.0,21.0,8.0,3.0,9.0,3.0,2.0,15.0,19.0,4.0,7.0,4.0,5.0,3.0,3.0,2.0,6.0,21.0,10.0,11.0,6.0,13.0,6.0,15.0,5.0,7.0,7.0,4.0,4.0,9.0,3.0,8.0,0.0,6.0,12.0,5.0,2.0,12.0,2.0,6.0,7.0,13.0,8.0,5.0,8.0,12.0,7.0,5.0,3.0,11.0,2.0,2.0,0.0,15.0,7.0,3.0,4.0,0.0,4.0,7.0,8.0,2.0,2.0,7.0,7.0,14.0,10.0,6.0,10.0,11.0,8.0,1.0,3.0,10.0,5.0,5.0,10.0,4.0,11.0,8.0,13.0,5.0,0.0,12.0,11.0,7.0,12.0,12.0,9.0,4.0,7.0,4.0,3.0,4.0,0.0,8.0,4.0,4.0,6.0,4.0,11.0,9.0,4.0,8.0,14.0,1.0,11.0,4.0,1.0,6.0,6.0,5.0,5.0,14.0,3.0,11.0,8.0,7.0,7.0,5.0,4.0,10.0,9.0,5.0,13.0,9.0,15.0,7.0,3.0,19.0,10.0,4.0,9.0,16.0,4.0,8.0,9.0,11.0,9.0,3.0,0.0,22.0,18.0,11.0,5.0,15.0,10.0,6.0,9.0,8.0,3.0,16.0,8.0,7.0,6.0,18.0,15.0,4.0,2.0,10.0,6.0,1.0,10.0,4.0,1.0,7.0,12.0,8.0,8.0,13.0,3.0,7.0,9.0,11.0,6.0,5.0,8.0,15.0,13.0,7.0,6.0,3.0,14.0,1.0,6.0,10.0,13.0,5.0,4.0,19.0,7.0,2.0,13.0,17.0,3.0,8.0,13.0,11.0,0.0,17.0,5.0,4.0,11.0,0.0,2.0,9.0,6.0,9.0,9.0,11.0,7.0,12.0,5.0,6.0,14.0,9.0,7.0,7.0,3.0,12.0,6.0,8.0,13.0,5.0,10.0,9.0,5.0,14.0,12.0,3.0,7.0,12.0,11.0,11.0,7.0,6.0,6.0,8.0,7.0,7.0,6.0,1.0,7.0,2.0,7.0,19.0,14.0,9.0,2.0,12.0,2.0,7.0,5.0,3.0,3.0,11.0,10.0,5.0,14.0,19.0,7.0,14.0,7.0,8.0,6.0,6.0,4.0,4.0,14.0,13.0,6.0,11.0,11.0,5.0,7.0,8.0,9.0,5.0,5.0,7.0,0.0,11.0,7.0,5.0,7.0,17.0,12.0,1.0,8.0,10.0,5.0,5.0,9.0,10.0,5.0,5.0,8.0,3.0,3.0,6.0,5.0,0.0,6.0,4.0,5.0,4.0,13.0,0.0,8.0,8.0,2.0,7.0,7.0,6.0,2.0,11.0,13.0,3.0,1.0,5.0,3.0,10.0,9.0,7.0,6.0,4.0,8.0,6.0,1.0,11.0,7.0,2.0,1.0,12.0,7.0,1.0,5.0,12.0,15.0,16.0,14.0,2.0,7.0,9.0,1.0,7.0,0.0,0.0,0.0,0.0,0.0,0.0,0.0,0.0,1.0,0.0,3.0,4.0,0.0,4.0,3.0,2.0,4.0,8.0,5.0,10.0,3.0,2.0,7.0,4.0,16.0,9.0,5.0,4.0,3.0,3.0,2.0,5.0,2.0,4.0,5.0,2.0,3.0,5.0,2.0,3.0,4.0,8.0,2.0,2.0,2.0,2.0,2.0,0.0,1.0,2.0,2.0,3.0,2.0,2.0,3.0,2.0,2.0,2.0,2.0,2.0,3.0,3.0,2.0,3.0,5.0,4.0,1.0,4.0,2.0,2.0,2.0,3.0,4.0,3.0,0.0,0.0,4.0,3.0,4.0,4.0,4.0,4.0,4.0,3.0,2.0,2.0,0.0,3.0,0.0,2.0,4.0,4.0,2.0,3.0,3.0,2.0,4.0,2.0,3.0,0.0,4.0,3.0,3.0,2.0,0.0,5.0,3.0,2.0,1.0,2.0,2.0,1.0,2.0,3.0,2.0,2.0,2.0,3.0,2.0,2.0,3.0,2.0,3.0,3.0,2.0,3.0,5.0,5.0,3.0,1.0,3.0,5.0,2.0,1.0,1.0,3.0,4.0,2.0,5.0,4.0,2.0,1.0,9.0,4.0,7.0,4.0,3.0,3.0,4.0,6.0,4.0,5.0,5.0,7.0,11.0,6.0,6.0,5.0,4.0,4.0,7.0,5.0,6.0,4.0,2.0,0.0,14.0,0.0,0.0,8.0,7.0,0.0,0.0,1.0,6.0,0.0,0.0,0.0,6.0,5.0,8.0,4.0,3.0,0.0,5.0,3.0,1.0,4.0,0.0,0.0,0.0,0.0,0.0,3.0,9.0,4.0,12.0,8.0,0.0,0.0,12.0,5.0,5.0,5.0,5.0,5.0,3.0,5.0,5.0,5.0,4.0,8.0,5.0,4.0,8.0,8.0,2.0,3.0,3.0,10.0,4.0,8.0,6.0,8.0,6.0,7.0,7.0,8.0,6.0,4.0,9.0,6.0,8.0,9.0,12.0,5.0,7.0,6.0,6.0,2.0,5.0,2.0,5.0,6.0,8.0,7.0,7.0,11.0,3.0,7.0,10.0,9.0,8.0,4.0,6.0,5.0,8.0,3.0,5.0,5.0,10.0,4.0,6.0,13.0,11.0,7.0,3.0,6.0,13.0,8.0,8.0,12.0,4.0,6.0,2.0,8.0,10.0,6.0,8.0,17.0,3.0,13.0,10.0,8.0,6.0,10.0,13.0,10.0,4.0,15.0,7.0,14.0,8.0,1.0,5.0,8.0,11.0,8.0,5.0,6.0,0.0,1.0,9.0,5.0,13.0,7.0,16.0,10.0,9.0,4.0,8.0,15.0,9.0,7.0,11.0,6.0,8.0,2.0,7.0,12.0,5.0,6.0,9.0,7.0,4.0,10.0,13.0,8.0,6.0,15.0,0.0,11.0,3.0,2.0,6.0,10.0,3.0,3.0,5.0,4.0,6.0,15.0,10.0,7.0,8.0,5.0,5.0,0.0,9.0,4.0,7.0,9.0,10.0,6.0,4.0,3.0,3.0,4.0,3.0,8.0,13.0,9.0,9.0,0.0,8.0,7.0,8.0,8.0,5.0,6.0,3.0,8.0,7.0,6.0,8.0,5.0,3.0,5.0,5.0,2.0,3.0,7.0,8.0,7.0,4.0,6.0,6.0,6.0,6.0,2.0,5.0,6.0,4.0,7.0,4.0,4.0,7.0,5.0,6.0,6.0,6.0,5.0,3.0,7.0,6.0,11.0,8.0,8.0,4.0,3.0,7.0,5.0,5.0,6.0,22.0,31.0,51.0,7.0,4.0,26.0,6.0,46.0,25.0,15.0,2.0,16.0,16.0,2.0,7.0,33.0,19.0,17.0,12.0,48.0,22.0,21.0,5.0,20.0,36.0,32.0,18.0,10.0,4.0,26.0,16.0,20.0,15.0,7.0,5.0,20.0,6.0,20.0,19.0,24.0,1.0,17.0,16.0,22.0,16.0,12.0,9.0,3.0,6.0,25.0,22.0,24.0,20.0,5.0,2.0,0.0,3.0,17.0,27.0,7.0,13.0,2.0,13.0,19.0,18.0,21.0,19.0,8.0,7.0,17.0,17.0,29.0,1.0,10.0,3.0,17.0,23.0,31.0,13.0,25.0,6.0,7.0,6.0,17.0,0.0,13.0,15.0,29.0,28.0,10.0,4.0,4.0,20.0,1.0,11.0,11.0,14.0,15.0,23.0,10.0,12.0,6.0,23.0,1.0,5.0,5.0,1.0,4.0,3.0,1.0,14.0,8.0,5.0,4.0,0.0,2.0,17.0,2.0,2.0,1.0,2.0,2.0,22.0,22.0,16.0,0.0,0.0,1.0,12.0,14.0,20.0,21.0,24.0,30.0,4.0,21.0,9.0,14.0,22.0,9.0,3.0,33.0,8.0,15.0,10.0,10.0,14.0,22.0,6.0,28.0,30.0,18.0,20.0,27.0,5.0,19.0,14.0,26.0,27.0,3.0,25.0,11.0,4.0,21.0,31.0,12.0,8.0,1.0,31.0,7.0,12.0,1.0,0.0,18.0,18.0,27.0,17.0,3.0,19.0,14.0,8.0,2.0,2.0,22.0,0.0,8.0,1.0,4.0,0.0,0.0,0.0,2.0,6.0,0.0,0.0,5.0,5.0,14.0,25.0,12.0,19.0,11.0,12.0,10.0,4.0,22.0,9.0,2.0,9.0,14.0,13.0,8.0,22.0,14.0,27.0,24.0,16.0,23.0,27.0,8.0,24.0,4.0,18.0,30.0,24.0,12.0,15.0,17.0,21.0,35.0,0.0,45.0,26.0,22.0,43.0,38.0,37.0,25.0,1.0,4.0,31.0,9.0,16.0,0.0,6.0,18.0,9.0,15.0,1.0,34.0,18.0,24.0,19.0,26.0,5.0,19.0,16.0,10.0,17.0,18.0,21.0,26.0,20.0,6.0,59.0,16.0,2.0,1.0,19.0,12.0,4.0,25.0,7.0,21.0,7.0,11.0,14.0,10.0,15.0,19.0,9.0,12.0,30.0,15.0,10.0,7.0,7.0,29.0,16.0,25.0,12.0,0.0,12.0,27.0,1.0,7.0,10.0,16.0,13.0,12.0,15.0,8.0,3.0,21.0,10.0,19.0,23.0,10.0,59.0,23.0,10.0,31.0,24.0,26.0,22.0,22.0,39.0,12.0,43.0,22.0,25.0,23.0,31.0,29.0,24.0,30.0,20.0,26.0,18.0,2.0,25.0,14.0,44.0,12.0,3.0,5.0,2.0,12.0,18.0,23.0,26.0,48.0,50.0,12.0,1.0,15.0,7.0,3.0,20.0,4.0,9.0,13.0,5.0,45.0,2.0,26.0,1.0,27.0,2.0,0.0,4.0,2.0,21.0,1.0,0.0,1.0,2.0,33.0,15.0,4.0,3.0,2.0,,0.0,4.0,3.0,1.0,53.0,21.0,11.0,5.0,2.0,0.0,6.0,0.0,23.0,3.0,13.0,14.0,9.0,0.0,2.0,3.0,6.0,8.0,31.0,13.0,23.0,2.0,4.0,14.0,35.0,3.0,9.0,20.0,27.0,31.0,1.0,33.0,8.0,2.0,5.0,21.0,6.0,0.0,9.0,14.0,6.0,53.0,7.0,22.0,7.0,3.0,24.0,23.0,4.0,23.0,12.0,35.0,29.0,36.0,18.0,2.0,10.0,6.0,5.0,3.0,0.0,8.0,13.0,16.0,8.0,8.0,9.0,3.0,6.0,19.0,2.0,1.0,16.0,4.0,2.0,7.0,0.0,12.0,10.0,14.0,17.0,10.0,29.0,6.0,15.0,9.0,9.0,8.0,1.0,6.0,7.0,18.0,2.0,2.0,2.0,3.0,16.0,3.0,17.0,13.0,23.0,29.0,9.0,19.0,17.0,2.0,22.0,15.0,1.0,16.0,39.0,32.0,48.0,19.0,22.0,19.0,12.0,1.0,4.0,1.0,17.0,2.0,7.0,14.0,8.0,9.0,0.0,26.0,44.0,22.0,22.0,22.0,4.0,18.0,14.0,14.0,4.0,9.0,12.0,9.0,0.0,10.0,6.0,5.0,3.0,21.0,15.0,24.0,29.0,21.0,8.0,20.0,0.0,12.0,18.0,11.0,16.0,19.0,5.0,28.0,25.0,18.0,10.0,2.0,1.0,6.0,11.0,3.0,18.0,1.0,1.0,20.0,22.0,6.0,0.0,6.0,28.0,2.0,2.0,21.0,16.0,23.0,0.0,17.0,14.0,15.0,11.0,6.0,29.0,16.0,14.0,3.0,2.0,6.0,5.0,2.0,21.0,9.0,4.0,6.0,10.0,3.0,12.0,4.0,7.0,6.0,9.0,0.0,27.0,3.0,3.0,11.0,20.0,9.0,16.0,10.0,22.0,0.0,22.0,43.0,5.0,0.0,0.0,2.0,17.0,19.0,29.0,10.0,20.0,7.0,15.0,13.0,4.0,14.0,5.0,6.0,13.0,1.0,6.0,1.0,1.0,2.0,14.0,39.0,12.0,0.0,1.0,18.0,8.0,2.0,14.0,23.0,23.0,19.0,7.0,0.0,23.0,19.0,6.0,20.0,0.0,3.0,2.0,9.0,3.0,17.0,8.0,10.0,2.0,19.0,14.0,38.0,15.0,40.0,24.0,17.0,23.0,5.0,0.0,36.0,1.0,13.0,12.0,2.0,9.0,10.0,1.0,23.0,9.0,23.0,8.0,21.0,2.0,10.0,3.0,22.0,23.0,9.0,13.0,0.0,8.0,4.0,4.0,23.0,37.0,2.0,28.0,0.0,5.0,15.0,8.0,14.0,31.0,19.0,12.0,8.0,16.0,22.0,38.0,17.0,30.0,26.0,13.0,10.0,2.0,4.0,5.0,17.0,9.0,15.0,27.0,2.0,22.0,7.0,9.0,23.0,20.0,9.0,18.0,27.0,22.0,21.0,16.0,2.0,0.0,7.0,18.0,27.0,5.0,31.0,55.0,12.0,15.0,18.0,1.0,0.0,1.0,7.0,7.0,4.0,3.0,0.0,23.0,2.0,0.0,8.0,13.0,1.0,55.0,7.0,40.0,49.0,3.0,7.0,8.0,8.0,0.0,2.0,32.0,7.0,11.0,25.0,3.0,12.0,11.0,1.0,21.0,27.0,29.0,29.0,2.0,3.0,0.0,20.0,36.0,4.0,5.0,18.0,4.0,3.0,23.0,0.0,25.0,73.0,25.0,41.0,31.0,19.0,14.0,30.0,16.0,29.0,16.0,15.0,28.0,12.0,26.0,9.0,6.0,1.0,2.0,13.0,22.0,6.0,22.0,23.0,0.0,1.0,2.0,2.0,2.0,4.0,13.0,1.0,4.0,7.0,2.0,44.0,9.0,15.0,1.0,25.0,12.0,16.0,18.0,2.0,20.0,11.0,16.0,21.0,7.0,33.0,7.0,12.0,37.0,18.0,6.0,1.0,8.0,14.0,0.0,8.0,2.0,5.0,5.0,1.0,5.0,2.0,3.0,10.0,4.0,0.0,15.0,8.0,8.0,7.0,2.0,3.0,7.0,45.0,15.0,2.0,0.0,1.0,1.0,3.0,2.0,12.0,1.0,13.0,14.0,13.0,0.0,0.0,8.0,27.0,1.0,0.0,0.0,10.0,18.0,18.0,8.0,2.0,12.0,18.0,9.0,13.0,2.0,2.0,12.0,15.0,0.0,22.0,0.0,1.0,4.0,19.0,10.5,12.0,16.0,13.0,5.0,7.0,0.0,14.0,1.0,17.0,13.0,9.0,16.0,4.0,6.0,1.0,20.0,1.0,2.0,1.0,1.0,30.0,3.0,0.0,6.0,16.0,2.0,5.0,5.0,19.0,0.0,40.0,1.0,8.0,8.0,2.0,4.0,13.0,2.0,3.0,14.0,0.0,12.0,20.0,15.0,9.0,35.0,10.0,16.0,1.0,4.0,6.0,31.0,0.0,7.0,5.0,12.0,0.0,10.0,14.0,3.0,4.0,2.0,9.0,19.0,4.0,22.0,6.0,4.0,27.0,7.0,22.0,2.0,8.0,0.0,16.0,11.0,14.0,7.0,4.0,9.0,5.0,1.0,21.0,18.0,1.0,1.0,4.0,11.0,0.0,3.0,13.0,6.0,10.0,10.0,11.0,0.0,14.0,2.0,13.0,4.0,1.0,19.0,11.0,6.0,2.0,5.0,9.0,12.0,1.0,0.0,2.0,0.0,5.0,0.0,9.0,8.0,12.0,2.0,4.0,0.0,28.0,39.0,14.0,5.0,13.0,9.0,9.0,3.0,7.0,15.0,23.0,2.0,2.0,12.0,0.0,8.0,4.0,28.0,1.0,3.0,31.0,22.0,8.0,11.0,2.0,10.0,33.0,15.0,8.0,1.0,7.0,13.0,44.0,1.0,2.0,2.0,3.0,7.0,16.0,13.0,5.0,8.0,36.0,6.0,6.0,49.0,0.0,15.0,0.0,9.0,1.0,5.0,0.0,2.0,3.0,10.0,16.0,1.0,31.0,9.0,3.0,16.0,9.0,9.0,24.0,13.0,1.0,1.0,2.0,16.0,9.0,14.0,1.0,16.0,17.0,3.0,5.0,9.0,30.0,13.0,8.0,10.0,16.0,9.0,14.0,0.0,15.0,8.0,1.0,15.0,1.0,1.0,21.0,0.0,0.0,5.0,1.0,5.0,0.0,10.0,1.0,17.0,10.0,1.0,0.0,9.0,11.0,0.0,1.0,0.0,12.0,23.0,0.0,3.0,10.0,7.0,1.0,39.0,6.0,36.0,0.0,0.0,4.0,9.0,6.0,1.0,4.0,3.0,13.0,10.0,11.0,2.0,1.0,4.0,0.0,10.0,17.0,17.0,14.0,3.0,18.0,3.0,18.0,5.0,10.0,1.0,15.0,19.0,7.0,1.0,0.0,13.0,0.0,11.0,2.0,76.0,0.0,14.0,0.0,11.0,4.0,9.0,22.0,5.0,1.0,12.0,15.0,1.0,10.0,0.0,7.0,1.0,5.0,2.0,11.0,51.0,14.0,20.0,2.0,9.0,1.0,6.0,0.0,9.0,7.0,8.0,8.0,10.0,14.0,6.0,7.0,15.0,3.0,10.0,16.0,20.0,3.0,8.0,3.0,0.0,19.0,26.0,1.0,5.0,1.0,5.0,19.0,17.0,12.0,11.0,0.0,0.0,2.0,1.0,0.0,17.0,8.0,1.0,5.0,9.0,6.0,4.0,6.0,1.0,13.0,29.0,3.0,3.0,12.0,1.0,65.0,17.0,6.0,8.0,19.0,16.0,6.0,6.0,42.0,0.0,24.0,6.0,14.0,10.0,17.0,13.0,1.0,4.0,4.0,3.0,3.0,1.0,3.0,13.0,18.0,4.0,6.0,11.0,2.0,4.0,5.0,7.0,11.0,5.0,14.0,2.0,4.0,4.0,1.0,3.0,4.0,6.0,8.0,15.0,10.0,18.0,20.0,4.0,11.0,1.0,8.0,14.0,13.0,14.0,15.0,9.0,10.0,9.0,14.0,1.0,1.0,5.0,12.0,12.0,1.0,10.0,3.0,10.0,2.0,14.0,18.0,6.0,18.0,16.0,12.0,29.0,16.0,8.0,21.0,0.0,13.0,16.0,19.0,23.0,13.0,24.0,16.0,19.0,7.0,29.0,10.0,16.0,8.0,22.0,19.0,25.0,17.0,12.0,18.0,12.0,6.0,7.0,4.0,2.0,16.0,0.0,0.0,12.0,11.0,0.0,9.0,22.0,0.0,4.0,0.0,3.0,6.0,1.0,5.0,18.0,17.0,10.0,23.0,0.0,11.0,2.0,13.0,3.0,1.0,0.0,0.0,16.0,1.0,3.0,1.0,12.0,11.0,18.0,3.0,0.0,9.0,3.0,5.0,6.0,14.0,12.0,6.0,9.0,6.0,17.0,16.0,20.0,3.0,15.0,0.0,3.0,8.0,2.0,10.0,13.0,15.0,6.0,3.0,18.0,8.0,0.0,9.0,7.0,16.0,24.0,0.0,13.0,20.0,12.0,13.0,13.0,15.0,14.0,7.0,13.0,13.0,26.0,17.0,14.0,5.0,17.0,15.0,7.0,16.0,9.0,3.0,,,,,,,,,,,,,,,,,,,,,,,,,,,,,,,,,,,,,,,,,,,,,,,,,,,,,,,,,,,,,,,,,,,,,,,,,,,,,,,,,,,,,,,,,,,,,,,,,,,,,,,,,,,,,,,,,,,,,,,,,0.0,0.0,0.0,0.0,13.0,10.0,15.0,7.0,11.0,9.0,0.0,9.0,8.0,11.0,5.0,4.0,6.0,8.0,13.0,2.0,3.0,4.0,3.0,13.0,0.0,6.0,8.0,7.0,6.0,1.0,1.0,9.0,14.0,13.0,7.0,4.0,15.0,13.0,16.0,4.0,9.0,9.0,15.0,13.0,5.0,10.0,2.0,16.0,10.0,8.0,8.0,10.0,5.0,7.0,0.0,0.0,0.0,0.0,0.0,0.0,0.0,6.0,8.0,9.0,5.0,6.0,9.0,13.0,7.0,3.0,5.0,6.0,4.0,6.0,4.0,11.0,6.0,6.0,7.0,7.0,5.0,5.0,5.0,5.0,4.0,9.0,9.0,13.0,7.0,5.0,5.0,8.0,7.0,8.0,6.0,3.0,9.0,5.0,4.0,6.0,7.0,7.0,8.0,6.0,8.0,5.0,4.0,6.0,8.0,7.0,9.0,8.0,8.0,5.0,6.0,6.0,5.0,4.0,5.0,5.0,11.0,10.0,4.0,7.0,4.0,4.0,6.0,6.0,6.0,8.0,5.0,6.0,8.0,11.0,8.0,4.0,9.0,2.0,10.0,14.0,3.0,11.0,7.0,8.0,14.0,4.0,7.0,3.0,4.0,8.0,6.0,12.0,9.0,5.0,5.0,3.0,7.0,9.0,5.0,9.0,7.0,4.0,0.0,0.0,1.0,1.0,2.0,2.0,2.0,0.0,1.0,0.0,0.0,0.0,3.0,0.0,0.0,2.0,0.0,0.0,4.0,6.0,9.0,6.0,10.0,9.0,3.0,6.0,5.0,4.0,0.0,12.0,7.0,0.0,14.0,5.0,3.0,18.0,0.0,15.0,4.0,7.0,13.0,1.0,7.0,12.0,2.0,1.0,16.0,5.0,4.0,0.0,6.0,11.0,6.0,5.0,3.0,9.0,8.0,7.0,10.0,3.0,0.0,16.0,13.0,8.0,8.0,10.0,15.0,7.0,9.0,6.0,9.0,16.0,11.0,11.0,7.0,4.0,7.0,6.0,5.0,2.0,12.0,7.0,9.0,10.0,9.0,1.0,3.0,11.0,8.0,4.0,19.0,6.0,4.0,9.0,9.0,0.0,8.0,13.0,6.0,1.0,7.0,3.0,5.0,2.0,5.0,,,,,,,,,,,0.0,0.0,0.0,0.0,0.0,0.0,0.0,0.0,0.0,13.0,5.0,10.0,10.0,12.0,17.0,18.0,7.0,14.0,16.0,2.0,13.0,2.0,10.0,8.0,8.0,8.0,0.0,12.0,3.0,5.0,10.0,11.0,7.0,8.0,7.0,8.0,6.0,4.0,3.0,0.0,0.0,8.0,4.0,1.0,1.0,12.0,0.0,0.0,0.0,0.0,0.0,0.0,0.0,0.0,0.0,0.0,0.0,0.0,0.0,0.0,0.0,0.0,0.0,0.0,0.0,0.0,0.0,20.0,16.0,,,,,,,,,,,,,,,,,,,,,,,,,,,,8.0,12.0,7.0,0.0,10.0,9.0,11.0,10.0,6.0,8.0,13.0,11.0,15.0,11.0,7.0,9.0,7.0,6.0,9.0,4.0,7.0,8.0,8.0,2.0,4.0,6.0,4.0,6.0,7.0,4.0,6.0,6.0,9.0,8.0,3.0,4.0,9.0,8.0,9.0,4.0,7.0,5.0,5.0,5.0,4.0,5.0,7.0,12.0,2.0,6.0,4.0,4.0,9.0,4.0,9.0,3.0,6.0,0.0,7.0,4.0,6.0,8.0,8.0,5.0,6.0,9.0,6.0,6.0,10.0,4.0,6.0,3.0,7.0,9.0,5.0,4.0,7.0,4.0,13.0,9.0,6.0,6.0,3.0,3.0,6.0,13.0,11.0,1.0,6.0,7.0,9.0,0.0,13.0,12.0,4.0,6.0,8.0,4.0,6.0,5.0,20.0,2.0,4.0,2.0,8.0,11.0,10.0,9.0,15.0,7.0,2.0,5.0,9.0,11.0,7.0,5.0,9.0,7.0,4.0,9.0,6.0,7.0,2.0,4.0,11.0,2.0,10.0,6.0,9.0,1.0,7.0,13.0,11.0,11.0,4.0,5.0,4.0,3.0,6.0,6.0,10.0,10.0,2.0,6.0,2.0,3.0,3.0,6.0,7.0,9.0,18.0,1.0,,,,,,,,,,,,,,,,,,,,,,,7.0,8.0,4.0,2.0,8.0,1.0,1.0,0.0,8.0,11.0,6.0,7.0,21.0,0.0,6.0,6.0,6.0,1.0,4.0,4.0,11.0,11.0,15.0,10.0,10.0,4.0,13.0,13.0,2.0,9.0,4.0,19.0,15.0,4.0,3.0,3.0,11.0,5.0,6.0,1.0,6.0,11.0,4.0,12.0,4.0,0.0,16.0,18.0,3.0,23.0,11.0,3.0,12.0,18.0,13.0,21.0,28.0,7.0,15.0,19.0,4.0,4.0,9.0,10.0,5.0,10.0,15.0,14.0,13.0,1.0,5.0,10.0,10.0,13.0,8.0,10.0,8.0,4.0,8.0,12.0,8.0,13.0,36.0,0.0,0.0,29.0,21.0,0.0,15.0,1.0,3.0,3.0,2.0,1.0,3.0,11.0,3.0,12.0,7.0,2.0,3.0,0.0,1.0,2.0,5.0,11.0,3.0,4.0,6.0,4.0,4.0,10.0,14.0,21.0,15.0,12.0,13.0,16.0,8.0,1.0,8.0,22.0,34.0,7.0,18.0,2.0,10.0,8.0,17.0,7.0,7.0,18.0,6.0,8.0,4.0,17.0,14.0,6.0,11.0,14.0,15.0,14.0,7.0,17.0,1.0,20.0,0.0,0.0,0.0,27.0,10.0,0.0,9.0,5.0,8.0,1.0,4.0,8.0,10.0,8.0,2.0,4.0,4.0,0.0,12.0,1.0,5.0,7.0,7.0,16.0,8.0,6.0,5.0,9.0,15.0,13.0,18.0,5.0,9.0,15.0,6.0,3.0,16.0,22.0,4.0,15.0,0.0,16.0,0.0,2.0,1.0,0.0,1.0,4.0,5.0,1.0,5.0,3.0,5.0,2.0,0.0,9.0,13.0,4.0,1.0,5.0,2.0,9.0,3.0,3.0,4.0,4.0,9.0,4.0,0.0,11.0,6.0,13.0,7.0,6.0,3.0,4.0,15.0,8.0,6.0,4.0,4.0,19.0,10.0,0.0,1.0,23.0,2.0,1.0,1.0,1.0,2.0,0.0,9.0,4.0,0.0,1.0,13.0,15.0,8.0,2.0,3.0,9.0,3.0,3.0,4.0,7.0,5.0,4.0,5.0,9.0,1.0,1.0,1.0,21.0,3.0,1.0,0.0,2.0,11.0,13.0,13.0,5.0,0.0,18.0,5.0,2.0,14.0,14.0,7.0,4.0,13.0,2.0,0.0,4.0,8.0,6.0,4.0,1.0,3.0,8.0,5.0,6.0,4.0,12.0,10.0,10.0,4.0,4.0,8.0,4.0,7.0,8.0,4.0,7.0,18.0,12.0,3.0,2.0,10.0,2.0,2.0,4.0,0.0,0.0,2.0,0.0,12.0,4.0,2.0,17.0,18.0,23.0,1.0,7.0,17.0,14.0,13.0,14.0,19.0,4.0,2.0,3.0,15.0,8.0,0.0,11.0,3.0,4.0,17.0,2.0,7.0,13.0,9.0,15.0,11.0,7.0,5.0,14.0,18.0,11.0,5.0,14.0,11.0,10.0,13.0,14.0,9.0,5.0,18.0,10.0,10.0,14.0,19.0,7.0,0.0,5.0,5.0,11.0,3.0,4.0,7.0,22.0,6.0,5.0,6.0,3.0,0.0,8.0,3.0,26.0,5.0,19.0,22.0,1.0,3.0,1.0,0.0,2.0,0.0,5.0,0.0,0.0,3.0,0.0,6.0,2.0,8.0,4.0,16.0,14.0,10.0,13.0,10.0,13.0,11.0,0.0,3.0,4.0,1.0,13.0,2.0,13.0,3.0,1.0,3.0,10.0,8.0,1.0,5.0,0.0,0.0,14.0,9.0,1.0,0.0,3.0,2.0,1.0,4.0,5.0,14.0,22.0,3.0,9.0,2.0,6.0,5.0,9.0,7.0,2.0,5.0,12.0,7.0,3.0,3.0,13.0,5.0,17.0,3.0,0.0,1.0,7.0,7.0,1.0,15.0,4.0,9.0,1.0,9.0,1.0,8.0,8.0,7.0,5.0,1.0,5.0,4.0,0.0,9.0,2.0,13.0,14.0,14.0,4.0,11.0,0.0,2.0,0.0,25.0,19.0,16.0,10.0,24.0,15.0,7.0,4.0,20.0,5.0,13.0,18.0,6.0,3.0,3.0,6.0,17.0,10.0,2.0,6.0,13.0,6.0,2.0,13.0,10.0,2.0,13.0,17.0,18.0,19.0,11.0,12.0,6.0,2.0,11.0,9.0,2.0,4.0,5.0,0.0,3.0,3.0,2.0,3.0,1.0,1.0,4.0,5.0,7.0,0.0,1.0,15.0,2.0,9.0,5.0,3.0,5.0,1.0,7.0,5.0,27.0,4.0,4.0,12.0,10.0,6.0,1.0,0.0,10.0,8.0,2.0,2.0,33.0,3.0,4.0,16.0,2.0,8.0,4.0,22.0,3.0,3.0,11.0,0.0,1.0,8.0,1.0,6.0,7.0,2.0,18.0,15.0,0.0,4.0,14.0,0.0,7.0,3.0,0.0,4.0,10.0,13.0,6.0,3.0,9.0,17.0,10.0,2.0,7.0,18.0,15.0,12.0,10.0,21.0,8.0,1.0,16.0,20.0,5.0,8.0,7.0,14.0,8.0,1.0,11.0,13.0,16.0,10.0,15.0,1.0,5.0,6.0,7.0,1.0,0.0,3.0,0.0,4.0,3.0,0.0,0.0,0.0,0.0,0.0,2.0,1.0,0.0,4.25,10.0,1.0,7.0,0.0,0.0,2.0,2.0,1.0,1.0,3.0,1.0,1.0,1.0,2.0,4.0,6.0,2.0,0.0,2.0,0.0,0.0,2.0,0.0,0.0,3.0,0.0,1.0,4.0,1.0,0.0,3.0,4.0,5.0,50.0,50.0,30.0,30.0,40.0,10.0,7.0,11.0,7.0,11.0,15.0,5.0,14.0,22.0,33.0,11.0,8.0,18.0,15.0,11.0,5.0,18.0,9.0,11.0,9.0,12.0,28.0,11.0,3.0,4.0,10.0,14.0,14.0,15.0,5.0,7.0,5.0,4.0,20.0,15.0,6.0,17.0,17.0,11.0,14.0,7.0,10.0,21.0,14.0,16.0,6.0,8.0,16.0,18.0,15.0,9.0,10.0,16.0,17.0,15.0,15.0,18.0,15.0,14.0,18.0,0.0,5.0,21.0,17.0,19.0,14.0,18.0,14.0,22.0,16.0,6.0,5.0,12.0,14.0,15.0,14.0,12.0,14.0,10.0,26.0,30.0,10.0,11.0,1.0,21.0,15.0,15.0,4.0,28.0,6.0,11.0,4.0,16.0,10.0,11.0,10.0,11.0,13.0,8.0,11.0,3.0,7.0,0.0,4.0,4.0,5.0,13.0,4.0,5.0,2.0,6.0,13.0,6.0,10.0,4.0,20.0,5.0,14.0,20.0,20.0,24.0,5.0,5.0,5.0,5.0,3.0,8.0,7.0,16.0,6.0,2.0,3.0,3.0,3.0,3.0,3.0,5.0,4.0,9.0,5.0,6.0,5.0,7.0,4.0,5.0,5.0,6.0,8.0,3.0,15.0,15.0,0.0,5.0,5.0,4.0,3.0,3.0,3.0,21.0,5.0,6.0,3.0,4.0,25.0,20.0,18.0,10.0,15.0,10.0,26.0,5.0,21.0,29.0,31.0,32.0,31.0,30.0,25.0,17.0,28.0,32.0,31.0,31.0,31.0,28.0,14.0,19.0,14.0,5.0,10.0,33.0,20.0,9.0,3.0,4.0,10.0,6.0,14.0,16.0,8.0,28.0,3.0,8.0,14.0,12.0,13.0,25.0,23.0,12.0,11.0,29.0,11.0,3.0,3.0,2.0,4.0,4.0,4.0,5.0,6.0,7.0,3.0,11.0,6.0,14.0,9.0,7.0,4.0,5.0,18.0,13.0,8.0,13.0,12.0,15.0,3.0,16.0,4.0,6.0,5.0,7.0,18.0,12.0,7.0,6.0,10.0,4.0,3.0,4.0,14.0,4.0,15.0,20.0,19.0,15.0,25.0,12.0,7.0,8.0,6.0,4.0,4.0,5.0,20.0,11.0,10.0,3.0,8.0,4.0,7.0,4.0,11.0,4.0,11.0,6.0,4.0,3.0,10.0,10.0,16.0,4.0,4.0,4.0,4.0,8.0,5.0,5.0,4.0,4.0,4.0,14.0,9.0,4.0,13.0,7.0,9.0,12.0,12.0,7.0,5.0,12.0,30.0,16.0,4.0,7.0,5.0,9.0,5.0,6.0,5.0,5.0,14.0,12.0,6.0,13.0,11.0,5.0,10.0,15.0,5.0,5.0,13.0,24.0,13.0,5.0,7.0,11.0,15.0,27.0,5.0,3.0,13.0,14.0,15.0,14.0,3.0,5.0,4.0,4.0,7.0,4.0,4.0,3.0,6.0,10.0,12.0,9.0,12.0,12.0,15.0,30.0,12.0,9.0,11.0,13.0,9.0,7.0,4.0,14.0,8.0,5.0,14.0,9.0,0.0,7.0,8.0,23.0,12.0,21.0,7.0,19.0,4.0,3.0,3.0,3.0,3.0,3.0,8.0,2.0,3.0,3.0,3.0,14.0,8.0,6.0,10.0,6.0,6.0,6.0,7.0,4.0,5.0,1.0,7.0,10.0,14.0,8.0,4.0,5.0,5.0,19.0,11.0,3.0,10.0,13.0,6.0,12.0,16.0,4.0,18.0,22.0,9.0,4.0,10.0,12.0,16.0,6.0,8.0,7.0,5.0,14.0,20.0,15.0,17.0,7.0,12.0,9.0,10.0,17.0,4.0,6.0,19.0,19.0,11.0,6.0,15.0,9.0,15.0,7.0,9.0,7.0,5.0,6.0,14.0,9.0,10.0,8.0,6.0,12.0,4.0,17.0,15.0,3.0,10.0,7.0,18.0,10.0,6.0,6.0,4.0,4.0,6.0,9.0,17.0,9.0,13.0,5.0,17.0,15.0,19.0,19.0,6.0,3.0,3.0,3.0,4.0,4.0,9.0,3.0,10.0,1.0,0.0,1.0,0.0,2.0,0.0,10.0,3.0,0.0,2.0,0.0,3.0,1.0,0.0,0.0,6.0,3.0,1.0,0.0,0.0,6.0,0.0,0.0,1.0,5.0,0.0,5.0,14.0,1.0,0.0,0.0,0.0,3.0,4.0,1.0,1.0,1.0,1.0,1.0,0.0,2.0,1.0,0.0,0.0,0.0,0.0,1.0,2.0,15.0,2.0,1.0,1.0,0.0,0.0,1.0,0.0,0.0,1.0,4.0,2.0,1.0,1.0,0.0,2.0,1.0,8.0,0.0,3.0,1.0,3.0,2.0,8.0,2.0,3.0,7.0,2.0,1.0,0.0,1.0,1.0,6.0,1.0,1.0,0.0,0.0,1.0,0.0,0.0,1.0,2.0,4.0,1.0,22.0,4.0,0.0,3.0,3.0,0.0,0.0,0.0,1.0,2.0,24.0,3.0,0.0,0.0,19.0,0.0,0.0,0.0,1.0,1.0,0.0,1.0,1.0,0.0,0.0,0.0,8.0,4.0,0.0,0.0,0.0,1.0,0.0,0.0,1.0,1.0,0.0,10.0,3.0,0.0,7.0,0.0,4.0,2.0,1.0,9.0,1.0,3.0,1.0,0.0,3.0,1.0,16.0,4.0,7.0,0.0,2.0,7.0,10.0,0.0,1.0,9.0,2.0,3.0,1.0,0.0,2.0,1.0,1.0,0.0,7.0,3.0,2.0,0.0,0.0,0.0,0.0,6.0,0.0,1.0,0.0,2.0,0.0,0.0,0.0,6.0,3.0,3.0,0.0,8.0,3.0,0.0,8.0,14.0,2.0,0.0,4.0,0.0,1.0,0.0,5.0,3.0,1.0,0.0,2.0,11.0,6.0,15.0,2.0,9.0,4.0,4.0,9.0,12.0,3.0,1.0,3.0,6.0,2.0,7.0,2.0,0.0,12.0,2.0,8.0,15.0,0.0,4.0,0.0,3.0,0.0,8.0,13.0,2.0,3.0,1.0,0.0,0.0,0.0,12.0,8.0,0.0,0.0,2.0,2.0,0.0,4.0,2.0,3.0,0.0,1.0,0.0,3.0,7.0,1.0,1.0,2.0,2.0,5.0,1.0,2.0,2.0,0.0,6.0,5.0,1.0,0.0,2.0,2.0,2.0,5.0,7.0,5.0,2.0,7.0,15.0,7.0,9.0,4.0,1.0,7.0,5.0,0.0,1.0,1.0,6.0,11.0,7.0,1.0,4.0,16.0,7.0,10.0,12.0,0.0,2.0,1.0,3.0,2.0,3.0,0.0,0.0,0.0,4.0,0.0,0.0,1.0,15.0,1.0,15.0,13.0,2.0,8.0,4.0,16.0,0.0,14.0,2.0,3.0,16.0,2.0,0.0,3.0,7.0,13.0,6.0,5.0,10.0,5.0,0.0,1.0,3.0,1.0,4.0,9.0,4.0,0.0,2.0,0.0,1.0,0.0,13.0,1.0,11.0,2.0,3.0,1.0,3.0,0.0,0.0,4.0,4.0,3.0,6.0,11.0,7.0,5.0,4.0,13.0,0.0,0.0,1.0,5.0,4.0,13.0,6.0,0.0,0.0,0.0,13.0,6.0,2.0,0.0,5.0,10.0,0.0,3.0,6.0,1.0,0.0,0.0,0.0,7.0,8.0,4.0,0.0,7.0,4.0,0.0,0.0,4.0,4.0,19.0,1.0,0.0,1.0,3.0,9.0,2.0,1.0,0.0,0.0,0.0,3.0,1.0,0.0,9.0,5.0,7.0,3.0,3.0,7.0,10.0,9.0,7.0,11.0,10.0,11.0,10.0,6.0,10.0,0.0,0.0,0.0,0.0,0.0,0.0,0.0,0.0,0.0,0.0,0.0,3.0,0.0,13.0,2.0,14.0,3.0,7.0,1.0,1.0,12.0,13.0,2.0,8.0,7.0,1.0,8.0,3.0,4.0,14.0,0.0,6.0,7.0,0.0,6.0,5.0,0.0,12.0,1.0,10.0,3.0,2.0,3.0,4.0,3.0,5.0,0.0,19.0,0.0,0.0,8.0,13.0,6.0,3.0,6.0,17.0,1.0,2.0,17.0,3.0,14.0,5.0,2.0,3.0,12.0,0.0,7.0,16.0,3.0,17.0,1.0,0.0,1.0,0.0,19.0,2.0,1.0,2.0,16.0,1.0,6.0,7.0,17.0,11.0,2.0,0.0,12.0,1.0,16.0,7.0,5.0,3.0,4.0,3.0,3.0,0.0,8.0,0.0,3.0,6.0,7.0,0.0,0.0,23.0,15.0,23.0,1.0,8.0,19.0,0.0,1.0,2.0,6.0,6.0,1.0,2.0,8.0,1.0,0.0,0.0,2.0,14.0,7.0,1.0,12.0,0.0,3.0,0.0,16.0,0.0,0.0,4.0,7.0,2.0,1.0,2.0,1.0,0.0,0.0,3.0,3.0,5.0,0.0,3.0,4.0,0.0,10.0,9.0,0.0,15.0,5.0,22.0,2.0,4.0,6.0,4.0,0.0,3.0,7.0,3.0,0.0,0.0,6.0,14.0,6.0,10.0,8.0,1.0,7.0,6.0,10.0,0.0,1.0,1.0,6.0,7.0,6.0,3.0,3.0,0.0,11.0,0.0,14.0,0.0,1.0,22.0,5.0,3.0,2.0,5.0,22.0,19.0,0.0,9.0,7.0,4.0,2.0,13.0,4.0,7.0,0.0,0.0,0.0,15.0,0.0,13.0,0.0,0.0,23.0,0.0,3.0,13.0,15.0,5.0,18.0,20.0,9.0,5.0,4.0,9.0,1.0,0.0,3.0,0.0,1.0,1.0,2.0,2.0,11.0,0.0,14.0,11.0,3.0,2.0,3.0,17.0,7.0,2.0,0.0,6.0,15.0,14.0,3.0,4.0,2.0,12.0,6.0,12.0,0.0,9.0,0.0,2.0,1.0,0.0,12.0,0.0,2.0,7.0,14.0,22.0,16.0,0.0,15.0,1.0,8.0,3.0,5.0,5.0,7.0,8.0,6.0,11.0,1.0,3.0,0.0,4.0,3.0,1.0,0.0,12.0,3.0,1.0,4.0,3.0,0.0,2.0,0.0,0.0,6.0,9.0,0.0,3.0,3.0,10.0,15.0,0.0,2.0,4.0,2.0,1.0,0.0,0.0,0.0,3.0,0.0,1.0,7.0,1.0,0.0,3.0,7.0,1.0,14.0,5.0,1.0,1.0,14.0,16.0,17.0,1.0,0.0,3.0,6.0,5.0,0.0,1.0,1.0,0.0,4.0,0.0,3.0,3.0,24.0,0.0,2.0,3.0,14.0,8.0,0.0,2.0,2.0,13.0,8.0,8.0,0.0,2.0,2.0,5.0,0.0,5.0,19.0,4.0,2.0,3.0,5.0,7.0,1.0,1.0,0.0,8.0,4.0,11.0,3.0,1.0,14.0,2.0,2.0,2.0,23.0,4.0,19.0,19.0,6.0,5.0,0.0,2.0,15.0,4.0,16.0,2.0,1.0,11.0,2.0,5.0,8.0,6.0,6.0,13.0,4.0,5.0,8.0,6.0,5.0,6.0,5.0,3.0,12.0,8.0,6.0,6.0,6.0,5.0,9.0,8.0,0.0,11.0,6.0,5.0,7.0,6.0,5.0,8.0,4.0,4.0,14.0,9.0,6.0,8.0,6.0,8.0,15.0,10.0,10.0,4.0,5.0,6.0,5.0,4.0,5.0,5.0,5.0,1.0,5.0,0.0,5.0,0.0,5.0,4.0,5.0,2.0,4.0,5.0,1.0,5.0,0.0,3.0,3.0,5.0,5.0,5.0,5.0,5.0,5.0,0.0,5.0,2.0,0.0,3.0,1.0,2.0,5.0,5.0,5.0,5.0,3.0,0.0,5.0,2.0,5.0,5.0,5.0,3.0,1.0,5.0,5.0,3.0,5.0,0.0,4.0,1.0,0.0,0.0,0.0,1.0,0.0,1.0,4.0,0.0,5.0,0.0,0.0,1.0,5.0,0.0,0.0,1.0,0.0,3.0,0.0,0.0,1.0,1.0,0.0,5.0,1.0,4.0,1.0,0.0,5.0,0.0,1.0,3.0,1.0,0.0,0.0,2.0,0.0,0.0,,,,,,,,,,,,,,,,,,,,,,,,,,,,,,,,,,,,,,,,,,,,,,,,,,,,,,,,,,,,,,,,,,,,,,,,,,,,,,,,,,,,,,,,,,,,,,,,,,,,,8.0,12.0,10.0,11.0,4.0,12.0,9.0,11.0,13.0,7.0,9.0,14.0,11.0,4.0,0.0,10.0,15.0,9.0,11.0,5.0,3.0,11.0,9.0,10.0,5.0,6.0,10.0,12.0,11.0,14.0,22.0,11.0,14.0,1.0,5.0,5.0,5.0,5.0,5.0,5.0,5.0,4.0,5.0,5.0,4.0,0.0,0.0,0.0,2.0,2.0,0.0,0.0,1.0,2.0,0.0,0.0,0.0,6.0,1.0,9.0,6.0,11.0,6.0,8.0,1.0,0.0,3.0,5.0,11.0,7.0,5.0,2.0,1.0,8.0,0.0,0.0,8.0,0.0,1.0,5.0,7.0,7.0,14.0,18.0,9.0,0.0,9.0,5.0,3.0,2.0,3.0,1.0,3.0,13.0,16.0,2.0,1.0,12.0,0.0,10.0,10.0,9.0,4.0,11.0,9.0,3.0,2.0,6.0,4.0,10.0,3.0,1.0,3.0,0.0,2.0,0.0,5.0,15.0,8.0,5.0,8.0,5.0,1.0,7.0,7.0,14.0,7.0,4.0,5.0,1.0,1.0,4.0,0.0,18.0,10.0,2.0,3.0,13.0,2.0,16.0,8.0,7.0,12.0,2.0,1.0,13.0,3.0,14.0,10.0,2.0,8.0,8.0,6.0,0.0,1.0,4.0,5.0,2.0,5.0,4.0,7.0,1.0,0.0,0.0,3.0,1.0,0.0,6.0,5.0,5.0,1.0,1.0,1.0,2.0,0.0,6.0,8.0,0.0,0.0,5.0,5.0,4.0,4.0,5.0,0.0,0.0,4.0,5.0,4.0,5.0,3.0,5.0,4.0,4.0,5.0,4.0,3.0,5.0,2.0,1.0,5.0,4.0,,,,,,,,,11.0,5.0,7.0,3.0,8.0,13.0,14.0,7.0,7.0,8.0,1.0,1.0,0.0,0.0,0.0,0.0,3.0,1.0,4.0,2.0,0.0,2.0,3.0,4.0,1.0,4.0,4.0,2.0,5.0,7.0,3.0,2.0,0.0,1.0,0.0,0.0,0.0,2.0,0.0,1.0,2.0,2.0,3.0,1.0,1.0,2.0,6.0,1.0,4.0,0.0,1.0,4.0,5.0,0.0,0.0,1.0,4.0,1.0,1.0,7.0,0.0,6.0,5.0,6.0,1.0,2.0,8.0,4.0,0.0,1.0,0.0,6.0,1.0,2.0,3.0,5.0,6.0,2.0,10.0,9.0,3.0,0.0,1.0,5.0,0.0,2.0,0.0,0.0,4.0,1.0,2.0,1.0,5.0,5.0,0.0,0.0,7.0,4.0,5.0,10.0,6.0,2.0,3.0,6.0,5.0,3.0,11.0,3.0,3.0,7.0,7.0,5.0,11.0,7.0,5.0,5.0,6.0,5.0,4.0,5.0,11.0,8.0,7.0,3.0,5.0,6.0,0.0,6.0,7.0,11.0,6.0,2.0,13.0,12.0,7.0,2.0,10.0,4.0,9.0,6.0,5.0,5.0,7.0,4.0,9.0,1.0,1.0,8.0,9.0,4.0,2.0,6.0,5.0,7.0,5.0,9.0,3.0,8.0,5.0,1.0,0.0,0.0,3.0,2.0,1.0,3.0,7.0,0.0,8.0,3.0,2.0,0.0,1.0,4.0,3.0,5.0,0.0,5.0,2.0,7.0,1.0,4.0,1.0,0.0,9.0,1.0,0.0,5.0,1.0,2.0,5.0,2.0,2.0,3.0,2.0,1.0,4.0,5.0,4.0,2.0,7.0,0.0,5.0,4.0,3.0,0.0,13.0,8.0,5.0,3.0,2.0,1.0,2.0,4.0,4.0,3.0,1.0,0.0,0.0,3.0,1.0,4.0,3.0,0.0,3.0,0.0,12.0,5.0,8.0,5.0,9.0,1.0,1.0,0.0,1.0,2.0,1.0,3.0,0.0,1.0,1.0,0.0,2.0,1.0,5.0,1.0,2.0,3.0,4.0,1.0,3.0,3.0,2.0,4.0,3.0,2.0,3.0,6.0,2.0,6.0,8.0,6.0,5.0,10.0,5.0,3.0,5.0,3.0,7.0,5.0,7.0,4.0,5.0,5.0,6.0,5.0,6.0,4.0,3.0,3.0,5.0,2.0,5.0,4.0,4.0,2.0,5.0,3.0,4.0,7.0,1.0,3.0,0.0,6.0,2.0,3.0,3.0,3.0,5.0,5.0,4.0,2.0,2.0,5.0,6.0,3.0,3.0,4.0,0.0,7.0,5.0,3.0,2.0,10.0,4.0,8.0,3.0,6.0,6.0,6.0,3.0,4.0,4.0,1.0,4.0,6.0,4.0,6.0,7.0,4.0,4.0,4.0,8.0,5.0,5.0,3.0,10.0,3.0,11.0,5.0,2.0,1.0,7.0,2.0,4.0,4.0,5.0,3.0,4.0,10.0,7.0,7.0,4.0,7.0,11.0,6.0,5.0,6.0,2.0,0.0,7.0,13.0,8.0,0.0,7.0,1.0,3.0,5.0,3.0,5.0,7.0,8.0,3.0,3.0,6.0,6.0,10.0,4.0,6.0,4.0,3.0,0.0,3.0,8.0,5.0,8.0,6.0,3.0,14.0,9.0,0.0,6.0,6.0,6.0,4.0,6.0,9.0,7.0,2.0,5.0,4.0,8.0,5.0,5.0,8.0,6.0,7.0,2.0,10.0,4.0,5.0,8.0,6.0,1.0,5.0,2.0,6.0,14.0,10.0,10.0,4.0,8.0,9.0,4.0,1.0,11.0,1.0,11.0,10.0,14.0,14.0,11.0,7.0,0.0,4.0,9.0,6.0,2.0,4.0,13.0,8.0,6.0,16.0,0.0,10.0,10.0,11.0,4.0,12.0,16.0,4.0,1.0,17.0,17.0,22.0,4.0,16.0,3.0,7.0,24.0,20.0,5.0,4.0,16.0,15.0,6.0,20.0,4.0,5.0,12.0,4.0,8.0,17.0,6.0,19.0,12.0,15.0,8.0,3.0,7.0,8.0,3.0,4.0,6.0,6.0,5.0,6.0,4.0,2.0,4.0,3.0,21.0,5.0,2.0,4.0,4.0,17.0,13.0,4.0,16.0,12.0,15.0,2.0,19.0,3.0,10.0,0.0,8.0,5.0,9.0,9.0,7.0,2.0,2.0,10.0,4.0,17.0,13.0,8.0,9.0,10.0,26.0,20.0,12.0,13.0,14.0,3.0,11.0,9.0,16.0,13.0,17.0,9.0,13.0,12.0,2.0,3.0,33.0,10.0,8.0,9.0,20.0,5.0,5.0,7.0,16.0,0.0,6.0,22.0,9.0,4.0,11.0,0.0,1.0,9.0,6.0,4.0,4.0,6.0,4.0,2.0,4.0,11.0,9.0,6.0,8.0,2.0,8.0,2.0,7.0,2.0,1.0,8.0,4.0,10.0,6.0,9.0,0.0,4.0,5.0,10.0,2.0,10.0,0.0,3.0,16.0,2.0,1.0,4.0,9.0,0.0,1.0,0.0,2.0,1.0,3.0,6.0,1.0,4.0,5.0,1.0,6.0,0.0,0.0,0.0,0.0,1.0,1.0,0.0,0.0,0.0,5.0,9.0,8.0,3.0,7.0,0.0,4.0,0.0,0.0,0.0,10.0,1.0,3.0,5.0,1.0,1.0,0.0,0.0,0.0,5.0,2.0,0.0,0.0,1.0,2.0,0.0,5.0,3.0,3.0,2.0,1.0,0.0,6.0,2.0,7.0,1.0,2.0,6.0,0.0,15.0,0.0,0.0,2.0,4.0,0.0,1.0,1.0,2.0,2.0,0.0,1.0,0.0,0.0,0.0,0.0,3.0,1.0,2.0,1.0,3.0,3.0,0.0,0.0,0.0,0.0,0.0,8.0,0.0,0.0,0.0,0.0,1.0,0.0,0.0,1.0,5.0,5.0,5.0,5.0,5.0,5.0,1.0,0.0,2.0,0.0,0.0,1.0,0.0,1.0,1.0,1.0,1.0,0.0,1.0,0.0,1.0,1.0,1.0,0.0,5.0,3.0,14.0,8.0,8.0,8.0,35.0,10.0,20.0,7.0,12.0,9.0,12.0,14.0,7.0,7.0,8.0,5.0,0.0,36.0,0.0,10.0,14.0,10.0,10.0,7.0,9.0,11.0,2.0,6.0,4.0,7.0,3.0,2.0,2.0,5.0,8.0,3.0,2.0,12.0,8.0,8.0,15.0,2.0,11.0,5.0,1.0,4.0,3.0,5.0,5.0,5.0,5.0,5.0,5.0,2.0,4.0,5.0,5.0,5.0,5.0,5.0,1.0,3.0,5.0,5.0,5.0,5.0,4.0,5.0,2.0,4.0,5.0,5.0,5.0,5.0,5.0,0.0,2.0,1.0,5.0,5.0,3.0,0.0,5.0,3.0,3.0,2.0,5.0,4.0,3.0,5.0,0.0,5.0,5.0,1.0,5.0,5.0,5.0,1.0,5.0,5.0,5.0,5.0,5.0,5.0,5.0,5.0,1.0,5.0,0.0,0.0,0.0,3.0,5.0,5.0,0.0,3.0,0.0,5.0,3.0,1.0,5.0,5.0,3.0,1.0,2.0,4.0,5.0,5.0,1.0,5.0,2.0,0.0,5.0,2.0,2.0,5.0,2.0,5.0,4.0,5.0,3.0,5.0,5.0,4.0,5.0,4.0,3.0,0.0,5.0,0.0,5.0,5.0,2.0,5.0,5.0,0.0,5.0,5.0,1.0,5.0,2.0,10.0,18.0,8.0,7.0,18.0,10.0,5.0,4.0,11.0,6.0,16.0,17.0,17.0,16.0,11.0,2.0,4.0,5.0,5.0,1.0,5.0,5.0,5.0,2.0,1.0,5.0,5.0,5.0,2.0,5.0,5.0,3.0,5.0,5.0,2.0,5.0,5.0,5.0,5.0,5.0,5.0,5.0,5.0,2.0,5.0,5.0,1.0,0.0,4.0,3.0,5.0,5.0,5.0,5.0,5.0,1.0,5.0,5.0,5.0,5.0,5.0,5.0,5.0,5.0,1.0,2.0,5.0,4.0,3.0,5.0,5.0,4.0,4.0,5.0,5.0,0.0,5.0,3.0,0.0,5.0,5.0,1.0,4.0,0.0,5.0,5.0,1.0,5.0,5.0,5.0,5.0,5.0,5.0,5.0,5.0,5.0,0.0,5.0,5.0,0.0,5.0,1.0,5.0,5.0,2.0,5.0,5.0,5.0,3.0,5.0,1.0,5.0,0.0,5.0,5.0,5.0,5.0,0.0,5.0,5.0,3.0,5.0,5.0,5.0,5.0,2.0,9.0,4.0,3.0,7.0,5.0,6.0,6.0,6.0,3.0,8.0,8.0,7.0,0.0,2.0,9.0,2.0,3.0,15.0,5.0,14.0,15.0,5.0,9.0,12.0,5.0,12.0,6.0,12.0,3.0,0.0,5.0,5.0,7.0,10.0,5.0,5.0,1.0,5.0,6.0,7.0,6.0,8.0,6.0,7.0,13.0,6.0,6.0,9.0,8.0,7.0,9.0,5.0,0.0,12.0,11.0,0.0,1.0,0.0,0.0,10.0,12.0,10.0,7.0,4.0,2.0,0.0,2.0,11.0,1.0,7.0,1.0,3.0,5.0,5.0,10.0,16.0,2.0,3.0,1.0,7.0,7.0,13.0,9.0,4.0,2.0,0.0,5.0,3.0,3.0,1.0,7.0,6.0,3.0,2.0,4.0,7.0,4.0,7.0,5.0,10.0,12.0,9.0,8.0,2.0,7.0,10.0,4.0,10.0,8.0,5.0,11.0,3.0,12.0,3.0,5.0,9.0,0.0,10.0,10.0,2.0,5.0,12.0,6.0,6.0,7.0,1.0,13.0,11.0,8.0,6.0,5.0,15.0,4.0,9.0,13.0,10.0,2.0,5.0,9.0,7.0,9.0,8.0,6.0,7.0,13.0,5.0,9.0,9.0,10.0,7.0,11.0,4.0,3.0,6.0,14.0,9.0,3.0,8.0,2.0,3.0,2.0,3.0,9.0,7.0,5.0,8.0,3.0,3.0,7.0,0.0,3.0,5.0,12.0,4.0,11.0,11.0,1.0,13.0,11.0,7.0,9.0,7.0,4.0,4.0,7.0,6.0,4.0,6.0,6.0,6.0,12.0,5.0,9.0,9.0,12.0,7.0,10.0,4.0,6.0,8.0,8.0,4.0,4.0,7.0,4.0,0.0,0.0,0.0,0.0,0.0,,,,,,,,,,,,,,,,7.0,10.0,1.0,9.0,7.0,9.0,7.0,6.0,14.0,7.0,7.0,5.0,0.0,12.0,2.0,5.0,6.0,8.0,6.0,6.0,4.0,3.0,8.0,5.0,14.0,7.0,6.0,5.0,4.0,0.0,7.0,9.0,8.0,5.0,4.0,13.0,3.0,8.0,4.0,2.0,2.0,3.0,3.0,6.0,1.0,3.0,3.0,9.0,21.0,12.0,2.0,11.0,10.0,14.0,7.0,10.0,3.0,6.0,6.0,9.0,3.0,1.0,2.0,1.0,8.0,3.0,9.0,3.0,4.0,1.0,6.0,5.0,7.0,5.0,5.0,8.0,7.0,6.0,8.0,5.0,5.0,1.0,8.0,2.0,6.0,6.0,5.0,8.0,12.0,17.0,12.0,8.0,5.0,10.0,14.0,12.0,19.0,7.0,8.0,4.0,3.0,11.0,10.0,14.0,8.0,19.0,8.0,6.0,12.0,5.0,8.0,11.0,15.0,8.0,9.0,8.0,,7.0,5.0,8.0,0.0,1.0,4.0,7.0,7.0,6.0,14.0,4.0,16.0,3.0,6.0,3.0,6.0,9.0,5.0,12.0,3.0,0.0,3.0,6.0,8.0,4.0,2.0,1.0,1.0,0.0,0.0,0.0,0.0,0.0,1.0,6.0,0.0,3.0,0.0,8.0,1.0,8.0,10.0,7.0,15.0,19.0,15.0,14.0,9.0,13.0,14.0,14.0,16.0,12.0,7.0,8.0,8.0,0.0,3.0,1.0,9.0,9.0,7.0,5.0,12.0,5.0,16.0,17.0,11.0,6.0,1.0,8.0,4.0,16.0,18.0,7.0,7.0,4.0,18.0,12.0,7.0,11.0,7.0,21.0,9.0,7.0,12.0,0.0,7.0,7.0,8.0,17.0,9.0,10.0,10.0,12.0,13.0,1.0,4.0,5.0,7.0,6.0,2.0,5.0,8.0,7.0,8.0,10.0,4.0,3.0,2.0,4.0,9.0,0.0,5.0,5.0,12.0,0.0,6.0,3.0,0.0,12.0,0.0,3.0,8.0,14.0,6.0,6.0,7.0,1.0,7.0,10.0,3.0,1.0,2.0,1.0,5.0,0.0,2.0,0.0,3.0,6.0,1.0,1.0,2.0,4.0,5.0,1.0,6.0,8.0,7.0,10.0,10.0,9.0,13.0,22.0,6.0,8.0,17.0,10.0,10.0,21.0,13.0,10.0,10.0,10.0,9.0,9.0,6.0,12.0,11.0,11.0,0.0,0.0,11.0,14.0,13.0,13.0,12.0,12.0,7.0,12.0,15.0,17.0,17.0,7.0,26.0,0.0,11.0,10.0,9.0,10.0,0.0,15.0,12.0,24.0,0.0,10.0,14.0,12.0,7.0,5.0,15.0,7.0,12.0,14.0,12.0,10.0,7.0,15.0,14.0,20.0,17.0,18.0,16.0,9.0,6.0,11.0,10.0,10.0,6.0,20.0,12.0,8.0,14.0,14.0,13.0,10.0,18.0,11.0,9.0,8.0,17.0,13.0,18.0,18.0,18.0,15.0,24.0,16.0,22.0,11.0,9.0,13.0,19.0,15.0,18.0,17.0,10.0,15.0,21.0,13.0,13.0,10.0,9.0,11.0,16.0,15.0,15.0,24.0,11.0,9.0,13.0,11.0,11.0,12.0,11.0,9.0,12.0,8.0,17.0,16.0,9.0,13.0,13.0,5.0,13.0,15.0,14.0,5.0,11.0,14.0,7.0,21.0,8.0,11.0,17.0,15.0,14.0,5.0,15.0,9.0,11.0,13.0,13.0,16.0,13.0,13.0,8.0,12.0,6.0,6.0,14.0,6.0,6.0,0.0,1.0,7.0,1.0,9.0,10.0,10.0,9.0,6.0,7.0,3.0,14.0,10.0,5.0,5.0,6.0,1.0,15.0,8.0,13.0,5.0,10.0,0.0,10.0,8.0,8.0,20.0,5.0,11.0,2.0,21.0,12.0,6.0,8.0,5.0,14.0,12.0,7.0,13.0,3.0,13.0,6.0,5.0,5.0,3.0,15.0,9.0,7.0,2.0,2.0,4.0,3.0,3.0,1.0,0.0,0.0,9.0,0.0,0.0,0.0,1.0,0.0,0.0,0.0,0.0,18.0,4.0,8.0,9.0,5.0,12.0,24.0,10.0,12.0,3.0,7.0,4.0,25.0,7.0,1.0,5.0,10.0,2.0,16.0,22.0,14.0,3.0,12.0,13.0,9.0,3.0,18.0,12.0,4.0,7.0,8.0,7.0,1.0,10.0,8.0,3.0,12.0,11.0,23.0,0.0,5.0,1.0,3.0,1.0,3.0,10.0,2.0,2.0,5.0,6.0,6.0,7.0,10.0,13.0,9.0,17.0,9.0,6.0,7.0,12.0,11.0,12.0,8.0,7.0,14.0,10.0,9.0,1.0,5.0,11.0,13.0,11.0,7.0,8.0,12.0,8.0,7.0,13.0,14.0,13.0,10.0,7.0,0.0,4.0,6.0,9.0,14.0,12.0,10.0,9.0,9.0,11.0,10.0,7.0,11.0,1.0,3.0,10.0,3.0,13.0,10.0,8.0,6.0,12.0,11.0,3.0,9.0,2.0,9.0,9.0,7.0,8.0,7.0,6.0,11.0,12.0,8.0,26.0,2.0,13.0,15.0,5.0,11.0,6.0,6.0,8.0,11.0,16.0,16.0,9.0,9.0,4.0,14.0,8.0,3.0,11.0,8.0,12.0,14.0,5.0,18.0,9.0,13.0,12.0,9.0,5.0,5.0,4.0,10.0,23.0,15.0,1.0,5.0,5.0,7.0,11.0,10.0,10.0,7.0,7.0,4.0,6.0,7.0,5.0,8.0,16.0,9.0,8.0,4.0,15.0,5.0,7.0,7.0,18.0,6.0,2.0,2.0,7.0,7.0,6.0,8.0,2.0,8.0,7.0,5.0,3.0,13.0,4.0,8.0,6.0,3.0,5.0,14.0,4.0,3.0,12.0,6.0,7.0,0.0,4.5,9.0,6.0,1.0,0.0,3.0,5.0,1.0,0.0,3.0,5.0,4.0,5.0,0.0,3.0,3.0,14.0,0.0,9.0,4.0,5.0,6.0,0.0,0.0,0.0,0.0,1.0,0.0,2.0,2.0,0.0,1.0,4.0,3.0,2.0,0.0,0.0,4.0,3.0,0.0,2.0,1.0,0.0,0.0,0.0,4.0,0.0,3.0,0.0,0.0,4.0,0.0,4.0,2.0,4.0,5.0,2.0,7.0,6.0,2.0,5.0,5.0,0.0,0.0,4.0,4.0,4.0,0.0,4.0,5.0,1.0,4.0,0.0,0.0,0.0,0.0,0.0,0.0,0.0,0.0,0.0,0.0,0.0,0.0,0.0,0.0,0.0,2.0,0.0,0.0,6.0,0.0,5.0,2.0,4.0,4.0,2.0,5.0,0.0,2.0,0.0,4.0,2.0,3.0,1.0,3.0,2.0,1.0,0.0,0.0,0.0,0.0,0.0,0.0,0.0,2.0,0.0,0.0,2.0,0.0,2.0,12.0,8.0,13.0,16.0,20.0,7.0,8.0,13.0,3.0,18.0,0.0,9.0,1.0,1.0,22.0,4.0,2.0,1.0,4.0,4.0,9.0,12.0,12.0,23.0,5.0,7.0,10.0,1.0,1.0,11.0,14.0,13.0,13.0,11.0,5.0,19.0,15.0,13.0,13.0,19.0,5.0,54.0,7.0,7.0,19.0,1.0,1.0,8.0,0.0,4.0,7.0,5.0,8.0,11.0,14.0,17.0,5.0,4.0,7.0,13.0,19.0,0.0,15.0,19.0,18.0,17.0,17.0,8.0,16.0,0.0,4.0,10.0,12.0,15.0,4.0,9.0,2.0,7.0,3.0,4.0,12.0,15.0,4.0,6.0,3.0,0.0,6.0,5.0,1.0,10.0,6.0,5.0,9.0,18.0,4.0,4.0,14.0,5.0,11.0,1.0,18.0,16.0,4.0,15.0,4.0,1.0,3.0,2.0,3.0,8.0,5.0,9.0,6.0,9.0,22.0,15.0,14.0,5.0,10.0,0.0,2.0,11.0,6.0,13.0,11.0,9.0,0.0,13.0,2.0,5.0,1.0,11.0,8.0,1.0,2.0,0.0,17.0,2.0,7.0,13.0,7.0,11.0,9.0,13.0,8.0,13.0,11.0,3.0,1.0,9.0,6.0,11.0,6.0,27.0,10.0,5.0,0.0,3.0,5.0,2.0,12.0,1.0,4.0,2.0,3.0,9.0,3.0,9.0,5.0,11.0,7.0,6.0,2.0,8.0,4.0,8.0,3.0,6.0,12.0,15.0,10.0,9.0,12.0,10.0,12.0,9.0,6.0,1.0,4.0,1.0,0.0,0.0,0.0,0.0,0.0,0.0,0.0,0.0,0.0,0.0,0.0,0.0,0.0,0.0,0.0,0.0,0.0,0.0,0.0,0.0,0.0,0.0,0.0,0.0,0.0,0.0,0.0,0.0,0.0,0.0,0.0,0.0,0.0,0.0,0.0,0.0,0.0,0.0,0.0,0.0,0.0,0.0,0.0,0.0,0.0,0.0,0.0,0.0,0.0,0.0,0.0,0.0,0.0,0.0,0.0,0.0,0.0,0.0,0.0,0.0,0.0,3.0,0.0,0.0,0.0,4.0,0.0,1.0,0.0,0.0,0.0,4.0,0.0,0.0,0.0,0.0,0.0,0.0,0.0,0.0,0.0,0.0,0.0,0.0,0.0,0.0,0.0,0.0,0.0,0.0,0.0,0.0,0.0,0.0,0.0,0.0,0.0,0.0,0.0,0.0,0.0,0.0,0.0,0.0,0.0,0.0,0.0,0.0,1.0,5.0,0.0,0.0,2.0,0.0,0.0,,5.0,3.0,5.0,5.0,4.0,5.0,5.0,0.0,2.0,5.0,0.0,0.0,2.0,1.0,4.0,2.0,0.0,2.0,9.0,2.0,1.0,1.0,1.0,0.0,0.0,4.0,3.0,5.0,5.0,1.0,1.0,5.0,0.0,2.0,3.0,0.0,0.0,4.0,1.0,1.0,,5.0,4.0,3.0,4.0,4.0,2.0,4.0,0.0,0.0,0.0,0.0,0.0,3.0,2.0,1.0,,1.0,4.0,5.0,1.0,5.0,0.0,23.0,5.0,0.0,,3.0,5.0,5.0,4.0,3.0,,0.0,2.0,0.0,3.0,0.0,5.0,5.0,1.0,5.0,2.0,0.0,0.0,4.0,3.0,5.0,3.0,5.0,5.0,5.0,5.0,3.0,5.0,4.0,3.0,5.0,4.25,5.0,4.0,0.0,5.0,2.0,4.0,0.0,0.0,0.0,3.0,3.0,4.0,0.0,1.0,1.0,0.0,5.0,3.0,2.0,1.0,3.0,4.0,4.0,5.0,0.0,1.0,5.0,4.0,5.0,5.0,5.0,5.0,5.0,2.0,0.0,5.0,5.0,1.0,0.0,3.0,5.0,5.0,0.0,1.0,3.0,1.0,0.0,3.0,5.0,0.0,5.0,2.0,0.0,0.0,3.0,1.0,5.0,2.0,1.0,1.0,0.0,2.0,5.0,2.0,5.0,2.0,4.0,4.0,1.0,2.0,3.0,0.0,1.0,2.0,0.0,0.0,5.0,5.0,3.0,2.0,7.0,5.0,1.0,28.0,1.0,1.0,5.0,1.0,1.0,5.0,3.0,0.0,2.0,4.0,0.0,4.0,6.0,1.0,1.0,4.0,3.0,0.0,2.0,3.0,5.0,4.0,3.0,1.0,0.0,0.0,5.0,1.0,5.0,1.0,0.0,0.0,0.0,1.0,2.0,2.0,0.0,0.0,1.0,1.0,1.0,0.0,3.0,0.0,1.0,0.0,1.0,1.0,9.0,5.0,3.0,1.0,10.0,5.0,1.0,1.0,10.0,0.0,2.0,5.0,5.0,25.0,26.0,5.0,9.0,3.0,3.0,5.0,2.0,2.0,4.0,5.0,2.0,3.0,3.0,1.0,3.0,0.0,3.0,0.0,0.0,1.0,6.0,1.0,3.0,6.0,1.0,4.0,5.0,10.0,,9.0,14.0,6.0,5.0,1.0,0.0,,5.0,5.0,5.0,5.0,4.0,0.0,3.0,3.0,0.0,3.0,2.5,2.0,3.0,0.0,2.0,0.0,5.0,4.0,15.0,0.0,0.0,5.0,3.0,0.0,0.0,5.0,1.0,1.0,3.0,5.0,3.0,0.0,1.0,2.0,1.0,0.0,2.0,0.0,2.0,0.0,1.0,13.0,2.0,3.0,5.0,1.0,0.0,3.0,,1.0,5.0,5.0,3.0,5.0,2.0,0.0,5.0,4.0,5.0,5.0,5.0,2.0,4.0,5.0,0.0,5.0,5.0,0.0,6.0,1.0,4.0,4.0,0.0,5.0,1.0,5.0,5.0,7.0,,4.0,0.0,5.0,3.0,4.0,5.0,5.0,1.0,0.0,0.0,4.0,1.0,1.0,1.0,0.0,0.0,2.0,0.0,0.0,0.0,1.0,0.0,0.0,1.0,5.0,3.0,3.0,5.0,0.0,0.0,,5.0,17.0,1.0,3.0,2.0,5.0,4.0,5.0,3.0,0.0,2.0,3.0,3.0,0.0,2.0,5.0,1.0,3.0,5.0,10.0,10.0,5.0,5.0,6.0,5.0,1.0,0.0,12.0,8.0,1.0,35.0,5.0,5.0,2.0,3.0,3.0,1.0,1.0,5.0,5.0,11.0,3.0,0.0,1.0,1.0,5.0,0.0,2.0,1.0,2.0,5.0,5.0,3.0,5.0,5.0,5.0,5.0,5.0,3.0,0.0,0.0,4.0,0.0,5.0,4.0,4.0,7.0,2.0,5.0,5.0,0.0,4.0,5.0,0.0,1.0,0.0,5.0,3.0,3.0,2.0,4.0,5.0,0.0,5.0,5.0,0.0,0.0,0.0,0.0,5.0,5.0,5.0,5.0,3.0,5.0,5.0,2.0,1.0,5.0,5.0,5.0,1.0,0.0,5.0,5.0,5.0,3.0,5.0,5.0,5.0,5.0,1.0,5.0,0.0,3.0,5.0,1.0,5.0,5.0,5.0,5.0,5.0,5.0,4.0,1.0,5.0,4.0,3.0,1.0,5.0,4.0,5.0,1.0,1.0,4.0,5.0,3.0,4.0,2.0,3.0,4.0,4.0,1.0,2.0,5.0,1.0,5.0,0.0,5.0,3.0,0.0,0.0,1.0,9.0,5.0,5.0,5.0,0.0,5.0,5.0,5.0,5.0,5.0,5.0,5.0,5.0,5.0,3.0,5.0,4.0,5.0,5.0,0.0,0.0,5.0,0.0,1.0,0.0,3.0,4.0,1.0,5.0,5.0,1.0,5.0,5.0,5.0,4.0,0.0,4.0,1.0,0.0,1.0,3.0,4.0,3.0,0.0,2.0,3.0,1.0,0.0,0.0,4.0,3.0,0.0,5.0,5.0,3.0,5.0,6.0,3.0,14.0,1.0,0.0,3.0,5.0,0.0,2.0,2.0,0.0,4.0,2.0,5.0,2.0,3.0,5.0,1.0,1.0,5.0,4.0,5.0,4.0,2.0,1.0,1.0,1.0,2.0,0.0,5.0,1.0,5.0,5.0,0.0,5.0,1.0,0.0,5.0,5.0,5.0,4.0,4.0,3.0,3.0,5.0,2.0,3.0,2.0,2.0,2.0,5.0,5.0,4.0,2.0,2.0,2.0,2.0,0.0,0.0,5.0,3.0,2.0,1.0,2.0,5.0,5.0,5.0,3.0,5.0,4.0,0.0,1.0,4.0,5.0,,,2.0,,5.0,0.0,0.0,7.0,5.0,5.0,5.0,0.0,0.0,0.0,4.0,3.0,1.0,5.0,4.0,5.0,5.0,5.0,4.0,,3.0,4.0,5.0,,,,,,,,1.0,3.0,10.0,4.0,3.0,1.0,3.0,,3.0,1.0,0.0,4.0,0.0,1.0,0.0,1.0,4.0,0.0,0.0,0.0,5.0,5.0,3.0,4.0,5.0,3.0,5.0,3.0,5.0,5.0,5.0,0.0,0.0,5.0,5.0,2.0,0.0,4.0,5.0,5.0,5.0,5.0,1.0,4.0,4.0,5.0,0.0,1.0,0.0,5.0,0.0,0.0,,,5.0,2.0,0.0,5.0,4.0,2.0,1.0,5.0,3.0,4.0,4.0,0.0,2.0,0.0,2.0,2.0,4.0,3.0,5.0,5.0,4.0,0.0,5.0,5.0,1.0,5.0,1.0,0.0,3.0,0.0,0.0,0.0,1.0,1.0,5.0,5.0,5.0,0.0,3.0,0.0,5.0,0.0,4.0,1.0,0.0,2.0,4.0,4.0,0.0,1.0,5.0,0.0,1.0,,5.0,0.0,5.0,3.0,3.0,2.0,0.0,7.0,5.0,5.0,0.0,1.0,1.0,0.0,0.0,0.0,,5.0,3.0,5.0,2.0,1.0,0.0,3.0,4.0,5.0,5.0,3.0,0.0,2.0,5.0,0.0,4.0,2.0,2.0,3.0,1.0,4.0,3.0,2.0,2.0,5.0,3.0,5.0,3.0,4.0,3.0,4.0,5.0,0.0,2.0,4.0,5.0,0.0,9.0,5.0,0.0,3.0,0.0,0.0,1.0,0.0,0.0,4.0,0.0,2.0,0.0,5.0,0.0,1.0,0.0,0.0,0.0,0.0,0.0,0.0,0.0,0.0,4.0,2.0,,5.0,5.0,0.0,6.0,0.0,5.0,5.0,2.0,1.0,1.0,1.0,5.0,7.0,5.0,5.0,5.0,1.0,4.0,0.0,2.0,1.0,0.0,5.0,,2.0,1.0,3.0,2.0,2.0,3.0,3.0,2.0,5.0,5.0,2.0,1.0,2.0,1.0,5.0,,3.0,0.0,5.0,4.0,4.0,0.0,5.0,4.0,1.0,4.0,0.0,0.0,1.0,4.0,4.0,3.0,,4.0,2.0,5.0,2.0,2.0,,5.0,0.0,5.0,2.0,5.0,0.0,0.0,5.0,5.0,9.0,2.0,0.0,0.0,6.0,5.0,5.0,,0.0,1.0,3.0,5.0,1.0,,5.0,2.0,0.0,5.0,3.0,,,,,4.0,5.0,2.0,0.0,5.0,3.0,5.0,0.0,5.0,1.0,5.0,5.0,0.0,0.0,3.0,6.0,3.3333333333333335,2.0,0.0,2.0,2.0,0.0,3.0,1.0,4.0,1.0,4.0,2.0,0.0,1.0,1.0,2.0,0.0,4.0,4.0,5.0,5.0,1.0,2.0,0.0,2.0,0.0,5.0,0.0,5.0,0.0,1.0,2.0,2.0,7.0,0.0,4.0,3.0,4.0,3.0,5.0,4.0,2.0,0.0,1.0,0.0,0.0,4.0,2.0,1.0,1.0,1.0,3.0,2.0,3.0,3.0,5.0,2.0,5.0,4.0,2.0,3.0,3.0,3.0,1.0,3.0,2.0,3.0,2.0,0.0,1.0,2.0,5.0,0.0,0.0,5.0,0.0,0.0,5.0,4.0,2.0,9.0,10.0,0.0,0.0,0.0,0.0,2.0,5.0,1.0,3.0,0.0,5.0,5.0,5.0,0.0,4.0,1.0,3.0,5.0,,3.0,5.0,0.0,2.0,5.0,5.0,1.0,3.0,4.0,2.0,4.0,3.0,7.0,8.0,1.0,5.0,2.0,5.0,3.0,3.0,2.0,3.0,3.0,1.0,2.0,0.0,3.0,1.0,1.0,5.0,2.0,0.0,3.0,2.0,3.0,2.0,5.0,3.0,3.0,5.0,0.0,0.0,0.0,5.0,,,,,4.0,5.0,1.0,5.0,4.0,2.0,5.0,1.0,13.0,4.0,1.0,4.0,5.0,5.0,8.0,4.0,5.0,1.0,6.0,3.0,5.0,0.0,1.0,5.0,5.0,6.0,5.0,7.0,3.0,5.0,2.0,2.0,2.0,4.0,5.0,2.0,5.0,0.0,1.0,4.0,2.0,5.0,1.0,4.0,4.0,5.0,4.0,1.0,4.0,5.0,1.0,5.0,5.0,12.0,2.0,0.0,7.0,13.0,0.0,4.0,4.0,0.0,1.0,2.0,2.0,5.0,0.0,2.0,3.0,5.0,5.0,5.0,5.0,0.0,1.0,4.0,5.0,4.0,5.0,3.0,2.0,5.0,5.0,3.0,5.0,5.0,5.0,4.0,5.0,4.0,4.0,5.0,3.0,3.0,2.0,2.0,0.0,0.0,2.0,3.0,1.0,0.0,5.0,4.0,1.0,5.0,2.0,4.0,3.0,5.0,2.0,2.0,3.0,3.0,3.0,5.0,4.0,5.0,5.0,4.0,3.5,9.0,8.0,3.0,3.0,0.0,5.0,0.0,3.0,3.0,4.0,4.0,5.0,5.0,2.0,1.0,5.0,0.0,4.0,5.0,2.0,1.0,1.0,0.0,9.0,4.0,5.0,5.0,5.0,5.0,5.0,5.0,5.0,4.0,3.0,4.0,5.0,5.0,1.0,3.0,2.0,5.0,5.0,5.0,0.0,1.0,0.0,,0.0,2.0,5.0,0.0,0.0,2.0,2.0,3.0,5.0,3.0,2.0,0.0,3.0,5.0,5.0,2.0,2.0,3.0,5.0,4.0,5.0,5.0,5.0,3.0,4.0,3.0,5.0,0.0,,3.0,3.0,0.0,5.0,1.0,5.0,1.0,2.0,1.0,4.0,3.0,5.0,5.0,5.0,2.0,2.0,0.0,5.0,1.0,5.0,5.0,5.0,5.0,5.0,5.0,0.0,1.0,5.0,2.0,3.0,1.0,5.0,5.0,1.0,3.0,0.0,4.0,2.0,3.0,0.0,0.0,0.0,0.0,0.0,0.0,0.0,0.0,4.0,1.0,5.0,0.0,0.0,3.0,2.0,5.0,3.0,5.0,5.0,0.0,1.0,5.0,4.0,1.0,10.0,7.0,4.0,2.0,5.0,1.0,10.0,9.0,0.0,2.0,0.0,5.0,2.0,5.0,1.0,0.0,0.0,0.0,0.0,2.0,5.0,3.0,2.0,2.0,2.0,5.0,5.0,0.0,5.0,4.0,5.0,0.0,2.0,1.0,1.0,4.0,1.0,2.0,5.0,1.0,0.0,5.0,5.0,1.0,5.0,4.0,4.0,5.0,22.0,5.0,0.0,3.0,5.0,5.0,5.0,2.0,1.0,2.0,2.0,5.0,2.0,3.0,3.0,6.0,1.0,0.0,3.0,5.0,5.0,3.0,2.0,3.0,1.0,1.0,0.0,0.0,0.0,1.0,1.0,4.0,4.0,5.0,1.0,4.0,3.0,3.0,5.0,4.0,3.0,5.0,5.0,5.0,5.0,2.0,2.0,5.0,5.0,5.0,5.0,5.0,2.0,3.0,2.0,7.0,1.0,0.0,4.0,2.0,5.0,5.0,4.0,3.0,5.0,3.0,2.0,2.0,2.0,5.0,0.0,1.0,0.0,1.0,1.0,2.0,0.0,0.0,0.0,0.0,2.0,0.0,0.0,0.0,0.0,2.0,0.0,0.0,3.0,5.0,0.0,2.0,5.0,2.0,5.0,5.0,4.0,5.0,2.0,5.0,5.0,3.0,5.0,5.0,2.0,4.0,3.0,2.0,5.0,2.0,5.0,5.0,3.0,5.0,3.0,4.0,5.0,5.0,3.0,3.0,5.0,4.0,3.0,0.0,0.0,0.0,0.0,0.0,0.0,0.0,0.0,0.0,0.0,0.0,0.0,0.0,0.0,1.0,0.0,0.0,0.0,5.0,5.0,5.0,5.0,5.0,5.0,4.0,3.0,5.0,5.0,3.0,5.0,5.0,3.0,3.0,5.0,6.0,1.0,0.0,3.0,0.0,5.0,4.0,0.0,0.0,0.0,0.0,0.0,0.0,0.0,0.0,0.0,0.0,0.0,0.0,0.0,8.0,0.0,0.0,0.0,0.0,0.0,0.0,0.0,5.0,9.0,6.0,0.0,0.0,0.0,0.0,0.0,0.0,2.0,1.0,2.5714285714285716,0.0,0.0,3.0,0.0,1.5,7.0,3.0,6.0,6.0,0.0,1.0,1.0,1.0,8.0,6.0,5.0,6.0,0.0,0.0,0.0,0.0,0.0,4.0,0.0,2.0,0.0,3.0,0.0,0.0,5.0,0.0,7.0,5.0,1.0,7.0,0.0,1.5,0.0,0.0,0.0,0.0,7.0,0.0,6.0,4.0,4.0,0.0,3.0,0.0,0.0,2.0,3.0,3.0,4.0,0.0,1.0,3.0,2.5,2.0,0.0,9.0,1.6666666666666667,0.0,0.0,5.0,0.0,1.0,0.0,3.0,10.0,0.0,5.0,4.0,7.0,0.0,0.0,0.0,5.0,0.0,5.0,5.0,7.0,0.0,6.0,7.0,0.0,4.0,0.0,1.0,0.0,0.0,5.0,2.0,0.0,0.0,12.0,0.0,1.0,5.0,0.0,0.0,5.0,0.0,0.0,2.0,2.0,0.0,6.0,0.0,0.0,1.0,1.0,0.0,0.0,2.5,1.0,0.0,1.0,2.0,0.0,6.0,0.0,4.0,0.0,2.0,0.0,0.0,0.0,1.0,0.0,5.0,0.0,2.0,0.0,0.0,2.0,2.0,5.0,5.0,7.0,5.0,0.0,3.0,6.0,6.0,3.0,0.0,4.0,0.0,0.0,2.0,1.0,0.0,0.0,6.0,3.0,7.0,1.0,5.0,0.0,3.0,3.0,6.0,0.0,0.0,0.0,6.0,5.0,0.0,2.0,0.0,0.0,1.0,6.0,6.0,1.0,0.0,2.0,9.0,5.0,0.0,0.0,2.0,0.0,0.0,1.5,5.0,0.0,0.0,2.0,3.0,0.0,0.0,3.0,8.0,0.0,0.0,5.0,2.0,4.0,0.0,5.0,1.5,7.0,0.0,6.0,2.0,2.0,4.0,2.0,10.0,0.0,4.0,0.0,8.0,4.0,0.0,2.0,0.0,0.0,3.0,2.0,4.0,1.0,0.0,4.0,6.0,0.0,0.0,2.0,0.0,0.0,0.0,0.0,6.0,4.0,0.0,0.0,2.0,3.0,1.5,0.0,0.0,0.0,3.0,1.0,1.0,2.0,4.0,4.0,4.0,5.0,0.0,4.0,3.0,4.0,5.0,2.0,5.0,1.0,5.0,5.0,5.0,0.0,4.0,5.0,5.0,2.0,5.0,11.0,9.0,18.0,4.0,3.0,2.0,8.0,7.0,5.0,3.0,3.0,5.0,4.0,4.0,11.0,3.0,5.0,8.0,9.0,7.0,12.0,9.0,15.0,4.0,4.0,10.0,2.0,4.0,6.0,0.0,8.0,2.0,4.0,11.0,8.0,1.0,17.0,5.0,13.0,3.0,9.0,2.0,16.0,8.0,3.0,16.0,3.0,4.0,17.0,9.0,5.0,12.0,10.0,11.0,10.0,5.0,3.0,9.0,2.0,4.0,4.0,3.0,6.0,5.0,3.0,3.0,2.0,5.0,8.0,5.0,5.0,6.0,16.0,3.0,2.0,2.0,4.0,9.0,10.0,8.0,11.0,18.0,10.0,5.0,16.0,8.0,6.0,4.0,3.0,3.0,1.0,3.0,4.0,2.0,11.0,9.0,13.0,8.0,2.0,10.0,14.0,6.0,10.0,8.0,4.0,2.0,12.0,11.0,5.0,5.0,8.0,4.0,3.0,4.0,6.0,7.0,12.0,7.0,13.0,17.0,7.0,10.0,10.0,6.0,12.0,3.0,8.0,4.0,3.0,9.0,2.0,7.0,3.0,6.0,5.0,3.0,6.0,10.0,0.0,3.0,0.0,0.0,3.0,0.0,4.0,0.0,0.0,1.0,3.0,1.0,5.0,4.0,3.0,2.0,10.0,10.0,12.0,11.0,0.0,0.0,0.0,0.0,0.0,0.0,0.0,0.0,0.0,0.0,0.0,0.0,0.0,0.0,0.0,0.0,0.0,0.0,4.0,9.0,3.0,2.0,1.0,5.0,5.0,5.0,5.0,5.0,5.0,0.0,0.0,3.0,2.0,1.0,2.0,5.0,0.0,5.0,5.0,5.0,4.0,5.0,5.0,5.0,1.0,4.0,1.0,5.0,5.0,5.0,14.0,17.0,15.0,3.0,0.0,10.0,7.0,19.0,8.0,17.0,10.0,11.0,10.0,8.0,4.0,7.0,8.0,5.0,2.0,8.0,15.0,2.0,5.0,5.0,9.0,8.0,4.0,8.0,9.0,12.0,5.0,5.0,5.0,5.0,5.0,5.0,5.0,5.0,5.0,5.0,5.0,5.0,5.0,5.0,5.0,5.0,5.0,0.0,5.0,5.0,5.0,5.0,5.0,5.0,4.0,,,5.0,8.0,5.0,0.0,3.0,2.0,2.0,11.0,2.0,3.0,2.0,4.0,4.0,2.0,1.0,4.0,1.0,1.0,0.0,1.0,2.0,6.0,5.0,5.0,0.0,1.0,2.0,3.0,0.0,2.0,1.0,1.0,4.0,5.0,3.0,3.0,4.0,2.0,4.0,0.0,0.0,2.0,4.0,7.0,2.0,3.0,5.0,5.0,0.0,5.0,2.0,4.0,1.0,8.0,7.0,3.0,1.0,2.0,1.0,2.0,1.0,1.0,1.0,4.0,1.0,1.0,2.0,1.0,1.0,0.0,0.0,3.0,0.0,0.0,1.0,2.0,0.0,1.0,3.0,2.0,0.0,5.0,4.0,4.0,6.0,1.0,3.0,3.0,2.0,0.0,2.0,3.0,2.0,5.0,4.0,3.0,4.0,2.0,3.0,2.0,1.0,0.0,4.0,1.0,2.0,2.0,0.0,1.0,0.0,4.0,3.0,1.0,1.0,2.0,3.0,7.0,6.0,4.0,0.0,3.0,7.0,3.0,3.0,4.0,1.0,4.0,3.0,0.0,0.0,1.0,0.0,0.0,0.0,0.0,0.0,0.0,0.0,0.0,0.0,0.0,0.0,0.0,0.0,0.0,0.0,0.0,0.0,0.0,0.0,0.0,0.0,0.0,0.0,0.0,0.0,0.0,0.0,0.0,0.0,0.0,1.0,0.0,0.0,0.0,0.0,0.0,0.0,0.0,1.0,5.0,1.0,0.0,0.0,0.0,0.0,0.0,5.0,5.0,5.0,5.0,5.0,2.0,5.0,4.0,5.0,1.0,5.0,5.0,5.0,2.0,4.0,3.0,5.0,5.0,5.0,4.0,5.0,5.0,5.0,5.0,5.0,5.0,8.0,6.0,10.0,7.0,9.0,5.0,10.0,5.0,9.5,3.0,7.0,9.0,6.0,6.0,8.0,6.0,7.0,4.0,8.0,6.0,12.0,7.0,5.0,7.0,7.0,6.0,7.0,3.0,9.0,11.0,8.0,7.0,8.0,7.0,13.0,3.0,3.0,8.0,9.0,1.0,8.0,3.0,7.0,9.0,7.0,10.0,7.0,6.0,5.0,4.0,1.0,11.0,10.0,4.0,10.0,10.0,2.0,5.0,6.0,10.0,9.0,7.0,4.0,4.0,7.0,4.0,7.0,7.0,7.0,12.0,7.0,6.0,7.0,6.0,7.0,9.0,5.0,12.0,6.0,6.0,11.0,6.0,7.0,7.0,11.0,8.0,2.0,14.0,7.0,9.0,10.0,7.0,8.0,7.0,5.0,8.0,7.0,8.0,7.0,8.0,5.0,8.0,10.0,8.0,6.0,8.0,6.0,10.0,9.0,10.0,10.0,6.0,7.0,8.0,8.0,9.0,11.0,8.0,8.0,8.0,7.0,4.0,5.0,6.0,2.0,2.0,12.0,4.0,4.0,1.0,6.0,6.0,2.0,4.0,4.0,1.0,0.0,2.0,6.0,8.0,2.0,3.0,3.0,4.0,3.0,4.0,4.0,7.0,0.0,4.0,0.0,3.0,6.0,4.0,2.0,3.0,7.0,9.0,8.0,7.0,10.0,15.0,7.0,7.0,10.0,4.0,8.0,6.0,7.0,9.0,5.0,14.0,17.0,5.0,6.0,10.0,8.0,15.0,13.0,13.0,11.0,6.0,16.0,10.0,6.0,5.0,12.0,4.0,17.0,5.0,12.0,7.0,5.0,11.0,14.0,6.0,12.0,13.0,8.0,10.0,13.0,12.0,7.0,5.0,4.0,9.0,6.0,10.0,13.0,12.0,8.0,7.0,7.0,5.0,9.0,8.0,6.0,13.0,10.0,6.0,0.0,0.0,0.0,0.0,0.0,0.0,0.0,0.0,0.0,0.0,0.0,2.0,2.0,6.0,4.0,0.0,0.0,8.0,10.0,11.0,1.0,0.0,3.0,2.0,1.0,1.0,0.0,0.0,0.0,2.0,3.0,1.0,3.0,2.0,2.0,1.0,4.0,3.0,0.0,5.0,0.0,0.0,0.0,1.0,3.0,1.0,0.0,0.0,3.0,9.0,0.0,22.0,41.0,7.0,5.0,49.0,5.0,9.0,7.0,15.0,3.0,9.0,5.0,25.0,1.0,29.0,19.0,0.0,2.0,6.0,22.0,18.0,5.0,0.0,28.0,13.0,11.0,19.0,1.0,1.0,18.0,0.0,0.0,0.0,21.0,2.0,43.0,3.0,21.0,5.0,5.0,27.0,23.0,16.0,2.0,25.0,21.0,23.0,5.0,1.0,9.0,31.0,0.0,13.0,8.0,9.0,30.0,1.0,27.0,31.0,1.0,5.0,7.0,2.0,7.0,0.0,6.0,6.0,6.0,7.0,7.0,0.0,20.0,17.0,0.0,17.0,21.0,10.0,11.0,0.0,19.0,46.0,16.0,12.0,2.0,1.0,32.0,0.0,0.0,1.0,7.0,20.0,2.0,1.0,31.0,12.0,1.0,6.0,2.0,33.0,14.0,34.0,12.0,1.0,31.0,22.0,8.0,9.0,6.0,3.0,26.0,16.0,0.0,3.0,5.0,14.0,22.0,2.0,0.0,8.0,23.0,6.0,7.0,12.0,20.0,3.0,4.0,17.0,53.0,3.0,14.0,0.0,0.0,19.0,7.0,24.0,19.0,30.0,3.0,4.0,7.0,1.0,2.0,4.0,10.0,0.0,4.0,9.0,16.0,11.0,1.0,13.0,0.0,0.0,0.0,0.0,22.0,19.0,11.0,39.0,17.0,6.0,0.0,0.0,1.0,9.0,25.0,2.0,17.0,8.0,4.0,31.0,15.0,7.0,12.0,9.0,4.0,7.0,17.0,3.0,7.0,11.0,23.0,15.0,12.0,3.0,7.0,1.0,10.0,36.0,12.0,11.0,0.0,14.0,15.0,3.0,4.0,5.0,4.0,14.0,1.0,5.0,3.0,6.0,2.0,0.0,6.0,0.0,9.0,13.0,24.0,2.0,21.0,19.0,3.0,2.0,1.0,5.0,19.0,1.0,0.0,10.0,4.0,17.0,13.0,1.0,16.0,4.0,15.0,5.0,12.0,16.0,22.0,12.0,3.0,0.0,28.0,1.0,0.0,1.0,9.0,6.0,20.0,11.0,11.0,15.0,0.0,3.0,7.0,24.0,0.0,0.0,11.0,18.0,19.0,4.0,0.0,0.0,12.0,4.0,5.0,0.0,0.0,0.0,7.0,1.0,4.0,17.0,18.0,5.0,0.0,23.0,11.0,1.0,12.0,15.0,9.0,17.0,6.0,23.0,7.0,2.0,5.0,0.0,28.0,35.0,3.0,13.0,15.0,17.0,5.0,7.0,6.0,10.0,26.0,11.0,1.0,7.0,16.0,8.0,5.0,6.0,1.0,5.0,11.0,17.0,14.0,15.0,2.0,3.0,18.0,15.0,16.0,1.0,3.0,1.0,9.0,4.0,24.0,1.0,1.0,7.0,17.0,18.0,18.0,8.0,12.0,24.0,18.0,5.0,4.0,1.0,6.0,25.0,7.0,9.0,8.0,8.0,22.0,0.0,30.0,9.0,3.0,8.0,6.0,19.0,0.0,5.0,1.0,16.0,0.0,3.0,8.0,10.0,6.0,15.0,1.0,24.0,17.0,2.0,0.0,10.0,15.0,24.0,37.0,2.0,13.0,0.0,18.0,5.0,24.0,2.0,16.0,9.0,21.0,39.0,2.0,4.0,0.0,8.0,16.0,1.0,5.0,5.0,6.0,3.0,22.0,4.0,1.0,7.0,7.0,1.0,24.0,23.0,3.0,17.0,16.0,1.0,23.0,20.0,0.0,7.0,0.0,9.0,10.0,16.0,19.0,35.0,11.0,5.0,6.0,13.0,5.0,0.0,0.0,12.0,0.0,5.0,7.0,11.0,3.0,24.0,0.0,0.0,0.0,0.0,1.0,14.0,12.0,4.0,2.0,5.0,0.0,9.0,0.0,32.0,1.0,1.0,1.0,4.0,1.0,14.0,17.0,19.0,2.0,4.0,14.0,1.0,1.0,6.0,11.0,0.0,0.0,14.0,20.0,8.0,9.0,1.0,9.0,14.0,19.0,1.0,0.0,0.0,0.0,0.0,1.0,17.0,2.0,13.0,15.0,5.0,2.0,0.0,35.0,8.0,0.0,0.0,1.0,28.0,1.0,19.0,4.0,0.0,5.0,3.0,1.0,1.0,16.0,8.0,7.0,9.0,16.0,16.0,22.0,8.0,16.0,0.0,13.0,22.0,9.0,1.0,31.0,20.0,1.0,0.0,0.0,2.0,4.0,2.0,11.0,7.0,9.0,4.0,0.0,1.0,0.0,11.0,2.0,0.0,2.0,4.0,2.0,21.0,0.0,22.0,26.0,1.0,0.0,1.0,0.0,1.0,2.0,21.0,1.0,16.0,9.0,10.0,0.0,28.0,0.0,11.0,9.0,2.0,1.0,13.0,0.0,15.0,0.0,14.0,0.0,0.0,22.0,0.0,28.0,26.0,4.0,24.0,0.0,1.0,3.0,12.0,21.0,18.0,5.0,18.0,0.0,7.0,15.0,16.0,14.0,7.0,9.0,6.0,0.0,3.0,17.0,5.0,11.0,2.0,0.0,18.0,1.0,1.0,15.0,3.0,1.0,7.0,25.0,2.0,1.0,6.0,1.0,17.0,19.0,8.0,15.0,2.0,0.0,24.0,0.0,1.0,0.0,16.0,7.0,1.0,7.0,5.0,10.0,5.0,3.0,0.0,13.0,22.0,7.0,4.0,1.0,8.0,0.0,32.0,0.0,24.0,2.0,7.0,11.0,2.0,0.0,,20.0,2.0,0.0,1.0,0.0,0.0,1.0,2.0,22.0,0.0,16.0,25.0,19.0,0.0,2.0,0.0,0.0,10.0,2.0,9.0,0.0,6.0,6.0,3.0,8.0,7.0,3.0,4.0,7.0,19.0,0.0,8.0,0.0,22.0,8.0,0.0,6.0,17.0,1.0,2.0,27.0,11.0,7.0,3.0,3.0,26.0,1.0,0.0,5.0,0.0,0.0,2.0,10.0,1.0,0.0,0.0,1.0,2.0,5.0,3.0,39.0,19.0,11.0,0.0,0.0,1.0,17.0,9.0,7.0,0.0,1.0,9.0,7.0,2.0,0.0,23.0,21.0,14.0,6.0,17.0,0.0,15.0,1.0,8.0,19.0,15.0,6.0,18.0,10.0,7.0,0.0,10.0,6.0,0.0,9.0,0.0,13.0,23.0,0.0,10.0,0.0,1.0,30.0,0.0,4.0,24.0,0.0,5.0,0.0,20.0,3.0,29.0,0.0,1.0,9.0,0.0,7.0,31.0,7.0,22.0,22.0,4.0,22.0,9.0,0.0,20.0,29.0,0.0,12.0,26.0,16.0,36.0,15.0,6.0,17.0,22.0,4.0,20.0,5.0,19.0,6.0,0.0,1.0,21.0,3.0,12.0,2.0,4.0,1.0,2.0,2.0,14.0,2.0,5.0,4.0,5.0,3.0,5.0,5.0,5.0,2.0,3.0,5.0,5.0,3.0,5.0,5.0,5.0,5.0,5.0,4.0,5.0,5.0,5.0,4.0,3.0,1.0,5.0,3.0,5.0,3.0,5.0,2.0,4.0,2.0,1.0,2.0,3.0,1.0,4.0,0.0,5.0,2.0,0.0,2.0,2.0,1.0,0.0,0.0,0.0,0.0,0.0,0.0,0.0,0.0,0.0,4.0,2.0,2.0,0.0,3.0,0.0,5.0,3.0,0.0,0.0,3.0,7.0,17.0,11.0,21.0,7.0,1.0,18.0,17.0,2.0,9.0,7.0,1.0,9.0,1.0,0.0,0.0,1.0,6.0,5.0,7.0,16.0,4.0,1.0,18.0,8.0,12.0,13.0,12.0,2.0,1.0,5.0,4.0,9.0,9.0,4.0,5.0,3.0,2.0,28.0,2.0,0.0,3.0,7.0,0.0,0.0,1.0,1.0,3.0,0.0,2.0,20.0,17.0,1.0,9.0,10.0,9.0,5.0,9.0,11.0,18.0,11.0,20.0,6.0,0.0,3.0,16.0,3.0,7.0,23.0,9.0,6.0,11.0,2.0,14.0,15.0,9.0,0.0,5.0,15.0,13.0,9.0,3.0,19.0,19.0,3.0,25.0,4.0,5.0,3.0,0.0,6.0,0.0,3.0,2.0,6.0,11.0,13.0,29.0,13.0,39.0,19.0,20.0,5.0,17.0,4.0,14.0,12.0,15.0,19.0,10.0,1.0,10.0,24.0,12.0,5.0,14.0,19.0,6.0,15.0,13.0,19.0,20.0,20.0,15.0,22.0,9.0,13.0,10.0,18.0,20.0,18.0,14.0,7.0,13.0,15.0,19.0,10.0,15.0,3.0,15.0,8.0,12.0,19.0,11.0,17.0,3.0,0.0,4.0,2.0,1.0,5.0,25.0,10.0,13.0,16.0,8.0,8.0,15.0,2.0,12.0,4.0,2.0,16.0,12.0,8.0,3.0,20.0,5.0,5.0,9.0,9.0,6.0,18.0,1.0,2.0,13.0,3.0,12.0,2.0,13.0,15.0,16.0,14.0,14.0,19.0,16.0,7.0,7.0,4.0,3.0,2.0,16.0,15.0,17.0,12.0,19.0,16.0,10.0,13.0,6.0,11.0,13.0,5.0,8.0,12.0,13.0,2.0,8.0,0.0,11.0,11.0,4.0,8.0,14.0,0.0,14.0,14.0,4.0,4.0,7.0,2.0,7.0,5.0,0.0,6.0,14.0,15.0,15.0,8.0,6.0,0.0,1.0,4.0,1.0,12.0,13.0,18.0,9.0,14.0,13.0,9.0,29.0,15.0,10.0,12.0,7.0,1.0,8.0,6.0,6.0,1.0,8.0,13.0,24.0,16.0,0.0,0.0,0.0,0.0,0.0,0.0,0.0,0.0,0.0,0.0,0.0,0.0,0.0,0.0,0.0,0.0,0.0,0.0,0.0,0.0,0.0,0.0,0.0,0.0,0.0,0.0,0.0,0.0,0.0,0.0,0.0,0.0,0.0,0.0,0.0,0.0,0.0,0.0,0.0,0.0,0.0,0.0,0.0,0.0,0.0,0.0,0.0,0.0,0.0,0.0,0.0,0.0,0.0,0.0,0.0,0.0,0.0,5.0,1.0,5.0,1.0,1.0,2.0,1.0,1.0,5.0,1.0,2.0,5.0,5.0,2.0,0.0,1.0,5.0,1.0,1.0,3.0,1.0,3.0,3.0,2.0,3.0,1.0,5.0,3.0,5.0,0.0,4.0,5.0,5.0,5.0,5.0,2.0,5.0,5.0,5.0,5.0,4.0,5.0,5.0,5.0,5.0,5.0,0.0,1.0,5.0,5.0,5.0,5.0,5.0,5.0,1.0,5.0,4.0,4.0,5.0,4.0,5.0,5.0,4.0,5.0,5.0,5.0,5.0,5.0,3.0,4.0,4.0,3.0,5.0,5.0,5.0,5.0,3.0,4.0,7.0,6.0,3.0,7.0,1.0,1.0,6.0,4.0,2.0,5.0,3.0,1.0,1.0,5.0,6.0,1.0,3.0,5.0,2.0,5.0,5.0,5.0,5.0,5.0,5.0,5.0,1.0,5.0,4.0,5.0,5.0,5.0,5.0,5.0,5.0,5.0,5.0,2.0,2.0,5.0,4.0,5.0,4.0,5.0,5.0,5.0,5.0,5.0,5.0,5.0,2.0,4.0,5.0,5.0,5.0,5.0,5.0,5.0,5.0,5.0,5.0,5.0,5.0,4.0,5.0,5.0,3.0,1.0,13.0,7.0,9.0,1.0,,1.0,3.0,2.0,1.0,3.0,5.0,5.0,4.0,3.0,2.0,7.0,1.0,11.0,5.0,4.0,14.0,16.0,4.0,6.0,10.0,1.0,2.0,4.0,1.0,2.0,5.0,1.0,7.0,8.0,2.0,6.0,2.0,1.0,4.0,5.0,12.0,4.0,5.0,1.0,2.0,4.0,4.0,8.0,4.0,6.0,2.0,1.0,4.0,3.0,1.0,0.0,1.0,2.0,19.0,1.0,5.0,2.0,2.0,3.0,1.0,2.0,2.0,1.0,2.0,3.0,8.0,2.0,0.0,2.0,0.0,0.0,2.0,4.0,4.0,6.0,1.0,3.0,2.0,6.0,5.0,1.0,8.0,2.0,3.0,2.0,4.0,1.0,6.0,0.0,9.0,5.0,5.0,2.0,0.0,1.0,2.0,0.0,1.0,6.0,0.0,1.0,5.0,7.0,2.0,0.0,0.0,2.0,12.0,7.0,0.0,6.0,7.0,5.0,0.0,2.0,4.0,6.0,3.0,2.0,1.0,2.0,2.0,0.0,7.0,6.0,7.0,6.0,6.0,1.0,3.0,4.0,2.0,2.0,7.0,4.0,2.0,3.0,5.0,10.0,0.0,0.0,0.0,1.0,0.0,8.0,11.0,22.0,17.0,7.0,16.0,7.0,6.0,17.0,5.0,6.0,6.0,5.0,4.0,2.0,6.0,8.0,0.0,2.0,5.0,7.0,9.0,3.0,8.0,8.0,4.0,1.0,1.0,5.0,1.0,0.0,1.0,3.0,7.0,13.0,3.0,5.0,16.0,9.0,11.0,16.0,42.0,11.0,0.0,14.0,25.0,18.0,21.0,4.0,7.0,20.0,14.0,9.0,17.0,16.0,5.0,23.0,11.0,26.0,21.0,10.0,25.0,19.0,16.0,2.0,13.0,4.0,15.0,12.0,67.0,17.0,12.0,15.0,5.0,5.0,,,,,,,,,,,,,,,,,,,,,,,,,,,,,,,,,,,,,,,,,,,,,,,,,,,,,,,,,,,,,,,,,,,,,,,,,,,,,,,,,,,,,,,,,,,,,,,,,,,,,,,,,,,,,,,,,,7.0,5.0,9.0,6.0,8.0,4.0,2.0,6.0,6.0,4.0,4.0,3.0,1.0,11.0,15.0,5.0,5.0,5.0,5.0,5.0,5.0,5.0,3.0,2.0,13.0,12.0,10.0,5.0,17.0,5.0,6.0,16.0,11.0,12.0,3.0,0.0,3.0,3.0,2.0,3.0,0.0,0.0,0.0,4.0,3.0,2.0,2.0,2.0,2.0,3.0,2.0,0.0,7.0,2.0,3.0,5.0,2.0,16.0,2.0,46.0,6.0,2.0,2.0,2.0,2.0,5.0,4.0,0.0,0.0,0.0,0.0,1.0,2.0,2.0,1.0,2.0,1.0,0.0,1.0,0.0,0.0,1.0,0.0,0.0,0.0,1.0,1.0,1.0,0.0,1.0,1.0,1.0,0.0,0.0,1.0,1.0,1.0,1.0,2.0,1.0,0.0,0.0,1.0,0.0,2.0,2.0,0.0,1.0,5.0,1.0,1.0,1.0,1.0,1.0,2.0,1.0,0.0,0.0,1.0,0.0,1.0,2.0,1.0,1.0,1.0,0.0,3.0,1.0,0.0,0.0,1.0,1.0,1.0,1.0,0.0,1.0,0.0,0.0,1.0,0.0,1.0,0.0,0.0,1.0,0.0,1.0,1.0,1.0,1.0,1.0,2.0,0.0,4.0,3.0,2.0,3.0,0.0,7.0,0.0,4.0,1.0,9.0,0.0,2.0,1.0,0.0,0.0,0.0,0.0,1.0,0.0,1.0,1.0,0.0,0.0,0.0,2.0,1.0,1.0,4.0,1.0,1.0,2.0,2.0,7.0,0.0,2.0,0.0,0.0,2.0,4.0,0.0,2.0,1.0,1.0,1.0,2.0,1.0,2.0,0.0,7.0,2.0,0.0,0.0,1.0,1.0,0.0,2.0,2.0,0.0,1.0,4.0,3.0,0.0,0.0,9.0,7.0,1.0,0.0,0.0,0.0,0.0,1.0,1.0,1.0,4.0,0.0,0.0,0.0,2.0,0.0,1.0,0.0,0.0,1.0,0.0,0.0,0.0,0.0,4.0,0.0,2.0,1.0,1.0,2.0,1.0,11.0,1.0,0.0,0.0,0.0,0.0,0.0,2.0,1.0,2.0,4.0,0.0,0.0,4.0,0.0,10.0,0.0,0.0,0.0,0.0,0.0,0.0,2.0,1.0,0.0,7.0,0.0,0.0,5.0,0.0,3.0,0.0,0.0,0.0,1.0,0.0,0.0,0.0,0.0,0.0,0.0,0.0,7.0,4.0,0.0,2.0,7.0,1.0,5.0,2.0,9.0,2.0,2.0,3.0,2.0,3.0,5.0,5.0,4.0,5.0,2.0,4.0,2.0,2.0,3.0,3.0,4.0,5.0,4.0,2.0,6.0,3.0,2.0,21.0,11.0,7.0,3.0,13.0,15.0,14.0,7.0,7.0,3.0,23.0,8.0,11.0,12.0,9.0,9.0,8.0,5.0,5.0,5.0,5.0,5.0,5.0,5.0,4.0,5.0,2.0,2.0,3.0,3.0,0.0,3.0,3.0,0.0,9.0,1.0,4.0,6.0,0.0,6.0,2.0,1.0,1.0,5.0,3.0,0.0,5.0,3.0,1.0,5.0,4.0,6.0,4.0,3.0,5.0,12.0,2.0,2.0,2.0,2.0,3.0,2.0,6.0,3.0,6.0,4.0,3.0,5.0,4.0,1.0,2.0,9.0,0.0,0.0,1.0,0.0,7.0,0.0,5.0,2.0,5.0,5.0,5.0,5.0,4.0,0.0,5.0,5.0,2.0,5.0,0.0,5.0,5.0,5.0,5.0,5.0,5.0,5.0,3.0,5.0,4.0,4.0,0.0,4.0,4.0,5.0,5.0,5.0,3.0,5.0,5.0,5.0,5.0,1.0,5.0,5.0,5.0,4.0,5.0,4.0,4.0,2.0,4.0,5.0,5.0,5.0,5.0,4.0,5.0,5.0,4.0,5.0,2.0,4.0,4.0,4.0,5.0,5.0,5.0,5.0,5.0,2.0,5.0,4.0,5.0,4.0,5.0,4.0,5.0,5.0,4.0,5.0,4.0,5.0,5.0,5.0,5.0,5.0,4.0,5.0,4.0,5.0,5.0,4.0,5.0,5.0,4.0,4.0,5.0,3.0,5.0,3.0,5.0,5.0,5.0,5.0,4.0,5.0,5.0,5.0,4.0,5.0,5.0,4.0,5.0,2.0,5.0,4.0,3.0,5.0,2.0,5.0,5.0,5.0,5.0,4.0,0.0,5.0,0.0,0.0,0.0,0.0,5.0,3.0,11.0,10.0,28.0,25.0,13.0,10.0,17.0,12.0,3.0,4.0,6.0,5.0,7.0,7.0,10.0,21.0,35.0,9.0,15.0,19.0,18.0,26.0,13.0,13.0,10.0,29.0,19.0,30.0,5.0,8.0,9.0,0.0,19.0,3.0,7.0,16.0,11.0,32.0,15.0,7.0,7.0,17.0,5.0,0.0,20.0,20.0,1.0,13.0,1.0,11.0,4.0,10.0,6.0,1.0,10.0,12.0,3.0,17.0,5.0,0.0,11.0,2.0,10.0,20.0,21.0,7.0,21.0,15.0,20.0,15.0,15.0,10.0,11.0,2.0,12.0,11.0,5.0,6.0,12.0,5.0,1.0,15.0,6.0,4.0,3.0,0.0,15.0,15.0,18.0,1.0,9.0,10.0,10.0,4.0,17.0,13.0,20.0,17.0,21.0,4.0,2.0,26.0,15.0,24.0,24.0,11.0,11.0,17.0,19.0,11.0,12.0,24.0,12.0,19.0,18.0,5.0,13.0,13.0,11.0,2.0,5.0,32.0,29.0,3.0,16.0,15.0,17.0,25.0,12.0,7.0,27.0,5.0,9.0,22.0,24.0,13.0,21.0,16.0,4.0,18.0,12.0,1.0,18.0,19.0,4.0,21.0,30.0,5.0,0.0,13.0,25.0,14.0,16.0,19.0,3.0,7.0,11.0,5.0,12.0,2.0,12.0,8.0,12.0,8.0,7.0,25.0,17.0,10.0,10.0,2.0,16.0,6.0,20.0,4.0,5.0,15.0,1.0,22.0,12.0,19.0,9.0,12.0,2.0,7.0,5.0,28.0,18.0,7.0,10.0,9.0,16.0,15.0,12.0,14.0,34.0,14.0,6.0,3.0,12.0,4.0,9.0,15.0,3.0,20.0,11.0,11.0,13.0,1.0,12.0,8.0,13.0,2.0,15.0,11.0,9.0,0.0,1.0,12.0,6.0,3.0,14.0,16.0,13.0,6.0,11.0,2.0,4.0,8.0,19.0,16.0,9.0,11.0,7.0,5.0,7.0,6.0,29.0,26.0,7.0,23.0,17.0,13.0,1.0,26.0,4.0,7.0,14.0,6.0,8.0,20.0,25.0,0.0,8.0,1.0,40.0,2.0,18.0,14.0,24.0,21.0,14.0,6.0,12.0,5.0,1.0,33.0,23.0,28.0,17.0,11.0,25.0,5.0,12.0,8.0,5.0,22.0,2.0,10.0,10.0,7.0,6.0,11.0,22.0,25.0,11.0,7.0,10.0,15.0,3.0,7.0,11.0,12.0,4.0,13.0,11.0,16.0,3.0,5.0,0.0,8.0,7.0,1.0,12.0,7.0,22.0,10.0,14.0,4.0,10.0,20.0,4.0,7.0,15.0,4.0,13.0,16.0,3.0,13.0,5.0,15.0,19.0,11.0,6.0,24.0,21.0,21.0,7.0,23.0,4.0,11.0,20.0,4.0,12.0,6.0,15.0,11.0,15.0,15.0,11.0,2.0,11.0,7.0,14.0,1.0,10.0,23.0,13.0,1.0,12.0,21.0,8.0,3.0,1.0,1.0,3.0,2.0,1.0,5.0,1.0,0.0,0.0,0.0,0.0,1.0,3.0,1.0,2.0,4.0,0.0,1.0,0.0,1.0,0.0,1.0,1.0,0.0,0.0,5.0,1.0,0.0,1.0,5.0,2.0,,3.0,5.0,5.0,1.0,0.0,0.0,1.0,0.0,3.0,0.0,4.0,3.0,0.0,2.0,0.0,0.0,1.0,1.0,1.0,0.0,1.0,1.0,0.0,1.0,0.0,3.0,1.0,2.0,1.0,0.0,5.0,1.0,2.0,0.0,0.0,1.0,5.0,1.0,0.0,0.0,0.0,0.0,1.0,0.0,1.0,2.0,1.0,4.0,1.0,4.0,0.0,0.0,0.0,0.0,0.0,0.0,5.0,2.0,0.0,0.0,0.0,1.0,2.0,2.0,1.0,0.0,3.0,1.0,3.0,2.0,1.0,0.0,0.0,0.0,1.0,5.0,0.0,3.0,2.0,0.0,0.0,4.0,,1.0,5.0,1.0,1.0,3.0,1.0,2.0,3.0,4.0,11.0,1.0,1.0,0.0,5.0,4.0,4.0,5.6,0.0,0.0,0.0,1.0,8.0,1.0,2.0,1.0,0.0,4.0,3.0,,1.0,,14.0,0.0,5.0,1.0,6.0,0.0,0.0,,,3.0,2.0,3.0,10.0,,6.0,8.0,,5.0,,4.0,4.0,3.0,2.0,5.0,0.0,7.0,6.0,10.0,1.0,4.666666666666667,1.0,,4.0,3.0,0.0,9.0,4.0,0.0,2.0,6.0,2.0,6.0,,2.0,7.0,5.0,7.0,7.0,,,,8.0,1.0,0.0,4.0,6.0,10.0,,2.0,1.0,6.0,6.0,,,1.0,6.0,,,,,,,1.0,2.0,7.0,3.0,,,,,,,,,1.0,3.0,3.0,4.0,2.0,8.0,,12.0,7.0,,,4.0,0.0,1.0,5.0,3.0,9.0,3.0,2.0,2.0,,2.0,3.75,3.0,1.0,6.0,5.0,0.0,6.0,6.0,1.0,2.0,3.0,3.0,4.0,2.0,2.0,6.0,,,,8.0,3.0,9.0,2.0,4.0,8.0,3.0,3.0,13.0,,2.0,0.0,2.0,,,4.0,3.0,4.0,1.0,,,,5.0,1.0,1.0,2.0,0.0,9.0,3.0,6.0,5.0,4.0,3.0,2.0,1.0,4.0,5.0,3.0,10.0,5.0,8.0,19.0,0.0,11.0,5.0,8.0,18.0,14.0,17.0,19.0,22.0,14.0,15.0,19.0,19.0,20.0,4.0,10.0,0.0,3.0,14.0,1.0,0.0,7.0,12.0,22.0,11.0,9.0,9.0,6.0,3.0,4.0,6.0,11.0,8.0,2.0,5.0,0.0,15.0,5.0,5.0,4.0,9.0,6.0,13.0,19.0,0.0,10.0,5.0,10.0,15.0,11.0,19.0,18.0,3.0,5.0,22.0,20.0,13.0,0.0,4.0,2.0,10.0,4.0,9.0,12.0,19.0,20.0,4.0,12.0,30.0,4.0,6.0,15.0,18.0,28.0,28.0,22.0,7.0,4.0,6.0,0.0,8.0,14.0,18.0,0.0,0.0,2.0,20.0,8.0,0.0,13.0,1.0,7.0,0.0,7.0,12.0,2.0,0.0,4.0,3.0,2.0,1.0,13.0,3.0,0.0,7.0,24.0,3.0,3.0,13.0,11.0,10.0,17.0,1.0,15.0,7.0,0.0,3.0,7.0,10.0,2.0,16.0,4.0,17.0,3.0,13.0,14.0,20.0,16.0,11.0,6.0,11.0,11.0,8.0,10.0,6.0,16.0,4.0,3.0,7.0,2.0,3.0,3.0,3.0,2.0,4.0,3.0,3.0,10.0,5.0,0.0,5.0,23.0,14.0,15.0,4.0,18.0,13.0,11.0,3.0,9.0,6.0,17.0,10.0,5.0,0.0,3.0,8.0,14.0,11.0,0.0,1.0,4.0,14.0,11.0,10.0,12.0,15.0,1.0,13.0,16.0,0.0,7.0,7.0,2.0,19.0,8.0,17.0,12.0,1.0,3.0,20.0,10.0,8.0,10.0,8.0,6.0,2.0,0.0,5.0,5.0,5.0,1.0,14.0,19.0,1.0,4.0,14.0,15.0,2.0,20.0,3.0,7.0,14.0,10.0,10.0,15.0,15.0,7.0,6.0,8.0,11.0,10.0,11.0,20.0,7.0,19.0,6.0,15.0,1.0,4.0,6.0,4.0,1.0,0.0,0.0,14.0,6.0,2.0,1.0,19.0,2.0,5.0,0.0,0.0,2.0,11.0,7.0,12.0,2.0,5.0,7.0,9.0,9.0,6.0,8.0,7.0,8.0,6.0,11.0,3.0,5.0,5.0,16.0,0.0,17.0,12.0,19.0,20.0,13.0,8.0,12.0,11.0,7.0,11.0,6.0,10.0,12.0,24.0,11.0,7.0,12.0,7.0,7.0,10.0,5.0,11.0,7.0,10.0,8.0,14.0,8.0,14.0,10.0,11.0,7.0,11.0,7.0,9.0,0.0,0.0,0.0,0.0,0.0,0.0,16.0,0.0,0.0,2.0,7.0,2.0,10.0,23.0,7.0,2.0,6.0,1.0,0.0,9.0,21.0,16.0,2.0,10.0,11.0,1.0,3.0,9.0,9.0,8.0,18.0,13.0,12.0,6.0,2.0,6.0,4.0,0.0,1.0,1.0,11.0,22.0,12.0,16.0,5.0,19.0,2.0,11.0,6.0,5.0,0.0,2.0,4.0,28.0,20.0,7.0,2.0,4.0,7.0,2.0,1.0,2.0,3.0,2.0,18.0,11.0,9.0,28.0,0.0,3.0,5.0,15.0,0.0,13.0,5.0,0.0,3.0,2.0,1.0,9.0,8.0,15.0,5.0,0.0,2.0,24.0,6.0,5.0,3.0,4.0,3.0,1.0,2.0,8.0,1.0,4.0,1.0,4.0,6.0,13.0,41.0,22.0,30.0,8.0,30.0,3.0,0.0,18.0,5.0,8.0,8.0,0.0,27.0,11.0,12.0,29.0,8.0,20.0,7.0,0.0,2.0,2.0,3.0,7.0,5.0,9.0,3.0,2.0,3.0,5.0,2.0,4.0,1.0,2.0,5.0,1.0,11.0,37.0,5.0,3.0,4.0,17.0,0.0,0.0,18.0,0.0,1.0,12.0,2.0,2.0,13.0,45.0,8.0,17.0,8.0,1.0,2.0,4.0,0.0,0.0,0.0,3.0,7.0,3.0,26.0,23.0,0.0,5.0,3.0,10.0,2.0,8.0,1.0,5.0,7.0,5.0,0.0,8.0,23.0,1.0,21.0,6.0,12.0,1.0,3.0,9.0,2.0,18.0,5.0,7.0,2.0,19.0,10.0,0.0,0.0,19.0,1.0,2.0,6.0,3.0,5.0,5.0,3.0,4.0,8.0,8.0,0.0,5.0,6.0,5.0,3.0,3.0,15.0,12.0,4.0,1.0,7.0,8.0,3.0,18.0,6.0,10.0,3.0,1.0,4.0,0.0,22.0,12.0,3.0,4.0,16.0,10.0,2.0,27.0,19.0,5.0,28.0,1.0,2.0,1.0,3.0,3.0,9.0,20.0,5.0,4.0,22.0,1.0,3.0,5.0,14.0,0.0,9.0,2.0,8.0,19.0,3.0,3.0,5.0,3.0,11.0,1.0,13.0,40.0,9.0,15.0,4.0,3.0,12.0,27.0,2.0,4.0,2.0,0.0,7.0,28.0,0.0,3.0,1.0,13.0,3.0,2.0,15.0,5.0,0.0,0.0,27.0,3.0,3.0,15.0,5.0,11.0,3.0,1.0,1.0,0.0,10.0,9.0,35.0,2.0,7.0,3.0,6.0,3.0,3.0,11.0,4.0,11.0,4.0,6.0,9.0,0.0,1.0,5.0,4.0,11.0,0.0,2.0,12.0,7.0,3.0,1.0,0.0,4.0,1.0,1.0,0.0,8.0,12.0,1.0,2.0,2.0,3.0,14.0,9.0,6.0,5.0,10.0,9.0,3.0,3.0,4.0,2.0,14.0,9.0,3.0,10.0,18.0,1.0,1.0,2.0,38.0,0.0,5.0,0.0,15.0,1.0,12.0,2.0,1.0,15.0,6.0,4.0,2.0,5.0,0.0,9.0,10.0,11.0,3.0,4.0,6.0,8.0,2.0,3.0,8.0,3.0,5.0,16.0,35.0,7.0,14.0,22.0,3.0,46.0,4.0,2.0,3.0,4.0,6.0,3.0,3.0,1.0,19.0,7.0,0.0,2.0,3.0,6.0,20.0,26.0,8.0,4.0,22.0,4.0,10.0,0.0,4.0,14.0,8.0,7.0,1.0,9.0,9.0,1.0,4.0,23.0,16.0,4.0,2.0,11.0,2.0,6.0,9.0,10.0,20.0,4.0,3.0,8.0,11.0,0.0,14.0,18.0,2.0,12.0,0.0,8.0,15.0,7.0,26.0,8.0,21.0,8.0,18.0,4.0,24.0,7.0,10.0,25.0,8.0,0.0,4.0,13.0,1.0,12.0,8.0,5.0,9.0,32.0,36.0,35.0,8.0,25.0,4.0,4.0,16.0,2.0,2.0,4.0,5.0,2.0,4.0,6.0,4.0,4.0,5.0,15.0,4.0,1.0,6.0,7.0,7.0,9.0,5.0,2.0,16.0,0.0,3.0,17.0,7.0,6.0,5.0,4.0,12.0,13.0,19.0,8.0,8.0,8.0,7.0,8.0,4.0,17.0,4.0,2.0,5.0,17.0,8.0,17.0,2.0,5.0,0.0,3.0,10.0,0.0,7.0,0.0,2.0,6.0,16.0,6.0,4.0,6.0,16.0,12.0,7.0,10.0,4.0,21.0,8.0,19.0,2.0,9.0,11.0,2.0,4.0,16.0,11.0,0.0,4.0,2.0,11.0,2.0,0.0,10.0,10.0,7.0,2.0,20.0,48.0,12.0,14.0,10.0,8.0,12.0,4.0,8.0,5.0,6.0,3.0,3.0,9.0,9.0,10.0,3.0,2.0,1.0,1.0,10.0,0.0,3.0,3.0,10.0,2.0,2.0,14.0,4.0,1.0,11.0,2.0,8.0,9.0,3.0,3.0,8.0,8.0,7.0,9.0,4.0,29.0,3.0,3.0,3.0,1.0,8.0,3.0,13.0,3.0,18.0,2.0,1.0,4.0,13.0,0.0,8.0,7.0,3.0,1.0,3.0,3.0,9.0,2.0,11.0,16.0,2.0,0.0,4.0,8.0,3.0,17.0,3.0,9.0,7.0,1.0,6.0,17.0,13.0,0.0,5.0,3.0,0.0,2.0,2.0,0.0,4.0,5.0,7.0,4.0,8.0,27.0,21.0,25.0,25.0,6.0,3.0,0.0,5.0,13.0,7.0,7.0,1.0,12.0,3.0,3.0,6.0,4.0,8.0,2.0,4.0,25.0,3.0,8.0,3.0,6.0,5.0,5.0,3.0,3.0,2.0,2.0,2.0,5.0,1.0,13.0,13.0,9.0,15.0,8.0,14.0,5.0,12.0,27.0,5.0,12.0,4.0,20.0,26.0,2.0,1.0,2.0,2.0,5.0,12.0,11.0,3.0,7.0,7.0,6.0,31.0,4.0,12.0,6.0,15.0,15.0,13.0,1.0,3.0,0.0,29.0,2.0,0.0,6.0,16.0,6.0,0.0,3.0,5.0,2.0,1.0,10.0,3.0,21.0,3.0,2.0,7.0,10.0,11.0,4.0,19.0,10.0,3.0,5.0,5.0,5.0,3.0,2.0,8.0,3.0,2.0,1.0,1.0,19.0,2.0,18.0,18.0,14.0,17.0,8.0,13.0,21.0,48.0,6.0,2.0,5.0,8.0,11.0,11.0,5.0,2.0,1.0,14.0,22.0,7.0,6.0,9.0,2.0,8.0,3.0,4.0,16.0,1.0,2.0,30.0,6.0,15.0,4.0,3.0,10.0,27.0,36.0,2.0,10.0,8.0,11.0,4.0,10.0,1.0,11.0,18.0,5.0,11.0,0.0,1.0,33.0,0.0,11.0,1.0,3.0,9.0,4.0,4.0,8.0,11.0,9.0,3.0,5.0,6.0,11.0,0.0,3.0,4.0,2.0,2.0,7.0,23.0,9.0,12.0,6.0,2.0,11.0,8.0,3.0,9.0,22.0,4.0,3.0,12.0,6.0,6.0,3.0,7.0,10.0,1.0,12.0,4.0,15.0,17.0,2.0,0.0,2.0,9.0,1.0,2.0,1.0,5.0,6.0,5.0,5.0,18.0,14.0,14.0,5.0,8.0,0.0,2.0,7.0,5.0,6.0,18.0,8.0,3.0,22.0,8.0,10.0,10.0,3.0,3.0,3.0,2.0,4.0,3.0,0.0,8.0,4.0,10.0,52.0,6.0,3.0,4.0,21.0,40.0,4.0,36.0,14.0,13.0,7.0,6.0,5.0,1.0,4.0,1.0,8.0,14.0,5.0,18.0,9.0,2.0,12.0,16.0,12.0,1.0,14.0,0.0,6.0,10.0,8.0,28.0,13.0,8.0,7.0,17.0,7.0,3.0,5.0,3.0,3.0,11.0,12.0,20.0,3.0,3.0,16.0,17.0,16.0,2.0,3.0,2.0,3.0,9.0,10.0,4.0,10.0,15.0,2.0,7.0,22.0,10.0,2.0,11.0,0.0,13.0,7.0,9.0,20.0,15.0,2.0,8.0,4.0,5.0,5.0,3.0,9.0,41.0,14.0,9.0,13.0,17.0,5.0,5.0,23.0,3.0,6.0,2.0,0.0,6.0,4.0,12.0,3.0,3.0,12.0,6.0,5.0,10.0,12.0,20.0,2.0,1.0,20.0,6.0,2.0,0.0,1.0,4.0,0.0,5.0,5.5,8.0,14.0,2.0,8.0,5.0,26.0,21.0,16.0,10.0,4.0,8.0,0.0,7.0,0.0,11.0,34.0,23.0,4.0,5.0,24.0,7.0,4.0,14.0,19.0,9.0,17.0,4.0,0.0,20.0,0.0,17.0,11.0,8.0,8.0,27.0,16.0,9.0,4.0,36.0,52.0,7.0,5.0,1.0,9.0,5.0,4.0,1.0,10.0,20.0,25.0,0.0,28.0,19.0,1.0,2.0,6.0,13.0,15.0,16.0,18.0,8.0,15.0,24.0,7.0,3.0,0.0,2.0,9.0,3.0,0.0,16.0,2.0,10.0,0.0,19.0,11.0,15.0,3.0,13.0,4.0,0.0,31.0,3.0,,12.0,0.0,22.0,0.0,32.0,23.0,6.0,15.0,12.0,11.0,1.0,22.0,15.0,5.0,3.0,8.0,4.0,1.0,0.0,2.0,1.0,6.0,0.0,24.0,44.0,27.0,1.0,6.0,0.0,4.0,3.0,10.0,4.0,6.0,4.0,7.0,25.0,6.0,6.0,2.0,1.0,21.0,2.0,2.0,16.0,25.0,5.0,4.0,9.0,5.0,10.0,9.0,6.0,9.0,17.0,7.0,10.0,7.0,13.0,2.0,2.0,3.0,5.0,27.0,6.0,3.0,26.0,2.0,20.0,2.0,5.0,9.0,8.0,2.0,3.0,23.0,31.0,2.0,15.0,2.0,3.0,6.0,29.0,23.0,7.0,11.0,0.0,14.0,6.0,4.0,0.0,1.0,4.0,5.0,0.0,6.0,8.0,3.0,2.0,0.0,4.0,4.0,4.0,2.0,1.0,8.0,10.0,13.0,5.0,9.0,13.0,9.0,7.0,4.0,23.0,21.0,10.0,6.0,13.0,6.0,14.0,13.0,3.0,4.0,0.0,8.0,2.0,2.0,9.0,7.0,2.0,2.0,0.0,13.0,8.0,4.0,1.0,7.0,6.0,1.0,7.0,2.0,3.0,9.0,2.0,8.0,7.0,5.0,1.0,6.0,20.0,3.0,11.0,9.0,5.0,3.0,7.0,4.0,6.0,30.0,0.0,23.0,11.0,2.0,3.0,17.0,1.0,11.0,0.0,22.0,3.0,1.0,2.0,8.0,1.0,2.0,2.0,2.0,0.0,2.0,0.0,3.0,1.0,0.0,0.0,1.0,1.0,0.0,6.0,7.0,0.0,19.0,1.0,0.0,3.0,1.0,10.0,2.0,7.0,24.0,0.0,0.0,0.0,17.0,8.0,20.0,15.0,1.0,1.0,4.0,4.0,5.0,23.0,2.0,2.0,9.0,8.0,17.0,0.0,7.0,10.0,3.0,2.0,1.0,2.0,2.0,2.0,8.0,18.0,9.0,30.0,9.0,13.0,0.0,21.0,23.0,13.0,12.0,6.0,18.0,15.0,3.0,6.0,14.0,4.0,9.0,18.0,8.0,19.0,14.0,6.0,14.0,8.0,0.0,2.0,0.0,15.0,2.0,0.0,14.0,23.0,12.0,9.0,7.0,1.0,4.0,3.0,5.0,6.0,5.0,19.0,2.0,5.0,4.0,28.0,0.0,10.0,2.0,7.0,12.0,22.0,7.0,22.0,2.0,0.0,6.0,1.0,22.0,26.0,17.0,8.0,4.0,23.0,9.0,34.0,15.0,5.0,13.0,29.0,9.0,11.0,9.0,4.0,9.0,21.0,17.0,12.0,12.0,9.0,34.0,17.0,9.0,35.0,6.0,13.0,0.0,3.0,18.0,10.0,9.0,18.0,22.0,8.0,9.0,21.0,13.0,12.0,8.0,0.0,8.0,30.0,20.0,3.0,13.0,20.0,16.0,10.0,19.0,4.0,16.0,13.0,12.0,8.0,8.0,24.0,20.0,0.0,6.0,16.0,13.0,9.0,15.0,19.0,0.0,10.0,7.0,7.0,16.0,13.0,10.0,16.0,12.0,14.0,9.0,13.0,9.0,27.0,15.0,17.0,21.0,36.0,3.0,8.0,3.0,14.0,6.0,6.0,1.0,22.0,8.0,13.0,8.0,6.0,14.0,11.0,2.0,4.0,21.0,7.0,0.0,3.0,14.0,1.0,6.0,20.0,24.0,4.0,4.0,8.0,13.0,4.0,0.0,14.0,11.0,3.0,11.0,0.0,5.0,4.0,5.0,14.0,23.0,1.0,18.0,8.0,21.0,36.0,36.0,2.0,22.0,12.0,13.0,13.0,8.0,13.0,10.0,15.0,5.0,7.0,8.0,31.0,18.0,20.0,7.0,24.0,23.0,5.0,19.0,6.0,28.0,9.0,24.0,19.0,8.0,6.0,10.0,28.0,1.0,10.0,13.0,20.0,19.0,11.0,4.0,3.0,23.0,15.0,2.0,13.0,8.0,3.0,28.0,9.0,11.0,10.0,14.0,32.0,8.0,16.0,22.0,20.0,10.0,5.0,1.0,20.0,22.0,19.0,21.0,3.0,2.0,0.0,25.0,15.0,9.0,13.0,8.0,2.0,22.0,26.0,22.0,25.0,12.0,14.0,7.0,10.0,14.0,1.0,3.0,11.0,10.0,14.0,14.0,10.0,23.0,26.0,10.0,10.0,20.0,10.0,25.0,2.0,6.0,1.0,21.0,8.0,8.0,7.0,17.0,11.0,19.0,9.0,10.0,5.0,4.0,5.0,6.0,10.0,12.0,7.0,12.0,9.0,12.0,15.0,18.0,17.0,7.0,19.0,16.0,11.0,19.0,10.0,10.0,11.0,2.0,13.0,8.0,18.0,5.0,17.0,25.0,9.0,9.0,4.0,6.0,7.0,6.0,22.0,5.0,12.0,18.0,13.0,22.0,9.0,10.0,10.0,8.0,7.0,6.0,2.0,25.0,9.0,19.0,28.0,14.0,16.0,24.0,19.0,21.0,21.0,8.0,12.0,5.0,8.0,22.0,21.0,20.0,7.0,3.0,7.0,2.0,9.0,4.0,5.0,8.0,3.0,5.0,6.0,7.0,10.0,10.0,8.0,5.0,7.0,6.0,17.0,23.0,5.0,6.0,8.0,15.0,13.0,8.0,3.0,7.0,6.0,8.0,7.0,6.0,5.0,5.0,11.0,7.0,5.0,2.0,6.0,6.0,1.0,7.0,0.0,0.0,5.0,2.0,0.0,3.0,0.0,5.0,6.0,2.0,6.0,11.0,19.0,2.0,11.0,11.0,12.0,9.0,8.0,9.0,15.0,13.0,2.0,10.0,16.0,3.0,0.0,13.0,15.0,3.0,1.0,0.0,1.0,13.0,5.0,6.0,0.0,11.0,5.0,13.0,4.0,1.0,6.0,7.0,8.0,13.0,4.0,1.0,8.0,14.0,7.0,5.0,1.0,5.0,4.0,8.0,12.0,7.0,16.0,0.0,4.0,5.0,5.0,4.0,4.0,5.0,4.0,6.0,5.0,0.0,3.0,0.0,2.0,6.0,6.0,3.0,14.0,10.0,6.0,14.0,2.0,3.0,3.0,1.0,7.0,7.0,0.0,,6.0,10.0,12.0,0.0,1.0,3.0,2.0,3.0,3.0,1.0,3.0,1.0,2.0,2.0,9.0,4.0,4.0,8.0,9.0,7.0,3.0,2.0,2.0,3.0,10.0,14.0,28.0,12.0,2.0,3.0,5.0,7.0,15.0,18.0,7.0,4.0,,,7.0,11.0,12.0,14.0,10.0,12.0,,0.0,17.0,5.0,4.0,10.0,5.0,8.0,16.0,15.0,15.0,15.0,9.0,13.0,8.0,5.0,10.0,4.0,11.0,18.0,11.0,8.0,2.0,12.0,5.0,3.0,7.0,8.0,10.0,24.0,4.0,14.0,0.0,1.0,27.0,2.0,3.0,8.0,8.0,14.0,6.0,6.0,9.0,14.0,0.0,7.0,16.0,10.0,14.0,5.0,7.0,4.0,18.0,11.0,10.0,11.0,10.0,9.0,6.0,20.0,14.0,9.0,1.0,9.0,11.0,8.0,11.0,8.0,14.0,4.0,12.0,6.0,,4.0,14.0,8.0,15.0,19.0,10.0,13.0,10.0,2.0,17.0,5.0,9.0,11.0,11.0,,2.0,4.0,10.0,1.0,,6.0,11.0,12.0,7.0,14.0,3.0,16.0,0.0,14.0,17.0,13.0,13.0,10.0,3.0,13.0,10.0,3.0,3.0,11.0,1.0,5.0,9.0,14.0,5.0,1.0,2.0,16.0,7.0,7.0,5.0,22.0,15.0,18.0,10.0,6.0,1.0,1.0,3.0,14.0,10.0,11.0,11.0,12.0,0.0,3.0,0.0,9.0,11.0,4.0,12.0,4.0,11.0,5.0,9.0,11.0,6.0,5.0,6.0,5.0,6.0,1.0,7.0,9.0,1.0,6.0,3.0,7.0,6.0,2.0,4.0,3.0,2.0,5.0,1.0,7.0,7.0,9.0,0.0,5.0,5.0,4.0,4.0,6.0,3.0,0.0,3.0,4.0,7.0,5.0,5.0,3.0,5.0,3.0,4.0,4.0,3.0,,,,,,,,,,,,,,,,,,,,,,,,,,,,,,,,,,,,,,,,,,,,,,,,,,,,,,,,,,,,,,,,,,,,,,,,,,,,,,,,,,,,,,,,,,,,,,,,,,,,,,,,,,,,,,,,,,,,,,,,,,,,,,,,,,,,,,,,,,,,,,,,,,,,,,,,,,,,,,,,,,,,,,,,,,,,,,,,,0.0,10.0,5.0,13.0,0.0,18.0,34.0,3.0,3.0,7.0,0.0,1.0,0.0,19.0,0.0,2.0,0.0,0.0,0.0,0.0,25.0,4.0,2.0,2.0,7.0,10.0,2.0,0.0,9.0,2.0,0.0,3.0,3.0,12.0,0.0,10.0,3.0,1.0,22.0,8.0,14.0,13.0,2.0,0.0,3.0,1.0,2.0,1.0,0.0,6.0,1.0,0.0,7.0,3.0,0.0,12.0,5.0,3.0,0.0,6.0,2.0,4.0,2.0,0.0,2.0,1.0,13.0,1.0,2.0,5.0,3.0,5.0,0.0,0.0,0.0,21.0,0.0,1.0,2.0,0.0,3.0,4.0,10.0,2.0,4.0,0.0,5.0,3.0,0.0,3.0,5.0,2.0,9.0,5.0,0.0,3.0,7.0,0.0,16.0,14.0,3.0,4.0,18.0,5.0,26.0,31.0,18.0,16.0,12.0,8.0,10.0,14.0,26.0,12.0,25.0,17.0,13.0,14.0,4.0,27.0,9.0,20.0,12.0,10.0,0.0,8.0,2.0,11.0,18.0,19.0,1.0,2.0,21.0,2.0,0.0,42.0,0.0,2.0,17.0,9.0,0.0,0.0,2.0,0.0,9.0,17.0,15.0,38.0,18.0,1.0,12.0,0.0,3.0,3.0,15.0,1.0,0.0,2.0,0.0,12.0,25.0,4.0,17.0,21.0,1.0,3.0,15.0,14.0,2.0,1.0,14.0,13.0,4.0,0.0,3.0,5.0,2.0,8.0,6.0,2.0,5.0,4.0,1.0,7.0,2.0,0.0,0.0,3.0,7.0,7.0,16.0,1.0,9.0,12.0,12.0,0.0,14.0,4.0,16.0,27.0,4.0,14.0,6.0,8.0,5.0,17.0,8.0,3.0,7.0,6.0,9.0,0.0,10.0,4.0,3.0,8.0,9.0,11.0,10.0,9.0,4.0,0.0,13.0,13.0,17.0,11.0,6.0,5.0,7.0,18.0,23.0,1.0,0.0,1.0,6.0,2.0,9.0,2.0,15.0,7.0,2.0,14.0,18.0,22.0,24.0,13.0,7.0,17.0,29.0,8.0,15.0,5.0,6.0,2.0,1.0,6.0,25.0,4.0,0.0,6.0,1.0,0.0,10.0,18.0,4.0,10.0,1.0,12.0,1.0,4.0,7.0,1.0,2.0,3.0,18.0,6.0,1.0,5.0,0.0,5.0,0.0,3.0,10.0,13.0,23.0,4.0,8.0,2.0,3.0,6.0,3.0,0.0,0.0,0.0,6.0,1.0,7.0,3.0,9.0,1.0,3.0,0.0,1.0,1.0,0.0,4.0,0.0,0.0,2.0,15.0,11.0,0.0,3.0,5.0,2.0,12.0,0.0,6.0,0.0,6.0,0.0,12.0,0.0,10.0,0.0,0.0,5.0,2.0,7.0,6.0,16.0,5.0,5.0,7.0,2.0,13.0,2.0,17.0,13.0,5.0,7.0,8.0,8.0,10.0,0.0,17.0,14.0,13.0,2.0,7.0,0.0,0.0,0.0,17.0,7.0,6.0,7.0,6.0,7.0,6.0,6.0,1.0,8.0,8.0,6.0,4.0,4.0,5.0,5.0,6.0,7.0,3.0,7.0,4.0,7.0,5.0,5.0,8.0,6.0,7.0,10.0,7.0,3.0,10.0,6.0,4.0,6.0,4.0,10.0,6.0,4.0,4.0,6.0,6.0,5.0,6.0,4.0,8.0,8.0,3.0,4.0,7.0,3.0,4.0,5.0,5.0,6.0,6.0,8.0,9.0,6.0,4.0,6.0,6.0,8.0,3.0,7.0,7.0,5.0,6.0,5.0,4.0,5.0,13.0,10.0,3.0,7.0,12.0,14.0,8.0,8.0,0.0,9.0,5.0,5.0,12.0,4.0,4.0,5.0,4.0,0.0,9.0,21.0,15.0,9.0,15.0,5.0,20.0,2.0,11.0,18.0,6.0,2.0,0.0,17.0,4.0,13.0,12.0,10.0,7.0,6.0,13.0,5.0,2.0,19.0,18.0,6.0,13.0,6.0,4.0,11.0,3.0,9.0,8.0,12.0,8.0,9.0,10.0,7.0,9.0,7.0,4.0,12.0,4.0,10.0,12.0,11.0,17.0,8.0,24.0,10.0,7.0,8.0,8.0,6.0,5.0,10.0,9.0,8.0,7.0,10.0,9.0,13.0,8.0,8.0,13.0,7.0,7.0,12.0,12.0,7.0,4.0,8.0,8.0,9.0,16.0,5.0,12.0,8.0,16.0,18.0,19.0,8.0,10.0,10.0,11.0,5.0,6.0,7.0,8.0,17.0,14.0,9.0,8.0,17.0,9.0,13.0,10.0,13.0,12.0,6.0,4.0,8.0,6.0,9.0,6.0,14.0,5.0,11.0,14.0,10.0,16.0,14.0,14.0,17.0,4.0,4.0,12.0,2.0,6.0,11.0,10.0,6.0,16.0,11.0,18.0,6.0,9.0,7.0,8.0,3.0,0.0,8.0,9.0,0.0,8.0,7.0,4.0,9.0,6.0,17.0,17.0,8.0,11.0,5.0,11.0,10.0,10.0,16.0,2.0,9.0,4.0,5.0,4.0,10.0,8.0,16.0,7.0,11.0,4.0,10.0,7.0,14.0,14.0,5.0,3.0,10.0,4.0,5.0,2.0,8.0,8.0,18.0,9.0,9.0,4.0,10.0,12.0,5.0,2.0,5.0,5.0,15.0,5.0,2.0,14.0,10.0,14.0,9.0,11.0,9.0,4.0,10.0,3.0,2.0,4.0,2.0,7.0,11.0,1.0,8.0,14.0,12.0,3.0,4.0,1.0,2.0,3.0,7.0,5.0,14.0,14.0,3.0,4.0,6.0,6.0,7.0,7.0,2.0,11.0,15.0,13.0,6.0,1.0,8.0,12.0,5.0,1.0,4.0,2.0,9.0,7.0,5.0,9.0,11.0,10.0,9.0,12.0,10.0,6.0,9.0,9.0,7.0,9.0,8.0,7.0,5.0,4.0,6.0,9.0,13.0,2.0,6.0,12.0,4.0,5.0,7.0,5.0,10.0,8.0,10.0,6.0,10.0,11.0,3.0,6.0,0.0,12.0,1.0,9.0,6.0,6.0,12.0,17.0,4.0,8.0,5.0,0.0,11.0,9.0,7.0,10.0,2.0,7.0,17.0,3.0,0.0,2.0,0.0,1.0,0.0,0.0,0.0,1.0,0.0,3.0,0.0,0.0,0.0,1.0,2.0,5.0,2.0,0.0,0.0,3.0,0.0,0.0,5.0,0.0,1.0,1.0,0.0,3.0,0.0,1.0,0.0,2.0,0.0,5.0,4.0,1.0,1.0,0.0,0.0,0.0,0.0,5.0,1.0,2.0,0.0,2.0,0.0,0.0,1.0,3.0,3.0,0.0,2.0,0.0,0.0,0.0,2.0,5.0,2.0,0.0,4.0,0.0,0.0,1.0,2.0,2.0,3.0,0.0,0.0,1.0,0.0,4.0,1.0,2.0,3.0,3.0,0.0,1.0,0.0,2.0,4.0,0.0,13.0,9.0,8.0,5.0,0.0,1.0,4.0,3.0,20.0,0.0,5.0,5.0,2.0,16.0,1.0,1.0,6.0,0.0,9.0,8.0,7.0,19.0,4.0,7.0,1.0,5.0,14.0,2.0,9.0,3.0,2.0,3.0,4.0,4.0,0.0,1.0,0.0,8.0,3.0,5.0,6.0,0.0,1.0,7.0,3.0,6.0,54.0,7.0,16.0,1.0,4.0,11.0,13.0,2.0,15.0,7.0,8.0,1.0,2.0,7.0,0.0,0.0,3.0,17.0,4.0,11.0,3.0,8.0,1.0,6.0,1.0,9.0,0.0,4.0,23.0,11.0,8.0,7.0,7.0,7.0,28.0,2.0,0.0,1.0,2.0,0.0,8.0,1.0,1.0,1.0,1.0,0.0,2.0,8.0,18.0,1.0,0.0,18.0,6.0,3.0,17.0,8.0,10.0,0.0,5.0,3.0,8.0,17.0,12.0,35.0,0.0,3.0,5.0,12.0,2.0,6.0,2.0,1.0,1.0,7.0,3.0,13.0,0.0,4.0,0.0,3.0,22.0,0.0,7.0,0.0,5.0,4.0,8.0,5.0,18.0,6.0,12.0,40.0,3.0,0.0,5.0,3.0,11.0,3.0,7.0,12.0,2.0,3.0,7.0,11.0,3.0,13.0,19.0,0.0,10.0,0.0,0.0,4.0,1.0,24.0,2.0,11.0,30.0,2.0,10.0,2.0,18.0,8.0,17.0,0.0,0.0,0.0,1.0,10.0,5.0,1.0,1.0,2.0,7.0,6.0,16.0,3.0,7.0,11.0,5.0,9.0,0.0,9.0,0.0,0.0,4.0,6.0,6.0,31.0,6.0,7.0,4.0,1.0,5.0,1.0,1.0,4.0,4.0,25.0,13.0,12.0,7.0,6.0,9.0,11.0,0.0,12.0,10.0,4.0,8.0,4.0,2.0,11.0,2.0,4.0,12.0,12.0,3.0,0.0,4.0,0.0,0.0,13.0,6.0,4.0,1.0,5.0,1.0,4.0,0.0,5.0,0.0,4.0,2.0,2.0,12.0,4.0,6.0,6.0,2.0,0.0,4.0,13.0,0.0,1.0,0.0,12.0,2.0,0.0,14.0,11.0,5.0,0.0,1.0,9.0,17.0,11.0,1.0,13.0,0.0,2.0,0.0,6.0,1.0,9.0,2.0,10.0,10.0,12.0,0.0,7.0,8.0,12.0,0.0,0.0,0.0,4.0,7.0,2.0,0.0,12.0,7.0,0.0,9.0,6.0,1.0,1.0,7.0,3.0,13.0,6.0,1.0,2.0,4.0,1.0,4.0,2.0,3.0,2.0,4.0,0.0,0.0,14.0,2.0,8.0,4.0,7.0,0.0,2.0,6.0,1.0,10.0,1.0,8.0,0.0,2.0,1.0,15.0,0.0,0.0,13.0,7.0,4.0,4.0,2.0,0.0,0.0,0.0,7.0,6.0,11.0,8.0,4.0,4.0,9.0,2.0,7.0,3.0,3.0,14.0,4.0,0.0,3.0,0.0,2.0,4.0,3.0,4.0,5.0,3.0,4.0,2.0,6.0,27.0,8.0,14.0,13.0,9.0,2.0,0.0,10.0,17.0,11.0,16.0,19.0,1.0,4.0,0.0,1.0,11.0,0.0,1.0,0.0,0.0,1.0,3.0,0.0,0.0,2.0,0.0,2.0,9.0,5.0,0.0,1.0,1.0,1.0,2.0,0.0,1.0,0.0,0.0,1.0,2.0,0.0,3.0,1.0,0.0,2.0,0.0,0.0,0.0,1.0,4.0,0.0,0.0,3.0,1.0,0.0,0.0,1.0,1.0,0.0,3.0,2.0,1.0,1.0,0.0,1.0,0.0,0.0,1.0,1.0,0.0,0.0,1.0,3.0,0.0,3.0,4.0,1.0,0.0,0.0,1.0,1.0,3.0,0.0,2.0,0.0,1.0,0.0,0.0,0.0,1.0,4.0,0.0,1.0,0.0,1.0,2.0,7.0,10.0,4.0,12.0,7.0,6.0,10.0,5.0,5.0,5.0,5.0,5.0,5.0,5.0,5.0,3.0,5.0,5.0,1.0,4.0,5.0,5.0,3.0,5.0,5.0,5.0,5.0,5.0,5.0,5.0,5.0,1.0,5.0,5.0,5.0,5.0,5.0,5.0,5.0,5.0,5.0,3.0,0.0,5.0,0.0,5.0,5.0,1.0,0.0,0.0,0.0,0.0,2.0,0.0,1.0,0.0,2.0,0.0,2.0,0.0,3.0,3.0,0.0,4.0,0.0,1.0,1.0,1.0,3.0,4.0,0.0,0.0,0.0,1.0,4.0,0.0,1.0,3.0,2.0,2.0,1.0,0.0,3.0,3.0,5.0,2.0,3.0,2.0,0.0,2.0,1.0,0.0,1.0,2.0,1.0,3.0,7.0,4.0,6.0,4.0,2.0,0.0,4.0,3.0,1.0,5.0,2.0,1.0,1.0,0.0,1.0,0.0,1.0,0.0,2.0,0.0,1.0,2.0,0.0,2.0,0.0,5.0,2.0,0.0,0.0,1.0,1.0,0.0,0.0,0.0,1.0,2.0,2.0,5.0,1.0,4.0,2.0,2.0,1.0,4.0,2.0,3.0,0.0,3.0,2.0,1.0,0.0,0.0,1.0,0.0,1.0,0.0,0.0,2.0,7.0,2.0,0.0,1.0,0.0,0.0,0.0,10.0,0.0,1.0,2.0,0.0,0.0,0.0,1.0,4.0,0.0,7.0,0.0,0.0,0.0,3.0,3.0,5.0,0.0,5.0,1.0,2.0,2.0,2.0,5.0,1.0,2.0,1.0,1.0,1.0,0.0,1.0,7.0,0.0,0.0,3.0,0.0,3.0,3.0,2.0,1.0,0.0,3.0,3.0,0.0,4.0,0.0,1.0,0.0,2.0,4.0,5.0,1.0,4.0,2.0,3.0,0.0,2.0,1.0,2.0,0.0,1.0,0.0,4.0,1.0,1.0,1.0,0.0,1.0,4.0,1.0,0.0,3.0,2.0,3.0,0.0,2.0,2.0,2.0,0.0,5.0,0.0,1.0,1.0,4.0,1.0,4.0,0.0,5.0,5.0,0.0,5.0,12.0,8.0,8.0,4.0,5.0,0.0,20.0,8.0,12.0,3.0,6.0,7.0,7.0,14.0,15.0,11.0,4.0,18.0,9.0,6.0,4.0,13.0,6.0,28.0,4.0,5.0,11.0,9.0,9.0,9.0,10.0,17.0,12.0,10.0,12.0,10.0,10.0,2.0,12.0,7.0,10.0,9.0,7.0,6.0,3.0,6.0,7.0,7.0,,,,,,,,,,,,,,,,,,,,,,,,,,,,,,,,,,,,,,,,,,,,,,,,,,,,,,,,,,,,,,,,,,,,,,,,,,,,,,,,,,,,,,,,,,,,,,,,,,,,,,,,,,,,,,,,0.0,3.0,3.0,1.0,3.0,3.0,3.0,3.0,1.0,1.0,1.0,4.0,3.0,1.0,0.0,3.0,4.0,2.0,0.0,2.0,0.0,2.0,3.0,1.0,2.0,5.0,3.0,1.0,8.0,1.0,3.0,3.0,1.0,0.0,2.0,1.0,2.0,6.0,1.0,0.0,2.0,3.0,1.0,5.0,2.0,4.0,3.0,0.0,1.0,3.0,0.0,5.0,0.0,0.0,0.0,0.0,0.0,0.0,1.0,2.0,5.0,0.0,0.0,0.0,1.0,0.0,0.0,0.0,0.0,5.0,1.0,0.0,3.0,5.0,2.0,2.0,1.0,0.0,2.0,0.0,2.0,0.0,4.0,4.0,1.0,4.0,1.0,5.0,1.0,3.0,4.0,1.0,1.0,2.0,1.0,3.0,4.0,3.0,0.0,2.0,2.0,2.0,4.0,1.0,1.0,2.0,0.0,5.0,4.0,3.0,0.0,1.0,4.0,5.0,4.5,0.0,3.0,1.0,5.0,4.0,2.0,4.0,3.0,3.0,0.0,2.0,0.0,2.0,0.0,0.0,2.0,5.0,0.0,0.0,3.0,2.0,0.0,2.0,5.0,0.0,4.0,2.0,0.0,2.0,1.0,3.0,1.0,2.0,1.0,3.0,1.0,1.0,0.0,4.0,5.0,2.0,5.0,2.0,2.0,0.0,4.0,3.5,0.0,5.0,3.5,5.0,2.0,5.0,3.0,5.0,5.0,1.0,3.0,1.0,0.0,0.0,0.0,0.0,0.0,4.0,0.0,1.0,3.0,0.0,0.0,0.0,1.0,1.0,1.0,1.0,0.0,0.0,0.0,2.0,3.0,3.0,5.0,2.0,5.0,1.0,2.0,2.0,2.0,1.0,4.0,0.0,2.0,2.0,4.0,0.0,0.0,0.0,1.0,0.0,0.0,3.0,0.0,1.0,0.0,2.0,1.0,1.0,3.0,5.0,1.0,1.0,2.0,1.0,0.0,2.0,1.0,0.0,1.0,4.0,3.0,2.0,0.0,2.0,4.0,2.0,2.0,1.0,1.0,1.0,4.0,5.0,0.0,0.0,3.0,5.0,2.0,0.0,0.0,0.0,3.0,2.0,1.0,0.0,1.0,2.0,0.0,5.0,0.0,0.0,2.0,1.0,5.0,5.0,3.0,1.0,0.0,2.0,2.0,5.0,0.0,1.0,1.0,2.0,2.0,1.0,0.0,0.0,3.0,0.0,1.0,1.0,1.0,2.0,2.0,0.0,0.0,0.0,0.0,5.0,0.0,1.0,3.0,1.5,1.0,0.0,3.0,4.0,3.0,2.0,2.0,1.0,0.0,1.0,0.0,2.0,1.0,3.0,2.0,3.0,3.0,1.0,2.0,0.0,4.0,4.0,3.0,0.0,0.0,3.0,0.0,2.0,5.0,2.0,3.0,3.0,1.0,2.0,0.0,1.0,0.0,0.0,1.0,2.0,0.0,0.0,5.0,1.0,5.0,0.0,0.0,3.0,3.0,2.0,5.0,3.0,2.0,2.0,2.0,4.0,0.0,5.0,5.0,5.0,5.0,0.0,0.0,2.0,3.0,1.0,3.0,5.0,2.0,4.0,3.0,0.0,0.0,5.0,1.0,1.0,1.0,5.0,1.0,3.0,1.0,1.0,4.0,5.0,5.0,2.0,2.0,4.0,4.0,1.0,2.0,3.0,1.0,0.0,0.0,0.0,5.0,2.0,3.0,0.0,5.0,4.0,5.0,1.0,1.0,0.0,0.0,0.0,0.0,0.0,0.0,4.0,0.0,3.0,1.0,3.0,2.0,2.0,2.0,2.0,3.0,0.0,5.0,0.0,0.0,1.0,2.0,0.0,1.0,5.0,0.0,0.0,2.0,4.0,0.0,2.0,0.0,0.0,1.0,0.0,1.0,0.0,0.0,0.0,0.0,0.0,1.0,1.0,0.0,5.0,4.0,2.0,5.0,0.0,2.0,0.0,0.0,1.0,0.0,1.0,1.0,2.0,1.0,2.0,2.0,0.0,0.0,0.0,3.0,0.0,0.0,4.0,1.0,0.0,5.0,1.0,0.0,0.0,5.0,5.0,1.0,2.0,0.0,2.0,0.0,1.0,0.0,2.0,1.0,3.0,0.0,2.0,5.0,1.0,0.0,1.0,3.0,3.0,2.0,1.0,0.0,2.0,1.0,2.0,1.0,1.0,0.0,1.0,4.0,4.0,4.0,0.0,2.0,2.0,0.0,1.0,1.0,5.0,2.0,5.0,0.0,2.0,2.0,0.0,0.0,0.0,2.0,1.0,0.0,0.0,2.0,2.0,0.0,1.0,2.0,0.0,4.0,3.0,1.0,3.0,0.0,3.0,2.0,5.0,3.0,0.0,1.0,2.0,0.0,1.0,5.0,1.0,2.0,5.0,1.0,0.0,4.0,1.0,1.0,1.0,1.0,5.0,0.0,1.0,0.0,4.0,7.0,11.0,13.0,1.0,0.0,12.0,4.0,0.0,9.0,12.0,5.0,19.0,22.0,21.0,15.0,22.0,18.0,4.0,4.0,27.0,18.0,1.0,31.0,0.0,14.0,19.0,17.0,20.0,10.0,16.0,15.0,17.0,8.0,18.0,6.0,9.0,4.0,0.0,11.0,0.0,11.0,16.0,5.0,11.0,2.0,9.0,16.0,16.0,15.0,6.0,32.0,15.0,12.0,7.0,18.0,24.0,13.0,3.0,16.0,19.0,1.0,11.0,17.0,13.0,5.0,18.0,23.0,6.0,7.0,12.0,16.0,12.0,4.0,19.0,17.0,8.0,14.0,4.0,9.0,7.0,7.0,11.0,16.0,9.0,8.0,21.0,5.0,9.0,11.0,15.0,6.0,3.0,9.0,7.0,3.0,5.0,11.0,9.0,11.0,11.0,9.0,16.0,9.0,6.0,4.0,4.0,14.0,2.0,8.0,17.0,1.0,3.0,8.0,13.0,15.0,10.0,19.0,0.0,0.0,12.0,18.0,13.0,0.0,4.0,0.0,0.0,4.0,23.0,17.0,17.0,13.0,6.0,8.0,13.0,6.0,36.0,21.0,14.0,14.0,11.0,11.0,15.0,16.0,16.0,15.0,5.0,17.0,6.0,7.0,0.0,2.0,1.0,7.0,15.0,13.0,19.0,17.0,18.0,9.0,19.0,7.0,7.0,18.0,1.0,8.0,20.0,5.0,7.0,11.0,15.0,7.0,12.0,3.0,10.0,4.0,0.0,0.0,12.0,12.0,14.0,0.0,13.0,2.0,13.0,12.0,22.0,3.0,12.0,15.0,17.0,10.0,8.0,3.0,9.0,20.0,4.0,7.0,18.0,4.0,13.0,9.0,7.0,21.0,8.0,0.0,9.0,8.0,18.0,13.0,14.0,8.0,13.0,8.0,13.0,13.0,17.0,21.0,11.0,11.0,12.0,15.0,4.0,8.0,9.0,8.0,13.0,7.0,6.0,4.0,15.0,14.0,5.0,20.0,9.0,17.0,14.0,9.0,5.0,13.0,9.0,3.0,12.0,6.0,19.0,9.0,9.0,13.0,15.0,0.0,14.0,18.0,6.0,10.0,10.0,10.0,13.0,7.0,9.0,13.0,4.0,17.0,11.0,10.0,11.0,24.0,14.0,12.0,8.0,13.0,15.0,16.0,14.0,9.0,7.0,20.0,2.0,9.0,9.0,11.0,5.0,1.0,14.0,12.0,11.0,8.0,11.0,14.0,0.0,11.0,20.0,10.0,7.0,7.0,5.0,14.0,14.0,11.0,15.0,23.0,6.0,4.0,16.0,15.0,5.0,19.0,12.0,23.0,7.0,11.0,14.0,5.0,11.0,9.0,12.0,7.0,20.0,11.0,12.0,5.0,4.0,7.0,9.0,3.0,19.0,7.0,1.0,7.0,13.0,14.0,12.0,6.0,13.0,4.0,3.0,4.0,3.0,19.0,17.0,13.0,12.0,18.0,9.0,12.0,13.0,15.0,8.0,7.0,6.0,8.0,6.0,12.0,10.0,,,,,,,,,,,,,,,,,,,,,,,,,,,5.0,5.0,5.0,1.0,5.0,5.0,3.0,5.0,5.0,2.0,2.0,3.0,5.0,5.0,5.0,5.0,5.0,5.0,2.0,5.0,2.0,5.0,0.0,4.0,5.0,5.0,5.0,5.0,2.0,5.0,5.0,5.0,5.0,5.0,0.0,5.0,3.0,5.0,5.0,5.0,5.0,5.0,5.0,5.0,5.0,5.0,5.0,5.0,5.0,1.0,5.0,5.0,5.0,5.0,5.0,5.0,4.0,0.0,5.0,4.0,4.0,5.0,1.0,2.0,5.0,4.0,0.0,0.0,5.0,5.0,5.0,5.0,5.0,0.0,5.0,,2.0,1.0,5.0,3.0,5.0,0.0,2.0,5.0,5.0,5.0,5.0,1.0,5.0,0.0,5.0,4.0,5.0,5.0,1.0,2.0,3.0,0.0,5.0,5.0,4.0,5.0,2.0,1.0,2.0,5.0,5.0,5.0,5.0,3.0,5.0,2.0,4.0,5.0,0.0,3.0,4.0,5.0,3.0,4.0,5.0,5.0,2.0,5.0,5.0,5.0,5.0,3.0,5.0,5.0,1.0,5.0,4.0,5.0,5.0,2.0,5.0,1.0,5.0,3.0,5.0,5.0,5.0,5.0,5.0,5.0,5.0,3.0,1.0,3.0,5.0,4.0,5.0,3.0,5.0,5.0,18.0,16.0,12.0,1.0,2.0,3.0
10,3.0,5.0,5.0,5.0,4.0,7.0,3.0,5.0,5.0,4.0,4.0,2.0,2.0,5.0,5.0,22.0,6.0,5.0,5.0,5.0,7.0,2.0,7.0,0.0,2.0,7.0,5.0,4.0,6.0,1.0,4.0,4.0,5.0,11.0,5.0,5.0,5.0,2.0,6.0,6.0,4.0,5.0,4.0,4.0,3.0,4.0,10.0,6.0,2.0,2.0,4.0,2.0,3.0,0.0,3.0,6.0,0.0,3.0,0.0,0.0,0.0,0.0,0.0,0.0,0.0,0.0,0.0,0.0,0.0,0.0,0.0,0.0,0.0,0.0,0.0,0.0,0.0,0.0,0.0,,5.0,5.0,5.0,5.0,5.0,5.0,5.0,0.0,0.0,0.0,0.0,0.0,10.0,0.0,0.0,0.0,0.0,0.0,0.0,0.0,0.0,0.0,0.0,0.0,0.0,0.0,0.0,0.0,0.0,0.0,0.0,0.0,0.0,1.0,5.0,6.0,4.0,5.0,2.0,5.0,3.0,14.0,4.0,5.0,6.0,15.0,2.0,3.0,8.0,5.0,9.0,3.0,10.0,4.0,9.0,3.0,9.0,5.0,6.0,3.0,2.0,2.0,0.0,5.0,4.0,7.0,11.0,8.0,9.0,5.0,5.0,8.0,0.0,4.0,3.0,7.0,3.0,5.0,7.0,1.0,4.0,3.0,15.0,0.0,5.0,5.0,5.0,5.0,4.0,3.0,8.0,11.0,11.0,2.0,7.0,7.0,4.0,7.0,5.0,2.0,5.0,3.0,0.0,11.0,5.0,6.0,4.0,4.0,2.0,4.0,4.0,4.0,7.0,7.0,3.0,4.0,1.0,7.0,12.0,5.0,5.0,1.0,7.0,3.0,5.0,2.0,4.0,2.0,3.0,4.0,3.0,4.0,9.0,7.0,0.0,14.0,11.0,8.0,0.0,1.0,5.0,11.0,4.0,6.0,0.0,2.0,8.0,3.0,8.0,6.0,7.0,0.0,3.0,2.0,8.0,8.0,9.0,2.0,4.0,3.0,4.0,11.0,0.0,3.0,8.0,7.0,3.0,12.0,0.0,5.0,1.0,9.0,13.0,2.0,4.0,4.0,10.0,3.0,13.0,2.0,0.0,11.0,2.0,4.0,8.0,2.0,5.0,10.0,0.0,4.0,5.0,3.0,7.0,11.0,8.0,7.0,6.0,2.0,9.0,7.0,4.0,10.0,7.0,7.0,4.0,5.0,10.0,4.0,10.0,11.0,10.0,5.0,11.0,3.0,4.0,2.0,5.0,5.0,4.0,3.0,2.0,3.0,0.0,2.0,3.0,2.0,3.0,4.0,2.0,8.0,13.0,14.0,7.0,8.0,6.0,6.0,3.0,11.0,7.0,8.0,12.0,10.0,4.0,11.0,16.0,7.0,8.0,4.0,12.0,7.0,7.0,11.0,7.0,8.0,15.0,12.0,12.0,12.0,6.0,15.0,16.0,9.0,11.0,11.0,9.0,8.0,6.0,6.0,11.0,11.0,6.0,13.0,10.0,9.0,6.0,19.0,4.0,10.0,8.0,8.0,9.0,7.0,3.0,9.0,6.0,0.0,3.0,6.0,3.0,15.0,4.0,13.0,1.0,11.0,1.0,1.0,2.0,4.0,1.0,3.0,0.0,1.0,2.0,0.0,3.0,2.0,8.0,0.0,5.0,2.0,1.0,9.0,0.0,3.0,2.0,3.0,1.0,0.0,0.0,2.0,0.0,0.0,1.0,3.0,0.0,3.0,0.0,0.0,0.0,0.0,1.0,0.0,0.0,1.0,1.0,2.0,4.0,3.0,4.0,0.0,2.0,1.0,8.0,3.0,6.0,0.0,0.0,1.0,5.0,6.0,7.0,1.0,6.0,10.0,14.0,1.0,9.0,6.0,9.0,2.0,3.0,5.0,4.0,9.0,10.0,19.0,12.0,3.0,5.0,2.0,15.0,1.0,8.0,9.0,1.0,8.0,5.0,2.0,4.0,6.0,1.0,1.0,2.0,0.0,4.0,2.0,4.0,0.0,3.0,1.0,1.0,1.0,2.0,1.0,0.0,0.0,2.0,4.0,1.0,4.0,5.0,3.0,3.0,0.0,4.0,7.0,5.0,3.0,4.0,5.0,7.0,1.0,2.0,5.0,0.0,1.0,6.0,4.0,6.0,10.0,11.0,0.0,0.0,1.0,13.0,20.0,1.0,2.0,3.0,1.0,2.0,6.0,1.0,8.0,4.0,3.0,7.0,2.0,2.0,8.0,8.0,5.0,8.0,1.0,5.0,5.0,5.0,5.0,5.0,2.0,0.0,2.0,6.0,5.0,1.0,4.0,1.0,6.0,1.0,6.0,3.0,4.0,1.0,2.0,2.0,2.0,,,,,,,,,,,,,,,,,,,,,,,,,,,,,,,,,,10.5,12.0,8.5,7.0,7.5,,,8.0,10.0,15.0,21.0,4.5,9.0,,,,19.0,,,,,,,,,11.0,,,,,,,,5.5,5.0,,,12.0,7.0,15.0,7.0,,16.0,12.5,,3.0,12.0,4.0,,12.0,,,15.0,24.0,24.0,,,10.0,,13.0,7.0,14.0,21.0,18.0,6.0,0.0,2.0,0.0,0.0,18.0,0.0,0.0,0.0,0.0,0.0,1.0,0.0,2.0,7.0,0.0,3.0,0.0,2.0,1.0,0.0,0.0,2.0,5.0,5.0,5.0,1.0,5.0,1.0,0.0,1.0,0.0,5.0,0.0,0.0,3.0,2.0,5.0,5.0,2.0,0.0,5.0,4.0,4.0,2.0,1.0,5.0,3.0,0.0,5.0,1.0,5.0,0.0,0.0,5.0,2.0,3.0,1.0,0.0,1.0,2.0,1.0,2.0,5.0,0.0,5.0,1.0,5.0,5.0,5.0,4.0,5.0,5.0,5.0,8.0,7.0,0.0,0.0,1.0,8.0,10.0,1.0,1.0,17.0,2.0,1.0,6.0,3.0,4.0,0.0,4.0,1.0,1.0,4.0,3.0,6.0,9.0,3.0,6.0,4.0,4.0,4.0,3.0,5.0,3.0,0.0,0.0,4.0,5.0,3.0,1.0,3.0,7.0,3.0,3.0,7.0,6.0,3.0,9.0,14.0,9.0,7.0,8.0,7.0,8.0,10.0,9.0,13.0,6.0,4.0,11.0,11.0,5.0,13.0,6.0,3.0,12.0,11.0,11.0,6.0,5.0,4.0,5.0,8.0,6.0,7.0,8.0,5.0,8.0,0.0,4.0,5.0,4.0,7.0,2.0,5.0,9.0,5.0,3.0,5.0,11.0,9.0,7.0,7.0,12.0,6.0,9.0,7.0,6.0,7.0,11.0,3.0,5.0,6.0,8.0,0.0,5.0,4.0,6.0,7.0,4.0,4.0,5.0,5.0,5.0,5.0,5.0,8.0,4.0,6.0,8.0,4.0,13.0,5.0,3.0,3.0,3.0,5.0,3.0,8.0,6.0,9.0,6.0,8.0,9.0,7.0,4.0,10.0,5.0,6.0,7.0,7.0,6.0,6.0,17.0,3.0,0.0,3.0,5.0,20.0,7.0,15.0,7.0,11.0,12.0,1.0,0.0,15.0,0.0,23.0,28.0,3.0,7.0,20.0,4.0,7.0,4.0,2.0,4.0,17.0,13.0,23.0,19.0,20.0,9.0,16.0,6.0,23.0,3.0,7.0,23.0,11.0,14.0,7.0,2.0,3.0,2.0,1.0,3.0,12.0,1.0,4.0,12.0,6.0,16.0,5.0,2.0,1.0,17.0,14.0,0.0,4.5,17.0,0.0,14.0,17.0,0.0,16.0,4.0,8.0,3.0,5.0,3.0,5.0,2.0,5.0,0.0,0.0,7.0,14.0,20.0,8.0,14.0,13.0,5.0,8.0,19.0,13.0,1.0,15.0,13.0,7.0,8.0,9.0,9.0,2.0,1.0,19.0,4.0,3.0,6.0,19.0,10.0,19.0,6.0,0.0,4.0,4.0,1.0,7.0,11.0,10.0,11.0,12.0,11.0,9.0,9.0,1.0,8.0,8.0,0.0,10.0,7.0,17.0,6.0,6.0,1.0,3.0,2.0,3.0,19.0,2.0,3.0,0.0,6.0,3.0,5.0,9.0,1.0,6.0,6.0,1.0,6.0,8.0,2.0,10.0,7.0,6.0,6.0,0.0,3.0,2.0,9.0,18.0,21.0,7.0,10.0,3.0,8.0,10.0,1.0,0.0,4.0,3.0,8.0,3.0,2.0,1.0,10.0,24.0,4.0,9.0,9.0,0.0,3.0,3.0,19.0,3.0,3.0,6.0,0.0,4.0,22.0,12.0,0.0,14.0,9.0,0.0,13.0,19.0,12.0,3.0,12.0,21.0,2.0,4.0,4.0,1.0,3.0,1.0,1.0,3.0,3.0,2.0,0.0,5.0,3.0,4.0,1.0,4.0,3.0,2.0,2.0,2.0,5.0,6.0,1.0,5.0,3.0,1.0,2.0,0.0,4.0,0.0,2.0,2.0,2.0,5.0,4.0,5.0,1.0,4.0,1.0,0.0,2.0,0.0,3.0,1.0,1.0,1.0,0.0,1.0,2.0,1.0,0.0,1.0,0.0,4.0,1.0,5.0,0.0,4.0,0.0,6.0,2.0,1.0,3.0,2.0,2.0,2.0,2.0,3.0,0.0,1.0,1.0,0.0,0.0,0.0,5.0,1.0,2.0,1.0,9.0,0.0,4.0,8.0,3.0,0.0,0.0,0.0,2.0,6.0,7.0,9.0,15.0,6.0,1.0,2.0,3.0,4.0,0.0,6.0,4.0,1.0,4.0,9.0,0.0,2.0,0.0,3.0,1.0,15.0,3.0,7.0,8.0,2.0,1.0,2.0,2.0,4.0,11.0,0.0,0.0,1.0,5.0,5.0,4.0,4.0,7.0,2.0,1.0,10.0,3.0,5.0,6.0,8.0,4.0,1.0,6.0,9.0,0.0,5.0,4.0,7.0,4.0,1.0,6.0,11.0,0.0,1.0,1.0,0.0,1.0,6.0,3.0,4.0,9.0,0.0,8.0,5.0,1.0,3.0,2.0,4.0,4.0,4.0,2.0,5.0,14.0,3.0,1.0,2.0,4.0,3.0,2.0,0.5,4.0,14.0,0.5,9.0,1.0,4.0,12.0,7.5,12.0,17.0,4.0,5.0,4.5,17.0,9.5,2.0,1.0,9.5,5.5,18.5,1.0,1.0,7.5,3.5,4.5,1.5,14.5,0.5,6.5,0.5,6.5,7.0,14.0,4.0,4.0,5.5,9.0,8.5,11.0,1.5,3.0,7.5,1.5,5.5,5.5,8.0,6.0,3.5,2.5,4.0,11.0,1.5,9.5,0.5,9.5,0.5,8.0,5.0,4.0,2.0,0.0,1.0,0.0,0.0,0.0,0.0,0.0,0.0,0.0,0.0,5.0,0.0,0.0,0.0,2.0,0.0,0.0,0.0,1.0,0.0,3.0,0.0,2.0,0.0,0.0,10.0,0.0,2.0,0.0,4.0,0.0,1.0,0.0,2.0,0.0,2.0,1.0,4.0,2.0,1.0,2.0,3.0,0.0,1.0,4.0,2.0,0.0,0.0,0.0,0.0,3.0,0.0,0.0,0.0,0.0,0.0,2.0,0.0,0.0,0.0,0.0,0.0,4.0,2.0,0.0,0.0,0.0,0.0,0.0,0.0,5.0,3.0,0.0,0.0,0.0,0.0,0.0,2.0,8.0,6.0,0.0,3.0,4.0,0.0,0.0,0.0,0.0,0.0,0.0,0.0,0.0,0.0,0.0,0.0,0.0,4.0,0.0,1.0,0.0,0.0,0.0,0.0,0.0,0.0,0.0,0.0,4.0,0.0,0.0,0.0,0.0,0.0,0.0,0.0,0.0,0.0,0.0,6.0,0.0,0.0,0.0,0.0,0.0,0.0,0.0,0.0,0.0,6.0,0.0,5.0,0.0,2.0,0.0,0.0,4.0,0.0,0.0,0.0,0.0,0.0,0.0,0.0,0.0,1.0,2.0,0.0,0.0,0.0,0.0,1.0,0.0,0.0,1.0,1.0,0.0,0.0,2.0,0.0,0.0,3.0,0.0,0.0,1.0,3.0,4.0,0.0,0.0,0.0,3.0,0.0,1.0,0.0,2.1666666666666665,4.0,0.0,0.0,0.0,0.0,0.0,3.0,2.3333333333333335,0.0,2.0,0.0,1.0,0.0,2.0,3.0,3.0,1.0,4.0,2.0,0.0,0.0,0.0,0.0,0.0,0.0,0.0,0.0,0.0,0.0,0.0,0.0,0.0,0.0,3.0,0.0,0.0,0.0,0.0,1.0,0.0,0.0,0.0,0.0,0.0,0.0,0.0,0.0,0.0,1.0,2.0,2.0,0.0,0.0,0.0,2.0,0.0,0.0,3.0,0.0,0.0,0.0,0.0,0.0,0.0,0.0,0.0,0.0,0.0,0.0,0.0,0.0,0.0,0.0,0.0,0.0,0.0,4.0,0.0,0.0,0.0,3.0,0.0,2.0,1.5,3.0,0.0,0.0,0.0,0.0,0.0,7.0,0.0,0.0,0.0,2.0,0.0,0.0,5.0,0.0,0.0,0.0,0.0,4.0,0.0,0.0,4.0,0.0,0.0,15.0,24.0,10.0,11.0,16.0,16.0,2.0,2.0,13.0,6.0,3.0,11.0,10.0,18.0,21.0,0.0,6.0,2.0,2.0,13.0,4.0,0.0,1.0,0.0,0.0,10.0,25.0,18.0,5.0,23.0,18.0,0.0,2.0,1.0,1.0,26.0,11.0,20.0,5.0,11.0,18.0,41.0,10.0,19.0,12.0,15.0,9.0,11.0,4.0,3.0,5.0,18.0,13.0,1.0,16.0,17.0,24.0,27.0,23.0,11.0,1.0,17.0,17.0,7.0,26.0,24.0,22.0,24.0,12.0,22.0,1.0,11.0,30.0,28.0,19.0,12.0,27.0,0.0,22.0,8.0,6.0,17.0,34.0,29.0,26.0,1.0,15.0,20.0,25.0,0.0,21.0,7.0,11.0,36.0,4.0,4.0,22.0,4.0,1.0,0.0,1.0,7.0,8.0,24.0,1.0,0.0,1.0,5.0,3.0,22.0,1.0,6.0,1.0,0.0,1.0,18.0,0.0,18.0,12.0,19.0,28.0,20.0,12.0,0.0,0.0,2.0,9.0,3.0,22.0,7.0,5.0,0.0,1.0,0.0,0.0,2.0,17.0,5.0,1.0,1.0,7.0,0.0,0.0,0.0,0.0,1.0,16.0,0.0,0.0,14.0,1.0,4.0,1.0,6.0,8.0,5.0,13.0,1.0,3.0,17.0,18.0,6.0,2.0,0.0,2.0,13.0,2.0,13.0,3.0,2.0,2.0,0.0,0.0,0.0,9.0,0.0,10.0,9.0,0.0,9.0,4.0,2.0,3.0,12.0,3.0,11.0,6.0,12.0,3.0,3.0,2.0,10.0,10.0,12.0,0.0,2.0,0.0,1.0,1.0,0.0,1.0,0.0,1.0,0.0,2.0,20.0,0.0,9.0,14.0,2.0,7.0,0.0,1.0,0.0,1.0,1.0,2.0,0.0,0.0,1.0,17.0,11.0,0.0,4.0,1.0,4.0,1.0,9.0,7.0,6.0,1.0,2.0,1.0,16.0,21.0,14.0,0.0,1.0,1.0,1.0,7.0,22.0,0.0,5.0,25.0,0.0,1.0,2.0,10.0,1.0,16.0,2.0,13.0,18.0,16.0,21.0,3.0,15.0,3.0,18.0,11.0,13.0,9.0,26.0,16.0,10.0,16.0,16.0,5.0,24.0,24.0,24.0,30.0,17.0,19.0,28.0,13.0,8.0,30.0,26.0,2.0,1.0,0.0,,12.0,15.0,18.0,21.0,27.0,2.0,22.0,30.0,3.0,3.0,2.0,2.0,21.0,4.0,1.0,9.0,8.0,23.0,18.0,27.0,22.0,14.0,20.0,14.0,9.0,2.0,2.0,9.0,8.0,2.0,12.0,43.0,11.0,5.0,8.0,20.0,16.0,20.0,21.0,14.0,3.0,8.0,25.0,23.0,13.0,27.0,0.0,26.0,24.0,22.0,2.0,21.0,23.0,22.0,17.0,0.0,2.0,9.0,29.0,21.0,0.0,1.0,2.0,2.0,15.0,16.0,3.0,25.0,13.0,3.0,42.0,22.0,16.0,17.0,22.0,21.0,1.0,4.0,0.0,15.0,18.0,5.0,16.0,11.0,14.0,20.0,19.0,23.0,26.0,23.0,26.0,18.0,20.0,13.0,2.0,21.0,18.0,2.0,2.0,9.0,6.0,1.0,0.0,1.0,17.0,15.0,13.0,0.0,0.0,3.0,4.0,,2.0,1.0,9.0,16.0,7.0,17.0,10.0,1.0,1.0,0.0,3.0,2.0,6.0,0.0,0.0,0.0,0.0,0.0,0.0,0.0,,0.0,,0.0,0.0,0.0,0.0,0.0,0.0,9.0,5.0,5.0,2.0,7.0,6.0,7.0,9.0,3.0,6.0,3.0,3.0,5.0,2.0,3.0,2.0,7.0,8.0,7.0,6.0,4.0,7.0,12.0,16.0,5.0,13.0,22.0,8.0,4.0,10.0,3.0,7.0,5.0,4.0,6.0,6.0,20.0,6.0,6.0,10.0,4.0,8.0,9.0,15.0,16.0,1.0,6.0,9.0,8.0,7.0,7.0,10.0,8.0,4.0,9.0,4.0,12.0,5.0,8.0,0.0,7.0,5.0,10.0,12.0,8.0,24.0,10.0,9.0,7.0,6.0,5.0,11.0,22.0,11.0,13.0,2.0,5.0,21.0,7.0,2.0,3.0,6.0,7.0,5.0,6.0,14.0,8.0,9.0,19.0,2.0,4.0,14.0,4.0,10.0,7.0,5.0,0.0,5.0,5.0,5.0,11.0,10.0,6.0,5.0,3.0,10.0,8.0,5.0,2.0,6.0,22.0,5.0,6.0,8.0,7.0,8.0,6.0,9.0,6.0,4.0,4.0,5.0,2.0,3.0,9.0,13.0,22.0,8.0,17.0,6.0,0.0,3.0,1.0,10.0,13.0,8.0,6.0,14.0,0.0,0.0,5.0,3.0,8.0,12.0,5.0,10.0,6.0,1.0,9.0,2.0,7.0,9.0,3.0,6.0,10.0,0.0,5.0,0.0,3.0,2.0,2.0,3.0,2.0,2.0,3.0,0.0,0.0,4.0,0.0,2.0,4.0,8.0,1.0,1.0,4.0,8.0,1.0,5.0,7.0,7.0,7.0,3.0,1.0,8.0,5.0,5.0,0.0,11.0,,2.0,4.0,9.0,13.0,11.0,2.0,10.0,13.0,12.0,10.0,11.0,20.0,4.0,11.0,2.0,4.0,3.0,11.0,1.0,7.0,18.0,4.0,14.0,1.0,35.0,10.0,5.0,2.0,9.0,2.0,7.0,9.0,1.0,63.0,6.0,3.0,10.0,9.0,0.0,4.0,10.0,1.0,7.0,16.0,2.0,5.0,3.0,11.0,1.0,2.0,1.0,7.0,,28.0,4.0,3.0,1.0,16.0,5.0,4.0,15.0,3.0,0.0,7.0,17.0,8.0,1.0,6.0,9.0,3.0,2.0,4.0,1.0,23.0,1.0,13.0,13.0,6.0,3.0,3.0,11.0,0.0,1.0,2.0,3.0,2.0,20.0,14.0,2.0,,3.0,3.0,4.0,17.0,3.0,1.0,16.0,4.0,1.0,9.0,11.0,13.0,10.0,17.0,3.0,17.0,4.0,14.0,3.0,4.0,4.0,1.0,10.0,14.0,7.0,6.0,6.0,3.0,6.0,3.0,8.0,3.0,7.0,,19.0,4.0,6.0,8.0,9.0,12.0,9.0,9.0,15.0,15.0,10.0,17.0,17.0,16.0,3.0,7.0,4.0,2.0,9.0,3.0,5.0,12.0,14.0,17.0,8.0,1.0,4.0,0.0,12.0,4.0,13.0,4.0,17.0,6.0,42.0,23.0,19.0,12.0,19.0,9.0,5.0,2.0,12.0,4.0,1.0,1.0,9.0,10.0,11.0,20.0,8.0,1.0,21.0,17.0,11.0,14.0,10.0,23.0,6.0,7.0,9.0,9.0,9.0,15.0,10.0,9.0,5.0,6.0,25.0,13.0,6.0,12.0,1.0,5.0,19.0,8.0,4.0,14.0,8.0,3.0,1.0,2.0,0.0,17.0,8.0,16.0,18.0,12.0,7.0,2.0,5.0,12.0,10.0,0.0,5.0,8.0,8.0,9.0,,22.0,13.0,3.0,17.0,14.0,2.0,5.0,13.0,13.0,6.0,11.0,14.0,11.0,4.0,9.0,10.0,9.0,,14.0,12.0,14.0,2.0,3.0,10.0,12.0,6.0,10.0,14.0,16.0,7.0,1.0,13.0,12.0,5.0,5.0,1.0,1.0,7.0,1.0,7.0,18.0,9.0,6.0,2.0,4.0,,12.0,16.0,6.0,15.0,6.0,4.0,10.0,12.0,12.0,2.0,14.0,0.0,12.0,1.0,1.0,8.0,1.0,9.0,12.0,5.0,5.0,4.0,9.0,4.0,12.0,8.0,8.0,17.0,1.0,15.0,15.0,16.0,9.0,4.0,16.0,8.0,13.0,8.0,2.0,9.0,12.0,4.0,17.0,1.0,24.0,13.0,3.0,2.0,9.0,11.0,13.0,12.0,13.0,4.0,19.0,16.0,5.0,12.0,2.0,15.0,23.0,18.0,7.0,2.0,6.0,23.0,3.0,10.0,18.0,3.0,8.0,8.0,16.0,9.0,13.0,1.0,4.0,2.0,12.0,13.0,,21.0,13.0,7.0,1.0,5.0,2.0,10.0,4.0,2.0,1.0,6.0,,3.0,1.0,3.0,8.0,11.0,4.0,4.0,10.0,7.0,13.0,10.0,10.0,15.0,6.0,21.0,5.0,5.0,8.0,6.0,4.0,4.0,8.0,6.0,8.0,11.0,5.0,21.0,0.0,4.0,1.0,5.0,11.0,2.0,3.0,1.0,2.0,4.0,9.0,13.0,15.0,13.0,,2.0,8.0,16.0,1.0,0.0,7.0,13.0,5.0,18.0,3.0,12.0,18.0,4.0,8.0,5.0,15.0,9.0,13.0,3.0,9.0,2.0,20.0,6.0,5.0,1.0,17.0,13.0,,7.0,6.0,10.0,3.0,5.0,5.0,9.0,23.0,0.0,24.0,3.0,8.0,3.0,4.0,3.0,20.0,3.0,8.0,1.0,4.0,2.0,1.0,0.0,0.0,5.0,3.0,8.0,7.0,2.0,9.0,10.0,4.0,8.0,6.0,2.0,3.0,0.0,1.0,2.0,7.0,1.0,3.0,0.0,10.0,0.0,2.0,5.0,1.0,6.0,3.0,1.0,3.0,3.0,1.0,2.0,0.0,2.0,2.0,1.0,0.0,7.0,1.0,1.0,5.0,0.0,11.0,8.0,1.0,0.0,1.0,0.0,1.0,1.0,4.0,2.0,0.0,8.0,0.0,0.0,0.0,7.0,1.0,1.0,3.0,2.0,0.0,1.0,5.0,0.0,4.0,1.0,0.0,0.0,5.0,4.0,1.0,5.0,5.0,0.0,5.0,5.0,3.0,5.0,3.0,15.0,2.0,11.0,16.0,8.0,6.0,24.0,3.0,0.0,8.0,4.0,24.0,14.0,16.0,8.0,6.0,3.0,5.0,13.0,27.0,7.0,8.0,15.0,6.0,7.0,13.0,0.0,19.0,5.0,9.0,9.0,15.0,19.0,21.0,12.0,16.0,1.0,8.0,18.0,10.0,2.0,12.0,14.0,1.0,16.0,12.0,11.0,0.0,6.0,3.0,24.0,6.0,26.0,13.0,17.0,6.0,11.0,17.0,14.0,14.0,16.0,13.0,11.0,4.0,10.0,11.0,10.0,10.0,6.0,12.0,21.0,18.0,20.0,12.0,19.0,13.0,13.0,7.0,20.0,19.0,7.0,14.0,10.0,6.0,2.0,29.0,4.0,10.0,5.0,9.0,1.0,14.0,11.0,14.0,33.0,10.0,21.0,14.0,17.0,14.0,17.0,6.0,8.0,17.0,12.0,8.0,10.0,3.0,16.0,22.0,19.0,8.0,12.0,7.0,8.0,4.0,9.0,9.0,7.0,8.0,12.0,25.0,4.0,5.0,8.0,19.0,5.0,9.0,11.0,10.0,18.0,0.0,1.0,18.0,15.0,2.0,3.0,18.0,24.0,30.0,11.0,8.0,10.0,9.0,12.0,9.0,9.0,13.0,8.0,8.0,11.0,21.0,16.0,19.0,6.0,5.0,5.0,9.0,17.0,14.0,14.0,9.0,14.0,12.0,5.0,19.0,9.0,3.0,24.0,17.0,15.0,14.0,19.0,3.0,2.0,22.0,18.0,22.0,6.0,4.0,19.0,8.0,7.0,15.0,3.0,19.0,12.0,14.0,4.0,13.0,6.0,34.0,13.0,14.0,8.0,12.0,8.0,15.0,8.0,10.0,11.0,13.0,5.0,11.0,16.0,13.0,2.0,19.0,27.0,17.0,15.0,17.0,10.0,11.0,6.0,15.0,14.0,19.0,6.0,23.0,8.0,9.0,7.0,8.0,2.0,16.0,22.0,13.0,22.0,3.0,14.0,8.0,16.0,7.0,17.0,7.0,2.0,6.0,7.0,18.0,19.0,7.0,14.0,16.0,6.0,9.0,12.0,10.0,6.0,10.0,14.0,16.0,15.0,12.0,17.0,11.0,12.0,14.0,10.0,15.0,11.0,4.0,9.0,4.0,5.0,8.0,15.0,7.0,7.0,10.0,6.0,16.0,23.0,11.0,12.0,14.0,14.0,11.0,14.0,14.0,13.0,9.0,1.0,15.0,6.0,14.0,13.0,10.0,8.0,9.0,5.0,14.0,8.0,12.0,5.0,12.0,11.0,4.0,6.0,4.0,2.0,1.0,0.0,8.0,13.0,14.0,9.0,13.0,6.0,6.0,3.0,13.0,5.0,11.0,11.0,12.0,4.0,13.0,14.0,12.0,5.0,12.0,10.0,20.0,6.0,7.0,14.0,4.0,7.0,2.0,0.0,3.0,0.0,0.0,0.0,3.0,7.0,3.0,11.0,13.0,11.0,11.0,1.0,14.0,12.0,0.0,6.0,8.0,2.0,6.0,6.0,7.0,9.0,12.0,11.0,1.0,5.0,9.0,12.0,5.0,5.0,9.0,5.0,14.0,12.0,19.0,5.0,9.0,5.0,23.0,7.0,15.0,0.0,5.0,9.0,13.0,3.0,18.0,5.0,11.0,20.0,6.0,9.0,14.0,8.0,13.0,8.0,9.0,9.0,10.0,2.0,5.0,24.0,0.0,0.0,8.0,12.0,14.0,3.0,1.0,2.0,0.0,8.0,10.0,4.0,9.0,3.0,15.0,4.0,12.0,12.0,4.0,16.0,15.0,16.0,19.0,0.0,3.0,2.0,4.0,0.0,7.0,1.0,0.0,16.0,1.0,3.0,0.0,10.0,5.0,7.0,0.0,7.0,0.0,11.0,4.0,7.0,0.0,2.0,7.0,0.0,3.0,10.0,2.0,10.0,4.0,8.0,0.0,6.0,12.0,17.0,2.0,8.0,1.0,0.0,2.0,11.0,3.0,6.0,1.0,2.0,2.0,10.0,1.0,10.0,6.0,0.0,6.0,1.0,3.0,6.0,1.0,0.0,0.0,3.0,5.0,3.0,3.0,1.0,6.0,4.0,22.0,17.0,0.0,13.0,7.0,5.0,0.0,4.0,2.0,12.0,2.0,0.0,9.0,5.0,10.0,9.0,7.0,10.0,0.0,7.0,9.0,11.0,5.0,5.0,10.0,8.0,2.0,0.0,6.0,7.0,1.0,10.0,1.0,3.0,1.0,4.0,2.0,7.0,14.0,17.0,15.0,8.0,14.0,15.0,11.0,9.0,0.0,21.0,2.0,13.0,18.0,8.0,6.0,1.0,1.0,2.0,6.0,0.0,0.0,12.0,8.0,2.0,4.0,2.0,4.0,0.0,12.0,2.0,23.0,10.0,1.0,0.0,5.0,6.0,1.0,4.0,1.0,3.0,7.0,0.0,6.0,6.0,9.0,10.0,5.0,3.0,6.0,2.0,11.0,1.0,4.0,7.0,3.0,6.0,7.0,1.0,1.0,4.0,16.0,6.0,4.0,1.0,4.0,0.0,17.0,1.0,3.0,0.0,8.0,5.0,6.0,3.0,6.0,1.0,4.0,5.0,7.0,5.0,0.0,1.0,7.0,2.0,4.0,0.0,10.0,5.0,2.0,11.0,3.0,9.0,8.0,0.0,3.0,2.0,3.0,1.0,2.0,8.0,4.0,1.0,5.0,9.0,2.0,0.0,0.0,3.0,8.0,16.0,7.0,1.0,0.0,4.0,10.0,2.0,2.0,0.0,8.0,7.0,7.0,0.0,1.0,6.0,17.0,1.0,10.0,0.0,3.0,3.0,1.0,4.0,1.0,10.0,6.0,8.0,5.0,8.0,0.0,11.0,1.0,5.0,16.0,1.0,1.0,5.0,2.0,4.0,1.0,0.0,1.0,1.0,0.0,16.0,7.0,0.0,0.0,48.0,4.0,5.0,9.0,11.0,6.0,5.0,5.0,4.0,7.0,2.0,15.0,6.0,8.0,0.0,0.0,9.0,5.0,5.0,8.0,9.0,7.0,39.0,4.0,17.0,1.0,3.0,3.0,6.0,4.0,4.0,1.0,0.0,9.0,9.0,6.0,2.0,5.0,19.0,4.0,7.0,6.0,2.0,1.0,7.0,6.0,7.0,10.0,1.0,6.0,4.0,16.0,7.0,5.0,6.0,0.0,3.0,8.0,3.0,9.0,6.0,3.0,0.0,5.0,1.0,4.0,5.0,6.0,6.0,2.0,2.0,2.0,4.0,0.0,5.0,13.0,3.0,4.0,1.0,6.0,9.0,3.0,2.0,2.0,1.0,8.0,4.0,1.0,1.0,2.0,3.0,5.0,2.0,2.0,3.0,6.0,2.0,8.0,5.0,12.0,3.0,11.0,1.0,9.0,1.0,5.0,4.0,8.0,6.0,9.0,3.0,3.0,4.0,6.0,3.0,5.0,2.0,3.0,11.0,11.0,4.0,13.0,9.0,11.0,2.0,9.0,7.0,13.0,9.0,4.0,7.0,15.0,11.0,9.0,2.0,11.0,9.0,9.0,12.0,11.0,11.0,13.0,8.0,3.0,0.0,3.0,11.0,1.0,13.0,6.0,10.0,13.0,9.0,4.0,3.0,3.0,4.0,6.0,4.0,5.0,8.0,4.0,2.0,15.0,6.0,2.0,9.0,11.0,2.0,7.0,7.0,2.0,15.0,11.0,4.0,11.0,14.0,5.0,9.0,9.0,6.0,3.0,8.0,7.0,2.0,4.0,3.0,5.0,2.0,3.0,5.0,7.0,5.0,2.0,5.0,2.0,5.0,4.0,4.0,4.0,7.0,9.0,16.0,3.0,5.0,3.0,6.0,2.0,3.0,4.0,6.0,4.0,3.0,0.0,3.0,3.0,3.0,6.0,9.0,11.0,9.0,9.0,6.0,6.0,2.0,5.0,1.0,10.0,3.0,10.0,10.0,10.0,15.0,5.0,14.0,13.0,5.0,4.0,4.0,14.0,2.0,8.0,4.0,2.0,7.0,7.0,1.0,7.0,3.0,4.0,4.0,4.0,5.0,5.0,6.0,6.0,8.0,7.0,8.0,6.0,7.0,5.0,3.0,11.0,13.0,6.0,16.0,8.0,5.0,8.0,10.0,11.0,6.0,4.0,13.0,7.0,12.0,8.0,10.0,11.0,12.0,4.0,5.0,4.0,8.0,6.0,7.0,14.0,5.0,7.0,10.0,7.0,4.0,5.0,11.0,10.0,6.0,10.0,9.0,10.0,9.0,8.0,6.0,13.0,5.0,2.0,14.0,20.0,2.0,8.0,7.0,14.0,5.0,12.0,15.0,7.0,7.0,9.0,6.0,3.0,17.0,11.0,9.0,12.0,7.0,7.0,8.0,6.0,7.0,11.0,5.0,14.0,9.0,6.0,6.0,11.0,8.0,8.0,5.0,12.0,5.0,9.0,7.0,1.0,12.0,12.0,7.0,7.0,10.0,9.0,8.0,11.0,9.0,12.0,7.0,9.0,2.0,11.0,9.0,3.0,4.0,9.0,14.0,4.0,11.0,9.0,9.0,4.0,3.0,4.0,14.0,5.0,6.0,5.0,9.0,4.0,11.0,9.0,6.0,7.0,2.0,10.0,8.0,7.0,9.0,13.0,12.0,6.0,7.0,15.0,18.0,11.0,6.0,11.0,6.0,16.0,9.0,12.0,4.0,7.0,5.0,18.0,15.0,6.0,3.0,9.0,7.0,6.0,10.0,6.0,9.0,10.0,5.0,11.0,7.0,9.0,5.0,6.0,8.0,9.0,1.0,5.0,9.0,5.0,7.0,5.0,9.0,6.0,3.0,2.0,7.0,6.0,7.0,6.0,13.0,4.0,3.0,8.0,10.0,12.0,8.0,7.0,19.0,10.0,8.0,10.0,8.0,3.0,8.0,5.0,5.0,8.0,8.0,6.0,8.0,6.0,4.0,3.0,7.0,6.0,3.0,10.0,1.0,8.0,3.0,4.0,6.0,4.0,0.0,2.0,8.0,12.0,1.0,6.0,0.0,4.0,6.0,2.0,1.0,5.0,3.0,8.0,4.0,1.0,4.0,8.0,1.0,6.0,3.0,0.0,0.0,4.0,8.0,3.0,1.0,5.0,5.0,3.0,5.0,0.0,5.0,3.0,5.0,1.0,5.0,5.0,5.0,3.0,5.0,5.0,2.0,5.0,0.0,0.0,3.0,3.0,5.0,5.0,1.0,1.0,2.0,2.0,2.0,4.0,2.0,2.0,2.0,5.0,5.0,4.0,2.0,3.0,1.0,5.0,5.0,5.0,5.0,0.0,5.0,1.0,0.0,5.0,5.0,2.0,4.0,5.0,5.0,5.0,1.0,5.0,5.0,2.0,3.0,3.0,3.0,5.0,5.0,5.0,5.0,5.0,5.0,3.0,0.0,5.0,5.0,5.0,5.0,5.0,5.0,5.0,0.0,5.0,4.0,5.0,1.0,5.0,3.0,5.0,5.0,5.0,1.0,0.0,0.0,0.0,0.0,0.0,0.0,0.0,4.0,0.0,1.0,1.0,4.0,5.0,5.0,1.0,0.0,0.0,1.0,1.0,0.0,0.0,8.0,1.0,0.0,0.0,1.0,0.0,2.0,1.0,2.0,1.0,0.0,1.0,2.0,1.0,16.0,0.0,0.0,5.0,2.0,7.0,20.0,7.0,15.0,8.0,22.0,13.0,20.0,14.0,26.0,12.0,8.0,16.0,12.0,3.0,5.0,14.0,11.0,16.0,7.0,5.0,17.0,25.0,11.0,11.0,17.0,1.0,0.0,7.0,2.0,5.0,10.0,7.0,8.0,13.0,6.0,4.0,14.0,6.0,6.0,8.0,3.0,17.0,7.0,14.0,18.0,10.0,5.0,5.0,14.0,,10.0,18.0,25.0,7.0,11.0,7.0,16.0,12.0,16.0,10.0,8.0,8.0,22.0,2.0,10.0,17.0,21.0,11.0,15.0,19.0,16.0,6.0,23.0,4.0,20.0,24.0,6.0,5.0,22.0,21.0,32.0,10.0,15.0,8.0,18.0,6.0,1.0,12.0,8.0,2.0,0.0,1.0,5.0,5.0,2.0,4.0,9.0,12.0,7.0,15.0,13.0,12.0,8.0,9.0,16.0,0.0,3.0,2.0,15.0,22.0,24.0,11.0,8.0,10.0,15.0,6.0,6.0,0.0,5.0,9.0,19.0,22.0,6.0,14.0,1.0,5.0,6.0,16.0,15.0,23.0,17.0,7.0,6.0,17.0,19.0,1.0,4.0,7.0,9.0,6.0,15.0,14.0,10.0,13.0,1.0,9.0,13.0,11.0,5.0,18.0,15.0,7.0,20.0,15.0,23.0,8.0,16.0,14.0,25.0,10.0,23.0,5.0,6.0,21.0,21.0,14.0,9.0,13.0,11.0,11.0,4.0,16.0,11.0,6.0,1.0,9.0,16.0,24.0,18.0,1.0,13.0,1.0,3.0,23.0,14.0,5.0,10.0,10.0,0.0,6.0,20.0,13.0,10.0,6.0,2.0,20.0,1.0,15.0,11.0,16.0,7.0,10.0,19.0,4.0,9.0,0.0,7.0,15.0,2.0,7.0,1.0,4.0,16.0,7.0,14.0,6.0,14.0,7.0,5.0,10.0,3.0,14.0,9.0,9.0,19.0,17.0,15.0,13.0,4.0,19.0,9.0,14.0,10.0,20.0,18.0,14.0,14.0,13.0,3.0,6.0,12.0,12.0,25.0,9.0,16.0,9.0,1.0,5.0,5.0,8.0,2.0,2.0,9.0,10.0,6.0,11.0,21.0,11.0,18.0,1.0,5.0,9.0,21.0,9.0,10.0,13.0,13.0,2.0,3.0,2.0,1.0,11.0,2.0,4.0,9.0,4.0,16.0,12.0,7.0,1.0,15.0,14.0,17.0,17.0,10.0,2.0,3.0,16.0,10.0,14.0,2.0,12.0,6.0,9.0,5.0,0.0,8.0,16.0,6.0,11.0,9.0,2.0,8.0,2.0,11.0,4.0,12.0,17.0,15.0,13.0,1.0,8.0,4.0,12.0,18.0,19.0,23.0,22.0,14.0,10.0,3.0,13.0,1.0,1.0,2.0,17.0,6.0,1.0,3.0,11.0,17.0,21.0,21.0,0.0,8.0,9.0,3.0,0.0,10.0,12.0,9.0,3.0,24.0,3.0,2.0,9.0,7.0,12.0,16.0,17.0,11.0,24.0,1.0,12.0,11.0,1.0,5.0,20.0,9.0,10.0,30.0,21.0,6.0,0.0,42.0,14.0,2.0,17.0,5.0,16.0,11.0,11.0,6.0,20.0,11.0,21.0,8.0,3.0,4.0,5.0,11.0,14.0,6.0,13.0,6.0,12.0,20.0,23.0,10.0,11.0,24.0,10.0,4.0,8.0,2.0,8.0,6.0,19.0,18.0,11.0,8.0,10.0,11.0,5.0,15.0,10.0,16.0,15.0,21.0,10.0,16.0,16.0,5.0,7.0,6.0,7.0,13.0,13.0,4.0,2.0,21.0,4.0,1.0,18.0,17.0,15.0,16.0,16.0,1.0,1.0,3.0,13.0,19.0,20.0,7.0,,0.0,9.0,5.0,22.0,13.0,2.0,3.0,27.0,7.0,8.0,1.0,5.0,0.0,2.0,27.0,8.0,3.0,13.0,10.0,0.0,0.0,16.0,1.0,0.0,16.0,0.0,4.0,5.0,0.0,1.0,0.0,11.0,5.0,2.0,10.0,2.0,9.0,6.0,8.0,1.0,9.0,18.0,12.0,18.0,28.0,8.0,10.0,5.0,0.0,5.0,3.0,0.0,4.0,16.0,14.0,14.0,12.0,9.0,5.0,8.0,2.0,14.0,14.0,10.0,8.0,18.0,3.0,0.0,3.0,16.0,5.0,0.0,1.0,0.0,19.0,8.0,9.0,9.0,15.0,10.0,17.0,2.0,10.0,10.0,8.0,7.0,13.0,8.0,14.0,11.0,18.0,14.0,20.0,12.0,18.0,13.0,8.0,12.0,24.0,16.0,9.0,4.0,4.0,22.0,11.0,13.0,16.0,18.0,10.0,15.0,12.0,12.0,0.0,5.0,8.0,6.0,3.0,2.0,1.0,12.0,6.0,7.0,21.0,10.0,9.0,23.0,13.0,17.0,8.0,7.0,8.0,5.0,6.0,17.0,12.0,11.0,1.0,6.0,10.0,15.0,3.0,6.0,1.0,4.0,2.0,16.0,9.0,2.0,0.0,1.0,12.0,15.0,17.0,7.0,12.0,10.0,8.0,9.0,8.0,6.0,1.0,12.0,22.0,6.0,18.0,23.0,8.0,6.0,3.0,6.0,7.0,16.0,11.0,9.0,7.0,23.0,19.0,10.0,7.0,2.0,0.0,0.0,2.0,21.0,21.0,1.0,12.0,12.0,6.0,6.0,7.0,13.0,7.0,13.0,8.0,11.0,6.0,7.0,18.0,11.0,1.0,15.0,7.0,11.0,16.0,6.0,7.0,8.0,18.0,12.0,13.0,10.0,8.0,3.0,10.0,2.0,15.0,10.0,6.0,5.0,7.0,8.0,13.0,13.0,10.0,1.0,8.0,11.0,0.0,4.0,0.0,7.0,3.0,6.0,10.0,5.0,12.0,16.0,0.0,2.0,11.0,7.0,9.0,0.0,6.0,8.0,14.0,6.0,8.0,16.0,11.0,8.0,12.0,14.0,5.0,7.0,11.0,3.0,9.0,8.0,10.0,19.0,2.0,15.0,12.0,24.0,12.0,20.0,4.0,1.0,18.0,8.0,19.0,16.0,6.0,9.0,20.0,11.0,16.0,16.0,14.0,17.0,7.0,10.0,13.0,8.0,17.0,15.0,17.0,6.0,7.0,11.0,8.0,20.0,21.0,6.0,7.0,12.0,5.0,6.0,1.0,10.0,6.0,14.0,10.0,13.0,4.0,13.0,18.0,5.0,20.0,20.0,12.0,4.0,8.0,10.0,6.0,4.0,3.0,14.0,12.0,3.0,4.0,2.0,11.0,6.0,7.0,7.0,6.0,2.0,6.0,6.0,6.0,0.0,4.0,11.0,17.0,7.0,4.0,11.0,6.0,3.0,15.0,11.0,0.0,0.0,7.0,11.0,10.0,10.0,4.0,1.0,2.0,0.0,6.0,2.0,0.0,6.0,4.0,8.0,4.0,12.0,13.0,9.0,8.0,0.0,9.0,13.0,18.0,1.0,16.0,17.0,10.0,0.0,4.0,17.0,12.0,14.0,10.0,10.0,5.0,4.0,8.0,2.0,2.0,7.0,6.0,4.0,6.0,6.0,1.0,6.0,13.0,1.0,9.0,11.0,12.0,9.0,9.0,2.0,4.0,21.0,9.0,7.0,4.0,14.0,6.0,16.0,5.0,5.0,0.0,0.0,8.0,10.0,10.0,3.0,15.0,0.0,1.0,14.0,15.0,18.0,13.0,6.0,2.0,5.0,0.0,7.0,20.0,12.0,6.0,31.0,13.0,1.0,4.0,0.0,10.0,11.0,3.0,17.0,2.0,9.0,4.0,7.0,4.0,0.0,5.0,12.0,2.0,3.0,0.0,5.0,9.0,2.0,1.0,13.0,5.0,11.0,4.0,9.0,10.0,2.0,4.0,12.0,1.0,5.0,12.0,12.0,4.0,13.0,8.0,16.0,5.0,1.0,1.0,1.0,6.0,11.0,15.0,9.0,11.0,14.0,14.0,4.0,15.0,8.0,4.0,9.0,8.0,18.0,10.0,14.0,4.0,10.0,4.0,4.0,2.0,12.0,12.0,2.0,14.0,9.0,8.0,6.0,5.0,2.0,6.0,16.0,5.0,3.0,2.0,5.0,2.0,11.0,1.0,0.0,3.0,2.0,6.0,11.0,21.0,2.0,6.0,7.0,18.0,12.0,10.0,10.0,12.0,1.0,2.0,11.0,0.0,0.0,9.0,6.0,0.0,16.0,10.0,3.0,7.0,10.0,12.0,5.0,1.0,4.0,14.0,5.0,2.0,11.0,0.0,11.0,14.0,4.0,3.0,11.0,9.0,9.0,1.0,2.0,7.0,14.0,7.0,1.0,12.0,12.0,9.0,6.0,4.0,0.0,8.0,2.0,6.0,0.0,14.0,14.0,0.0,7.0,13.0,17.0,2.0,12.0,13.0,12.0,7.0,1.0,14.0,4.0,12.0,18.0,0.0,10.0,13.0,10.0,8.0,14.0,8.0,1.0,16.0,0.0,6.0,6.0,2.0,33.0,16.0,12.0,1.0,0.0,0.0,0.0,0.0,0.0,2.0,5.0,3.0,3.0,1.0,0.0,3.0,1.0,0.0,1.0,10.0,0.0,4.0,0.0,1.0,6.0,0.0,5.0,0.0,0.0,0.0,0.0,0.0,0.0,5.0,1.0,0.0,0.0,0.0,0.0,0.0,4.0,1.0,1.0,1.0,0.0,0.0,2.0,0.0,0.0,0.0,1.0,2.0,3.0,2.0,4.0,3.0,0.0,1.0,0.0,3.0,2.0,0.0,0.0,0.0,0.0,1.0,0.0,0.0,2.0,2.0,0.0,1.0,0.0,0.0,2.0,0.0,2.0,2.0,0.0,0.0,0.0,0.0,0.0,1.0,0.0,3.0,0.0,1.0,4.0,2.0,0.0,0.0,0.0,0.0,0.0,0.0,3.0,1.0,1.0,1.0,0.0,0.0,3.0,8.0,12.0,1.0,3.0,2.0,1.0,3.0,6.0,9.0,2.0,3.0,10.0,13.0,11.0,9.0,6.0,2.0,5.0,4.0,11.0,9.0,8.0,7.0,7.0,9.0,1.0,0.0,3.0,1.0,4.0,4.0,8.0,4.0,8.0,0.0,9.0,13.0,9.0,5.0,7.0,6.0,2.0,9.0,0.0,1.0,3.0,3.0,2.0,2.0,4.0,3.0,4.0,6.0,5.0,2.0,2.0,8.0,3.0,5.0,3.0,5.0,2.0,1.0,5.0,1.0,2.0,6.0,3.0,3.0,5.0,4.0,1.0,3.0,8.0,6.0,3.0,5.0,7.0,1.0,3.0,10.0,3.0,4.0,5.0,4.0,0.0,3.0,5.0,5.0,4.0,0.0,1.0,8.0,0.0,0.0,4.0,2.0,4.0,5.0,2.0,0.0,3.0,2.0,3.0,6.0,7.0,1.0,2.0,4.0,4.0,0.0,2.0,2.0,4.0,0.0,0.0,2.0,7.0,6.0,7.0,5.0,2.0,2.0,4.0,9.0,3.0,3.0,3.0,2.0,2.0,5.0,6.0,6.0,6.0,4.0,0.0,5.0,3.0,5.0,4.0,4.0,4.0,0.0,3.0,2.0,11.0,3.0,7.0,14.0,5.0,11.0,7.0,6.0,3.0,3.0,3.0,4.0,4.0,2.0,12.0,7.0,3.0,6.0,0.0,1.0,8.0,3.0,3.0,0.0,2.0,7.0,0.0,1.0,1.0,1.0,3.0,2.0,0.0,0.0,2.0,0.0,2.0,7.0,1.0,1.0,6.0,0.0,0.0,0.0,0.0,0.0,4.0,8.0,11.0,6.0,5.0,4.0,5.0,4.0,6.0,8.0,4.0,6.0,5.0,6.0,3.0,4.0,9.0,7.0,4.0,6.0,7.0,6.0,4.0,7.0,8.0,5.0,8.0,4.0,12.0,3.0,13.0,5.0,7.0,6.0,5.0,5.0,5.0,3.0,9.0,3.0,7.0,4.0,5.0,9.0,6.0,2.0,2.0,9.0,6.0,5.0,13.0,4.0,2.0,3.0,6.0,4.0,6.0,8.0,8.0,5.0,5.0,6.0,2.0,7.0,7.0,3.0,6.0,6.0,2.0,3.0,10.0,4.0,2.0,7.0,14.0,6.0,8.0,2.0,11.0,2.0,3.0,6.0,8.0,2.0,6.0,3.0,4.0,7.0,5.0,2.0,5.0,5.0,10.0,7.0,5.0,6.0,6.0,8.0,5.0,3.0,3.0,2.0,4.0,2.0,6.0,7.0,5.0,5.0,7.0,7.0,4.0,3.0,4.0,5.0,4.0,4.0,0.0,0.0,4.0,4.0,5.0,5.0,5.0,5.0,5.0,5.0,4.0,4.0,5.0,5.0,5.0,5.0,4.0,3.0,3.0,5.0,2.0,5.0,5.0,0.0,2.0,4.0,5.0,3.0,3.0,3.0,4.0,5.0,0.0,6.0,1.0,0.0,3.0,0.0,4.0,3.0,8.0,0.0,11.0,1.0,7.0,0.0,14.0,1.0,1.0,1.0,0.0,0.0,0.0,7.0,2.0,0.0,6.0,0.0,2.0,3.0,8.0,3.0,9.0,7.0,0.0,0.0,10.0,5.0,7.0,0.0,0.0,14.0,7.0,0.0,18.0,2.0,7.0,16.0,3.0,1.0,5.0,0.0,0.0,0.0,12.0,0.0,0.0,1.0,6.0,0.0,14.0,0.0,2.0,0.0,12.0,0.0,1.0,7.0,0.0,0.0,0.0,3.0,1.0,0.0,6.0,0.0,0.0,3.0,2.0,0.0,0.0,0.0,4.0,10.0,1.0,11.0,0.0,2.0,2.0,1.0,1.0,3.0,0.0,0.0,0.0,0.0,0.0,2.0,7.0,7.0,4.0,0.0,3.0,7.0,10.0,7.0,7.0,2.0,8.0,6.0,2.0,6.0,6.0,6.0,18.0,12.0,4.0,6.0,7.0,3.0,2.0,3.0,3.0,4.0,3.0,0.0,0.0,2.0,12.0,8.0,0.0,1.0,0.0,4.0,11.0,1.0,0.0,9.0,2.0,3.0,8.0,0.0,9.0,1.0,2.0,4.0,5.0,10.0,3.0,8.0,2.0,6.0,8.0,6.0,12.0,1.0,0.0,10.0,7.0,4.0,4.0,7.0,1.0,11.0,0.0,6.0,17.0,3.0,11.0,6.0,5.0,3.0,2.0,9.0,5.0,11.0,15.0,5.0,4.0,15.0,5.0,8.0,7.0,13.0,4.0,14.0,1.0,14.0,10.0,10.0,8.0,4.0,5.0,8.0,8.0,4.0,8.0,9.0,3.0,1.0,15.0,1.0,4.0,10.0,3.0,5.0,13.0,8.0,10.0,14.0,8.0,3.0,4.0,11.0,11.0,8.0,13.0,0.0,3.0,10.0,6.0,9.0,7.0,10.0,21.0,19.0,0.0,7.0,0.0,21.0,6.0,11.0,8.0,4.0,3.0,17.0,9.0,1.0,38.0,0.0,11.0,0.0,14.0,6.0,6.0,13.0,27.0,16.0,0.0,0.0,9.0,23.0,2.0,12.0,7.0,0.0,0.0,0.0,0.0,2.0,0.0,1.0,22.0,26.0,1.0,0.0,0.0,0.0,13.0,25.0,18.0,1.0,18.0,13.0,3.0,8.0,2.0,12.0,5.0,0.0,2.0,0.0,1.0,5.0,2.0,,11.0,18.0,0.0,1.0,1.0,3.0,2.0,5.0,3.0,13.0,14.0,10.0,0.0,12.0,0.0,3.0,18.0,1.0,0.0,20.0,3.0,3.0,2.0,0.0,0.0,16.0,9.0,2.0,5.0,16.0,17.0,4.0,1.0,18.0,0.0,5.0,10.0,10.0,0.0,10.0,27.0,3.0,18.0,13.0,13.0,5.0,12.0,2.0,0.0,6.0,0.0,0.0,10.0,5.0,0.0,0.0,30.0,6.0,0.0,1.0,14.0,0.0,15.0,0.0,8.0,9.0,13.0,1.0,0.0,18.0,0.0,2.0,9.0,14.0,0.0,15.0,15.0,13.0,20.0,15.0,23.0,0.0,3.0,5.0,17.0,12.0,9.0,1.0,11.0,6.0,13.0,10.0,0.0,18.0,9.0,14.0,2.0,11.0,4.0,0.0,2.0,3.0,1.0,0.0,0.0,15.0,2.0,0.0,1.0,7.0,22.0,11.0,0.0,11.0,12.0,0.0,19.0,10.0,23.0,0.0,12.0,0.0,6.0,15.0,13.0,3.0,1.0,18.0,11.0,0.0,6.0,0.0,10.0,1.0,0.0,2.0,22.0,9.0,10.0,7.0,8.0,12.0,11.0,0.0,25.0,15.0,8.0,11.0,21.0,2.0,2.0,5.0,2.0,1.0,2.0,23.0,8.0,2.0,0.0,26.0,0.0,8.0,2.0,9.0,3.0,5.0,0.0,19.0,5.0,0.0,20.0,17.0,0.0,0.0,3.0,2.0,11.0,18.0,15.0,8.0,13.0,13.0,13.0,11.0,4.0,4.0,1.0,26.0,11.0,3.0,1.0,36.0,1.0,25.0,0.0,9.0,20.0,45.0,1.0,1.0,0.0,10.0,19.0,17.0,0.0,3.0,4.0,6.0,10.0,20.0,32.0,18.0,40.0,12.0,5.0,15.0,12.0,0.0,11.0,5.0,0.0,11.0,1.0,0.0,12.0,14.0,7.0,4.0,0.0,5.0,44.0,39.0,12.0,18.0,1.0,28.0,7.0,24.0,6.0,0.0,23.0,7.0,14.0,39.0,16.0,0.0,0.0,11.0,0.0,2.0,0.0,2.0,0.0,4.0,3.0,42.0,41.0,6.0,1.0,0.0,5.0,9.0,5.0,20.0,17.0,1.0,9.0,0.0,10.0,0.0,9.0,10.0,1.0,21.0,15.0,8.0,2.0,20.0,0.0,39.0,1.0,8.0,11.0,29.0,5.0,14.0,10.0,1.0,3.0,0.0,0.0,11.0,30.0,20.0,23.0,16.0,17.0,0.0,17.0,13.0,17.0,5.0,21.0,1.0,7.0,14.0,3.0,5.0,0.0,2.0,19.0,17.0,5.0,1.0,0.0,0.0,3.0,8.0,0.0,27.0,8.0,4.0,7.0,22.0,11.0,11.0,12.0,9.0,10.0,2.0,0.0,6.0,14.0,7.0,15.0,11.0,0.0,2.0,0.0,0.0,2.0,0.0,2.0,0.0,0.0,2.0,0.0,1.0,0.0,1.0,1.0,1.0,2.0,0.0,2.0,1.0,2.0,0.0,3.0,0.0,1.0,1.0,2.0,0.0,0.0,1.0,2.0,1.0,0.0,0.0,0.0,0.0,0.0,0.0,0.0,2.0,1.0,1.0,0.0,0.0,3.0,1.0,2.0,1.0,1.0,0.0,0.0,0.0,3.0,0.0,0.0,0.0,1.0,0.0,0.0,0.0,0.0,0.0,0.0,0.0,1.0,2.0,1.0,0.0,10.0,7.0,4.0,11.0,9.0,2.0,16.0,8.0,14.0,14.0,12.0,19.0,3.0,8.0,11.0,24.0,14.0,5.0,5.0,6.0,4.0,12.0,8.0,4.0,4.0,5.0,8.0,8.0,5.0,6.0,7.0,8.0,34.0,7.0,10.0,9.0,10.0,11.0,3.0,4.0,13.0,18.0,11.0,10.0,5.0,6.0,6.0,17.0,0.0,0.0,4.0,0.0,2.0,4.0,3.0,2.0,4.0,3.0,4.0,4.0,3.0,13.0,2.0,5.0,5.0,8.0,1.0,3.0,0.0,3.0,19.0,18.0,26.0,8.0,9.0,15.0,20.0,11.0,9.0,5.0,25.0,7.0,5.0,26.0,5.0,14.0,9.0,0.0,9.0,1.0,2.0,16.0,15.0,18.0,2.0,13.0,10.0,0.0,2.0,16.0,15.0,3.0,1.0,11.0,6.0,8.0,9.0,15.0,6.0,2.0,1.0,11.0,14.0,1.0,10.0,9.0,1.0,18.0,13.0,8.0,2.0,11.0,0.0,6.0,2.0,14.0,2.0,0.0,1.0,0.0,2.0,12.0,4.0,9.0,1.0,7.0,0.0,8.0,2.0,9.0,4.0,2.0,6.0,1.0,1.0,0.0,7.0,11.0,11.0,8.0,1.0,7.0,12.0,8.0,13.0,2.0,0.0,5.0,13.0,1.0,0.0,7.0,1.0,5.0,2.0,3.0,3.0,16.0,0.0,2.0,3.0,1.0,14.0,6.0,5.0,15.0,6.0,12.0,6.0,5.0,6.0,4.0,4.0,11.0,9.0,22.0,14.0,11.0,1.0,12.0,3.0,10.0,4.0,9.0,5.0,12.0,6.0,7.0,8.0,11.0,9.0,1.0,2.0,0.0,6.0,17.0,9.0,5.0,15.0,3.0,15.0,13.0,6.0,6.0,2.0,15.0,4.0,6.0,4.0,6.0,13.0,,7.0,10.0,8.0,4.0,2.0,11.0,4.0,4.0,9.0,1.0,5.0,3.0,2.0,11.0,9.0,6.0,7.0,7.0,10.0,5.0,9.0,9.0,10.0,3.0,5.0,7.0,7.0,9.0,13.0,14.0,9.0,6.0,7.0,5.0,6.0,10.0,11.0,6.0,5.0,4.0,4.0,6.0,0.0,11.0,15.0,10.0,7.0,9.0,4.0,10.0,7.0,11.0,8.0,1.0,2.0,0.0,1.0,20.0,7.0,3.0,9.0,2.0,2.0,11.0,15.0,4.0,6.0,15.0,5.0,0.0,3.0,2.0,6.0,22.0,10.0,11.0,4.0,12.0,6.0,15.0,7.0,11.0,7.0,4.0,4.0,9.0,3.0,9.0,1.0,9.0,15.0,6.0,2.0,10.0,2.0,6.0,6.0,13.0,8.0,5.0,8.0,12.0,7.0,4.0,4.0,11.0,2.0,3.0,3.0,14.0,7.0,3.0,4.0,0.0,4.0,6.0,8.0,2.0,2.0,7.0,7.0,14.0,10.0,6.0,10.0,7.0,7.0,1.0,2.0,10.0,5.0,5.0,9.0,4.0,11.0,8.0,13.0,5.0,2.0,12.0,9.0,7.0,11.0,12.0,9.0,4.0,6.0,3.0,3.0,4.0,0.0,7.0,3.0,4.0,6.0,4.0,10.0,9.0,3.0,6.0,14.0,1.0,11.0,5.0,1.0,6.0,6.0,6.0,5.0,13.0,3.0,11.0,8.0,6.0,7.0,5.0,4.0,10.0,9.0,5.0,14.0,9.0,14.0,7.0,1.0,12.0,10.0,4.0,9.0,15.0,4.0,8.0,9.0,11.0,9.0,3.0,0.0,20.0,16.0,11.0,5.0,16.0,10.0,7.0,9.0,7.0,3.0,15.0,7.0,7.0,6.0,18.0,9.0,5.0,6.0,10.0,6.0,1.0,10.0,4.0,2.0,7.0,12.0,8.0,8.0,10.0,4.0,7.0,9.0,11.0,6.0,5.0,8.0,15.0,12.0,7.0,6.0,3.0,14.0,1.0,6.0,10.0,9.0,5.0,4.0,19.0,7.0,5.0,13.0,14.0,0.0,8.0,12.0,8.0,3.0,17.0,5.0,4.0,11.0,2.0,3.0,9.0,7.0,9.0,7.0,11.0,7.0,12.0,5.0,6.0,12.0,9.0,6.0,7.0,5.0,12.0,6.0,6.0,13.0,5.0,10.0,9.0,7.0,13.0,11.0,4.0,9.0,12.0,11.0,11.0,7.0,6.0,6.0,8.0,7.0,7.0,6.0,1.0,7.0,3.0,7.0,19.0,12.0,8.0,1.0,12.0,10.0,7.0,4.0,3.0,3.0,11.0,10.0,5.0,11.0,17.0,7.0,14.0,7.0,8.0,6.0,6.0,3.0,4.0,15.0,13.0,6.0,11.0,9.0,3.0,7.0,8.0,9.0,5.0,5.0,7.0,0.0,11.0,7.0,5.0,8.0,5.0,12.0,1.0,7.0,11.0,5.0,5.0,9.0,10.0,5.0,5.0,7.0,3.0,2.0,6.0,5.0,0.0,8.0,4.0,5.0,4.0,13.0,3.0,8.0,9.0,3.0,7.0,7.0,6.0,1.0,11.0,13.0,4.0,0.0,5.0,3.0,10.0,11.0,7.0,6.0,4.0,8.0,6.0,2.0,11.0,7.0,0.0,1.0,12.0,7.0,1.0,5.0,12.0,15.0,17.0,14.0,2.0,7.0,8.0,6.0,7.0,0.0,0.0,0.0,0.0,0.0,0.0,0.0,0.0,1.0,0.0,3.0,4.0,0.0,4.0,3.0,2.0,4.0,8.0,5.0,10.0,3.0,2.0,7.0,4.0,16.0,9.0,5.0,4.0,3.0,3.0,2.0,5.0,2.0,4.0,5.0,2.0,3.0,5.0,2.0,3.0,4.0,8.0,2.0,2.0,2.0,2.0,2.0,0.0,1.0,2.0,2.0,3.0,2.0,2.0,3.0,2.0,2.0,2.0,2.0,2.0,3.0,3.0,2.0,3.0,5.0,4.0,2.0,4.0,2.0,2.0,2.0,3.0,4.0,3.0,0.0,0.0,4.0,3.0,4.0,4.0,4.0,4.0,4.0,3.0,2.0,1.0,0.0,3.0,0.0,2.0,4.0,4.0,2.0,3.0,3.0,2.0,4.0,2.0,3.0,0.0,4.0,3.0,3.0,2.0,0.0,2.0,3.0,2.0,1.0,2.0,2.0,1.0,2.0,3.0,2.0,2.0,2.0,3.0,2.0,2.0,3.0,2.0,3.0,3.0,2.0,3.0,5.0,2.0,3.0,1.0,3.0,5.0,2.0,1.0,1.0,3.0,4.0,2.0,5.0,4.0,2.0,1.0,9.0,4.0,7.0,4.0,3.0,3.0,4.0,6.0,4.0,5.0,5.0,7.0,11.0,6.0,6.0,5.0,4.0,4.0,7.0,5.0,6.0,3.0,3.0,0.0,13.0,0.0,3.0,7.0,9.0,0.0,0.0,0.0,6.0,0.0,0.0,0.0,7.0,4.0,8.0,4.0,3.0,0.0,4.0,3.0,1.0,3.0,0.0,0.0,0.0,0.0,0.0,3.0,9.0,2.0,11.0,8.0,0.0,0.0,10.0,5.0,5.0,5.0,5.0,5.0,4.0,5.0,5.0,5.0,4.0,8.0,5.0,4.0,8.0,7.0,2.0,3.0,3.0,11.0,4.0,8.0,6.0,8.0,6.0,7.0,7.0,8.0,6.0,4.0,9.0,6.0,6.0,9.0,12.0,6.0,7.0,6.0,6.0,2.0,5.0,2.0,5.0,6.0,8.0,7.0,7.0,11.0,3.0,7.0,10.0,9.0,8.0,5.0,6.0,5.0,8.0,3.0,5.0,5.0,10.0,5.0,6.0,13.0,11.0,7.0,3.0,6.0,13.0,8.0,8.0,12.0,4.0,6.0,2.0,8.0,10.0,6.0,8.0,17.0,3.0,13.0,10.0,8.0,6.0,10.0,13.0,10.0,4.0,15.0,7.0,14.0,8.0,1.0,5.0,8.0,11.0,8.0,5.0,6.0,0.0,1.0,9.0,5.0,13.0,7.0,16.0,10.0,9.0,4.0,8.0,15.0,9.0,7.0,11.0,6.0,8.0,2.0,7.0,12.0,5.0,6.0,9.0,7.0,4.0,10.0,13.0,8.0,6.0,15.0,0.0,11.0,3.0,2.0,6.0,10.0,3.0,3.0,5.0,4.0,6.0,15.0,10.0,7.0,8.0,5.0,5.0,0.0,9.0,4.0,7.0,9.0,10.0,6.0,4.0,3.0,3.0,4.0,3.0,8.0,13.0,9.0,9.0,,8.0,7.0,8.0,8.0,5.0,6.0,3.0,8.0,7.0,6.0,8.0,5.0,3.0,5.0,5.0,2.0,3.0,7.0,8.0,7.0,4.0,6.0,6.0,6.0,6.0,2.0,5.0,6.0,4.0,7.0,4.0,4.0,7.0,5.0,6.0,6.0,6.0,5.0,3.0,7.0,6.0,11.0,8.0,8.0,4.0,3.0,7.0,5.0,5.0,6.0,19.0,20.0,36.0,20.0,0.0,19.0,25.0,42.0,25.0,15.0,1.0,17.0,16.0,1.0,19.0,32.0,15.0,17.0,13.0,50.0,22.0,20.0,2.0,17.0,36.0,32.0,16.0,13.0,4.0,28.0,16.0,19.0,16.0,7.0,5.0,21.0,8.0,20.0,19.0,22.0,2.0,17.0,14.0,24.0,16.0,8.0,9.0,3.0,7.0,25.0,25.0,23.0,20.0,5.0,1.0,0.0,0.0,14.0,27.0,5.0,13.0,1.0,13.0,18.0,17.0,16.0,19.0,8.0,9.0,16.0,19.0,30.0,6.0,9.0,4.0,17.0,22.0,31.0,12.0,24.0,8.0,6.0,5.0,16.0,0.0,14.0,15.0,29.0,27.0,10.0,4.0,3.0,20.0,1.0,8.0,11.0,14.0,15.0,23.0,9.0,11.0,5.0,20.0,3.0,5.0,5.0,0.0,4.0,4.0,1.0,14.0,8.0,6.0,3.0,1.0,3.0,20.0,1.0,2.0,2.0,7.0,3.0,22.0,21.0,1.0,1.0,0.0,3.0,8.0,4.0,20.0,21.0,24.0,29.0,5.0,15.0,9.0,10.0,20.0,11.0,3.0,33.0,8.0,12.0,2.0,4.0,13.0,23.0,7.0,28.0,29.0,17.0,17.0,21.0,5.0,22.0,0.0,21.0,25.0,5.0,21.0,10.0,8.0,18.0,31.0,10.0,7.0,2.0,34.0,8.0,13.0,2.0,1.0,19.0,17.0,26.0,19.0,4.0,19.0,15.0,1.0,3.0,12.0,20.0,2.0,8.0,10.0,4.0,0.0,3.0,1.0,5.0,24.0,6.0,4.0,21.0,2.0,14.0,25.0,13.0,19.0,10.0,12.0,10.0,4.0,20.0,9.0,2.0,11.0,12.0,12.0,8.0,21.0,12.0,24.0,21.0,13.0,19.0,23.0,8.0,25.0,4.0,19.0,26.0,24.0,12.0,16.0,17.0,21.0,35.0,6.0,49.0,24.0,20.0,39.0,34.0,37.0,22.0,1.0,7.0,29.0,9.0,11.0,0.0,5.0,14.0,8.0,11.0,2.0,32.0,20.0,24.0,19.0,26.0,11.0,15.0,15.0,10.0,17.0,16.0,21.0,24.0,20.0,7.0,58.0,12.0,6.0,1.0,19.0,12.0,2.0,23.0,14.0,21.0,10.0,10.0,12.0,10.0,16.0,17.0,10.0,12.0,38.0,13.0,8.0,4.0,6.0,31.0,15.0,25.0,12.0,1.0,12.0,26.0,0.0,6.0,8.0,14.0,13.0,16.0,18.0,7.0,2.0,17.0,6.0,21.0,23.0,8.0,72.0,21.0,8.0,31.0,23.0,27.0,22.0,22.0,35.0,9.0,34.0,20.0,23.0,23.0,30.0,28.0,23.0,27.0,19.0,27.0,23.0,2.0,23.0,13.0,34.0,9.0,12.0,5.0,9.0,7.0,15.0,29.0,25.0,47.0,42.0,8.0,1.0,8.0,20.0,1.0,15.0,14.0,8.0,10.0,11.0,53.0,2.0,16.0,5.0,20.0,5.0,0.0,11.0,7.0,19.0,2.0,4.0,6.0,6.0,27.0,11.0,5.0,13.0,20.0,,2.0,2.0,8.0,8.0,44.0,19.0,11.0,5.0,3.0,0.0,6.0,0.0,19.0,4.0,14.0,12.0,8.0,3.0,2.0,1.0,0.0,5.0,22.0,12.0,21.0,1.0,5.0,9.0,26.0,4.0,12.0,18.0,21.0,32.0,0.0,32.0,9.0,2.0,5.0,20.0,8.0,0.0,9.0,12.0,6.0,53.0,7.0,24.0,2.0,4.0,23.0,23.0,4.0,23.0,12.0,35.0,30.0,36.0,17.0,2.0,13.0,10.0,4.0,5.0,4.0,7.0,13.0,15.0,10.0,6.0,9.0,1.0,4.0,18.0,1.0,0.0,11.0,3.0,1.0,8.0,1.0,10.0,10.0,6.0,17.0,13.0,29.0,5.0,15.0,10.0,9.0,3.0,11.0,8.0,6.0,12.0,0.0,1.0,4.0,3.0,15.0,3.0,16.0,16.0,19.0,19.0,9.0,19.0,14.0,3.0,22.0,12.0,0.0,14.0,37.0,29.0,47.0,17.0,21.0,18.0,10.0,2.0,4.0,0.0,19.0,1.0,6.0,10.0,10.0,10.0,2.0,24.0,43.0,23.0,22.0,23.0,4.0,18.0,12.0,12.0,5.0,9.0,12.0,9.0,3.0,10.0,6.0,7.0,4.0,24.0,16.0,25.0,32.0,20.0,7.0,20.0,0.0,10.0,20.0,11.0,14.0,18.0,3.0,27.0,24.0,19.0,4.0,6.0,0.0,3.0,11.0,6.0,17.0,1.0,3.0,9.0,23.0,2.0,1.0,11.0,27.0,1.0,16.0,20.0,14.0,23.0,0.0,17.0,14.0,8.0,8.0,20.0,30.0,16.0,13.0,4.0,2.0,7.0,15.0,4.0,18.0,8.0,3.0,5.0,9.0,2.0,12.0,3.0,7.0,6.0,5.0,1.0,27.0,4.0,17.0,11.0,22.0,9.0,19.0,9.0,22.0,5.0,21.0,39.0,5.0,1.0,1.0,3.0,17.0,16.0,25.0,2.0,19.0,4.0,15.0,18.0,5.0,13.0,2.0,7.0,13.0,2.0,4.0,2.0,2.0,3.0,9.0,33.0,12.0,4.0,1.0,18.0,8.0,0.0,11.0,19.0,23.0,19.0,8.0,0.0,23.0,19.0,6.0,20.0,0.0,3.0,1.0,8.0,4.0,17.0,7.0,10.0,2.0,19.0,12.0,36.0,15.0,34.0,20.0,19.0,22.0,5.0,0.0,33.0,0.0,13.0,12.0,4.0,9.0,9.0,1.0,23.0,10.0,19.0,8.0,21.0,9.0,8.0,2.0,22.0,19.0,2.0,15.0,0.0,5.0,3.0,3.0,17.0,30.0,1.0,28.0,0.0,3.0,16.0,8.0,11.0,35.0,17.0,11.0,9.0,16.0,22.0,41.0,17.0,30.0,25.0,12.0,12.0,1.0,4.0,5.0,16.0,8.0,15.0,25.0,1.0,23.0,8.0,7.0,23.0,20.0,6.0,18.0,27.0,21.0,23.0,14.0,5.0,0.0,10.0,10.0,24.0,3.0,30.0,52.0,9.0,17.0,18.0,4.0,1.0,1.0,6.0,7.0,9.0,4.0,4.0,24.0,9.0,1.0,8.0,27.0,3.0,45.0,15.0,35.0,37.0,0.0,6.0,7.0,6.0,4.0,1.0,7.0,21.0,9.0,22.0,2.0,4.0,2.0,7.0,0.0,3.0,20.0,25.0,8.0,12.0,2.0,24.0,30.0,9.0,4.0,13.0,22.0,30.0,20.0,0.0,22.0,68.0,23.0,35.0,26.0,13.0,9.0,30.0,17.0,26.0,13.0,9.0,25.0,10.0,18.0,7.0,5.0,3.0,0.0,14.0,20.0,6.0,22.0,22.0,1.0,4.0,1.0,0.0,12.0,4.0,11.0,0.0,2.0,6.0,9.0,37.0,9.0,15.0,0.0,21.0,12.0,15.0,19.0,6.0,20.0,10.0,13.0,21.0,7.0,33.0,7.0,7.0,37.0,16.0,5.0,0.0,4.0,12.0,2.0,8.0,2.0,4.0,5.0,1.0,6.0,3.0,3.0,13.0,6.0,0.0,17.0,8.0,9.0,7.0,2.0,2.0,6.0,43.0,14.0,2.0,0.0,3.0,0.0,5.0,3.0,12.0,3.0,10.0,9.0,13.0,0.0,5.0,6.0,28.0,1.0,0.0,0.0,10.0,17.0,14.0,6.0,2.0,12.0,13.0,8.0,13.0,0.0,3.0,13.0,13.0,3.0,22.0,0.0,1.0,3.0,18.0,8.5,14.0,14.0,9.0,5.0,7.0,0.0,12.0,1.0,17.0,13.0,9.0,16.0,15.0,12.0,0.0,20.0,3.0,2.0,0.0,0.0,35.0,3.0,1.0,2.0,15.0,1.0,6.0,5.0,19.0,2.0,37.0,1.0,8.0,8.0,1.0,4.0,13.0,1.0,3.0,17.0,1.0,11.0,19.0,15.0,5.0,46.0,10.0,2.0,2.0,4.0,4.0,32.0,1.0,9.0,5.0,12.0,0.0,10.0,15.0,1.0,3.0,1.0,9.0,18.0,5.0,22.0,6.0,3.0,36.0,7.0,19.0,2.0,8.0,0.0,14.0,8.0,14.0,7.0,4.0,12.0,6.0,1.0,17.0,19.0,1.0,5.0,4.0,11.0,0.0,3.0,13.0,1.0,0.0,10.0,11.0,3.0,14.0,3.0,12.0,1.0,1.0,22.0,12.0,6.0,2.0,4.0,6.0,12.0,2.0,0.0,2.0,1.0,5.0,0.0,9.0,8.0,11.0,2.0,5.0,0.0,29.0,40.0,14.0,5.0,13.0,10.0,8.0,3.0,6.0,19.0,24.0,1.0,1.0,12.0,0.0,8.0,5.0,27.0,2.0,7.0,35.0,21.0,9.0,11.0,1.0,10.0,36.0,15.0,8.0,1.0,9.0,12.0,47.0,1.0,3.0,3.0,1.0,7.0,17.0,13.0,5.0,8.0,33.0,7.0,7.0,50.0,1.0,9.0,0.0,11.0,1.0,4.0,2.0,2.0,4.0,10.0,19.0,3.0,33.0,14.0,2.0,16.0,8.0,9.0,24.0,13.0,1.0,1.0,3.0,16.0,8.0,8.0,1.0,15.0,18.0,3.0,5.0,9.0,29.0,14.0,8.0,10.0,16.0,7.0,14.0,4.0,17.0,3.0,0.0,17.0,0.0,2.0,20.0,0.0,1.0,8.0,1.0,2.0,0.0,10.0,0.0,17.0,10.0,4.0,17.0,9.0,14.0,2.0,1.0,0.0,11.0,19.0,0.0,1.0,12.0,6.0,0.0,39.0,7.0,43.0,0.0,0.0,0.0,12.0,7.0,1.0,4.0,2.0,13.0,9.0,11.0,0.0,0.0,4.0,0.0,9.0,18.0,19.0,18.0,4.0,18.0,1.0,20.0,5.0,9.0,1.0,16.0,19.0,7.0,3.0,0.0,13.0,0.0,11.0,2.0,75.0,3.0,14.0,0.0,10.0,2.0,9.0,19.0,4.0,3.0,13.0,16.0,1.0,8.0,0.0,7.0,2.0,5.0,3.0,11.0,51.0,14.0,19.0,1.0,8.0,1.0,5.0,0.0,9.0,5.0,8.0,6.0,10.0,14.0,6.0,7.0,14.0,5.0,10.0,16.0,18.0,3.0,8.0,4.0,1.0,18.0,23.0,0.0,6.0,1.0,5.0,19.0,17.0,12.0,9.0,0.0,0.0,0.0,1.0,0.0,18.0,8.0,1.0,5.0,8.0,7.0,4.0,4.0,1.0,18.0,39.0,0.0,0.0,1.0,1.0,71.0,16.0,8.0,8.0,18.0,16.0,6.0,4.0,45.0,1.0,26.0,6.0,14.0,10.0,21.0,13.0,1.0,0.0,1.0,3.0,3.0,1.0,2.0,12.0,20.0,1.0,8.0,11.0,2.0,3.0,5.0,7.0,11.0,5.0,15.0,1.0,2.0,4.0,1.0,3.0,4.0,5.0,8.0,14.0,10.0,18.0,20.0,4.0,11.0,1.0,8.0,14.0,13.0,13.0,15.0,9.0,9.0,11.0,14.0,1.0,2.0,5.0,12.0,12.0,0.0,10.0,4.0,10.0,3.0,14.0,18.0,6.0,18.0,16.0,15.0,30.0,14.0,8.0,23.0,0.0,13.0,17.0,19.0,23.0,15.0,24.0,18.0,20.0,7.0,28.0,8.0,16.0,8.0,22.0,20.0,23.0,17.0,13.0,18.0,12.0,5.0,6.0,3.0,0.0,16.0,0.0,0.0,11.0,10.0,3.0,11.0,21.0,0.0,2.0,0.0,3.0,6.0,0.0,5.0,18.0,17.0,10.0,22.0,1.0,13.0,2.0,13.0,3.0,3.0,0.0,0.0,17.0,1.0,3.0,0.0,12.0,10.0,18.0,4.0,1.0,9.0,3.0,5.0,6.0,14.0,12.0,6.0,7.0,6.0,15.0,16.0,20.0,2.0,15.0,0.0,1.0,8.0,2.0,10.0,13.0,15.0,5.0,3.0,19.0,8.0,0.0,9.0,7.0,18.0,24.0,0.0,13.0,22.0,13.0,13.0,13.0,15.0,14.0,9.0,13.0,14.0,26.0,16.0,15.0,4.0,18.0,13.0,7.0,16.0,8.0,4.0,15.0,0.5,1.0,11.5,12.5,4.0,20.0,18.0,13.0,23.0,1.0,8.0,19.5,0.0,21.5,3.0,3.5,6.5,6.0,14.5,14.5,1.5,8.5,13.0,0.0,3.5,11.5,1.5,4.5,7.0,22.5,15.5,9.5,12.5,4.5,15.0,15.0,2.5,21.0,15.5,16.0,21.0,0.0,12.0,11.0,1.5,16.0,6.0,6.0,2.0,20.0,9.5,6.0,3.5,22.5,3.0,22.5,8.5,1.0,25.0,9.0,20.5,10.0,11.5,20.5,12.0,1.5,19.5,20.0,11.0,19.0,12.0,4.0,14.0,2.0,0.0,1.0,2.0,16.5,3.0,15.5,0.5,16.5,4.5,16.5,0.5,19.0,6.0,31.5,7.0,6.5,8.5,3.0,4.5,10.0,18.0,18.0,14.0,15.0,14.0,28.0,0.5,16.5,15.5,1.0,13.5,6.0,5.0,9.5,0.5,25.0,1.5,0.5,13.5,6.0,21.5,26.5,21.0,17.0,8.5,0.0,0.0,0.0,0.0,13.0,9.0,15.0,7.0,11.0,9.0,0.0,9.0,9.0,14.0,2.0,7.0,5.0,7.0,14.0,1.0,2.0,4.0,3.0,13.0,0.0,6.0,8.0,9.0,4.0,4.0,0.0,8.0,12.0,12.0,10.0,4.0,16.0,10.0,15.0,4.0,9.0,9.0,15.0,13.0,4.0,10.0,2.0,15.0,10.0,10.0,6.0,12.0,5.0,10.0,0.0,0.0,0.0,0.0,0.0,0.0,0.0,6.0,8.0,9.0,5.0,6.0,9.0,13.0,7.0,3.0,5.0,6.0,4.0,6.0,4.0,11.0,6.0,6.0,7.0,8.0,5.0,5.0,4.0,4.0,4.0,10.0,9.0,13.0,7.0,5.0,5.0,8.0,6.0,8.0,6.0,3.0,9.0,5.0,4.0,6.0,7.0,7.0,7.0,6.0,8.0,5.0,4.0,6.0,8.0,7.0,9.0,8.0,8.0,5.0,6.0,6.0,5.0,4.0,4.0,5.0,11.0,10.0,4.0,7.0,4.0,4.0,6.0,6.0,6.0,8.0,5.0,6.0,8.0,11.0,8.0,4.0,9.0,2.0,10.0,14.0,3.0,11.0,7.0,8.0,13.0,4.0,7.0,4.0,4.0,8.0,6.0,12.0,9.0,5.0,5.0,3.0,7.0,9.0,5.0,9.0,7.0,4.0,0.0,0.0,1.0,1.0,2.0,2.0,2.0,0.0,1.0,0.0,0.0,0.0,3.0,0.0,0.0,2.0,0.0,0.0,4.0,6.0,9.0,8.0,12.0,11.0,4.0,6.0,6.0,4.0,0.0,13.0,8.0,0.0,14.0,5.0,3.0,17.0,0.0,14.0,5.0,6.0,13.0,1.0,9.0,11.0,2.0,1.0,16.0,5.0,3.0,0.0,6.0,11.0,6.0,6.0,3.0,9.0,8.0,7.0,9.0,3.0,0.0,15.0,13.0,8.0,7.0,9.0,14.0,7.0,8.0,6.0,9.0,16.0,11.0,11.0,7.0,3.0,6.0,5.0,5.0,3.0,12.0,7.0,8.0,9.0,9.0,1.0,3.0,11.0,8.0,4.0,19.0,3.0,4.0,9.0,9.0,0.0,9.0,13.0,,1.0,7.0,3.0,5.0,1.0,5.0,13.0,2.0,3.0,10.0,8.0,9.0,4.0,12.0,3.0,11.0,0.0,0.0,0.0,0.0,0.0,0.0,0.0,0.0,0.0,13.0,4.0,9.0,6.0,10.0,16.0,17.0,9.0,11.0,16.0,1.0,9.0,5.0,12.0,10.0,9.0,7.0,2.0,13.0,3.0,5.0,10.0,14.0,6.0,9.0,7.0,11.0,6.0,4.0,3.0,1.0,6.0,9.0,7.0,0.0,1.0,12.0,0.0,0.0,0.0,0.0,0.0,0.0,0.0,0.0,0.0,0.0,0.0,0.0,0.0,0.0,0.0,0.0,0.0,0.0,0.0,0.0,0.0,20.0,16.0,1.0,2.0,0.0,0.0,0.0,1.0,4.0,0.0,0.0,0.0,0.0,0.0,1.0,0.0,4.0,0.0,0.0,1.0,2.0,0.0,2.0,2.0,0.0,0.0,0.0,0.0,0.0,11.0,12.0,6.0,5.0,10.0,9.0,9.0,10.0,8.0,8.0,11.0,11.0,6.0,9.0,8.0,10.0,7.0,6.0,9.0,4.0,7.0,8.0,9.0,3.0,4.0,6.0,6.0,7.0,7.0,4.0,5.0,7.0,8.0,7.0,4.0,4.0,9.0,8.0,8.0,3.0,7.0,5.0,3.0,5.0,3.0,5.0,7.0,12.0,3.0,9.0,5.0,6.0,9.0,4.0,9.0,2.0,6.0,0.0,8.0,4.0,6.0,6.0,8.0,5.0,6.0,9.0,6.0,6.0,10.0,4.0,6.0,4.0,7.0,9.0,5.0,4.0,7.0,4.0,13.0,9.0,6.0,6.0,3.0,3.0,6.0,13.0,11.0,1.0,9.0,7.0,9.0,0.0,13.0,12.0,4.0,6.0,8.0,4.0,6.0,5.0,20.0,2.0,4.0,2.0,8.0,11.0,10.0,9.0,15.0,7.0,2.0,6.0,9.0,11.0,7.0,5.0,9.0,7.0,4.0,9.0,6.0,7.0,2.0,4.0,11.0,2.0,10.0,6.0,9.0,1.0,7.0,13.0,11.0,11.0,4.0,5.0,4.0,4.0,6.0,6.0,10.0,10.0,2.0,6.0,2.0,3.0,3.0,6.0,7.0,9.0,18.0,1.0,5.0,3.0,5.0,6.0,6.0,3.0,4.0,5.0,5.0,3.0,3.0,5.0,8.0,6.0,4.0,6.0,5.0,2.0,6.0,7.0,7.0,4.0,7.0,8.0,4.0,2.0,5.0,1.0,0.0,0.0,8.0,11.0,6.0,7.0,22.0,0.0,6.0,6.0,6.0,1.0,4.0,4.0,11.0,11.0,14.0,9.0,9.0,4.0,13.0,14.0,2.0,9.0,4.0,19.0,15.0,4.0,3.0,3.0,11.0,5.0,6.0,1.0,6.0,11.0,4.0,14.0,4.0,0.0,16.0,18.0,3.0,22.0,12.0,3.0,14.0,17.0,13.0,21.0,28.0,7.0,13.0,19.0,4.0,4.0,9.0,10.0,5.0,10.0,15.0,14.0,13.0,1.0,4.0,8.0,10.0,13.0,9.0,10.0,8.0,4.0,8.0,10.0,8.0,13.0,30.0,0.0,0.0,30.0,21.0,0.0,15.0,1.0,3.0,3.0,2.0,1.0,3.0,11.0,3.0,12.0,7.0,2.0,3.0,0.0,1.0,2.0,5.0,11.0,3.0,4.0,6.0,4.0,4.0,10.0,10.0,21.0,15.0,12.0,12.0,15.0,8.0,0.0,8.0,22.0,31.0,6.0,18.0,0.0,10.0,8.0,17.0,6.0,7.0,17.0,5.0,8.0,4.0,16.0,14.0,6.0,11.0,14.0,14.0,14.0,7.0,18.0,1.0,23.0,0.0,1.0,0.0,29.0,10.0,0.0,9.0,5.0,8.0,1.0,4.0,8.0,10.0,8.0,2.0,4.0,4.0,0.0,12.0,3.0,5.0,7.0,7.0,16.0,8.0,5.0,5.0,8.0,16.0,13.0,18.0,6.0,7.0,15.0,6.0,1.0,16.0,22.0,4.0,15.0,1.0,14.0,0.0,4.0,2.0,0.0,1.0,4.0,6.0,0.0,5.0,3.0,5.0,2.0,0.0,9.0,13.0,4.0,1.0,5.0,2.0,9.0,3.0,3.0,4.0,4.0,9.0,5.0,0.0,11.0,6.0,13.0,7.0,6.0,3.0,4.0,15.0,8.0,4.0,7.0,4.0,17.0,8.0,0.0,0.0,23.0,2.0,2.0,1.0,2.0,3.0,1.0,9.0,4.0,0.0,0.0,13.0,14.0,8.0,2.0,3.0,8.0,3.0,3.0,4.0,7.0,5.0,4.0,5.0,9.0,1.0,1.0,0.0,20.0,3.0,1.0,1.0,4.0,12.0,10.0,12.0,5.0,0.0,18.0,5.0,1.0,14.0,14.0,7.0,4.0,12.0,1.0,0.0,4.0,8.0,6.0,4.0,1.0,3.0,8.0,5.0,6.0,4.0,12.0,10.0,10.0,4.0,4.0,8.0,4.0,7.0,8.0,4.0,7.0,18.0,8.0,4.0,2.0,10.0,2.0,2.0,3.0,0.0,2.0,4.0,2.0,12.0,4.0,2.0,16.0,18.0,23.0,1.0,7.0,17.0,12.0,12.0,14.0,16.0,4.0,2.0,3.0,13.0,7.0,2.0,11.0,3.0,2.0,16.0,2.0,7.0,13.0,9.0,15.0,10.0,7.0,5.0,13.0,18.0,11.0,5.0,14.0,12.0,10.0,13.0,14.0,9.0,5.0,19.0,10.0,9.0,14.0,19.0,7.0,0.0,5.0,5.0,11.0,3.0,4.0,7.0,22.0,6.0,5.0,8.0,3.0,0.0,7.0,5.0,25.0,5.0,19.0,22.0,1.0,3.0,1.0,0.0,2.0,0.0,5.0,0.0,0.0,0.0,4.0,6.0,1.0,8.0,5.0,18.0,14.0,10.0,13.0,9.0,13.0,11.0,0.0,3.0,3.0,1.0,13.0,2.0,13.0,3.0,2.0,3.0,7.0,7.0,1.0,6.0,0.0,0.0,13.0,9.0,3.0,1.0,3.0,1.0,1.0,4.0,5.0,13.0,21.0,3.0,9.0,2.0,6.0,5.0,9.0,7.0,2.0,5.0,11.0,7.0,3.0,3.0,12.0,5.0,15.0,3.0,0.0,1.0,7.0,7.0,1.0,15.0,8.0,8.0,1.0,8.0,1.0,7.0,4.0,6.0,5.0,3.0,5.0,4.0,0.0,9.0,3.0,15.0,14.0,13.0,4.0,11.0,0.0,1.0,2.0,25.0,18.0,16.0,9.0,24.0,14.0,7.0,4.0,20.0,5.0,13.0,18.0,6.0,2.0,3.0,6.0,17.0,10.0,2.0,6.0,13.0,6.0,2.0,13.0,10.0,3.0,12.0,18.0,17.0,19.0,12.0,11.0,6.0,10.0,11.0,9.0,2.0,5.0,5.0,0.0,3.0,3.0,1.0,3.0,1.0,1.0,0.0,5.0,6.0,0.0,1.0,15.0,2.0,9.0,5.0,3.0,5.0,1.0,8.0,5.0,27.0,3.0,4.0,12.0,10.0,6.0,2.0,0.0,10.0,8.0,2.0,2.0,33.0,3.0,4.0,16.0,2.0,8.0,5.0,20.0,3.0,4.0,11.0,0.0,1.0,8.0,1.0,6.0,7.0,6.0,15.0,15.0,1.0,2.0,13.0,0.0,6.0,3.0,0.0,4.0,11.0,13.0,6.0,3.0,9.0,17.0,10.0,2.0,7.0,18.0,15.0,12.0,10.0,21.0,8.0,1.0,16.0,21.0,6.0,9.0,5.0,14.0,8.0,2.0,11.0,13.0,16.0,10.0,15.0,1.0,5.0,6.0,7.0,1.0,0.0,3.0,0.0,4.0,3.0,0.0,0.0,0.0,0.0,0.0,2.0,1.0,0.0,4.25,10.0,1.0,7.0,0.0,0.0,2.0,2.0,1.0,1.0,3.0,1.0,1.0,1.0,2.0,4.0,6.0,2.0,0.0,2.0,0.0,0.0,2.0,0.0,0.0,3.0,0.0,1.0,4.0,1.0,0.0,3.0,4.0,5.0,50.0,50.0,30.0,30.0,40.0,9.0,6.0,11.0,6.0,11.0,13.0,6.0,14.0,22.0,33.0,10.0,7.0,18.0,15.0,11.0,4.0,17.0,9.0,10.0,8.0,12.0,28.0,11.0,3.0,4.0,10.0,14.0,14.0,15.0,4.0,8.0,5.0,3.0,22.0,16.0,5.0,17.0,17.0,9.0,14.0,7.0,10.0,21.0,15.0,14.0,7.0,8.0,16.0,18.0,15.0,9.0,10.0,16.0,19.0,16.0,15.0,15.0,15.0,14.0,17.0,0.0,5.0,21.0,17.0,20.0,14.0,18.0,13.0,22.0,15.0,6.0,5.0,12.0,15.0,15.0,14.0,11.0,14.0,8.0,23.0,30.0,10.0,11.0,1.0,23.0,14.0,15.0,3.0,26.0,5.0,10.0,4.0,16.0,10.0,11.0,10.0,10.0,13.0,8.0,12.0,3.0,7.0,5.0,4.0,4.0,5.0,12.0,4.0,5.0,4.0,6.0,13.0,6.0,10.0,4.0,19.0,5.0,13.0,20.0,18.0,23.0,4.0,5.0,5.0,5.0,3.0,8.0,7.0,16.0,6.0,4.0,1.0,3.0,3.0,3.0,4.0,4.0,4.0,11.0,5.0,6.0,5.0,7.0,4.0,5.0,5.0,6.0,8.0,3.0,15.0,4.0,4.0,5.0,5.0,4.0,1.0,3.0,4.0,21.0,6.0,6.0,3.0,4.0,25.0,20.0,18.0,11.0,15.0,13.0,26.0,4.0,21.0,28.0,31.0,31.0,31.0,30.0,25.0,18.0,29.0,29.0,28.0,31.0,31.0,28.0,14.0,19.0,14.0,5.0,8.0,34.0,20.0,8.0,3.0,4.0,9.0,5.0,14.0,16.0,8.0,28.0,3.0,8.0,13.0,12.0,13.0,27.0,23.0,12.0,10.0,30.0,11.0,3.0,2.0,3.0,4.0,5.0,4.0,5.0,6.0,7.0,3.0,11.0,6.0,14.0,8.0,7.0,4.0,5.0,18.0,14.0,8.0,14.0,12.0,13.0,3.0,16.0,4.0,6.0,5.0,7.0,19.0,12.0,7.0,6.0,10.0,4.0,3.0,4.0,14.0,4.0,15.0,20.0,19.0,15.0,25.0,12.0,7.0,8.0,6.0,4.0,4.0,5.0,19.0,11.0,10.0,3.0,8.0,4.0,7.0,4.0,11.0,4.0,11.0,6.0,4.0,3.0,9.0,10.0,16.0,4.0,4.0,4.0,4.0,8.0,5.0,5.0,4.0,4.0,4.0,14.0,9.0,4.0,13.0,7.0,9.0,12.0,12.0,7.0,4.0,12.0,30.0,15.0,4.0,7.0,5.0,9.0,8.0,6.0,5.0,5.0,14.0,12.0,6.0,12.0,11.0,5.0,10.0,15.0,5.0,3.0,14.0,23.0,12.0,5.0,7.0,10.0,15.0,24.0,6.0,3.0,13.0,14.0,15.0,14.0,3.0,4.0,4.0,4.0,6.0,5.0,4.0,3.0,6.0,10.0,12.0,9.0,10.0,15.0,14.0,31.0,12.0,9.0,11.0,12.0,9.0,8.0,4.0,13.0,8.0,5.0,13.0,9.0,0.0,7.0,8.0,23.0,13.0,21.0,8.0,18.0,5.0,3.0,2.0,3.0,3.0,3.0,8.0,4.0,3.0,2.0,3.0,13.0,8.0,6.0,10.0,5.0,6.0,6.0,7.0,6.0,6.0,16.0,7.0,9.0,14.0,7.0,3.0,5.0,6.0,19.0,11.0,3.0,10.0,14.0,6.0,12.0,18.0,3.0,18.0,22.0,9.0,5.0,10.0,12.0,16.0,4.0,7.0,6.0,5.0,14.0,21.0,15.0,17.0,9.0,12.0,9.0,10.0,16.0,3.0,5.0,19.0,19.0,12.0,6.0,16.0,9.0,14.0,6.0,9.0,7.0,5.0,6.0,14.0,8.0,10.0,7.0,6.0,12.0,4.0,17.0,15.0,13.0,10.0,7.0,15.0,10.0,6.0,7.0,4.0,4.0,6.0,14.0,17.0,9.0,12.0,5.0,17.0,15.0,18.0,19.0,6.0,3.0,3.0,3.0,4.0,5.0,9.0,3.0,10.0,5.0,0.0,4.0,0.0,1.0,1.0,4.0,3.0,2.0,3.0,0.0,0.0,0.0,3.0,4.0,1.0,1.0,0.0,1.0,0.0,9.0,0.0,0.0,0.0,5.0,4.0,0.0,7.0,2.0,0.0,0.0,3.0,2.0,1.0,0.0,2.0,4.0,0.0,3.0,0.0,2.0,0.0,1.0,1.0,0.0,1.0,1.0,2.0,15.0,0.0,0.0,1.0,2.0,0.0,0.0,0.0,1.0,0.0,6.0,0.0,1.0,0.0,0.0,0.0,1.0,8.0,0.0,0.0,0.0,0.0,1.0,0.0,0.0,2.0,4.0,2.0,2.0,0.0,0.0,1.0,0.0,0.0,3.0,1.0,0.0,1.0,0.0,2.0,1.0,0.0,2.0,1.0,21.0,4.0,3.0,0.0,12.0,0.0,1.0,3.0,2.0,4.0,15.0,4.0,0.0,2.0,19.0,0.0,1.0,4.0,0.0,0.0,3.0,1.0,1.0,0.0,0.0,0.0,6.0,1.0,2.0,0.0,0.0,0.0,2.0,0.0,1.0,0.0,0.0,7.0,5.0,1.0,1.0,2.0,7.0,3.0,0.0,5.0,1.0,1.0,0.0,0.0,1.0,1.0,6.0,0.0,4.0,1.0,8.0,7.0,11.0,2.0,0.0,12.0,8.0,0.0,1.0,1.0,3.0,3.0,0.0,0.0,10.0,0.0,0.0,0.0,2.0,0.0,0.0,4.0,0.0,0.0,1.0,5.0,3.0,1.0,1.0,4.0,0.0,0.0,1.0,1.0,1.0,1.0,1.0,9.0,0.0,0.0,0.0,0.0,1.0,0.0,0.0,1.0,1.0,1.0,3.0,6.0,0.0,5.0,4.0,7.0,2.0,3.0,11.0,7.0,4.0,0.0,1.0,7.0,2.0,7.0,2.0,3.0,8.0,0.0,11.0,14.0,3.0,6.0,1.0,1.0,0.0,6.0,12.0,1.0,0.0,1.0,0.0,0.0,0.0,1.0,4.0,1.0,0.0,5.0,2.0,0.0,0.0,0.0,4.0,3.0,0.0,1.0,3.0,5.0,0.0,0.0,0.0,0.0,3.0,0.0,1.0,0.0,1.0,6.0,2.0,1.0,1.0,5.0,0.0,0.0,2.0,7.0,4.0,3.0,5.0,15.0,3.0,7.0,0.0,1.0,2.0,0.0,2.0,2.0,1.0,6.0,6.0,11.0,4.0,2.0,8.0,2.0,5.0,6.0,1.0,2.0,2.0,7.0,2.0,2.0,1.0,0.0,1.0,0.0,1.0,0.0,0.0,16.0,6.0,14.0,10.0,1.0,7.0,3.0,13.0,0.0,16.0,0.0,3.0,13.0,1.0,0.0,2.0,7.0,11.0,6.0,3.0,6.0,2.0,0.0,3.0,0.0,1.0,4.0,7.0,6.0,1.0,0.0,0.0,3.0,2.0,12.0,4.0,8.0,1.0,1.0,0.0,0.0,2.0,0.0,4.0,8.0,0.0,6.0,7.0,9.0,7.0,7.0,13.0,0.0,0.0,0.0,5.0,1.0,7.0,6.0,0.0,0.0,2.0,19.0,7.0,2.0,0.0,11.0,9.0,0.0,2.0,0.0,2.0,0.0,1.0,0.0,4.0,8.0,2.0,0.0,6.0,0.0,1.0,0.0,3.0,5.0,19.0,1.0,1.0,2.0,2.0,7.0,3.0,2.0,0.0,0.0,0.0,1.0,2.0,0.0,9.0,5.0,7.0,3.0,3.0,7.0,10.0,9.0,7.0,11.0,10.0,11.0,10.0,6.0,10.0,0.0,0.0,0.0,0.0,0.0,0.0,0.0,0.0,0.0,0.0,0.0,3.0,0.0,13.0,2.0,14.0,3.0,7.0,1.0,1.0,12.0,13.0,2.0,8.0,7.0,1.0,8.0,3.0,4.0,15.0,0.0,6.0,7.0,0.0,6.0,5.0,0.0,12.0,1.0,10.0,3.0,2.0,3.0,4.0,3.0,5.0,0.0,19.0,1.0,0.0,8.0,13.0,6.0,2.0,6.0,17.0,1.0,2.0,17.0,3.0,14.0,5.0,2.0,3.0,12.0,0.0,7.0,16.0,3.0,17.0,1.0,0.0,2.0,0.0,19.0,2.0,1.0,2.0,16.0,1.0,6.0,7.0,17.0,11.0,2.0,0.0,10.0,1.0,16.0,7.0,5.0,3.0,4.0,3.0,3.0,0.0,8.0,0.0,3.0,6.0,7.0,0.0,0.0,23.0,15.0,23.0,1.0,8.0,19.0,0.0,1.0,2.0,6.0,6.0,1.0,2.0,8.0,1.0,0.0,0.0,2.0,14.0,7.0,1.0,12.0,0.0,3.0,0.0,16.0,0.0,0.0,4.0,7.0,3.0,1.0,2.0,1.0,0.0,0.0,3.0,3.0,5.0,0.0,3.0,4.0,0.0,10.0,9.0,0.0,15.0,5.0,22.0,2.0,4.0,6.0,4.0,0.0,3.0,7.0,3.0,0.0,0.0,6.0,14.0,6.0,10.0,8.0,1.0,7.0,6.0,10.0,0.0,1.0,1.0,6.0,7.0,6.0,3.0,3.0,0.0,11.0,0.0,14.0,0.0,0.0,22.0,5.0,3.0,2.0,5.0,22.0,19.0,0.0,9.0,7.0,4.0,2.0,13.0,4.0,7.0,0.0,0.0,0.0,15.0,0.0,13.0,0.0,0.0,23.0,0.0,3.0,13.0,15.0,5.0,18.0,20.0,9.0,5.0,4.0,9.0,1.0,0.0,3.0,0.0,1.0,1.0,2.0,2.0,11.0,0.0,14.0,11.0,3.0,2.0,3.0,17.0,7.0,2.0,0.0,6.0,15.0,14.0,3.0,4.0,2.0,12.0,6.0,12.0,0.0,9.0,0.0,2.0,1.0,0.0,12.0,0.0,2.0,8.0,14.0,22.0,15.0,0.0,15.0,1.0,8.0,3.0,5.0,5.0,7.0,8.0,6.0,11.0,1.0,3.0,0.0,4.0,3.0,1.0,0.0,12.0,3.0,1.0,4.0,3.0,0.0,2.0,0.0,0.0,6.0,10.0,0.0,3.0,3.0,10.0,15.0,0.0,2.0,4.0,2.0,1.0,0.0,0.0,0.0,3.0,0.0,1.0,5.0,1.0,0.0,3.0,7.0,1.0,14.0,5.0,1.0,1.0,14.0,16.0,17.0,1.0,0.0,3.0,6.0,5.0,0.0,1.0,1.0,0.0,4.0,0.0,3.0,3.0,24.0,0.0,2.0,3.0,14.0,8.0,0.0,2.0,2.0,13.0,8.0,8.0,0.0,2.0,2.0,4.0,1.0,5.0,19.0,4.0,2.0,3.0,5.0,7.0,1.0,1.0,0.0,7.0,4.0,11.0,3.0,1.0,14.0,2.0,2.0,2.0,23.0,4.0,19.0,19.0,5.0,5.0,0.0,2.0,15.0,4.0,16.0,2.0,1.0,11.0,2.0,5.0,8.0,6.0,6.0,13.0,4.0,5.0,8.0,6.0,5.0,6.0,5.0,3.0,12.0,8.0,6.0,6.0,6.0,5.0,9.0,8.0,0.0,11.0,6.0,5.0,7.0,6.0,5.0,8.0,4.0,4.0,14.0,9.0,6.0,8.0,6.0,8.0,15.0,10.0,10.0,4.0,5.0,6.0,5.0,4.0,5.0,5.0,5.0,1.0,5.0,0.0,5.0,0.0,5.0,5.0,5.0,1.0,4.0,5.0,2.0,5.0,0.0,3.0,3.0,5.0,5.0,4.0,5.0,5.0,5.0,0.0,5.0,2.0,0.0,2.0,1.0,1.0,5.0,5.0,5.0,5.0,3.0,0.0,5.0,2.0,5.0,5.0,5.0,3.0,0.0,4.0,5.0,3.0,5.0,0.0,4.0,1.0,0.0,0.0,0.0,1.0,0.0,1.0,4.0,1.0,5.0,0.0,0.0,0.0,5.0,0.0,3.0,1.0,0.0,3.0,0.0,0.0,1.0,0.0,0.0,5.0,1.0,4.0,1.0,0.0,3.0,0.0,1.0,3.0,3.0,0.0,1.0,2.0,0.0,0.0,0.0,0.0,12.5,3.5,3.5,0.0,10.0,0.0,0.0,4.5,8.5,0.0,0.0,0.0,0.0,0.0,9.0,6.5,6.5,0.0,0.0,0.0,2.5,0.0,0.0,9.0,10.0,14.5,0.0,0.0,0.0,0.0,5.0,6.0,16.5,3.0,6.5,4.5,0.0,0.0,4.25,6.0,0.0,0.0,0.0,3.0,0.0,,0.0,0.0,4.5,0.0,0.0,0.0,0.0,0.0,6.0,0.0,0.0,0.0,0.0,4.5,0.0,4.0,3.0,7.0,1.0,0.0,2.5,1.5,0.0,10.0,0.0,0.0,0.0,0.0,0.0,2.5,8.5,6.0,2.0,0.0,0.0,0.0,0.0,0.0,10.0,0.0,3.5,2.5,0.0,0.0,4.5,4.0,0.0,16.0,0.0,0.0,4.0,0.0,8.0,12.0,10.0,11.0,4.0,12.0,9.0,11.0,13.0,7.0,9.0,14.0,11.0,4.0,0.0,10.0,15.0,9.0,11.0,5.0,3.0,11.0,9.0,10.0,5.0,6.0,10.0,12.0,11.0,14.0,22.0,11.0,14.0,1.0,4.0,5.0,5.0,5.0,5.0,5.0,5.0,4.0,5.0,5.0,4.0,0.0,0.0,0.0,2.0,2.0,0.0,0.0,2.0,2.0,0.0,0.0,0.0,6.0,1.0,9.0,5.0,9.0,5.0,8.0,1.0,1.0,0.0,2.0,11.0,6.0,3.0,2.0,0.0,4.0,2.0,2.0,10.0,0.0,1.0,4.0,7.0,5.0,16.0,16.0,8.0,1.0,10.0,8.0,4.0,1.0,1.0,1.0,4.0,13.0,15.0,1.0,14.0,10.0,1.0,6.0,10.0,10.0,5.0,12.0,12.0,1.0,3.0,4.0,4.0,12.0,6.0,1.0,3.0,0.0,1.0,2.0,5.0,15.0,7.0,5.0,8.0,5.0,1.0,6.0,5.0,15.0,7.0,4.0,6.0,1.0,1.0,1.0,2.0,18.0,10.0,3.0,2.0,13.0,8.0,18.0,10.0,5.0,10.0,2.0,4.0,13.0,3.0,14.0,7.0,2.0,9.0,8.0,5.0,0.0,0.0,4.0,5.0,2.0,5.0,4.0,7.0,1.0,0.0,0.0,4.0,2.0,1.0,7.0,5.0,5.0,1.0,1.0,1.0,1.0,0.0,4.0,10.0,0.0,0.0,5.0,5.0,4.0,4.0,5.0,0.0,0.0,4.0,5.0,4.0,5.0,3.0,5.0,4.0,4.0,5.0,4.0,3.0,5.0,2.0,1.0,2.0,4.0,2.0,4.0,4.0,1.0,4.0,5.0,1.0,0.0,11.0,5.0,7.0,3.0,8.0,13.0,14.0,7.0,7.0,8.0,1.0,1.0,0.0,0.0,0.0,0.0,3.0,1.0,4.0,2.0,0.0,2.0,3.0,4.0,1.0,4.0,4.0,2.0,5.0,7.0,3.0,2.0,0.0,1.0,0.0,0.0,0.0,2.0,0.0,1.0,2.0,2.0,3.0,1.0,1.0,2.0,5.0,2.0,4.0,0.0,1.0,4.0,5.0,0.0,0.0,1.0,4.0,1.0,1.0,7.0,0.0,6.0,5.0,6.0,1.0,2.0,8.0,4.0,0.0,1.0,0.0,6.0,1.0,2.0,3.0,5.0,6.0,2.0,10.0,9.0,3.0,0.0,1.0,4.0,0.0,2.0,0.0,0.0,4.0,1.0,2.0,1.0,5.0,5.0,0.0,0.0,7.0,3.0,5.0,10.0,6.0,2.0,3.0,6.0,5.0,3.0,11.0,3.0,3.0,7.0,7.0,5.0,11.0,7.0,5.0,5.0,6.0,5.0,4.0,5.0,11.0,8.0,7.0,3.0,5.0,6.0,0.0,6.0,,,,,,,,,,,,,,,,,,,,,9.0,4.0,2.0,6.0,5.0,7.0,5.0,9.0,3.0,8.0,5.0,1.0,0.0,0.0,3.0,2.0,1.0,3.0,7.0,0.0,7.0,3.0,2.0,0.0,1.0,4.0,3.0,4.0,0.0,5.0,2.0,7.0,1.0,4.0,1.0,0.0,10.0,1.0,0.0,5.0,1.0,2.0,5.0,2.0,2.0,3.0,2.0,1.0,4.0,5.0,4.0,2.0,7.0,0.0,6.0,4.0,3.0,0.0,15.0,7.0,5.0,3.0,2.0,1.0,2.0,4.0,4.0,3.0,1.0,0.0,0.0,3.0,1.0,4.0,3.0,0.0,3.0,0.0,12.0,5.0,8.0,5.0,9.0,1.0,1.0,0.0,1.0,2.0,1.0,3.0,0.0,1.0,1.0,0.0,2.0,1.0,5.0,1.0,2.0,3.0,4.0,1.0,3.0,3.0,2.0,4.0,3.0,2.0,3.0,6.0,2.0,6.0,9.0,6.0,5.0,10.0,5.0,3.0,5.0,3.0,7.0,5.0,7.0,4.0,5.0,5.0,6.0,5.0,6.0,4.0,3.0,3.0,5.0,2.0,5.0,4.0,4.0,2.0,5.0,3.0,4.0,7.0,1.0,3.0,0.0,6.0,2.0,3.0,3.0,3.0,5.0,5.0,3.0,2.0,2.0,5.0,6.0,3.0,3.0,4.0,0.0,7.0,5.0,3.0,2.0,10.0,4.0,8.0,3.0,6.0,6.0,6.0,3.0,4.0,4.0,1.0,4.0,6.0,4.0,6.0,7.0,4.0,4.0,4.0,8.0,5.0,5.0,3.0,10.0,3.0,11.0,5.0,2.0,1.0,7.0,2.0,4.0,4.0,5.0,3.0,4.0,10.0,7.0,7.0,4.0,7.0,11.0,6.0,5.0,6.0,2.0,0.0,7.0,13.0,8.0,0.0,7.0,1.0,3.0,5.0,3.0,5.0,7.0,8.0,3.0,3.0,6.0,6.0,10.0,4.0,6.0,4.0,3.0,0.0,3.0,8.0,5.0,8.0,6.0,3.0,14.0,9.0,0.0,6.0,6.0,6.0,4.0,6.0,9.0,7.0,2.0,5.0,4.0,8.0,5.0,5.0,8.0,6.0,7.0,2.0,10.0,4.0,5.0,8.0,6.0,1.0,5.0,2.0,6.0,14.0,10.0,10.0,4.0,8.0,9.0,4.0,0.0,10.0,2.0,11.0,10.0,14.0,12.0,10.0,7.0,0.0,4.0,9.0,5.0,3.0,4.0,14.0,8.0,6.0,15.0,1.0,10.0,12.0,10.0,6.0,11.0,16.0,5.0,4.0,16.0,17.0,20.0,4.0,16.0,3.0,7.0,23.0,16.0,4.0,4.0,15.0,15.0,9.0,20.0,2.0,5.0,12.0,4.0,7.0,17.0,6.0,18.0,12.0,15.0,6.0,8.0,5.0,6.0,3.0,4.0,5.0,6.0,5.0,6.0,3.0,1.0,4.0,3.0,21.0,4.0,2.0,3.0,4.0,14.0,13.0,4.0,15.0,10.0,15.0,2.0,19.0,3.0,10.0,0.0,6.0,4.0,9.0,9.0,8.0,4.0,2.0,10.0,4.0,17.0,13.0,9.0,9.0,10.0,26.0,22.0,12.0,13.0,14.0,3.0,11.0,8.0,16.0,14.0,19.0,10.0,12.0,11.0,2.0,4.0,34.0,10.0,8.0,9.0,19.0,5.0,5.0,7.0,16.0,1.0,6.0,19.0,8.0,4.0,12.0,6.0,2.0,9.0,13.0,4.0,4.0,6.0,4.0,2.0,4.0,11.0,9.0,6.0,7.0,2.0,8.0,2.0,7.0,2.0,1.0,8.0,4.0,10.0,6.0,9.0,0.0,4.0,5.0,10.0,2.0,10.0,0.0,3.0,16.0,2.0,1.0,3.0,8.0,0.0,1.0,0.0,1.0,0.0,4.0,5.0,2.0,2.0,6.0,1.0,6.0,4.0,0.0,0.0,0.0,1.0,0.0,0.0,0.0,1.0,3.0,9.0,7.0,3.0,7.0,0.0,4.0,0.0,0.0,0.0,8.0,1.0,3.0,4.0,1.0,1.0,0.0,0.0,0.0,5.0,2.0,0.0,0.0,1.0,4.0,0.0,4.0,3.0,3.0,2.0,1.0,0.0,4.0,2.0,6.0,1.0,2.0,5.0,6.0,15.0,1.0,1.0,2.0,4.0,0.0,1.0,1.0,3.0,2.0,0.0,1.0,0.0,0.0,0.0,0.0,3.0,1.0,2.0,1.0,3.0,3.0,0.0,1.0,0.0,0.0,0.0,8.0,0.0,0.0,0.0,0.0,1.0,0.0,0.0,1.0,5.0,5.0,5.0,5.0,5.0,5.0,1.0,0.0,2.0,0.0,0.0,1.0,0.0,1.0,0.0,1.0,1.0,0.0,1.0,0.0,1.0,1.0,1.0,0.0,2.0,3.0,14.0,5.0,8.0,7.0,34.0,10.0,21.0,7.0,12.0,8.0,12.0,14.0,6.0,8.0,8.0,3.0,0.0,37.0,0.0,8.0,14.0,10.0,11.0,8.0,9.0,7.0,2.0,6.0,3.0,8.0,3.0,2.0,1.0,5.0,8.0,3.0,2.0,13.0,8.0,7.0,15.0,1.0,10.0,5.0,1.0,4.0,3.0,5.0,5.0,5.0,4.0,5.0,5.0,5.0,4.0,5.0,5.0,5.0,5.0,5.0,1.0,3.0,5.0,5.0,5.0,5.0,2.0,5.0,2.0,3.0,5.0,5.0,5.0,5.0,5.0,2.0,4.0,1.0,5.0,5.0,3.0,0.0,5.0,2.0,3.0,0.0,5.0,4.0,3.0,3.0,1.0,5.0,5.0,1.0,5.0,5.0,5.0,1.0,5.0,5.0,5.0,5.0,5.0,5.0,5.0,5.0,1.0,5.0,1.0,0.0,0.0,3.0,5.0,5.0,1.0,3.0,1.0,5.0,3.0,1.0,5.0,2.0,2.0,1.0,2.0,4.0,5.0,5.0,0.0,5.0,2.0,1.0,5.0,1.0,5.0,5.0,3.0,5.0,3.0,3.0,3.0,5.0,5.0,4.0,5.0,5.0,3.0,0.0,5.0,0.0,5.0,5.0,4.0,3.0,5.0,0.0,5.0,5.0,1.0,5.0,3.0,10.0,17.0,8.0,7.0,18.0,10.0,5.0,4.0,11.0,6.0,16.0,17.0,15.0,17.0,11.0,2.0,2.0,5.0,5.0,2.0,5.0,5.0,5.0,2.0,1.0,5.0,5.0,5.0,5.0,5.0,5.0,3.0,5.0,5.0,5.0,5.0,5.0,5.0,5.0,4.0,5.0,5.0,5.0,0.0,5.0,5.0,0.0,0.0,0.0,3.0,5.0,5.0,5.0,5.0,5.0,1.0,5.0,5.0,5.0,5.0,5.0,5.0,5.0,4.0,2.0,1.0,5.0,4.0,5.0,5.0,5.0,3.0,5.0,5.0,5.0,0.0,5.0,2.0,1.0,5.0,5.0,2.0,3.0,0.0,5.0,3.0,3.0,5.0,5.0,5.0,5.0,5.0,5.0,5.0,5.0,5.0,0.0,5.0,5.0,0.0,5.0,3.0,5.0,5.0,4.0,5.0,5.0,5.0,1.0,5.0,1.0,5.0,5.0,5.0,5.0,5.0,5.0,0.0,5.0,3.0,1.0,5.0,5.0,5.0,5.0,5.0,8.0,5.0,7.0,6.0,9.0,2.0,10.0,3.0,4.0,9.0,9.0,7.0,1.0,1.0,11.0,2.0,3.0,13.0,8.0,13.0,17.0,9.0,8.0,12.0,5.0,11.0,6.0,9.0,2.0,4.0,6.0,4.0,7.0,12.0,4.0,4.0,1.0,4.0,5.0,6.0,7.0,6.0,3.0,9.0,12.0,7.0,6.0,9.0,9.0,6.0,8.0,2.0,0.0,11.0,11.0,3.0,2.0,7.0,5.0,10.0,10.0,10.0,6.0,7.0,1.0,0.0,1.0,11.0,0.0,6.0,2.0,3.0,3.0,4.0,12.0,10.0,2.0,6.0,0.0,10.0,7.0,9.0,7.0,3.0,0.0,1.0,4.0,4.0,4.0,8.0,2.0,8.0,3.0,4.0,2.0,9.0,6.0,6.0,4.0,7.0,13.0,8.0,7.0,2.0,5.0,9.0,6.0,10.0,8.0,6.0,16.0,0.0,7.0,3.0,5.0,10.0,0.0,9.0,10.0,2.0,5.0,12.0,6.0,6.0,7.0,1.0,15.0,10.0,8.0,6.0,6.0,13.0,3.0,9.0,13.0,10.0,2.0,5.0,9.0,7.0,9.0,8.0,6.0,7.0,12.0,5.0,9.0,9.0,10.0,7.0,11.0,3.0,3.0,6.0,14.0,9.0,3.0,11.0,3.0,4.0,4.0,3.0,10.0,6.0,4.0,8.0,3.0,3.0,5.0,0.0,4.0,4.0,11.0,4.0,10.0,12.0,1.0,13.0,11.0,7.0,9.0,7.0,4.0,4.0,7.0,6.0,4.0,6.0,6.0,6.0,12.0,5.0,9.0,9.0,12.0,7.0,10.0,4.0,6.0,8.0,8.0,4.0,4.0,7.0,4.0,0.0,0.0,0.0,0.0,0.0,13.0,17.0,8.0,2.0,4.0,6.0,10.0,35.0,25.0,12.0,3.0,7.0,11.0,20.0,10.0,6.0,10.0,1.0,8.0,7.0,9.0,7.0,6.0,14.0,7.0,7.0,5.0,0.0,12.0,2.0,5.0,6.0,8.0,6.0,6.0,4.0,3.0,8.0,4.0,14.0,7.0,6.0,5.0,4.0,0.0,7.0,9.0,8.0,5.0,4.0,13.0,3.0,8.0,4.0,2.0,2.0,3.0,3.0,6.0,1.0,3.0,3.0,9.0,20.0,12.0,2.0,11.0,10.0,14.0,7.0,10.0,3.0,6.0,6.0,9.0,3.0,7.0,2.0,1.0,8.0,3.0,9.0,3.0,4.0,1.0,6.0,5.0,9.0,5.0,5.0,8.0,7.0,6.0,8.0,5.0,5.0,1.0,8.0,2.0,6.0,6.0,5.0,8.0,12.0,17.0,12.0,8.0,5.0,10.0,14.0,12.0,19.0,8.0,8.0,4.0,3.0,11.0,10.0,14.0,8.0,19.0,8.0,6.0,12.0,5.0,8.0,11.0,15.0,8.0,9.0,8.0,,7.0,5.0,8.0,0.0,1.0,4.0,7.0,7.0,6.0,14.0,4.0,16.0,3.0,6.0,3.0,6.0,9.0,5.0,12.0,3.0,0.0,3.0,6.0,8.0,4.0,2.0,1.0,1.0,0.0,0.0,0.0,0.0,0.0,1.0,6.0,0.0,3.0,0.0,8.0,1.0,8.0,10.0,7.0,15.0,19.0,15.0,14.0,9.0,13.0,14.0,14.0,16.0,12.0,7.0,8.0,8.0,0.0,3.0,1.0,9.0,9.0,7.0,5.0,12.0,5.0,15.0,17.0,11.0,6.0,1.0,8.0,4.0,16.0,18.0,7.0,7.0,4.0,18.0,12.0,7.0,11.0,7.0,21.0,9.0,7.0,12.0,0.0,7.0,7.0,8.0,17.0,9.0,10.0,10.0,12.0,13.0,1.0,4.0,5.0,7.0,6.0,2.0,5.0,8.0,7.0,8.0,10.0,4.0,3.0,2.0,4.0,9.0,0.0,5.0,5.0,12.0,0.0,6.0,3.0,0.0,12.0,0.0,3.0,8.0,14.0,6.0,6.0,7.0,1.0,7.0,10.0,3.0,1.0,2.0,1.0,5.0,0.0,2.0,0.0,3.0,6.0,1.0,1.0,2.0,4.0,5.0,1.0,6.0,8.0,7.0,10.0,10.0,9.0,13.0,22.0,6.0,8.0,19.0,10.0,10.0,21.0,13.0,11.0,10.0,11.0,9.0,9.0,7.0,12.0,11.0,11.0,0.0,0.0,10.0,13.0,13.0,13.0,12.0,12.0,7.0,12.0,14.0,19.0,17.0,6.0,24.0,0.0,9.0,11.0,12.0,8.0,0.0,18.0,12.0,24.0,0.0,6.0,15.0,13.0,17.0,4.0,10.0,7.0,10.0,16.0,12.0,9.0,5.0,19.0,14.0,18.0,17.0,19.0,13.0,9.0,6.0,11.0,7.0,10.0,6.0,16.0,12.0,7.0,14.0,14.0,14.0,9.0,18.0,11.0,9.0,7.0,18.0,13.0,18.0,19.0,18.0,16.0,23.0,18.0,22.0,11.0,11.0,13.0,20.0,15.0,18.0,17.0,10.0,15.0,21.0,12.0,12.0,10.0,9.0,11.0,17.0,15.0,16.0,20.0,11.0,9.0,15.0,11.0,11.0,10.0,11.0,9.0,12.0,7.0,17.0,16.0,9.0,13.0,13.0,3.0,15.0,15.0,17.0,5.0,11.0,14.0,7.0,22.0,8.0,11.0,16.0,14.0,14.0,5.0,14.0,9.0,11.0,13.0,13.0,16.0,13.0,13.0,8.0,12.0,6.0,6.0,14.0,5.0,6.0,0.0,3.0,6.0,0.0,8.0,10.0,8.0,10.0,7.0,7.0,3.0,15.0,10.0,5.0,3.0,7.0,4.0,16.0,8.0,12.0,5.0,10.0,0.0,10.0,8.0,7.0,9.0,4.0,11.0,5.0,22.0,10.0,6.0,8.0,5.0,15.0,9.0,7.0,11.0,3.0,14.0,7.0,6.0,6.0,4.0,15.0,8.0,4.0,2.0,2.0,4.0,3.0,3.0,2.0,0.0,0.0,9.0,0.0,0.0,0.0,1.0,0.0,0.0,0.0,0.0,18.0,4.0,9.0,9.0,5.0,11.0,24.0,10.0,12.0,3.0,7.0,4.0,25.0,7.0,1.0,5.0,10.0,2.0,14.0,22.0,14.0,3.0,12.0,12.0,9.0,3.0,18.0,13.0,4.0,7.0,4.0,7.0,2.0,10.0,8.0,3.0,12.0,11.0,23.0,0.0,7.0,3.0,3.0,1.0,3.0,10.0,2.0,2.0,6.0,6.0,6.0,7.0,10.0,13.0,9.0,17.0,9.0,5.0,7.0,12.0,11.0,12.0,8.0,7.0,14.0,10.0,9.0,1.0,5.0,11.0,13.0,11.0,7.0,8.0,12.0,8.0,7.0,13.0,14.0,13.0,10.0,7.0,0.0,4.0,6.0,9.0,14.0,12.0,10.0,9.0,9.0,11.0,10.0,7.0,11.0,1.0,3.0,10.0,3.0,13.0,10.0,8.0,6.0,12.0,11.0,3.0,9.0,2.0,9.0,9.0,7.0,8.0,7.0,6.0,11.0,12.0,8.0,26.0,2.0,13.0,15.0,5.0,11.0,6.0,6.0,8.0,11.0,16.0,16.0,9.0,9.0,4.0,14.0,8.0,3.0,11.0,8.0,12.0,14.0,5.0,18.0,9.0,13.0,12.0,9.0,5.0,5.0,4.0,10.0,23.0,15.0,1.0,5.0,5.0,7.0,11.0,10.0,10.0,7.0,7.0,4.0,6.0,7.0,5.0,8.0,16.0,9.0,8.0,4.0,15.0,5.0,7.0,7.0,18.0,6.0,2.0,2.0,7.0,7.0,6.0,8.0,2.0,8.0,7.0,5.0,3.0,13.0,4.0,8.0,6.0,3.0,5.0,14.0,4.0,3.0,12.0,6.0,7.0,0.0,4.0,9.0,6.0,1.0,0.0,0.0,5.0,1.0,0.0,3.0,5.0,3.0,5.0,0.0,3.0,3.0,14.0,0.0,9.0,4.0,5.0,6.0,0.0,0.0,0.0,0.0,1.0,0.0,2.0,2.0,0.0,1.0,4.0,3.0,2.0,0.0,0.0,4.0,3.0,0.0,2.0,1.0,0.0,0.0,0.0,3.0,0.0,3.0,0.0,0.0,5.0,0.0,5.0,2.0,4.0,5.0,2.0,5.0,6.0,3.0,5.0,5.0,0.0,0.0,4.0,4.0,4.0,0.0,4.0,5.0,1.0,3.0,0.0,0.0,0.0,0.0,0.0,0.0,0.0,0.0,0.0,0.0,0.0,0.0,0.0,0.0,0.0,2.0,0.0,0.0,6.0,0.0,5.0,2.0,4.0,4.0,2.0,5.0,0.0,2.0,0.0,4.0,2.0,3.0,0.0,3.0,2.0,1.0,0.0,0.0,0.0,0.0,0.0,0.0,0.0,2.0,0.0,0.0,1.0,0.0,2.0,12.0,8.0,13.0,16.0,20.0,7.0,8.0,13.0,3.0,18.0,0.0,9.0,1.0,1.0,22.0,4.0,2.0,1.0,4.0,4.0,9.0,12.0,12.0,23.0,5.0,7.0,11.0,1.0,1.0,11.0,14.0,13.0,13.0,11.0,4.0,19.0,15.0,13.0,13.0,18.0,5.0,54.0,7.0,7.0,19.0,1.0,1.0,8.0,0.0,4.0,7.0,5.0,8.0,11.0,14.0,17.0,5.0,4.0,7.0,13.0,19.0,0.0,15.0,19.0,18.0,17.0,17.0,8.0,16.0,0.0,4.0,10.0,12.0,15.0,4.0,9.0,2.0,7.0,3.0,4.0,12.0,15.0,4.0,6.0,3.0,0.0,6.0,5.0,1.0,10.0,6.0,5.0,9.0,18.0,4.0,4.0,14.0,5.0,11.0,1.0,18.0,16.0,4.0,15.0,4.0,1.0,3.0,2.0,3.0,8.0,5.0,9.0,6.0,9.0,22.0,15.0,14.0,5.0,10.0,0.0,2.0,11.0,6.0,13.0,11.0,9.0,0.0,13.0,2.0,5.0,1.0,11.0,8.0,1.0,2.0,0.0,17.0,2.0,7.0,13.0,8.0,11.0,9.0,13.0,8.0,13.0,11.0,3.0,1.0,9.0,6.0,11.0,6.0,27.0,10.0,5.0,0.0,3.0,5.0,2.0,12.0,1.0,4.0,2.0,3.0,9.0,3.0,9.0,5.0,11.0,7.0,6.0,2.0,8.0,4.0,8.0,3.0,6.0,12.0,15.0,10.0,9.0,11.0,10.0,12.0,9.0,6.0,1.0,4.0,1.0,0.0,0.0,0.0,0.0,0.0,0.0,0.0,0.0,0.0,0.0,0.0,0.0,0.0,0.0,0.0,0.0,0.0,0.0,0.0,0.0,0.0,0.0,0.0,0.0,0.0,0.0,0.0,0.0,0.0,0.0,0.0,0.0,0.0,0.0,0.0,0.0,0.0,0.0,0.0,0.0,0.0,0.0,0.0,0.0,0.0,0.0,0.0,0.0,0.0,0.0,0.0,0.0,0.0,0.0,0.0,0.0,0.0,0.0,0.0,0.0,0.0,3.0,0.0,0.0,0.0,3.0,0.0,1.0,,0.0,,4.0,,,,,,,,,,,,,,,,,,,,,,,,,,,,,,,,,,,,,,5.0,,,2.0,,,5.0,5.0,3.0,5.0,5.0,4.0,5.0,5.0,0.0,2.0,5.0,0.0,0.0,2.0,1.0,4.0,2.0,0.0,3.0,8.0,1.0,1.0,1.0,1.0,0.0,0.0,4.0,3.0,5.0,5.0,1.0,1.0,5.0,0.0,2.0,2.0,0.0,1.0,4.0,0.0,1.0,5.0,5.0,4.0,3.0,4.0,4.0,2.0,4.0,0.0,2.0,1.0,3.0,0.0,3.0,2.0,1.0,3.0,1.0,4.0,,,5.0,2.0,25.0,5.0,0.0,5.0,3.0,5.0,5.0,4.0,3.0,5.0,0.0,2.0,0.0,2.0,2.0,5.0,5.0,1.0,5.0,2.0,0.0,0.0,5.0,3.0,5.0,3.0,5.0,5.0,5.0,5.0,3.0,5.0,4.0,3.0,5.0,3.5,5.0,4.0,0.0,5.0,2.0,4.0,0.0,0.0,0.0,3.0,2.0,4.0,0.0,1.0,1.0,0.0,5.0,3.0,2.0,1.0,3.0,4.0,4.0,5.0,1.0,1.0,5.0,4.0,5.0,5.0,5.0,5.0,5.0,2.0,0.0,5.0,5.0,1.0,0.0,3.0,5.0,5.0,0.0,1.0,3.0,1.0,1.0,1.0,4.0,0.0,5.0,2.0,0.0,5.0,3.0,1.0,3.0,1.0,1.0,1.0,0.0,2.0,5.0,2.0,5.0,2.0,4.0,4.0,2.0,2.0,3.0,0.0,3.0,2.0,0.0,0.0,5.0,5.0,3.0,2.0,3.0,4.0,1.0,33.0,1.0,1.0,5.0,1.0,1.0,2.0,3.0,5.0,2.0,5.0,0.0,4.0,7.0,1.0,1.0,4.0,3.0,0.0,2.0,5.0,5.0,4.0,2.0,1.0,0.0,0.0,5.0,1.0,5.0,1.0,0.0,0.0,0.0,0.0,2.0,3.0,0.0,0.0,2.0,1.0,2.0,1.0,4.0,0.0,0.0,0.0,0.0,0.0,10.0,5.0,3.0,1.0,10.0,5.0,0.0,1.0,7.0,0.0,2.0,5.0,5.0,27.0,26.0,5.0,9.0,3.0,3.0,5.0,2.0,3.0,4.0,5.0,1.0,4.0,2.0,5.0,10.0,1.0,3.0,0.0,1.0,0.0,6.0,0.0,0.0,6.0,1.0,4.0,5.0,13.0,5.0,9.0,14.0,6.0,5.0,1.0,1.0,5.0,5.0,5.0,5.0,5.0,4.0,0.0,2.0,3.0,0.0,3.0,2.5,2.0,3.0,0.0,2.0,0.0,5.0,3.0,15.0,0.0,0.0,5.0,3.0,0.0,0.0,5.0,1.0,1.0,3.0,1.0,3.0,0.0,1.0,2.0,1.0,0.0,2.0,0.0,1.0,0.0,1.0,13.0,2.0,3.0,5.0,1.0,0.0,3.0,5.0,1.0,4.0,5.0,3.0,5.0,2.0,0.0,5.0,4.0,5.0,4.0,5.0,2.0,5.0,5.0,0.0,5.0,4.0,0.0,6.0,0.0,4.0,4.0,0.0,5.0,1.0,5.0,2.0,6.0,5.0,4.0,0.0,5.0,3.0,4.0,5.0,5.0,0.0,0.0,0.0,2.0,1.0,1.0,1.0,0.0,0.0,2.0,0.0,1.0,0.0,0.0,0.0,0.0,0.0,5.0,3.0,3.0,5.0,0.0,0.0,3.0,5.0,17.0,1.0,3.0,1.0,5.0,3.0,5.0,3.0,0.0,2.0,3.0,1.0,0.0,2.0,5.0,2.0,4.0,5.0,10.0,12.0,5.0,5.0,6.0,5.0,0.0,0.0,12.0,11.0,1.0,36.0,5.0,5.0,2.0,3.0,3.0,1.0,2.0,5.0,5.0,11.0,3.0,5.0,1.0,1.0,5.0,0.0,0.0,1.0,1.0,5.0,5.0,3.0,2.0,5.0,5.0,5.0,5.0,3.0,0.0,1.0,4.0,0.0,5.0,4.0,4.0,7.0,2.0,5.0,5.0,0.0,4.0,5.0,0.0,0.0,0.0,5.0,3.0,3.0,2.0,4.75,5.0,0.0,5.0,5.0,0.0,0.0,0.0,0.0,5.0,5.0,5.0,3.0,4.0,5.0,5.0,2.0,1.0,3.0,5.0,5.0,0.0,0.0,5.0,6.0,5.0,3.0,5.0,5.0,5.0,5.0,1.0,5.0,0.0,3.0,5.0,1.0,3.0,5.0,5.0,5.0,5.0,5.0,4.0,0.0,5.0,4.0,3.0,1.0,5.0,4.0,5.0,1.0,3.0,4.0,5.0,3.0,4.0,2.0,3.0,5.0,4.0,1.0,1.0,5.0,1.0,5.0,0.0,5.0,5.0,0.0,0.0,1.0,9.0,5.0,5.0,5.0,0.0,5.0,5.0,5.0,5.0,5.0,5.0,5.0,5.0,5.0,3.0,5.0,4.0,5.0,5.0,0.0,0.0,5.0,0.0,1.0,0.0,3.0,3.0,1.0,5.0,5.0,1.0,5.0,5.0,5.0,4.0,0.0,4.0,1.0,0.0,1.0,3.0,4.0,2.0,0.0,2.0,3.0,0.0,0.0,0.0,2.0,5.0,0.0,5.0,5.0,3.0,5.0,6.0,2.0,8.0,1.0,0.0,3.0,5.0,0.0,2.0,2.0,0.0,4.0,2.0,5.0,3.0,3.0,5.0,1.0,1.0,5.0,4.0,5.0,4.0,0.0,1.0,1.0,0.0,2.0,0.0,5.0,0.0,5.0,5.0,0.0,5.0,1.0,0.0,5.0,5.0,5.0,4.0,5.0,3.0,3.0,5.0,2.0,3.0,2.0,2.0,2.0,5.0,5.0,4.0,2.0,0.0,1.0,2.0,0.0,0.0,5.0,1.0,3.0,1.0,2.0,5.0,5.0,5.0,2.0,5.0,4.0,5.0,5.0,3.0,5.0,4.0,4.0,1.0,5.0,5.0,0.0,0.0,6.0,5.0,4.0,5.0,0.0,0.0,0.0,4.0,3.0,1.0,5.0,4.0,5.0,5.0,5.0,4.0,2.0,5.0,4.0,5.0,,,,4.0,2.0,2.0,3.0,1.0,3.0,9.0,4.0,3.0,1.0,3.0,0.0,3.0,1.0,0.0,4.0,0.0,1.0,0.0,1.0,4.0,2.0,0.0,2.0,5.0,5.0,3.0,4.0,5.0,3.0,5.0,3.0,5.0,5.0,5.0,0.0,3.0,5.0,5.0,2.0,0.0,4.0,5.0,5.0,5.0,5.0,0.0,4.0,4.0,5.0,0.0,4.0,0.0,5.0,0.0,0.0,4.0,5.0,5.0,2.0,0.0,5.0,4.0,2.0,1.0,5.0,3.0,5.0,4.0,0.0,2.0,0.0,2.0,2.0,4.0,3.0,4.0,5.0,4.0,0.0,5.0,5.0,1.0,4.0,1.0,0.0,3.0,0.0,0.0,0.0,1.0,1.0,5.0,5.0,5.0,0.0,3.0,0.0,5.0,0.0,4.0,1.0,5.0,2.0,4.0,4.0,0.0,1.0,5.0,0.0,0.0,5.0,5.0,0.0,5.0,3.0,3.0,2.0,0.0,7.0,5.0,5.0,0.0,0.0,4.0,0.0,0.0,0.0,5.0,5.0,3.0,4.0,3.0,1.0,0.0,3.0,4.0,5.0,5.0,3.0,0.0,2.0,5.0,0.0,4.0,2.0,2.0,3.0,1.0,4.0,3.0,2.0,1.0,5.0,3.0,5.0,2.0,4.0,3.0,4.0,5.0,0.0,2.0,4.0,5.0,0.0,7.0,5.0,0.0,2.0,0.0,0.0,1.0,0.0,1.0,4.0,0.0,0.0,0.0,5.0,0.0,1.0,0.0,0.0,0.0,0.0,0.0,0.0,0.0,0.0,4.0,2.0,5.0,5.0,5.0,0.0,6.0,0.0,4.0,5.0,2.0,0.0,1.0,1.0,5.0,7.0,4.0,5.0,5.0,1.0,4.0,0.0,2.0,1.0,0.0,5.0,5.0,2.0,1.0,3.0,2.0,2.0,3.0,2.0,1.0,3.0,5.0,2.0,5.0,2.0,1.0,5.0,3.0,3.0,0.0,5.0,3.0,4.0,0.0,5.0,4.0,1.0,4.0,0.0,0.0,1.0,4.0,4.0,0.0,4.0,4.0,2.0,5.0,2.0,2.0,1.0,5.0,0.0,4.0,1.0,5.0,0.0,0.0,5.0,5.0,9.0,2.0,0.0,0.0,5.0,5.0,5.0,5.0,0.0,1.0,3.0,5.0,1.0,4.0,5.0,2.0,0.0,5.0,3.0,5.0,5.0,5.0,3.0,4.0,5.0,2.0,0.0,5.0,3.0,5.0,0.0,5.0,1.0,5.0,5.0,0.0,0.0,1.0,6.0,3.3333333333333335,2.0,0.0,2.0,2.0,0.0,2.0,1.0,5.0,1.0,2.0,2.0,0.0,0.0,0.0,2.0,0.0,4.0,3.0,5.0,5.0,1.0,2.0,0.0,5.0,0.0,2.0,0.0,4.0,0.0,0.0,2.0,3.0,5.0,0.0,4.0,3.0,4.0,3.0,5.0,4.0,2.0,0.0,1.0,0.0,0.0,4.0,2.0,1.0,1.0,1.0,3.0,0.0,2.0,3.0,5.0,2.0,5.0,4.0,2.0,2.0,2.0,2.0,0.0,1.0,2.0,3.0,3.0,0.0,1.0,5.0,4.0,0.0,0.0,5.0,1.0,5.0,5.0,4.0,2.0,9.0,10.0,0.0,0.0,0.0,1.0,1.0,5.0,1.0,3.0,0.0,5.0,5.0,5.0,0.0,4.0,1.0,3.0,5.0,5.0,3.0,5.0,0.0,1.0,5.0,5.0,1.0,3.0,2.0,2.0,4.0,3.0,7.0,8.0,1.0,5.0,2.0,5.0,3.0,3.0,2.0,3.0,3.0,1.0,2.0,0.0,3.0,1.0,1.0,5.0,2.0,0.0,3.0,2.0,3.0,2.0,5.0,3.0,3.0,5.0,0.0,0.0,0.0,4.0,5.0,3.0,2.0,1.0,4.0,5.0,1.0,5.0,4.0,2.0,5.0,1.0,13.0,4.0,0.0,4.0,5.0,5.0,6.0,4.0,5.0,1.0,6.0,3.0,5.0,0.0,0.0,5.0,5.0,6.0,5.0,6.0,3.0,5.0,2.0,2.0,2.0,4.0,5.0,1.0,5.0,0.0,0.0,4.0,2.0,5.0,6.0,4.0,4.0,5.0,4.0,1.0,4.0,5.0,1.0,5.0,5.0,12.0,1.0,0.0,7.0,12.0,8.0,4.0,4.0,0.0,1.0,2.0,2.0,5.0,0.0,2.0,2.0,5.0,5.0,5.0,5.0,0.0,1.0,4.0,5.0,2.0,5.0,3.0,2.0,5.0,5.0,3.0,5.0,5.0,5.0,4.0,5.0,4.0,3.0,5.0,4.0,3.0,2.0,1.0,0.0,0.0,1.0,3.0,1.0,0.0,5.0,4.0,1.0,5.0,2.0,5.0,2.0,4.0,2.0,2.0,3.0,3.0,3.0,5.0,4.0,5.0,5.0,4.0,3.5,7.0,10.0,3.0,3.0,0.0,5.0,0.0,3.0,3.0,5.0,4.0,5.0,5.0,2.0,1.0,5.0,0.0,4.0,5.0,2.0,1.0,0.0,0.0,9.0,4.0,5.0,5.0,5.0,5.0,5.0,5.0,5.0,4.0,3.0,4.0,5.0,5.0,1.0,3.0,2.0,4.0,5.0,5.0,2.0,1.0,0.0,3.0,0.0,2.0,3.0,0.0,1.0,2.0,0.0,3.0,5.0,3.0,2.0,0.0,3.0,5.0,5.0,2.0,3.0,3.0,4.0,4.0,5.0,5.0,5.0,3.0,4.0,3.0,5.0,0.0,5.0,3.0,3.0,0.0,5.0,1.0,5.0,1.0,2.0,0.0,4.0,2.0,5.0,5.0,5.0,2.0,2.0,0.0,5.0,1.0,5.0,5.0,5.0,5.0,5.0,5.0,0.0,0.0,5.0,3.0,3.0,1.0,5.0,4.0,4.0,4.0,0.0,3.0,2.0,3.0,0.0,0.0,0.0,0.0,0.0,0.0,0.0,0.0,5.0,2.0,5.0,0.0,0.0,3.0,2.0,5.0,3.0,5.0,5.0,0.0,2.0,5.0,4.0,1.0,10.0,6.0,4.0,4.0,5.0,2.0,8.0,6.0,0.0,4.0,2.0,5.0,2.0,5.0,1.0,0.0,0.0,0.0,0.0,2.0,5.0,3.0,2.0,2.0,2.0,2.0,5.0,0.0,5.0,4.0,5.0,0.0,2.0,1.0,1.0,4.0,1.0,2.0,5.0,1.0,0.0,5.0,5.0,1.0,5.0,4.0,4.0,5.0,26.0,5.0,1.0,3.0,5.0,5.0,5.0,2.0,1.0,2.0,2.0,5.0,2.0,3.0,3.0,6.0,1.0,0.0,3.0,5.0,5.0,3.0,2.0,3.0,1.0,1.0,0.0,0.0,0.0,1.0,1.0,4.0,4.0,5.0,1.0,4.0,3.0,0.0,5.0,3.0,3.0,5.0,5.0,5.0,4.0,2.0,2.0,5.0,5.0,5.0,5.0,5.0,2.0,2.0,1.0,7.0,1.0,1.0,5.0,2.0,5.0,5.0,5.0,3.0,5.0,2.0,3.0,2.0,2.0,5.0,0.0,2.0,0.0,1.0,1.0,2.0,0.0,0.0,0.0,0.0,2.0,0.0,0.0,1.0,0.0,2.0,0.0,0.0,3.0,5.0,0.0,2.0,5.0,2.0,5.0,5.0,4.0,5.0,2.0,5.0,5.0,3.0,5.0,5.0,1.0,4.0,3.0,2.0,3.0,2.0,5.0,3.0,4.0,5.0,2.0,4.0,5.0,5.0,3.0,4.0,5.0,4.0,3.0,0.0,0.0,0.0,0.0,0.0,0.0,0.0,0.0,0.0,0.0,0.0,0.0,0.0,0.0,1.0,0.0,0.0,0.0,5.0,5.0,5.0,5.0,0.0,5.0,3.0,5.0,5.0,5.0,3.0,5.0,5.0,4.0,3.0,5.0,6.0,1.0,0.0,3.0,0.0,5.0,4.0,0.0,0.0,0.0,0.0,0.0,0.0,0.0,0.0,0.0,0.0,0.0,0.0,0.0,8.0,0.0,0.0,0.0,0.0,0.0,0.0,0.0,5.0,9.0,6.0,0.0,0.0,0.0,0.0,0.0,0.0,2.0,1.0,2.5714285714285716,0.0,0.0,3.0,0.0,1.5,7.0,3.0,6.0,6.0,0.0,1.0,1.0,1.0,8.0,6.0,5.0,5.0,0.0,0.0,0.0,0.0,0.0,4.0,0.0,2.0,0.0,3.0,0.0,0.0,5.0,0.0,7.0,5.0,1.0,7.0,0.0,1.5,0.0,0.0,0.0,0.0,7.0,0.0,6.0,4.0,4.0,0.0,3.0,0.0,0.0,2.0,3.0,3.0,4.0,0.0,1.0,3.0,2.5,2.0,0.0,9.0,1.8333333333333333,0.0,0.0,6.0,0.0,1.0,0.0,3.0,10.0,0.0,4.0,5.0,7.0,0.0,0.0,0.0,5.0,0.0,5.0,5.0,7.0,0.0,6.0,7.0,0.0,4.0,0.0,1.0,0.0,0.0,5.0,2.0,0.0,0.0,12.0,0.0,1.0,5.0,0.0,0.0,5.0,0.0,0.0,2.0,3.0,0.0,6.0,0.0,0.0,1.0,1.0,0.0,0.0,2.5,1.0,0.0,1.0,2.0,0.0,6.0,0.0,4.0,0.0,2.0,0.0,0.0,0.0,1.0,0.0,5.0,0.0,1.0,0.0,0.0,2.0,2.0,6.0,5.0,7.0,5.0,0.0,3.0,6.0,6.0,3.0,0.0,4.0,0.0,0.0,2.0,1.0,0.0,0.0,6.0,3.0,7.0,1.0,5.0,0.0,3.0,3.0,6.0,0.0,0.0,0.0,6.0,5.0,0.0,2.0,0.0,0.0,1.0,6.0,6.0,1.0,0.0,2.0,9.0,5.0,0.0,0.0,2.0,0.0,0.0,1.5,5.0,0.0,0.0,2.0,3.0,0.0,0.0,3.0,8.0,0.0,0.0,5.0,2.0,4.0,0.0,5.0,1.5,7.0,0.0,6.0,2.0,2.0,4.0,2.0,10.0,0.0,4.0,0.0,8.0,4.0,0.0,2.0,0.0,0.0,3.0,3.0,4.0,1.0,0.0,4.0,6.0,0.0,0.0,2.0,0.0,0.0,0.0,0.0,6.0,4.0,0.0,0.0,2.0,3.0,1.5,0.0,0.0,0.0,3.0,1.0,1.0,2.0,4.0,4.0,3.0,5.0,0.0,5.0,2.0,4.0,5.0,5.0,5.0,1.0,5.0,5.0,5.0,0.0,4.0,5.0,5.0,2.0,5.0,14.0,9.0,19.0,4.0,3.0,2.0,8.0,5.0,5.0,7.0,3.0,6.0,4.0,4.0,12.0,3.0,4.0,7.0,9.0,7.0,12.0,11.0,13.0,4.0,4.0,10.0,5.0,5.0,7.0,4.0,5.0,2.0,4.0,11.0,9.0,7.0,17.0,4.0,13.0,3.0,9.0,2.0,18.0,2.0,3.0,14.0,3.0,2.0,18.0,9.0,5.0,11.0,11.0,14.0,11.0,5.0,3.0,4.0,1.0,4.0,5.0,3.0,6.0,4.0,3.0,3.0,2.0,4.5,6.0,5.0,7.0,6.0,13.0,3.0,2.0,8.0,5.0,8.0,6.0,8.0,16.0,15.0,10.0,5.0,7.0,6.0,4.0,5.0,3.0,3.0,2.0,4.0,4.0,7.0,11.0,8.0,13.0,3.0,6.0,9.0,19.0,10.0,11.0,9.0,3.0,2.0,10.0,12.0,4.0,5.0,8.0,7.0,3.0,4.0,2.0,9.0,8.0,7.0,12.0,14.0,7.0,10.0,10.0,6.0,12.0,4.0,8.0,4.0,3.0,8.0,8.0,7.0,2.0,6.0,5.0,5.0,3.0,9.0,0.0,3.0,0.0,0.0,3.0,0.0,4.0,0.0,0.0,1.0,3.0,1.0,5.0,4.0,3.0,2.0,11.0,10.0,14.0,8.0,0.0,0.0,0.0,0.0,0.0,0.0,0.0,0.0,0.0,0.0,0.0,0.0,0.0,0.0,0.0,0.0,0.0,0.0,4.0,9.0,3.0,1.0,1.0,5.0,5.0,5.0,5.0,5.0,5.0,1.0,1.0,4.0,0.0,0.0,1.0,5.0,0.0,5.0,5.0,5.0,4.0,5.0,5.0,5.0,0.0,4.0,3.0,5.0,5.0,5.0,12.0,17.0,16.0,4.0,0.0,5.0,7.0,19.0,5.0,15.0,10.0,8.0,13.0,12.0,2.0,7.0,8.0,4.0,4.0,5.0,16.0,3.0,7.0,4.0,8.0,12.0,3.0,8.0,10.0,14.0,5.0,5.0,5.0,5.0,5.0,5.0,5.0,5.0,5.0,5.0,5.0,5.0,5.0,5.0,5.0,5.0,5.0,5.0,5.0,5.0,5.0,5.0,5.0,5.0,3.0,,,5.0,8.0,5.0,0.0,3.0,2.0,2.0,11.0,2.0,3.0,2.0,4.0,4.0,2.0,5.0,4.0,1.0,1.0,0.0,1.0,2.0,6.0,5.0,5.0,0.0,1.0,2.0,3.0,0.0,2.0,1.0,1.0,4.0,5.0,3.0,3.0,4.0,2.0,4.0,0.0,0.0,2.0,4.0,7.0,2.0,3.0,5.0,5.0,0.0,5.0,2.0,4.0,1.0,8.0,7.0,3.0,1.0,2.0,1.0,2.0,1.0,1.0,1.0,4.0,1.0,1.0,2.0,1.0,1.0,0.0,0.0,3.0,0.0,0.0,1.0,2.0,0.0,1.0,3.0,2.0,0.0,5.0,4.0,4.0,6.0,1.0,3.0,3.0,2.0,0.0,2.0,3.0,2.0,5.0,4.0,3.0,4.0,2.0,3.0,2.0,1.0,0.0,4.0,1.0,2.0,2.0,0.0,1.0,0.0,4.0,3.0,1.0,1.0,2.0,3.0,7.0,6.0,4.0,0.0,3.0,7.0,3.0,3.0,4.0,1.0,4.0,3.0,0.0,0.0,1.0,0.0,0.0,0.0,0.0,0.0,0.0,0.0,0.0,0.0,0.0,0.0,0.0,0.0,0.0,0.0,0.0,0.0,0.0,0.0,0.0,0.0,0.0,0.0,0.0,0.0,0.0,0.0,0.0,0.0,0.0,1.0,0.0,0.0,0.0,0.0,0.0,0.0,0.0,1.0,5.0,1.0,0.0,0.0,0.0,0.0,0.0,5.0,5.0,5.0,5.0,5.0,1.0,5.0,2.0,5.0,1.0,5.0,5.0,5.0,2.0,4.0,2.0,5.0,5.0,5.0,5.0,5.0,5.0,5.0,5.0,5.0,5.0,7.0,5.0,10.0,7.5,7.0,6.0,10.0,5.0,10.0,4.0,7.0,8.0,6.0,4.0,8.0,6.0,7.0,3.0,8.0,6.0,8.0,7.0,5.0,7.0,7.0,6.0,6.0,3.0,9.0,10.0,8.0,7.0,8.0,7.0,9.0,3.0,3.0,8.0,10.0,2.0,7.0,5.0,6.0,9.0,7.0,10.0,7.0,6.0,6.0,5.0,0.0,11.0,10.0,8.0,10.0,10.0,8.0,7.0,6.0,10.0,9.0,7.0,5.0,4.0,7.0,4.0,7.0,7.0,7.0,10.0,8.0,6.0,7.0,6.0,7.0,9.0,5.0,12.0,6.0,6.0,10.0,6.0,7.0,7.0,11.0,8.0,1.0,14.0,9.0,9.0,10.0,7.0,6.0,7.0,5.0,9.0,6.0,8.0,7.0,8.0,5.0,8.0,10.0,7.0,6.0,8.0,6.0,10.0,9.0,8.0,10.0,6.0,7.0,11.0,8.0,9.0,11.0,8.0,8.0,8.0,7.0,4.0,5.0,6.0,2.0,2.0,6.0,4.0,4.0,2.0,6.0,6.0,1.0,4.0,4.0,1.0,0.0,2.0,6.0,8.0,2.0,8.0,3.0,4.0,3.0,4.0,4.0,7.0,0.0,4.0,0.0,3.0,6.0,5.0,2.0,3.0,7.0,9.0,8.0,7.0,10.0,15.0,7.0,7.0,10.0,4.0,8.0,6.0,7.0,9.0,5.0,14.0,17.0,5.0,6.0,10.0,8.0,15.0,13.0,13.0,12.0,6.0,16.0,10.0,6.0,6.0,12.0,4.0,17.0,5.0,12.0,7.0,5.0,11.0,14.0,6.0,12.0,13.0,8.0,11.0,13.0,12.0,7.0,5.0,4.0,9.0,6.0,10.0,13.0,12.0,8.0,7.0,7.0,5.0,9.0,8.0,6.0,13.0,10.0,6.0,0.0,0.0,0.0,0.0,0.0,0.0,0.0,0.0,0.0,0.0,3.0,2.0,2.0,6.0,4.0,0.0,0.0,8.0,10.0,11.0,1.0,0.0,0.0,2.0,1.0,1.0,0.0,0.0,0.0,2.0,3.0,1.0,3.0,2.0,2.0,1.0,4.0,3.0,0.0,5.0,0.0,0.0,0.0,1.0,3.0,1.0,0.0,0.0,3.0,7.0,0.0,25.0,45.0,4.0,6.0,49.0,4.0,10.0,5.0,15.0,3.0,5.0,8.0,24.0,0.0,26.0,19.0,0.0,1.0,2.0,25.0,20.0,5.0,0.0,25.0,16.0,11.0,19.0,7.0,0.0,15.0,3.0,0.0,0.0,17.0,1.0,42.0,6.0,18.0,10.0,2.0,25.0,25.0,11.0,1.0,23.0,26.0,24.0,3.0,6.0,3.0,28.0,1.0,12.0,2.0,5.0,32.0,1.0,26.0,32.0,2.0,5.0,6.0,0.0,6.0,8.0,14.0,8.0,5.0,6.0,6.0,2.0,20.0,15.0,0.0,17.0,21.0,12.0,9.0,0.0,20.0,46.0,14.0,12.0,2.0,2.0,31.0,3.0,2.0,0.0,20.0,11.0,2.0,0.0,32.0,12.0,0.0,7.0,2.0,33.0,16.0,34.0,6.0,0.0,36.0,21.0,7.0,9.0,3.0,2.0,28.0,3.0,0.0,0.0,3.0,13.0,23.0,2.0,0.0,9.0,19.0,12.0,12.0,10.0,19.0,2.0,3.0,15.0,53.0,2.0,16.0,0.0,7.0,30.0,8.0,26.0,18.0,31.0,18.0,4.0,6.0,0.0,2.0,4.0,7.0,0.0,8.0,7.0,15.0,13.0,1.0,13.0,0.0,0.0,2.0,0.0,23.0,20.0,12.0,39.0,17.0,1.0,0.0,0.0,1.0,8.0,18.0,4.0,14.0,5.0,4.0,29.0,15.0,7.0,13.0,5.0,8.0,6.0,14.0,7.0,7.0,11.0,23.0,20.0,10.0,0.0,7.0,3.0,14.0,33.0,19.0,8.0,0.0,6.0,18.0,2.0,3.0,5.0,7.0,16.0,1.0,4.0,2.0,4.0,1.0,0.0,3.0,0.0,9.0,12.0,24.0,0.0,20.0,21.0,3.0,2.0,1.0,4.0,19.0,2.0,0.0,11.0,5.0,16.0,11.0,4.0,16.0,6.0,11.0,2.0,11.0,16.0,19.0,11.0,0.0,0.0,29.0,0.0,0.0,0.0,7.0,0.0,16.0,9.0,15.0,14.0,1.0,3.0,7.0,24.0,0.0,1.0,11.0,18.0,21.0,0.0,0.0,0.0,13.0,4.0,7.0,3.0,0.0,10.0,7.0,0.0,4.0,17.0,18.0,6.0,0.0,24.0,14.0,1.0,14.0,13.0,9.0,17.0,8.0,23.0,9.0,1.0,3.0,4.0,27.0,29.0,3.0,12.0,12.0,20.0,5.0,7.0,4.0,9.0,26.0,14.0,0.0,3.0,16.0,2.0,6.0,8.0,2.0,12.0,8.0,0.0,15.0,9.0,1.0,0.0,18.0,15.0,16.0,7.0,7.0,0.0,8.0,1.0,24.0,0.0,3.0,6.0,19.0,19.0,14.0,7.0,15.0,24.0,17.0,10.0,4.0,0.0,5.0,27.0,10.0,10.0,12.0,9.0,20.0,0.0,30.0,9.0,2.0,7.0,6.0,1.0,0.0,5.0,1.0,16.0,0.0,4.0,10.0,9.0,8.0,13.0,0.0,24.0,17.0,3.0,3.0,9.0,14.0,24.0,36.0,0.0,14.0,0.0,18.0,8.0,7.0,1.0,16.0,7.0,20.0,38.0,4.0,5.0,0.0,8.0,15.0,1.0,0.0,7.0,5.0,4.0,16.0,3.0,1.0,7.0,7.0,2.0,26.0,24.0,6.0,17.0,14.0,0.0,21.0,20.0,0.0,3.0,0.0,10.0,4.0,17.0,2.0,37.0,10.0,5.0,3.0,15.0,5.0,0.0,0.0,12.0,0.0,5.0,7.0,7.0,3.0,24.0,1.0,5.0,1.0,2.0,6.0,6.0,12.0,4.0,5.0,3.0,1.0,9.0,6.0,31.0,19.0,0.0,2.0,5.0,1.0,14.0,17.0,18.0,0.0,4.0,17.0,1.0,0.0,6.0,11.0,0.0,0.0,15.0,19.0,7.0,9.0,1.0,7.0,10.0,19.0,0.0,0.0,1.0,2.0,0.0,0.0,18.0,5.0,13.0,13.0,4.0,0.0,1.0,35.0,7.0,1.0,1.0,5.0,27.0,1.0,19.0,4.0,0.0,6.0,4.0,1.0,3.0,17.0,7.0,6.0,3.0,16.0,17.0,23.0,7.0,16.0,4.0,7.0,28.0,8.0,0.0,30.0,20.0,1.0,18.0,0.0,0.0,4.0,2.0,12.0,3.0,11.0,0.0,4.0,1.0,6.0,12.0,3.0,1.0,2.0,4.0,2.0,21.0,0.0,22.0,28.0,1.0,0.0,1.0,0.0,2.0,1.0,24.0,2.0,16.0,9.0,14.0,0.0,29.0,0.0,10.0,10.0,1.0,1.0,13.0,0.0,14.0,0.0,14.0,6.0,0.0,22.0,2.0,25.0,29.0,0.0,26.0,0.0,1.0,3.0,12.0,21.0,19.0,3.0,17.0,1.0,8.0,14.0,14.0,11.0,7.0,7.0,6.0,0.0,3.0,16.0,4.0,10.0,1.0,0.0,18.0,1.0,1.0,18.0,3.0,1.0,6.0,24.0,3.0,0.0,4.0,0.0,17.0,17.0,7.0,14.0,2.0,0.0,24.0,0.0,0.0,0.0,16.0,7.0,2.0,8.0,4.0,8.0,7.0,5.0,0.0,13.0,24.0,2.0,4.0,0.0,10.0,0.0,32.0,0.0,24.0,2.0,7.0,10.0,3.0,0.0,3.0,19.0,0.0,2.0,9.0,1.0,5.0,6.0,3.0,19.0,0.0,16.0,24.0,16.0,0.0,2.0,0.0,0.0,9.0,1.0,7.0,0.0,6.0,4.0,4.0,7.0,6.0,3.0,4.0,7.0,15.0,0.0,7.0,5.0,22.0,9.0,0.0,4.0,15.0,1.0,2.0,26.0,11.0,8.0,1.0,2.0,25.0,0.0,0.0,6.0,0.0,0.0,1.0,10.0,1.0,1.0,0.0,2.0,2.0,5.0,3.0,43.0,19.0,8.0,1.0,0.0,4.0,17.0,7.0,6.0,0.0,0.0,7.0,8.0,2.0,0.0,24.0,19.0,13.0,5.0,17.0,0.0,15.0,1.0,8.0,18.0,15.0,6.0,16.0,7.0,7.0,0.0,9.0,4.0,8.0,7.0,0.0,14.0,21.0,0.0,9.0,0.0,1.0,30.0,1.0,4.0,24.0,0.0,4.0,6.0,20.0,4.0,29.0,1.0,1.0,8.0,1.0,6.0,29.0,9.0,21.0,23.0,0.0,21.0,9.0,0.0,20.0,29.0,0.0,11.0,14.0,8.0,35.0,15.0,4.0,19.0,19.0,1.0,18.0,2.0,19.0,7.0,1.0,1.0,18.0,4.0,17.0,2.0,4.0,1.0,3.0,2.0,18.0,2.0,4.0,4.0,5.0,3.0,5.0,5.0,5.0,2.0,3.0,5.0,5.0,3.0,5.0,5.0,5.0,5.0,5.0,4.0,5.0,5.0,5.0,2.0,3.0,2.0,5.0,3.0,5.0,3.0,5.0,2.0,4.0,2.0,3.0,2.0,3.0,1.0,4.0,0.0,5.0,2.0,0.0,1.0,2.0,1.0,0.0,0.0,0.0,0.0,0.0,0.0,0.0,0.0,0.0,4.0,1.0,2.0,0.0,3.0,0.0,3.0,3.0,0.0,0.0,5.0,5.0,17.0,9.0,21.0,6.0,1.0,18.0,17.0,1.0,9.0,11.0,5.0,9.0,2.0,0.0,0.0,2.0,8.0,5.0,9.0,15.0,4.0,0.0,19.0,9.0,13.0,15.0,14.0,4.0,0.0,6.0,5.0,6.0,8.0,5.0,3.0,3.0,1.0,28.0,1.0,1.0,0.0,6.0,2.0,0.0,1.0,0.0,5.0,0.0,1.0,19.0,16.0,1.0,5.0,12.0,10.0,4.0,10.0,10.0,19.0,14.0,20.0,8.0,2.0,6.0,17.0,3.0,10.0,24.0,10.0,7.0,11.0,2.0,17.0,16.0,6.0,0.0,4.0,14.0,14.0,8.0,2.0,17.0,18.0,3.0,23.0,4.0,6.0,2.0,2.0,5.0,0.0,6.0,4.0,6.0,8.0,6.0,29.0,11.0,37.0,18.0,19.0,5.0,18.0,8.0,11.0,11.0,15.0,17.0,10.0,0.0,9.0,24.0,12.0,5.0,13.0,19.0,7.0,15.0,13.0,19.0,19.0,20.0,15.0,22.0,10.0,14.0,9.0,17.0,20.0,18.0,14.0,6.0,13.0,15.0,19.0,11.0,15.0,3.0,18.0,10.0,12.0,20.0,11.0,17.0,5.0,0.0,1.0,2.0,0.0,4.0,24.0,10.0,12.0,16.0,6.0,10.0,16.0,2.0,14.0,4.0,3.0,17.0,13.0,9.0,9.0,19.0,5.0,6.0,10.0,10.0,5.0,19.0,0.0,3.0,13.0,2.0,11.0,1.0,12.0,15.0,15.0,12.0,12.0,19.0,17.0,4.0,6.0,4.0,3.0,1.0,17.0,14.0,15.0,11.0,19.0,16.0,10.0,14.0,8.0,10.0,13.0,5.0,9.0,12.0,13.0,2.0,7.0,0.0,11.0,11.0,5.0,10.0,12.0,1.0,15.0,14.0,4.0,3.0,7.0,2.0,7.0,5.0,1.0,6.0,15.0,14.0,15.0,8.0,6.0,0.0,1.0,5.0,1.0,11.0,14.0,19.0,7.0,13.0,12.0,9.0,29.0,15.0,10.0,11.0,5.0,1.0,8.0,6.0,6.0,1.0,8.0,13.0,25.0,16.0,0.0,0.0,0.0,0.0,0.0,0.0,0.0,0.0,0.0,0.0,0.0,0.0,0.0,0.0,0.0,0.0,0.0,0.0,0.0,0.0,0.0,0.0,0.0,0.0,0.0,0.0,0.0,0.0,0.0,0.0,0.0,0.0,0.0,0.0,0.0,0.0,0.0,0.0,0.0,0.0,0.0,0.0,0.0,0.0,0.0,0.0,0.0,0.0,0.0,0.0,0.0,0.0,0.0,0.0,0.0,0.0,0.0,5.0,1.0,5.0,1.0,0.0,1.0,2.0,1.0,5.0,1.0,2.0,5.0,3.0,2.0,0.0,1.0,5.0,1.0,1.0,3.0,1.0,3.0,2.0,2.0,4.0,0.0,5.0,5.0,5.0,0.0,4.0,5.0,5.0,5.0,5.0,1.0,5.0,5.0,5.0,5.0,3.0,5.0,5.0,5.0,5.0,5.0,0.0,5.0,5.0,5.0,5.0,4.0,5.0,5.0,1.0,4.0,4.0,0.0,5.0,4.0,5.0,5.0,1.0,5.0,5.0,5.0,5.0,5.0,5.0,5.0,5.0,5.0,5.0,5.0,5.0,5.0,5.0,5.0,7.0,6.0,3.0,7.0,1.0,1.0,6.0,4.0,2.0,5.0,3.0,1.0,1.0,5.0,6.0,1.0,3.0,5.0,2.0,5.0,5.0,5.0,5.0,5.0,5.0,5.0,1.0,5.0,4.0,5.0,5.0,5.0,5.0,5.0,5.0,5.0,5.0,2.0,2.0,5.0,4.0,5.0,4.0,5.0,5.0,5.0,5.0,5.0,5.0,5.0,2.0,4.0,5.0,5.0,5.0,5.0,5.0,5.0,5.0,5.0,5.0,5.0,5.0,4.0,5.0,5.0,3.0,1.0,13.0,7.0,9.0,1.0,,1.0,3.0,3.0,0.0,3.0,3.0,5.0,4.0,4.0,2.0,9.0,1.0,11.0,5.0,4.0,13.0,15.0,4.0,4.0,10.0,1.0,2.0,3.0,0.0,1.0,5.0,1.0,7.0,8.0,2.0,6.0,2.0,2.0,4.0,5.0,11.0,4.0,4.0,1.0,2.0,4.0,3.0,7.0,4.0,6.0,2.0,0.0,4.0,3.0,1.0,0.0,1.0,2.0,19.0,1.0,5.0,2.0,4.0,3.0,1.0,2.0,0.0,4.0,2.0,3.0,9.0,3.0,0.0,2.0,0.0,0.0,2.0,4.0,4.0,6.0,1.0,4.0,2.0,5.0,5.0,1.0,9.0,2.0,3.0,2.0,4.0,1.0,6.0,0.0,9.0,4.0,4.0,2.0,1.0,1.0,2.0,0.0,1.0,6.0,0.0,1.0,5.0,7.0,2.0,1.0,0.0,1.0,12.0,7.0,0.0,8.0,7.0,5.0,0.0,2.0,4.0,6.0,3.0,2.0,0.0,2.0,2.0,0.0,7.0,5.0,7.0,6.0,6.0,2.0,3.0,3.0,2.0,3.0,6.0,4.0,2.0,4.0,5.0,11.0,3.0,0.0,0.0,1.0,0.0,7.0,11.0,22.0,17.0,8.0,15.0,7.0,7.0,17.0,5.0,6.0,6.0,5.0,4.0,2.0,6.0,8.0,0.0,2.0,4.0,6.0,11.0,3.0,8.0,8.0,4.0,2.0,1.0,5.0,1.0,3.0,1.0,3.0,7.0,14.0,3.0,5.0,16.0,5.0,10.0,17.0,44.0,11.0,0.0,15.0,24.0,19.0,20.0,4.0,8.0,17.0,15.0,7.0,16.0,13.0,5.0,23.0,10.0,26.0,21.0,11.0,25.0,21.0,16.0,1.0,13.0,2.0,16.0,12.0,66.0,17.0,12.0,17.0,5.0,5.0,5.0,3.0,5.0,1.0,5.0,5.0,5.0,5.0,5.0,5.0,3.0,5.0,2.0,5.0,4.0,1.0,4.0,5.0,5.0,5.0,1.0,5.0,5.0,5.0,5.0,5.0,5.0,3.0,3.0,5.0,5.0,1.0,5.0,5.0,5.0,5.0,2.0,5.0,5.0,5.0,5.0,2.0,5.5,18.5,2.5,0.5,16.5,0.0,0.5,0.0,17.5,9.5,8.5,0.0,0.0,2.0,6.5,6.5,1.0,0.0,4.5,0.0,22.5,39.0,32.0,12.0,18.5,0.0,1.0,0.0,0.5,3.0,0.0,7.5,0.5,26.5,0.0,14.0,3.0,15.0,12.0,15.0,4.0,1.0,16.0,20.0,0.0,20.0,17.0,2.5,26.5,21.0,5.0,9.0,1.0,14.0,4.0,0.0,22.0,20.0,21.5,40.0,1.0,1.0,7.5,0.0,1.0,1.0,1.0,2.5,30.5,27.0,9.5,7.0,5.0,11.0,7.0,7.0,4.0,3.0,4.0,5.0,4.0,4.0,3.0,1.0,11.0,16.0,5.0,5.0,5.0,5.0,5.0,5.0,5.0,3.0,2.0,13.0,12.0,10.0,5.0,17.0,5.0,6.0,16.0,11.0,12.0,3.0,0.0,3.0,3.0,2.0,3.0,0.0,0.0,0.0,4.0,3.0,2.0,2.0,2.0,2.0,3.0,2.0,0.0,7.0,2.0,4.0,5.0,2.0,16.0,2.0,46.0,6.0,2.0,2.0,2.0,2.0,5.0,4.0,0.0,0.0,0.0,0.0,1.0,2.0,2.0,1.0,2.0,1.0,0.0,1.0,0.0,0.0,1.0,0.0,0.0,0.0,1.0,1.0,1.0,0.0,1.0,1.0,1.0,0.0,0.0,1.0,1.0,1.0,1.0,2.0,1.0,0.0,0.0,1.0,0.0,2.0,2.0,0.0,1.0,5.0,1.0,1.0,1.0,1.0,1.0,2.0,1.0,0.0,0.0,1.0,0.0,1.0,2.0,1.0,1.0,1.0,0.0,3.0,1.0,0.0,0.0,1.0,1.0,1.0,1.0,0.0,1.0,0.0,0.0,1.0,0.0,1.0,0.0,0.0,1.0,0.0,1.0,1.0,1.0,1.0,1.0,2.0,0.0,4.0,3.0,2.0,3.0,0.0,7.0,0.0,4.0,1.0,9.0,0.0,2.0,1.0,0.0,0.0,0.0,0.0,1.0,0.0,1.0,1.0,0.0,0.0,0.0,2.0,1.0,1.0,4.0,1.0,1.0,2.0,2.0,7.0,0.0,2.0,0.0,0.0,2.0,4.0,0.0,2.0,1.0,1.0,1.0,2.0,1.0,2.0,0.0,7.0,2.0,0.0,0.0,1.0,1.0,0.0,2.0,2.0,0.0,1.0,4.0,3.0,0.0,0.0,9.0,7.0,1.0,0.0,0.0,0.0,0.0,1.0,1.0,1.0,4.0,0.0,0.0,0.0,2.0,0.0,1.0,0.0,0.0,1.0,0.0,0.0,0.0,0.0,4.0,0.0,2.0,1.0,1.0,2.0,1.0,11.0,1.0,0.0,0.0,0.0,0.0,0.0,2.0,1.0,2.0,4.0,0.0,0.0,4.0,0.0,10.0,0.0,0.0,0.0,0.0,0.0,0.0,2.0,1.0,0.0,7.0,0.0,0.0,5.0,0.0,3.0,0.0,0.0,0.0,1.0,0.0,0.0,0.0,0.0,0.0,0.0,0.0,7.0,4.0,1.0,2.0,6.0,1.0,4.0,2.0,8.0,2.0,2.0,3.0,2.0,3.0,5.0,7.0,5.0,6.0,2.0,4.0,2.0,2.0,3.0,3.0,4.0,5.0,4.0,1.0,5.0,3.0,2.0,19.0,11.0,9.0,3.0,13.0,14.0,14.0,7.0,8.0,9.0,17.0,8.0,11.0,13.0,9.0,9.0,8.0,5.0,5.0,5.0,5.0,5.0,5.0,5.0,2.0,5.0,2.0,2.0,3.0,3.0,0.0,3.0,3.0,0.0,9.0,1.0,4.0,6.0,0.0,6.0,2.0,1.0,1.0,5.0,3.0,0.0,5.0,3.0,1.0,4.0,4.0,6.0,4.0,4.0,5.0,12.0,2.0,2.0,2.0,1.0,3.0,1.0,6.0,3.0,6.0,4.0,3.0,5.0,4.0,0.0,2.0,9.0,0.0,0.0,1.0,0.0,7.0,0.0,5.0,2.0,5.0,5.0,5.0,5.0,4.0,0.0,5.0,5.0,2.0,5.0,0.0,5.0,5.0,5.0,5.0,5.0,5.0,5.0,3.0,5.0,4.0,3.0,0.0,4.0,4.0,5.0,5.0,5.0,3.0,5.0,5.0,5.0,5.0,1.0,5.0,5.0,5.0,4.0,5.0,4.0,4.0,2.0,4.0,5.0,5.0,5.0,5.0,4.0,5.0,5.0,4.0,5.0,2.0,4.0,4.0,4.0,5.0,5.0,5.0,5.0,5.0,2.0,5.0,4.0,5.0,4.0,5.0,4.0,5.0,5.0,4.0,5.0,4.0,5.0,5.0,5.0,5.0,5.0,4.0,5.0,4.0,5.0,5.0,4.0,5.0,5.0,4.0,4.0,5.0,3.0,4.0,3.0,5.0,5.0,5.0,5.0,5.0,5.0,5.0,5.0,4.0,5.0,5.0,4.0,5.0,2.0,5.0,4.0,3.0,5.0,2.0,5.0,5.0,5.0,5.0,4.0,0.0,5.0,0.0,0.0,0.0,0.0,5.0,2.0,11.0,10.0,28.0,25.0,12.0,6.0,17.0,12.0,3.0,,,,,,,,,,,,,,,,,,,,,,,,,,,,,,,,,,,,,,,,,,,,,,,,,,,,,,,,,,,,,,,,,,,,,,,,,,,,,,,,,,,,,,,,,,,,,,,,,,,,,,,,,,,,,,,,,,,,,,,,,,,,,,,,,,,,,,,,,,,,,,,,,,,,,,,,,,,,,,,,,,,,,,,,,,,,,,,,,,,,,,,,,,,,,,,,,,,,,,,,,,,,,,,,,,,,,,,,,,,,,,,,,,,,,,,,,,,,,,,,,,,,,,,,,,,,,,,,,,,,,,,,,,,,,,,,,,,,,,,,,,,,,,,,,,,,,,,,,,,,,,,,,,,,,,,,,,,,,,,,,,,,,,,,,,,,,,,,,,,,,,,,1.0,1.0,3.0,2.0,1.0,5.0,1.0,0.0,0.0,0.0,0.0,1.0,3.0,1.0,2.0,4.0,0.0,1.0,0.0,1.0,0.0,1.0,1.0,0.0,0.0,5.0,1.0,0.0,1.0,5.0,2.0,,3.0,5.0,5.0,1.0,0.0,0.0,0.0,0.0,3.0,0.0,5.0,3.0,0.0,2.0,0.0,0.0,1.0,0.0,0.0,0.0,1.0,1.0,0.0,1.0,0.0,3.0,1.0,2.0,1.0,1.0,5.0,0.0,1.0,0.0,0.0,1.0,5.0,1.0,0.0,0.0,2.0,0.0,1.0,0.0,1.0,2.0,1.0,3.0,1.0,4.0,0.0,0.0,0.0,0.0,0.0,0.0,5.0,3.0,0.0,1.0,0.0,1.0,2.0,2.0,1.0,0.0,3.0,1.0,3.0,2.0,1.0,0.0,0.0,0.0,1.0,5.0,0.0,3.0,2.0,0.0,0.0,4.0,,1.0,,,,,,,,,11.0,1.0,1.0,0.0,5.0,4.0,4.0,5.6,1.0,0.0,0.0,,8.0,1.0,,,,4.0,3.0,,1.0,,14.0,0.0,5.0,1.0,6.0,0.0,0.0,,,3.0,,4.0,10.0,,6.0,8.0,,5.0,,3.0,4.0,3.0,2.0,6.0,0.0,7.0,6.0,10.0,,4.666666666666667,1.0,,,3.0,0.0,9.0,4.0,0.0,2.0,6.0,2.0,6.0,,2.0,,,7.0,5.0,,,,8.0,1.0,0.0,4.0,,10.0,,2.0,1.0,6.0,6.0,,,2.0,6.0,,,,,,,1.0,2.0,7.0,3.0,,,,,,,,,,,,,,,,12.0,7.0,,,,0.0,1.0,5.0,4.0,9.0,4.0,2.0,2.0,,2.0,4.0,3.0,,6.0,,0.0,,6.0,1.0,,,3.0,4.0,1.0,2.0,6.0,,,,8.0,3.0,,,4.0,6.0,3.0,3.0,13.0,,0.0,0.0,3.0,,,,3.0,5.0,1.0,,,,6.0,1.0,1.0,2.0,0.0,9.0,3.0,,5.0,4.0,2.0,,1.0,4.0,5.0,3.0,8.0,7.0,10.0,19.0,4.0,8.0,10.0,10.0,18.0,14.0,17.0,17.0,23.0,15.0,14.0,17.0,22.0,23.0,3.0,10.0,0.0,1.0,14.0,6.0,1.0,6.0,14.0,25.0,15.0,7.0,9.0,5.0,1.0,6.0,3.0,10.0,5.0,2.0,4.0,3.0,16.0,6.0,3.0,4.0,10.0,6.0,10.0,20.0,0.0,10.0,3.0,10.0,14.0,9.0,18.0,14.0,3.0,2.0,22.0,21.0,12.0,0.0,0.0,5.0,9.0,2.0,5.0,11.0,18.0,18.0,3.0,11.0,30.0,4.0,8.0,10.0,18.0,29.0,28.0,26.0,6.0,4.0,6.0,4.0,10.0,12.0,18.0,2.0,3.0,2.0,20.0,8.0,0.0,13.0,10.0,6.0,2.0,10.0,9.0,1.0,2.0,4.0,6.0,0.0,0.0,13.0,5.0,7.0,8.0,23.0,4.0,2.0,13.0,12.0,9.0,17.0,2.0,15.0,1.0,2.0,4.0,4.0,11.0,0.0,18.0,10.0,15.0,4.0,14.0,12.0,19.0,17.0,20.0,6.0,19.0,9.0,8.0,15.0,9.0,15.0,6.0,3.0,3.0,0.0,3.0,4.0,2.0,1.0,2.0,3.0,4.0,11.0,5.0,9.0,5.0,24.0,15.0,14.0,1.0,15.0,9.0,14.0,2.0,7.0,6.0,17.0,7.0,7.0,1.0,2.0,8.0,13.0,9.0,0.0,2.0,5.0,12.0,14.0,10.0,9.0,14.0,2.0,12.0,15.0,0.0,6.0,6.0,1.0,17.0,9.0,16.0,12.0,1.0,4.0,20.0,9.0,7.0,10.0,9.0,1.0,5.0,4.0,6.0,6.0,5.0,0.0,14.0,18.0,1.0,6.0,12.0,17.0,0.0,20.0,4.0,7.0,13.0,11.0,9.0,15.0,14.0,8.0,6.0,8.0,11.0,10.0,11.0,20.0,4.0,10.0,7.0,15.0,1.0,4.0,5.0,4.0,1.0,0.0,1.0,13.0,5.0,2.0,2.0,20.0,2.0,6.0,0.0,0.0,1.0,10.0,8.0,10.0,0.0,5.0,7.0,9.0,11.0,6.0,9.0,13.0,9.0,3.0,12.0,2.0,7.0,4.0,17.0,0.0,14.0,14.0,18.0,21.0,11.0,8.0,6.0,12.0,7.0,11.0,6.0,10.0,13.0,24.0,11.0,7.0,12.0,7.0,7.0,10.0,7.0,11.0,6.0,10.0,7.0,16.0,9.0,14.0,10.0,11.0,8.0,10.0,4.0,9.0,0.0,0.0,0.0,0.0,0.0,0.0,16.0,0.0,0.0,3.0,6.0,1.0,10.0,24.0,5.0,2.0,3.0,1.0,1.0,8.0,22.0,16.0,3.0,9.0,7.0,0.0,2.0,11.0,8.0,6.0,14.0,13.0,11.0,5.0,2.0,7.0,4.0,0.0,1.0,3.0,10.0,24.0,12.0,16.0,5.0,20.0,1.0,9.0,6.0,6.0,0.0,0.0,6.0,25.0,18.0,7.0,2.0,4.0,5.0,3.0,1.0,3.0,5.0,2.0,16.0,14.0,9.0,24.0,0.0,4.0,4.0,14.0,0.0,8.0,7.0,5.0,4.0,5.0,2.0,13.0,8.0,18.0,6.0,2.0,2.0,22.0,6.0,5.0,4.0,3.0,2.0,1.0,4.0,8.0,1.0,3.0,0.0,3.0,5.0,11.0,43.0,14.0,23.0,7.0,31.0,2.0,0.0,15.0,3.0,7.0,8.0,0.0,22.0,12.0,11.0,23.0,6.0,21.0,7.0,3.0,2.0,3.0,4.0,7.0,5.0,8.0,3.0,2.0,4.0,4.0,2.0,4.0,0.0,19.0,3.0,1.0,13.0,36.0,7.0,5.0,3.0,17.0,0.0,1.0,19.0,2.0,3.0,11.0,4.0,2.0,11.0,38.0,8.0,8.0,3.0,1.0,4.0,5.0,0.0,0.0,11.0,4.0,10.0,3.0,30.0,19.0,2.0,3.0,4.0,10.0,2.0,9.0,1.0,6.0,7.0,0.0,0.0,6.0,19.0,1.0,19.0,8.0,9.0,2.0,6.0,9.0,12.0,19.0,6.0,7.0,3.0,18.0,10.0,2.0,0.0,20.0,0.0,2.0,8.0,4.0,6.0,4.0,2.0,4.0,16.0,9.0,0.0,5.0,6.0,2.0,4.0,3.0,17.0,12.0,8.0,2.0,4.0,9.0,2.0,8.0,5.0,12.0,0.0,2.0,4.0,0.0,25.0,9.0,3.0,3.0,13.0,7.0,1.0,28.0,21.0,2.0,29.0,2.0,4.0,2.0,9.0,3.0,8.5,19.0,6.0,3.0,24.0,1.0,2.0,6.0,9.0,0.0,4.0,3.0,7.0,16.0,2.0,1.0,7.0,2.0,10.0,2.0,16.0,32.0,5.0,14.0,3.0,2.0,11.0,27.0,2.0,5.0,2.0,4.0,7.0,33.0,0.0,4.0,5.0,13.0,2.0,7.0,13.0,2.0,0.0,0.0,26.0,3.0,4.0,13.0,2.0,10.0,2.0,0.0,1.0,2.0,10.0,13.0,31.0,2.0,9.0,2.0,7.0,3.0,2.0,14.0,3.0,14.0,5.0,5.0,7.0,0.0,1.0,5.0,6.0,10.0,0.0,3.0,14.0,9.0,6.0,3.0,2.0,8.0,1.0,2.0,0.0,8.0,11.0,0.0,1.0,5.0,3.0,10.0,5.0,10.0,7.0,3.0,9.0,2.0,3.0,6.0,2.0,15.0,10.0,3.0,19.0,18.0,2.0,0.0,10.0,35.0,0.0,6.0,1.0,16.0,3.0,10.0,0.0,2.0,15.0,6.0,3.0,3.0,5.0,0.0,8.0,9.0,10.0,5.0,5.0,6.0,9.0,4.0,3.0,9.0,3.0,5.0,14.0,32.0,6.0,15.0,22.0,10.0,50.0,5.0,2.0,6.0,6.0,5.0,2.0,3.0,0.0,13.0,7.0,0.0,2.0,3.0,8.0,19.0,25.0,6.0,3.0,20.0,2.0,6.0,7.0,5.0,13.0,10.0,7.0,1.0,14.0,8.0,1.0,4.0,29.0,13.0,5.0,2.0,12.0,0.0,7.0,9.0,9.0,16.0,6.0,3.0,0.0,9.0,0.0,13.0,18.0,1.0,15.0,0.0,8.0,14.0,7.0,29.0,7.0,23.0,4.0,17.0,3.0,23.0,6.0,7.0,28.0,5.0,0.0,4.0,13.0,1.0,10.0,10.0,5.0,13.0,19.0,23.0,31.0,8.0,26.0,5.0,2.0,16.0,3.0,3.0,6.0,5.0,2.0,3.0,6.0,2.0,1.0,5.0,5.0,3.0,2.0,7.0,5.0,8.0,7.0,6.0,1.0,18.0,0.0,2.0,18.0,10.0,9.0,1.0,3.0,10.0,13.0,22.0,7.0,2.0,6.0,6.0,8.0,5.0,17.0,4.0,4.0,4.0,19.0,7.0,15.0,2.0,6.0,1.0,3.0,10.0,0.0,7.0,0.0,6.0,4.0,13.0,6.0,6.0,5.0,15.0,9.0,7.0,5.0,5.0,21.0,6.0,21.0,2.0,9.0,10.0,1.0,4.0,7.0,10.0,1.0,4.0,1.0,10.0,3.0,0.0,11.0,9.0,3.0,1.0,18.0,45.0,10.0,14.0,10.0,7.875,12.0,7.0,8.0,3.0,9.0,3.0,2.0,10.0,13.0,4.0,4.0,1.0,1.0,7.0,12.0,16.0,4.0,8.0,9.0,2.0,1.0,13.0,3.0,3.0,14.0,1.0,9.0,7.0,2.0,3.0,11.0,2.0,8.0,9.0,3.0,33.0,6.0,2.0,3.0,0.0,8.0,3.0,6.0,3.0,13.0,2.0,2.0,6.0,7.0,0.0,10.0,7.0,7.0,1.0,2.0,5.0,10.0,3.0,8.0,12.0,2.0,2.0,3.0,10.0,3.0,21.0,2.0,9.0,5.0,1.0,6.0,10.0,11.0,0.0,1.0,4.0,0.0,3.0,3.0,0.0,4.0,4.0,6.0,4.0,9.0,24.0,19.0,17.0,18.0,5.0,7.0,0.0,7.0,9.0,7.0,8.0,3.0,14.0,5.0,4.0,3.0,10.0,8.0,3.0,8.0,27.0,3.0,7.0,3.0,4.0,6.0,15.0,2.0,3.0,3.0,2.0,2.0,6.0,1.0,15.0,13.0,2.0,17.0,8.0,13.0,4.0,9.0,31.0,4.0,6.0,5.0,15.0,23.0,4.0,1.0,2.0,2.0,5.0,9.0,11.0,3.0,7.0,9.0,5.0,26.0,4.0,12.0,5.0,11.0,15.0,7.0,1.0,5.0,0.0,38.0,5.0,0.0,7.0,17.0,6.0,0.0,3.0,9.0,3.0,2.0,10.0,2.0,19.0,4.0,2.0,11.0,8.0,14.0,3.0,18.0,9.0,3.0,4.0,6.0,5.0,2.0,3.0,4.0,5.0,2.0,1.0,1.0,21.0,11.0,13.0,16.0,7.0,18.0,5.0,24.0,21.0,45.0,6.0,1.0,4.0,6.0,11.0,11.0,7.0,1.0,1.0,15.0,21.0,9.0,7.0,9.0,2.0,9.0,3.0,7.0,14.0,1.0,3.0,26.0,5.0,14.0,4.0,3.0,9.0,30.0,27.0,2.0,10.0,8.0,12.0,3.0,10.0,1.0,10.0,25.0,6.0,12.0,1.0,1.0,28.0,2.0,7.0,1.0,2.0,8.0,5.0,4.0,9.0,12.0,10.0,5.0,4.0,12.0,16.0,0.0,2.0,4.0,3.0,2.0,9.0,21.0,11.0,9.0,8.0,2.0,6.0,8.0,2.0,5.0,21.0,4.0,3.0,11.0,12.0,7.0,6.0,7.0,10.0,1.0,12.0,1.0,14.0,17.0,4.0,6.0,2.0,8.0,4.0,3.0,2.0,3.0,5.0,3.0,6.0,19.0,13.0,11.0,5.0,8.0,0.0,2.0,3.0,5.0,3.0,17.0,7.0,3.0,22.0,8.0,7.0,9.0,2.0,3.0,2.0,3.0,3.0,4.0,0.0,6.0,5.0,6.0,53.0,6.0,6.0,0.0,23.0,27.0,3.0,34.0,14.0,16.0,5.0,4.0,4.0,1.0,2.0,1.0,6.0,11.0,6.0,17.0,4.0,5.0,10.0,14.0,9.0,1.0,13.0,1.0,3.0,11.0,7.0,25.0,15.0,6.0,5.0,16.0,7.0,0.0,3.0,3.0,3.0,10.0,13.0,19.0,7.0,3.0,14.0,15.0,14.0,1.0,3.0,3.0,3.0,9.0,11.0,2.0,11.0,17.0,3.0,9.0,22.0,10.0,0.0,18.0,1.0,13.0,7.0,12.0,14.0,18.0,3.0,10.0,3.0,8.0,9.0,4.0,9.0,38.0,15.0,10.0,10.0,19.0,5.0,6.0,22.0,2.0,5.0,6.0,0.0,4.0,6.0,11.0,6.0,4.0,13.0,5.0,4.0,9.0,7.0,14.0,4.0,1.0,25.0,9.0,2.0,10.0,2.0,2.0,0.0,5.5,7.5,9.0,14.0,4.0,7.0,5.0,27.0,20.0,14.0,7.0,4.0,9.0,0.0,5.0,0.0,12.0,27.0,23.0,3.0,7.0,17.0,10.0,4.0,14.0,11.0,11.0,15.0,4.0,0.0,19.0,0.0,16.0,10.0,8.0,9.0,27.0,13.0,7.0,4.0,34.0,59.0,9.0,6.0,2.0,9.0,3.0,3.0,1.0,10.0,12.0,21.0,1.0,23.0,21.0,1.0,0.0,4.0,9.0,15.0,18.0,18.0,8.0,15.0,19.0,8.0,2.0,1.0,4.0,8.0,5.0,2.0,16.0,1.0,11.0,0.0,20.0,13.0,14.0,3.0,15.0,6.0,0.0,29.0,3.0,,10.0,0.0,12.0,0.0,31.0,21.0,8.0,14.0,10.0,13.0,2.0,22.0,20.0,5.0,3.0,5.0,5.0,1.0,2.0,3.0,1.0,12.0,0.0,19.0,41.0,18.0,3.0,7.0,0.0,2.0,6.0,13.0,6.0,5.0,5.0,7.0,20.0,3.0,6.0,2.0,1.0,13.0,4.0,6.0,18.0,25.0,9.0,5.0,13.0,4.0,6.0,10.0,7.0,13.0,18.0,7.0,10.0,12.0,9.0,3.0,2.0,3.0,4.0,22.0,4.0,4.0,24.0,1.0,21.0,16.0,5.0,7.0,8.0,1.0,2.0,24.0,32.0,3.0,15.0,1.0,3.0,2.0,28.0,23.0,6.0,6.0,0.0,12.0,6.0,3.0,0.0,1.0,4.0,6.0,0.0,7.0,8.0,3.0,3.0,0.0,4.0,3.0,3.0,2.0,2.0,7.0,14.0,15.0,4.0,15.0,17.0,14.0,9.0,2.0,23.0,23.0,10.0,7.0,15.0,5.0,13.0,18.0,5.0,6.0,0.0,10.0,2.0,5.0,7.0,9.0,2.0,2.0,0.0,13.0,11.0,5.0,2.0,7.0,8.0,1.0,6.0,4.0,2.0,10.0,5.0,7.0,4.0,7.0,1.0,9.0,18.0,2.0,6.0,10.0,5.0,5.0,10.0,5.0,7.0,28.0,0.0,17.0,11.0,5.0,4.0,18.0,2.0,9.0,0.0,11.0,7.0,1.0,3.0,10.0,0.0,6.0,6.0,2.0,0.0,4.0,0.0,3.0,1.0,1.0,6.0,1.0,1.0,0.0,8.0,5.0,0.0,17.0,2.0,0.0,4.0,0.0,5.0,5.0,7.0,11.0,0.0,0.0,0.0,15.0,9.0,21.0,17.0,1.0,1.0,4.0,5.0,1.0,24.0,2.0,3.0,11.0,8.0,17.0,0.0,5.0,11.0,5.0,3.0,2.0,3.0,2.0,3.0,8.0,19.0,14.0,27.0,8.0,23.0,0.0,21.0,26.0,19.0,9.0,6.0,18.0,16.0,4.0,0.0,21.0,3.0,10.0,15.0,10.0,17.0,5.0,6.0,14.0,9.0,0.0,5.0,0.0,12.0,1.0,0.0,11.0,24.0,13.0,3.0,5.0,3.0,5.0,4.0,5.0,4.0,5.0,20.0,5.0,2.0,2.0,26.0,0.0,6.0,1.0,11.0,8.0,22.0,6.0,18.0,4.0,0.0,6.0,1.0,21.0,18.0,3.0,7.0,4.0,8.0,10.0,35.0,19.0,1.0,8.0,20.0,11.0,17.0,12.0,7.0,5.0,31.0,23.0,21.0,11.0,12.0,32.0,21.0,20.0,33.0,7.0,15.0,8.0,4.0,21.0,14.0,10.0,14.0,24.0,8.0,11.0,19.0,17.0,11.0,5.0,0.0,4.0,28.0,23.0,12.0,18.0,14.0,13.0,11.0,20.0,4.0,18.0,13.0,13.0,12.0,8.0,25.0,20.0,3.0,4.0,15.0,13.0,8.0,5.0,19.0,7.0,10.0,4.0,7.0,15.0,14.0,9.0,8.0,5.0,21.0,6.0,6.0,13.0,7.0,15.0,13.0,29.0,32.0,10.0,10.0,2.0,14.0,3.0,0.0,0.0,21.0,9.0,16.0,9.0,8.0,14.0,11.0,2.0,3.0,21.0,1.0,0.0,4.0,14.0,10.0,10.0,10.0,25.0,6.0,2.0,11.0,5.0,9.0,7.0,10.0,16.0,2.0,8.0,0.0,4.0,1.0,9.0,11.0,26.0,0.0,15.0,5.0,11.0,36.0,33.0,0.0,29.0,10.0,15.0,15.0,8.0,12.0,10.0,17.0,8.0,7.0,7.0,27.0,14.0,20.0,6.0,24.0,25.0,3.0,17.0,7.0,28.0,8.0,11.0,20.0,8.0,6.0,13.0,28.0,1.0,10.0,12.0,20.0,18.0,11.0,4.0,3.0,23.0,14.0,2.0,20.0,8.0,13.0,21.0,11.0,11.0,11.0,11.0,30.0,9.0,17.0,24.0,19.0,10.0,3.0,2.0,20.0,22.0,19.0,17.0,3.0,1.0,0.0,24.0,16.0,9.0,13.0,8.0,7.0,22.0,27.0,22.0,24.0,11.0,13.0,6.0,12.0,13.0,0.0,0.0,12.0,10.0,14.0,12.0,9.0,23.0,23.0,9.0,8.0,19.0,7.0,26.0,1.0,5.0,1.0,20.0,6.0,10.0,9.0,17.0,11.0,18.0,9.0,7.0,5.0,14.0,4.0,7.0,11.0,12.0,7.0,12.0,8.0,13.0,15.0,11.0,18.0,8.0,20.0,17.0,9.0,19.0,11.0,8.0,11.0,1.0,10.0,9.0,18.0,5.0,15.0,25.0,8.0,9.0,13.0,6.0,7.0,6.0,21.0,4.0,12.0,19.0,12.0,22.0,8.0,11.0,11.0,8.0,7.0,6.0,1.0,26.0,8.0,19.0,21.0,14.0,16.0,24.0,19.0,21.0,19.0,8.0,12.0,4.0,7.0,21.0,18.0,20.0,7.0,3.0,7.0,2.0,8.0,4.0,5.0,9.0,2.0,5.0,6.0,7.0,9.0,11.0,7.0,5.0,7.0,7.0,17.0,23.0,4.0,7.0,8.0,15.0,13.0,8.0,3.0,8.0,6.0,8.0,7.0,6.0,5.0,5.0,11.0,7.0,5.0,2.0,6.0,6.0,0.0,5.0,3.0,2.0,4.0,0.0,6.0,1.0,1.0,3.0,3.0,1.0,5.0,16.0,24.0,1.0,9.0,15.0,9.0,12.0,8.0,11.0,16.0,10.0,1.0,13.0,10.0,0.0,4.0,10.0,13.0,7.0,2.0,1.0,1.0,5.0,5.0,5.0,3.0,7.0,3.0,12.0,4.0,2.0,7.0,11.0,8.0,13.0,6.0,1.0,8.0,8.0,6.0,5.0,0.0,5.0,5.0,7.0,15.0,11.0,13.0,0.0,5.0,6.0,6.0,4.0,4.0,7.0,4.0,5.0,4.0,2.0,3.0,2.0,2.0,5.0,8.0,3.0,10.0,9.0,6.0,13.0,2.0,3.0,4.0,1.0,7.0,7.0,0.0,,6.0,10.0,10.0,0.0,2.0,3.0,2.0,3.0,3.0,2.0,3.0,1.0,2.0,2.0,7.0,6.0,4.0,7.0,9.0,7.0,3.0,2.0,2.0,3.0,7.0,14.0,28.0,12.0,1.0,4.0,5.0,7.0,13.0,15.0,7.0,3.0,,,7.0,12.0,12.0,14.0,10.0,9.0,,3.0,17.0,1.0,4.0,11.0,5.0,8.0,16.0,15.0,16.0,12.0,9.0,13.0,8.0,3.0,9.0,4.0,13.0,17.0,12.0,8.0,3.0,12.0,5.0,3.0,4.0,8.0,9.0,26.0,4.0,14.0,0.0,4.0,29.0,2.0,8.0,5.0,8.0,14.0,5.0,3.0,5.0,15.0,4.0,7.0,16.0,8.0,15.0,4.0,9.0,3.0,16.0,11.0,10.0,11.0,9.0,9.0,6.0,19.0,14.0,9.0,1.0,8.0,11.0,8.0,13.0,,14.0,2.0,14.0,4.0,,2.0,14.0,8.0,14.0,19.0,10.0,14.0,10.0,2.0,17.0,3.0,6.0,11.0,13.0,,2.0,4.0,10.0,1.0,,4.0,11.0,12.0,7.0,14.0,3.0,16.0,1.0,14.0,17.0,13.0,8.0,10.0,2.0,11.0,10.0,2.0,1.0,9.0,0.0,3.0,12.0,21.0,5.0,2.0,3.0,16.0,6.0,6.0,5.0,22.0,11.0,18.0,10.0,6.0,1.0,1.0,3.0,15.0,10.0,10.0,10.0,12.0,0.0,5.0,3.0,10.0,11.0,5.0,11.0,2.0,11.0,5.0,9.0,10.0,6.0,4.0,7.0,5.0,6.0,1.0,9.0,9.0,2.0,5.0,2.0,7.0,7.0,2.0,7.0,3.0,4.0,6.0,1.0,7.0,9.0,8.0,0.0,4.0,5.0,4.0,4.0,5.0,3.0,0.0,3.0,4.0,7.0,5.0,5.0,3.0,6.0,2.0,3.0,4.0,4.0,7.0,2.0,2.0,14.0,7.0,7.0,16.5,6.5,1.0,0.0,7.0,6.0,3.0,11.0,21.0,3.0,1.5,13.0,5.5,7.5,21.0,9.0,8.5,12.0,20.0,4.0,14.0,3.5,5.5,20.5,23.5,20.0,1.0,3.5,1.0,11.0,0.0,0.0,11.5,8.0,0.0,0.0,7.5,7.0,10.5,1.5,9.0,12.5,5.0,3.5,6.5,4.0,1.5,5.0,8.0,0.0,15.5,7.0,8.5,5.5,1.0,2.0,1.5,5.5,6.0,6.5,3.5,7.0,1.0,0.0,5.0,6.5,8.0,10.5,2.0,1.0,6.0,5.0,7.0,12.0,6.5,0.5,17.5,5.0,12.5,1.5,3.0,8.5,4.0,8.5,4.5,10.0,9.0,6.5,2.0,9.0,7.0,4.5,4.5,8.5,15.0,4.0,9.0,10.0,18.0,9.0,8.5,11.5,10.0,19.0,0.5,5.5,13.0,6.0,1.0,6.0,0.0,5.0,7.0,7.0,8.0,4.0,7.0,18.0,4.0,11.0,4.0,3.0,2.0,2.0,9.0,7.5,6.5,8.5,5.0,12.0,11.0,9.0,11.0,21.5,2.5,11.0,12.0,4.0,8.0,2.0,6.0,6.0,2.0,5.0,12.0,9.0,10.0,5.0,6.0,8.0,3.0,8.5,2.5,5.5,7.5,3.0,2.0,1.0,6.0,7.0,7.0,2.0,9.0,11.0,8.5,8.0,0.0,3.5,4.5,0.0,0.0,8.0,4.0,8.0,0.0,17.0,28.0,4.0,4.0,9.0,2.0,1.0,0.0,18.0,0.0,1.0,0.0,2.0,0.0,4.0,24.0,8.0,0.0,1.0,6.0,5.0,2.0,0.0,12.0,1.0,0.0,2.0,6.0,13.0,1.0,11.0,0.0,0.0,14.0,6.0,14.0,13.0,5.0,1.0,1.0,3.0,1.0,1.0,0.0,7.0,1.0,6.0,11.0,3.0,1.0,12.0,3.0,5.0,1.0,5.0,2.0,2.0,2.0,2.0,9.0,1.0,15.0,7.0,3.0,3.0,3.0,5.0,4.0,0.0,0.0,15.0,4.0,2.0,2.0,2.0,8.0,2.0,4.0,3.0,2.0,0.0,4.0,8.0,0.0,4.0,0.0,10.0,10.0,3.0,0.0,4.0,6.0,0.0,18.0,2.0,2.0,6.0,23.0,9.0,25.0,40.0,16.0,17.0,13.0,11.0,12.0,11.0,20.0,11.0,16.0,20.0,15.0,13.0,7.0,26.0,5.0,19.0,14.0,10.0,0.0,8.0,7.0,8.0,19.0,19.0,5.0,2.0,18.0,2.0,1.0,36.0,1.0,6.0,13.0,6.0,6.0,3.0,2.0,5.0,4.0,10.0,15.0,33.0,15.0,7.0,13.0,0.0,3.0,0.0,14.0,5.0,0.0,3.0,2.0,9.0,17.0,2.0,17.0,24.0,4.0,2.0,18.0,14.0,2.0,1.0,11.0,6.0,5.0,5.0,8.0,6.0,3.0,7.0,3.0,11.0,6.0,8.0,3.0,6.0,1.0,7.0,5.0,3.0,5.0,6.0,15.0,1.0,8.0,12.0,6.0,7.0,13.0,19.0,16.0,38.0,1.0,15.0,5.0,7.0,7.0,13.0,8.0,10.0,9.0,6.0,10.0,0.0,10.0,7.0,1.0,8.0,9.0,11.0,10.0,3.0,4.0,0.0,12.0,9.0,18.0,9.0,13.0,13.0,6.0,17.0,18.0,4.0,3.0,1.0,5.0,7.0,6.0,1.0,3.0,13.0,3.0,11.0,14.0,14.0,17.0,9.0,11.0,11.0,27.0,6.0,11.0,2.0,8.0,4.0,4.0,7.0,23.0,5.0,2.0,7.0,5.0,1.0,12.0,16.0,3.0,10.0,0.0,18.0,1.0,6.0,11.0,0.0,3.0,6.0,16.0,13.0,8.0,1.0,0.0,9.0,1.0,2.0,14.0,13.0,22.0,2.0,8.0,4.0,0.0,6.0,8.0,3.0,2.0,2.0,3.0,1.0,8.0,5.0,7.0,1.0,5.0,0.0,0.0,0.0,1.0,4.0,0.0,0.0,8.0,15.0,15.0,0.0,3.0,3.0,2.0,10.0,0.0,3.0,0.0,5.0,0.0,11.0,0.0,7.0,5.0,0.0,5.0,1.0,5.0,6.0,17.0,10.0,1.0,8.0,6.0,14.0,2.0,14.0,7.0,7.0,7.0,8.0,7.0,8.0,0.0,14.0,15.0,15.0,3.0,9.0,0.0,0.0,0.0,16.0,8.0,6.0,7.0,7.0,8.0,6.0,6.0,4.0,11.0,8.0,9.0,3.0,8.0,5.0,6.0,3.0,4.0,2.0,7.0,4.0,7.0,6.0,7.0,8.0,7.0,10.0,11.0,6.0,3.0,11.0,5.0,6.0,0.0,2.0,7.0,4.0,3.0,4.0,11.0,6.0,2.0,7.0,4.0,8.0,4.0,2.0,4.0,8.0,5.0,2.0,6.0,2.0,10.0,6.0,4.0,9.0,4.0,3.0,6.0,6.0,6.0,3.0,5.0,7.0,6.0,5.0,6.0,5.0,6.0,13.0,10.0,3.0,7.0,12.0,14.0,8.0,8.0,0.0,9.0,5.0,5.0,12.0,4.0,4.0,5.0,4.0,0.0,17.0,22.0,17.0,12.0,13.0,9.0,24.0,0.0,12.0,21.0,13.0,6.0,0.0,16.0,5.0,15.0,14.0,8.0,8.0,6.0,13.0,2.0,0.0,13.0,17.0,8.0,12.0,8.0,5.0,6.0,3.0,7.0,9.0,13.0,5.0,7.0,12.0,7.0,6.0,2.0,8.0,12.0,5.0,8.0,15.0,15.0,19.0,6.0,17.0,15.0,9.0,9.0,8.0,6.0,7.0,11.0,9.0,11.0,8.0,12.0,6.0,10.0,5.0,9.0,13.0,5.0,2.0,5.0,15.0,10.0,5.0,11.0,8.0,8.0,13.0,7.0,8.0,5.0,16.0,20.0,20.0,5.0,6.0,9.0,12.0,13.0,7.0,2.0,12.0,18.0,13.0,13.0,8.0,15.0,13.0,11.0,10.0,12.0,10.0,8.0,9.0,6.0,6.0,7.0,9.0,13.0,3.0,10.0,12.0,6.0,14.0,15.0,16.0,16.0,5.0,8.0,11.0,2.0,8.0,10.0,9.0,4.0,16.0,11.0,19.0,5.0,15.0,7.0,11.0,2.0,2.0,7.0,9.0,0.0,12.0,7.0,2.0,8.0,6.0,17.0,17.0,8.0,11.0,3.0,7.0,11.0,10.0,15.0,8.0,11.0,5.0,5.0,5.0,11.0,7.0,18.0,8.0,12.0,3.0,9.0,7.0,14.0,13.0,4.0,0.0,10.0,2.0,5.0,2.0,8.0,8.0,15.0,9.0,11.0,4.0,10.0,10.0,5.0,3.0,5.0,5.0,9.0,5.0,3.0,16.0,10.0,15.0,9.0,8.0,9.0,3.0,8.0,3.0,3.0,4.0,1.0,6.0,14.0,0.0,9.0,14.0,14.0,0.0,4.0,2.0,2.0,2.0,7.0,4.0,14.0,14.0,0.0,3.0,6.0,6.0,7.0,7.0,2.0,11.0,15.0,14.0,5.0,2.0,8.0,12.0,6.0,0.0,5.0,2.0,8.0,7.0,5.0,11.0,12.0,11.0,10.0,13.0,8.0,4.0,7.0,9.0,9.0,8.0,8.0,8.0,5.0,4.0,6.0,10.0,11.0,2.0,6.0,12.0,4.0,5.0,7.0,4.0,10.0,9.0,10.0,6.0,10.0,11.0,2.0,6.0,0.0,12.0,1.0,11.0,4.0,6.0,12.0,15.0,5.0,8.0,5.0,1.0,11.0,9.0,7.0,10.0,1.0,6.0,16.0,3.0,0.0,2.0,0.0,1.0,0.0,0.0,0.0,1.0,0.0,3.0,0.0,0.0,0.0,1.0,2.0,5.0,2.0,0.0,0.0,3.0,0.0,0.0,5.0,0.0,1.0,1.0,0.0,4.0,0.0,1.0,0.0,2.0,0.0,5.0,4.0,1.0,1.0,0.0,0.0,0.0,0.0,4.0,2.0,2.0,0.0,2.0,0.0,0.0,5.0,3.0,3.0,1.0,2.0,0.0,0.0,1.0,3.0,5.0,2.0,0.0,4.0,0.0,0.0,1.0,2.0,2.0,3.0,0.0,0.0,1.0,0.0,4.0,1.0,2.0,3.0,3.0,0.0,1.0,0.0,2.0,4.0,4.0,16.0,8.0,7.0,3.0,0.0,1.0,4.0,3.0,18.0,1.0,3.0,3.0,2.0,15.0,0.0,3.0,6.0,1.0,2.0,7.0,6.0,23.0,4.0,10.0,2.0,5.0,9.0,2.0,10.0,3.0,3.0,2.0,3.0,4.0,0.0,0.0,0.0,8.0,0.0,6.0,5.0,3.0,1.0,8.0,3.0,6.0,57.0,7.0,16.0,1.0,1.0,12.0,14.0,2.0,14.0,8.0,6.0,2.0,1.0,6.0,0.0,0.0,0.0,16.0,5.0,11.0,1.0,11.0,1.0,4.0,2.0,7.0,1.0,3.0,21.0,11.0,7.0,6.0,7.0,6.0,26.0,1.0,0.0,1.0,0.0,0.0,9.0,0.0,0.0,1.0,1.0,0.0,2.0,8.0,18.0,1.0,0.0,20.0,7.0,3.0,17.0,11.0,10.0,0.0,5.0,3.0,10.0,16.0,14.0,26.0,0.0,5.0,11.0,9.0,4.0,9.0,2.0,2.0,0.0,11.0,1.0,13.0,0.0,4.0,1.0,1.0,26.0,0.0,7.0,0.0,8.0,2.0,8.0,6.0,18.0,5.0,19.0,34.0,2.0,0.0,0.0,1.0,8.0,4.0,7.0,12.0,1.0,4.0,7.0,12.0,3.0,3.0,18.0,0.0,10.0,0.0,0.0,4.0,0.0,25.0,4.0,11.0,32.0,1.0,10.0,2.0,18.0,11.0,14.0,1.0,0.0,0.0,1.0,9.0,6.0,1.0,2.0,1.0,6.0,5.0,16.0,3.0,4.0,8.0,5.0,15.0,0.0,9.0,0.0,0.0,6.0,6.0,6.0,28.0,5.0,5.0,2.0,1.0,4.0,5.0,1.0,3.0,4.0,23.0,15.0,12.0,6.0,6.0,9.0,13.0,1.0,9.0,10.0,4.0,10.0,4.0,4.0,6.0,5.0,3.0,12.0,9.0,3.0,0.0,4.0,0.0,0.0,14.0,6.0,4.0,0.0,6.0,1.0,3.0,0.0,5.0,0.0,6.0,1.0,2.0,10.0,4.0,6.0,6.0,1.0,0.0,4.0,14.0,1.0,1.0,0.0,12.0,2.0,0.0,13.0,11.0,3.0,1.0,1.0,5.0,17.0,11.0,1.0,12.0,0.0,7.0,0.0,6.0,5.0,9.0,2.0,10.0,7.0,11.0,0.0,9.0,9.0,11.0,1.0,0.0,1.0,8.0,6.0,2.0,0.0,13.0,7.0,0.0,8.0,6.0,1.0,1.0,7.0,1.0,13.0,7.0,1.0,2.0,6.0,0.0,4.0,2.0,3.0,2.0,3.0,1.0,0.0,16.0,2.0,8.0,3.0,7.0,0.0,1.0,6.0,0.0,10.0,1.0,8.0,0.0,1.0,1.0,15.0,0.0,1.0,12.0,9.0,4.0,5.0,2.0,0.0,0.0,4.0,7.0,5.0,12.0,9.0,2.0,5.0,13.0,2.0,7.0,3.0,4.0,15.0,4.0,0.0,3.0,0.0,2.0,3.0,3.0,5.0,6.0,3.0,3.0,2.0,7.0,28.0,7.0,11.0,14.0,8.0,3.0,0.0,9.0,16.0,11.0,16.0,20.0,1.0,5.0,1.0,1.0,11.0,0.0,1.0,0.0,0.0,1.0,3.0,0.0,0.0,2.0,0.0,2.0,9.0,5.0,0.0,1.0,1.0,1.0,2.0,0.0,1.0,0.0,0.0,1.0,2.0,0.0,3.0,1.0,0.0,2.0,0.0,0.0,0.0,1.0,4.0,0.0,0.0,3.0,0.0,0.0,0.0,1.0,1.0,0.0,3.0,2.0,1.0,1.0,0.0,1.0,0.0,0.0,1.0,1.0,0.0,0.0,1.0,3.0,1.0,3.0,4.0,1.0,0.0,0.0,1.0,1.0,3.0,0.0,2.0,0.0,1.0,0.0,0.0,0.0,1.0,4.0,0.0,1.0,0.0,1.0,2.0,7.0,10.0,4.0,12.0,7.0,6.0,10.0,5.0,5.0,5.0,5.0,5.0,5.0,5.0,5.0,3.0,5.0,5.0,2.0,4.0,5.0,5.0,2.0,5.0,5.0,5.0,5.0,5.0,5.0,5.0,5.0,0.0,5.0,5.0,5.0,5.0,5.0,5.0,5.0,5.0,3.0,4.0,0.0,5.0,0.0,5.0,5.0,1.0,0.0,0.0,0.0,0.0,2.0,0.0,1.0,0.0,2.0,0.0,2.0,0.0,3.0,3.0,0.0,4.0,0.0,1.0,1.0,1.0,3.0,4.0,0.0,0.0,0.0,0.0,4.0,0.0,1.0,3.0,2.0,2.0,2.0,0.0,4.0,2.0,5.0,1.0,3.0,1.0,0.0,3.0,1.0,1.0,1.0,2.0,1.0,4.0,7.0,2.0,6.0,4.0,4.0,0.0,4.0,1.0,1.0,4.0,4.0,1.0,1.0,0.0,1.0,0.0,1.0,0.0,2.0,0.0,3.0,1.0,0.0,2.0,0.0,4.0,2.0,0.0,0.0,1.0,0.0,0.0,0.0,0.0,1.0,0.0,2.0,0.0,1.0,2.0,2.0,1.0,1.0,3.0,1.0,2.0,0.0,1.0,2.0,1.0,1.0,0.0,1.0,0.0,1.0,0.0,0.0,3.0,6.0,4.0,0.0,1.0,0.0,1.0,0.0,9.0,0.0,1.0,3.0,0.0,0.0,0.0,3.0,3.0,0.0,7.0,0.0,0.0,0.0,3.0,3.0,2.0,0.0,5.0,1.0,2.0,1.0,2.0,6.0,2.0,2.0,1.0,0.0,1.0,0.0,0.0,7.0,0.0,0.0,3.0,0.0,0.0,5.0,2.0,1.0,0.0,2.0,2.0,0.0,4.0,0.0,0.0,0.0,2.0,4.0,4.0,0.0,4.0,2.0,3.0,0.0,0.0,1.0,3.0,0.0,0.0,1.0,4.0,2.0,1.0,0.0,1.0,1.0,3.0,1.0,0.0,3.0,2.0,3.0,0.0,2.0,1.0,2.0,0.0,4.0,0.0,1.0,2.0,4.0,1.0,4.0,0.0,5.0,5.0,0.0,5.0,15.0,7.0,10.0,4.0,5.0,1.0,11.0,7.0,13.0,2.0,6.0,9.0,7.0,14.0,13.0,9.0,4.0,18.0,8.0,6.0,6.0,13.0,6.0,27.0,4.0,6.0,10.0,8.0,9.0,8.0,16.0,13.0,15.0,10.0,13.0,10.0,10.0,0.0,15.0,7.0,9.0,9.0,7.0,5.0,3.0,4.0,6.0,7.0,0.0,33.0,0.0,1.0,2.0,0.0,0.0,0.0,7.0,0.0,0.0,20.0,19.0,0.0,38.0,2.0,10.0,4.0,0.0,2.0,26.0,0.0,6.0,0.0,7.0,31.0,34.0,26.0,28.0,28.0,0.0,31.0,4.0,2.0,3.0,38.0,0.0,0.0,5.0,9.0,23.0,5.0,38.0,40.0,14.0,2.0,0.0,28.0,30.0,36.0,1.0,0.0,1.0,0.0,0.0,0.0,8.0,0.0,1.0,0.0,0.0,0.0,3.0,30.0,35.0,0.0,1.0,28.0,38.0,16.0,19.0,0.0,38.0,6.0,0.0,25.0,35.0,2.0,1.0,0.0,17.0,2.0,2.0,5.0,8.0,16.0,0.0,0.0,17.0,0.0,0.0,0.0,33.0,39.0,0.0,3.0,25.0,1.0,1.0,17.0,2.0,3.0,26.0,0.0,0.0,8.0,1.0,36.0,4.0,32.0,7.0,0.0,4.0,3.0,1.0,2.0,4.0,3.0,3.0,0.0,1.0,2.0,4.0,2.0,1.0,0.0,3.0,4.0,2.0,0.0,4.0,0.0,1.0,3.0,2.0,2.0,2.0,4.0,1.0,8.0,1.0,3.0,3.0,1.0,0.0,2.0,1.0,2.0,5.0,2.0,1.0,2.0,2.0,1.0,5.0,2.0,4.0,3.0,0.0,1.0,3.0,0.0,5.0,0.0,0.0,0.0,0.0,0.0,0.0,1.0,2.0,4.0,0.0,0.0,0.0,0.0,0.0,0.0,0.0,0.0,5.0,1.0,0.0,3.0,4.0,2.0,2.0,1.0,0.0,3.0,0.0,3.0,0.0,4.0,4.0,1.0,4.0,1.0,4.0,1.0,4.0,4.0,1.0,1.0,3.0,0.5,3.0,4.0,3.0,0.0,3.0,2.0,2.0,4.0,1.0,1.0,2.0,0.0,5.0,4.0,3.0,0.0,1.0,4.0,5.0,4.5,0.0,3.0,2.0,5.0,3.0,0.0,3.0,4.0,3.0,0.0,2.0,1.0,5.0,5.0,0.0,3.0,3.0,0.0,0.0,3.0,2.0,0.0,2.0,5.0,0.0,4.0,1.0,0.0,2.0,1.0,3.0,1.0,2.0,1.0,3.0,1.0,1.0,1.0,4.0,5.0,2.0,4.0,2.0,2.0,0.0,5.0,3.5,0.0,5.0,3.5,5.0,2.0,5.0,3.5,5.0,5.0,1.0,4.0,1.0,0.0,0.0,0.0,1.0,0.0,5.0,0.0,0.0,3.0,0.0,0.0,1.0,1.0,1.0,1.0,1.0,0.0,1.0,0.0,2.0,3.0,3.0,5.0,2.0,5.0,1.0,2.0,2.0,2.0,1.0,5.0,0.0,2.0,2.0,2.0,0.0,0.0,0.0,1.0,0.0,0.0,3.0,0.0,1.0,0.0,2.0,1.0,1.0,3.0,5.0,1.0,1.0,2.0,1.0,0.0,2.0,1.0,0.0,1.0,4.0,3.0,2.0,0.0,3.0,4.0,2.0,1.0,1.0,1.0,1.0,4.0,5.0,0.0,0.0,3.0,5.0,2.0,0.0,0.0,0.0,2.0,1.0,1.0,0.0,1.0,2.0,0.0,5.0,0.0,0.0,2.0,0.0,5.0,5.0,3.0,0.0,0.0,2.0,5.0,5.0,0.0,0.0,0.0,2.0,2.0,1.0,0.0,0.0,2.0,1.0,1.0,1.0,0.0,2.0,1.0,0.0,0.0,0.0,0.0,5.0,0.0,1.0,3.0,2.0,1.0,0.0,2.0,3.0,4.0,2.0,1.0,1.0,0.0,1.0,0.0,2.0,1.0,2.0,2.0,3.0,5.0,1.0,2.0,0.0,3.0,0.0,3.0,0.0,0.0,3.0,0.0,2.0,3.0,3.0,3.0,3.0,1.0,2.0,0.0,1.0,0.0,0.0,1.0,2.0,0.0,0.0,5.0,1.0,5.0,0.0,0.0,3.0,3.0,5.0,2.0,4.0,2.0,2.0,2.0,5.0,0.0,5.0,5.0,5.0,5.0,0.0,0.0,1.0,3.0,1.0,4.0,5.0,2.0,4.0,2.0,0.0,0.0,5.0,1.0,1.0,1.0,5.0,1.0,3.0,2.0,1.0,4.0,5.0,5.0,2.0,2.0,4.0,4.0,1.0,2.0,3.0,1.0,0.0,0.0,0.0,5.0,3.0,3.0,0.0,2.0,3.0,5.0,1.0,1.0,0.0,0.0,0.0,0.0,0.0,1.0,4.0,0.0,3.0,1.0,0.0,2.0,2.0,2.0,3.0,2.0,0.0,5.0,0.0,0.0,0.0,2.0,0.0,0.0,5.0,2.0,0.0,3.0,1.0,0.0,2.0,0.0,0.0,1.0,0.0,1.0,0.0,1.0,0.0,2.0,0.0,1.0,1.0,0.0,5.0,4.0,2.0,5.0,0.0,0.0,0.0,1.0,0.0,0.0,1.0,1.0,4.0,2.0,2.0,2.0,1.0,0.0,0.0,5.0,2.0,0.0,2.0,1.0,0.0,5.0,1.0,0.0,1.0,5.0,5.0,1.0,2.0,0.0,1.0,0.0,1.0,0.0,2.0,1.0,3.0,0.0,2.0,5.0,1.0,0.0,1.0,4.0,3.0,2.0,1.0,0.0,1.0,2.0,1.0,1.0,1.0,0.0,1.0,2.0,4.0,4.0,1.0,3.0,2.0,1.0,1.0,0.0,5.0,2.0,5.0,0.0,1.0,5.0,0.0,0.0,0.0,2.0,0.0,1.0,1.0,3.0,1.0,0.0,1.0,2.0,1.0,4.0,4.0,1.0,4.0,1.0,3.0,2.0,5.0,3.0,0.0,1.0,4.0,0.0,1.0,3.0,1.0,2.0,5.0,1.0,0.0,1.0,1.0,3.0,1.0,0.0,5.0,0.0,0.0,1.0,5.0,7.0,11.0,13.0,1.0,0.0,12.0,2.0,0.0,12.0,11.0,2.0,22.0,20.0,19.0,17.0,20.0,19.0,4.0,2.0,31.0,19.0,3.0,32.0,0.0,15.0,19.0,8.0,19.0,10.0,16.0,15.0,21.0,4.0,23.0,3.0,10.0,4.0,0.0,8.0,1.0,11.0,14.0,6.0,11.0,2.0,9.0,17.0,14.0,15.0,3.0,31.0,18.0,11.0,6.0,18.0,25.0,14.0,4.0,17.0,17.0,1.0,9.0,16.0,11.0,6.0,20.0,21.0,8.0,8.0,12.0,13.0,13.0,4.0,17.0,15.0,7.0,9.0,3.0,9.0,6.0,7.0,11.0,18.0,9.0,8.0,22.0,5.0,9.0,11.0,15.0,6.0,3.0,9.0,8.0,3.0,4.0,8.0,5.0,11.0,10.0,11.0,15.0,8.0,9.0,3.0,3.0,14.0,2.0,7.0,19.0,1.0,5.0,8.0,13.0,15.0,11.0,18.0,0.0,16.0,11.0,18.0,12.0,0.0,4.0,0.0,0.0,4.0,22.0,17.0,17.0,13.0,7.0,8.0,14.0,6.0,36.0,21.0,14.0,13.0,10.0,10.0,14.0,16.0,16.0,15.0,6.0,17.0,8.0,9.0,0.0,3.0,1.0,7.0,14.0,13.0,20.0,16.0,18.0,9.0,19.0,7.0,6.0,18.0,2.0,9.0,20.0,5.0,7.0,12.0,15.0,10.0,12.0,20.0,11.0,5.0,0.0,0.0,10.0,12.0,14.0,0.0,14.0,3.0,13.0,12.0,22.0,3.0,12.0,15.0,17.0,10.0,8.0,3.0,9.0,20.0,5.0,7.0,18.0,4.0,12.0,9.0,7.0,22.0,8.0,0.0,9.0,8.0,18.0,13.0,14.0,8.0,12.0,8.0,13.0,13.0,17.0,5.0,10.0,11.0,12.0,15.0,13.0,10.0,9.0,8.0,13.0,7.0,6.0,4.0,15.0,14.0,5.0,21.0,8.0,17.0,14.0,8.0,5.0,13.0,9.0,3.0,12.0,6.0,19.0,9.0,9.0,13.0,16.0,0.0,14.0,18.0,6.0,10.0,10.0,9.0,13.0,7.0,9.0,14.0,4.0,17.0,10.0,10.0,10.0,24.0,14.0,11.0,8.0,13.0,15.0,16.0,14.0,9.0,7.0,20.0,2.0,9.0,9.0,10.0,5.0,1.0,14.0,12.0,11.0,8.0,11.0,14.0,1.0,11.0,20.0,10.0,7.0,8.0,5.0,14.0,14.0,11.0,15.0,23.0,6.0,2.0,16.0,16.0,5.0,10.0,10.0,14.0,16.0,11.0,14.0,4.0,11.0,9.0,12.0,6.0,20.0,11.0,12.0,5.0,4.0,7.0,9.0,3.0,19.0,7.0,1.0,7.0,13.0,14.0,11.0,6.0,13.0,4.0,3.0,4.0,3.0,19.0,16.0,13.0,12.0,17.0,9.0,12.0,12.0,15.0,8.0,7.0,6.0,8.0,6.0,12.0,9.0,7.5,1.5,23.0,7.0,2.5,3.0,4.5,3.5,29.0,21.5,3.0,4.0,3.5,7.0,5.0,14.0,14.0,4.0,12.0,2.0,4.5,10.0,8.0,14.5,5.5,17.5,5.0,5.0,5.0,1.0,5.0,5.0,5.0,5.0,5.0,3.0,2.0,3.0,5.0,4.0,5.0,3.0,5.0,5.0,3.0,5.0,3.0,5.0,0.0,4.0,5.0,5.0,4.0,5.0,3.0,5.0,5.0,5.0,5.0,5.0,1.0,5.0,2.0,5.0,5.0,5.0,5.0,5.0,5.0,5.0,5.0,5.0,5.0,5.0,5.0,1.0,5.0,5.0,5.0,5.0,5.0,5.0,5.0,0.0,5.0,5.0,5.0,5.0,1.0,4.0,5.0,5.0,1.0,1.0,5.0,5.0,5.0,5.0,5.0,0.0,5.0,,3.0,3.0,5.0,5.0,5.0,0.0,2.0,5.0,5.0,2.0,5.0,1.0,4.0,1.0,5.0,5.0,5.0,5.0,2.0,0.0,2.0,0.0,5.0,5.0,4.0,5.0,2.0,2.0,0.0,5.0,5.0,5.0,5.0,3.0,5.0,2.0,4.0,5.0,0.0,2.0,4.0,4.0,1.0,5.0,5.0,5.0,3.0,5.0,5.0,5.0,5.0,2.0,3.0,5.0,0.0,5.0,4.0,5.0,5.0,2.0,5.0,0.0,5.0,5.0,5.0,5.0,5.0,5.0,5.0,5.0,5.0,4.0,1.0,2.0,5.0,4.0,5.0,2.0,5.0,2.0,17.0,16.0,12.0,2.0,2.0,5.0
11,3.0,5.0,5.0,5.0,4.0,7.0,3.0,5.0,5.0,4.0,4.0,2.0,2.0,5.0,5.0,22.0,6.0,5.0,5.0,5.0,7.0,2.0,7.0,0.0,2.0,7.0,5.0,4.0,6.0,1.0,4.0,4.0,5.0,11.0,5.0,5.0,5.0,2.0,6.0,6.0,4.0,5.0,4.0,4.0,3.0,4.0,10.0,6.0,2.0,2.0,4.0,2.0,3.0,0.0,3.0,6.0,0.0,3.0,0.0,0.0,0.0,0.0,0.0,0.0,0.0,0.0,0.0,0.0,0.0,0.0,0.0,0.0,0.0,0.0,0.0,0.0,0.0,0.0,0.0,,5.0,3.0,5.0,5.0,5.0,5.0,5.0,0.0,0.0,0.0,0.0,0.0,10.0,0.0,0.0,0.0,0.0,0.0,0.0,0.0,0.0,0.0,0.0,0.0,0.0,0.0,0.0,0.0,0.0,0.0,0.0,0.0,0.0,1.0,5.0,6.0,4.0,5.0,2.0,5.0,3.0,16.0,4.0,5.0,4.0,15.0,2.0,3.0,8.0,5.0,9.0,3.0,10.0,4.0,9.0,3.0,9.0,5.0,6.0,3.0,2.0,2.0,0.0,5.0,4.0,7.0,11.0,8.0,9.0,5.0,5.0,8.0,0.0,4.0,3.0,7.0,3.0,5.0,7.0,1.0,4.0,3.0,15.0,0.0,5.0,5.0,5.0,5.0,4.0,3.0,8.0,11.0,11.0,2.0,7.0,7.0,4.0,7.0,5.0,2.0,5.0,3.0,0.0,11.0,5.0,6.0,4.0,4.0,2.0,4.0,4.0,4.0,7.0,7.0,3.0,4.0,1.0,7.0,12.0,5.0,5.0,1.0,7.0,3.0,5.0,2.0,4.0,2.0,3.0,4.0,3.0,4.0,9.0,7.0,0.0,13.0,11.0,8.0,0.0,1.0,5.0,11.0,4.0,6.0,0.0,0.0,8.0,6.0,6.0,5.0,7.0,3.0,0.0,3.0,5.0,8.0,8.0,2.0,5.0,5.0,3.0,11.0,0.0,3.0,6.0,2.0,4.0,13.0,0.0,5.0,1.0,9.0,13.0,2.0,4.0,4.0,10.0,3.0,12.0,1.0,0.0,11.0,2.0,4.0,8.0,2.0,5.0,11.0,0.0,4.0,10.0,3.0,9.0,12.0,8.0,7.0,6.0,2.0,6.0,7.0,4.0,10.0,6.0,8.0,4.0,6.0,10.0,5.0,9.0,11.0,7.0,4.0,11.0,3.0,2.0,2.0,5.0,5.0,4.0,3.0,2.0,3.0,0.0,2.0,3.0,2.0,3.0,4.0,2.0,8.0,14.0,15.0,7.0,7.0,6.0,6.0,3.0,12.0,11.0,8.0,12.0,10.0,4.0,11.0,16.0,7.0,8.0,3.0,11.0,7.0,6.0,11.0,3.0,7.0,13.0,10.0,13.0,13.0,6.0,16.0,19.0,9.0,11.0,10.0,7.0,8.0,8.0,6.0,14.0,10.0,6.0,13.0,9.0,8.0,6.0,21.0,2.0,10.0,9.0,8.0,6.0,6.0,2.0,11.0,3.0,0.0,1.0,5.0,3.0,15.0,2.0,18.0,1.0,11.0,1.0,1.0,2.0,4.0,1.0,3.0,0.0,1.0,2.0,0.0,3.0,2.0,8.0,0.0,5.0,2.0,1.0,9.0,0.0,3.0,2.0,3.0,1.0,0.0,0.0,2.0,0.0,0.0,1.0,3.0,0.0,3.0,0.0,0.0,0.0,0.0,1.0,0.0,0.0,1.0,1.0,2.0,4.0,3.0,4.0,0.0,2.0,1.0,8.0,3.0,6.0,0.0,0.0,1.0,5.0,6.0,7.0,1.0,6.0,10.0,14.0,1.0,9.0,6.0,9.0,2.0,3.0,5.0,4.0,10.0,10.0,19.0,11.0,3.0,5.0,2.0,15.0,1.0,8.0,9.0,1.0,8.0,5.0,2.0,4.0,6.0,1.0,1.0,2.0,0.0,4.0,2.0,4.0,0.0,3.0,1.0,1.0,1.0,2.0,1.0,0.0,0.0,2.0,4.0,1.0,4.0,5.0,3.0,3.0,0.0,5.0,7.0,5.0,3.0,4.0,5.0,7.0,1.0,2.0,5.0,0.0,1.0,6.0,4.0,6.0,10.0,11.0,0.0,0.0,1.0,13.0,20.0,1.0,2.0,3.0,1.0,2.0,6.0,1.0,8.0,4.0,3.0,7.0,2.0,2.0,8.0,8.0,5.0,8.0,1.0,5.0,5.0,5.0,5.0,5.0,2.0,0.0,2.0,6.0,5.0,1.0,4.0,1.0,6.0,1.0,6.0,3.0,4.0,1.0,2.0,2.0,2.0,,,,,,,,,,,,,,,,,,,,,,,,,,,,,,,,,,8.0,12.0,8.0,8.0,8.0,,,8.0,10.0,15.0,20.0,4.0,9.0,,,,19.0,,,,,,,,,11.0,,,,,,,,3.0,7.0,,,12.0,7.0,15.0,7.0,,16.0,12.0,,6.0,12.0,4.0,,12.0,,,15.0,24.0,24.0,,,9.0,,11.0,7.0,14.0,21.0,16.0,6.0,,3.0,0.0,0.0,20.0,0.0,0.0,0.0,0.0,0.0,1.0,0.0,2.0,7.0,0.0,3.0,0.0,2.0,1.0,0.0,0.0,2.0,4.0,5.0,5.0,1.0,5.0,0.0,0.0,0.0,0.0,5.0,0.0,0.0,1.0,3.0,5.0,5.0,3.0,0.0,5.0,5.0,5.0,2.0,1.0,5.0,2.0,0.0,5.0,1.0,4.0,0.0,0.0,5.0,2.0,3.0,1.0,1.0,1.0,2.0,1.0,2.0,5.0,0.0,5.0,3.0,5.0,5.0,5.0,4.0,5.0,5.0,5.0,13.0,7.0,2.0,0.0,2.0,6.0,10.0,1.0,1.0,14.0,5.0,1.0,8.0,3.0,5.0,0.0,4.0,1.0,1.0,3.0,2.0,7.0,6.0,3.0,6.0,4.0,4.0,4.0,3.0,5.0,3.0,0.0,0.0,4.0,4.0,3.0,1.0,3.0,7.0,2.0,2.0,9.0,6.0,3.0,9.0,13.0,9.0,7.0,8.0,7.0,8.0,10.0,9.0,13.0,6.0,4.0,11.0,10.0,5.0,13.0,6.0,3.0,12.0,10.0,11.0,6.0,6.0,3.0,5.0,7.0,5.0,7.0,6.0,5.0,8.0,0.0,4.0,5.0,5.0,6.0,5.0,6.0,9.0,5.0,3.0,5.0,10.0,9.0,7.0,7.0,6.0,6.0,9.0,7.0,6.0,7.0,11.0,3.0,5.0,6.0,7.0,0.0,4.0,4.0,6.0,7.0,4.0,4.0,5.0,5.0,5.0,4.0,5.0,8.0,4.0,6.0,8.0,4.0,14.0,5.0,3.0,5.0,4.0,5.0,6.0,8.0,6.0,8.0,6.0,9.0,9.0,4.0,3.0,10.0,5.0,6.0,6.0,5.0,5.0,2.0,16.0,1.0,4.0,1.0,4.0,14.0,7.0,15.0,6.0,11.0,7.0,4.0,0.0,18.0,1.0,23.0,25.0,3.0,7.0,17.0,1.0,4.0,3.0,2.0,5.0,18.0,14.0,22.0,20.0,20.0,13.0,17.0,4.0,21.0,5.0,6.0,23.0,10.0,15.0,7.0,1.0,2.0,1.0,3.0,3.0,14.0,0.0,3.0,11.0,5.0,17.0,4.0,3.0,1.0,18.0,16.0,0.0,5.0,18.0,2.0,12.0,17.0,10.0,11.0,7.0,9.0,0.0,3.0,4.0,6.0,0.0,4.0,4.0,0.0,6.0,16.0,18.0,13.0,12.0,15.0,4.0,11.0,19.0,7.0,1.0,13.0,8.0,6.0,10.0,6.0,9.0,3.0,5.0,21.0,5.0,2.0,5.0,18.0,10.0,21.0,6.0,1.0,3.0,5.0,2.0,8.0,11.0,13.0,12.0,14.0,12.0,10.0,8.0,2.0,4.0,6.0,2.0,9.0,9.0,17.0,5.0,7.0,3.0,5.0,1.0,4.0,21.0,5.0,4.0,2.0,5.0,2.0,4.0,8.0,0.0,5.0,6.0,2.0,5.0,6.0,1.0,8.0,9.0,4.0,5.0,2.0,0.0,2.0,8.0,17.0,22.0,5.0,6.0,2.0,6.0,10.0,1.0,0.0,6.0,3.0,10.0,3.0,3.0,1.0,9.0,23.0,3.0,10.0,4.0,1.0,2.0,1.0,17.0,3.0,5.0,7.0,1.0,6.0,21.0,12.0,0.0,15.0,11.0,0.0,17.0,20.0,12.0,2.0,14.0,18.0,1.0,4.0,3.0,0.0,3.0,1.0,1.0,4.0,3.0,1.0,1.0,6.0,4.0,3.0,3.0,5.0,3.0,3.0,1.0,3.0,6.0,6.0,2.0,6.0,4.0,1.0,2.0,0.0,3.0,0.0,1.0,2.0,2.0,3.0,5.0,2.0,0.0,6.0,0.0,0.0,1.0,0.0,3.0,1.0,3.0,1.0,2.0,1.0,2.0,1.0,0.0,1.0,1.0,1.0,7.0,3.0,1.0,4.0,1.0,7.0,2.0,1.0,3.0,2.0,2.0,2.0,2.0,3.0,1.0,2.0,9.0,3.0,1.0,1.0,3.0,0.0,2.0,2.0,2.0,1.0,3.0,8.0,2.0,0.0,0.0,0.0,1.0,6.0,8.0,9.0,13.0,7.0,1.0,2.0,5.0,4.0,0.0,7.0,4.0,1.0,3.0,11.0,0.0,3.0,2.0,3.0,1.0,15.0,3.0,6.0,10.0,2.0,0.0,0.0,4.0,4.0,3.0,1.0,0.0,1.0,6.0,4.0,2.0,5.0,9.0,2.0,2.0,8.0,3.0,5.0,4.0,8.0,3.0,2.0,6.0,10.0,0.0,5.0,3.0,7.0,4.0,1.0,10.0,11.0,0.0,1.0,1.0,0.0,1.0,8.0,2.0,4.0,9.0,3.0,8.0,2.0,1.0,3.0,2.0,1.0,4.0,3.0,3.0,5.0,14.0,5.0,0.0,3.0,4.0,3.0,1.0,,,,,,,,,,,,,,,,,,,,,,,,,,,,,,,,,,,,,,,,,,,,,,,,,,,,,,,,,,,5.0,4.0,2.0,0.0,1.0,0.0,0.0,0.0,0.0,0.0,0.0,0.0,0.0,2.0,0.0,0.0,0.0,3.0,0.0,0.0,0.0,2.0,0.0,4.0,0.0,1.0,0.0,0.0,10.0,0.0,3.0,0.0,3.0,0.0,2.0,0.0,4.0,0.0,2.0,1.0,4.0,2.0,1.0,2.0,3.0,0.0,1.0,4.0,2.0,0.0,0.0,0.0,0.0,,0.0,0.0,0.0,0.0,0.0,2.0,0.0,0.0,0.0,0.0,0.0,4.0,2.0,0.0,0.0,0.0,0.0,0.0,0.0,,3.0,0.0,0.0,0.0,0.0,0.0,2.0,9.0,6.0,0.0,3.0,2.0,0.0,0.0,0.0,0.0,0.0,0.0,0.0,0.0,0.0,0.0,0.0,0.0,4.0,0.0,1.0,0.0,0.0,0.0,0.0,0.0,0.0,0.0,0.0,4.0,0.0,0.0,0.0,0.0,0.0,0.0,0.0,0.0,0.0,0.0,6.0,0.0,0.0,0.0,0.0,0.0,0.0,0.0,0.0,0.0,6.0,0.0,5.0,0.0,2.0,0.0,0.0,5.0,0.0,0.0,0.0,0.0,0.0,0.0,0.0,0.0,1.0,2.0,0.0,0.0,0.0,0.0,1.0,0.0,0.0,1.0,1.0,0.0,0.0,2.0,0.0,0.0,3.0,0.0,0.0,1.0,3.0,4.0,0.0,1.0,0.0,3.0,0.0,1.0,0.0,1.8,4.0,0.0,0.0,0.0,0.0,0.0,3.0,2.3333333333333335,0.0,2.0,0.0,1.0,0.0,2.0,3.0,3.0,1.0,4.0,2.0,0.0,0.0,0.0,0.0,0.0,0.0,0.0,0.0,0.0,0.0,0.0,0.0,0.0,0.0,3.0,0.0,0.0,0.0,0.0,1.0,0.0,0.0,0.0,0.0,0.0,0.0,0.0,0.0,0.0,1.0,2.0,2.0,0.0,0.0,0.0,2.0,0.0,0.0,3.0,0.0,0.0,0.0,0.0,0.0,0.0,0.0,0.0,0.0,0.0,0.0,0.0,0.0,0.0,0.0,0.0,2.0,0.0,4.0,0.0,0.0,0.0,3.0,0.0,2.0,1.5,3.0,0.0,0.0,0.0,0.0,0.0,7.0,0.0,0.0,0.0,2.0,0.0,0.0,3.0,0.0,0.0,0.0,0.0,4.0,0.0,,3.0,0.0,0.0,12.0,25.0,10.0,10.0,15.0,18.0,1.0,1.0,17.0,1.0,1.0,5.0,6.0,14.0,20.0,2.0,5.0,4.0,6.0,14.0,6.0,0.0,1.0,0.0,4.0,13.0,26.0,18.0,4.0,21.0,21.0,6.0,1.0,0.0,0.0,27.0,7.0,20.0,7.0,16.0,25.0,38.0,8.0,20.0,14.0,16.0,10.0,14.0,19.0,4.0,3.0,19.0,15.0,3.0,19.0,21.0,22.0,9.0,22.0,8.0,3.0,16.0,19.0,8.0,18.0,19.0,21.0,27.0,13.0,11.0,1.0,13.0,30.0,27.0,19.0,12.0,27.0,7.0,19.0,7.0,6.0,16.0,17.0,28.0,30.0,3.0,16.0,20.0,27.0,1.0,23.0,10.0,9.0,40.0,5.0,5.0,24.0,8.0,4.0,2.0,2.0,0.0,2.0,8.0,0.0,6.0,2.0,3.0,0.0,20.0,1.0,2.0,4.0,0.0,0.0,14.0,2.0,15.0,7.0,19.0,29.0,16.0,10.0,0.0,4.0,4.0,11.0,0.0,24.0,7.0,3.0,0.0,3.0,5.0,1.0,2.0,11.0,1.0,0.0,0.0,0.0,0.0,2.0,1.0,1.0,1.0,18.0,1.0,1.0,5.0,0.0,4.0,0.0,7.0,3.0,1.0,6.0,15.0,12.0,18.0,16.0,0.0,0.0,1.0,2.0,12.0,2.0,15.0,4.0,1.0,3.0,2.0,3.0,1.0,9.0,1.0,13.0,9.0,0.0,11.0,6.0,2.0,4.0,13.0,1.0,11.0,8.0,13.0,1.0,0.0,2.0,9.0,10.0,8.0,3.0,20.0,0.0,2.0,1.0,10.0,1.0,1.0,2.0,0.0,1.0,21.0,0.0,8.0,13.0,1.0,6.0,4.0,1.0,0.0,0.0,2.0,2.0,1.0,1.0,1.0,17.0,12.0,3.0,4.0,0.0,4.0,1.0,7.0,3.0,4.0,1.0,1.0,0.0,12.0,21.0,12.0,1.0,1.0,2.0,1.0,7.0,25.0,4.0,0.0,24.0,0.0,2.0,0.0,8.0,1.0,14.0,1.0,12.0,16.0,13.0,19.0,1.0,14.0,3.0,18.0,11.0,12.0,7.0,25.0,19.0,13.0,16.0,15.0,1.0,24.0,23.0,27.0,31.0,18.0,20.0,27.0,14.0,6.0,29.0,17.0,1.0,3.0,0.0,0.0,17.0,12.0,16.0,14.0,29.0,2.0,21.0,29.0,1.0,1.0,9.0,3.0,21.0,2.0,16.0,14.0,8.0,7.0,15.0,25.0,24.0,12.0,20.0,19.0,10.0,3.0,7.0,11.0,5.0,8.0,11.0,35.0,11.0,3.0,7.0,12.0,13.0,30.0,25.0,18.0,2.0,1.0,28.0,22.0,19.0,26.0,0.0,26.0,26.0,13.0,10.0,17.0,23.0,22.0,17.0,2.0,2.0,11.0,25.0,19.0,0.0,4.0,13.0,2.0,12.0,13.0,4.0,24.0,18.0,5.0,44.0,22.0,18.0,14.0,15.0,17.0,0.0,2.0,2.0,13.0,19.0,2.0,16.0,19.0,18.0,16.0,18.0,23.0,24.0,22.0,25.0,17.0,19.0,14.0,0.0,2.0,18.0,6.0,3.0,7.0,9.0,0.0,0.0,6.0,9.0,8.0,19.0,4.0,2.0,2.0,2.0,14.0,2.0,0.0,3.0,12.0,0.0,9.0,1.0,1.0,2.0,2.0,1.0,6.0,10.0,0.0,,0.0,0.0,0.0,0.0,0.0,,0.0,,,0.0,0.0,0.0,0.0,0.0,11.0,3.0,10.0,1.0,7.0,7.0,5.0,6.0,0.0,4.0,2.0,6.0,5.0,2.0,3.0,2.0,7.0,6.0,10.0,6.0,6.0,4.0,12.0,12.0,5.0,12.0,11.0,9.0,1.0,10.0,2.0,10.0,5.0,5.0,8.0,7.0,17.0,8.0,9.0,10.0,9.0,7.0,6.0,16.0,16.0,5.0,13.0,9.0,6.0,1.0,6.0,10.0,7.0,9.0,7.0,4.0,9.0,7.0,10.0,0.0,9.0,6.0,10.0,11.0,7.0,21.0,5.0,8.0,7.0,5.0,4.0,10.0,20.0,10.0,17.0,1.0,6.0,21.0,15.0,1.0,7.0,7.0,7.0,3.0,5.0,14.0,9.0,7.0,23.0,7.0,3.0,8.0,5.0,13.0,2.0,5.0,0.0,5.0,2.0,5.0,12.0,11.0,6.0,8.0,2.0,12.0,8.0,2.0,1.0,7.0,18.0,8.0,3.0,11.0,4.0,6.0,7.0,9.0,6.0,1.0,0.0,4.0,1.0,3.0,6.0,12.0,22.0,8.0,17.0,6.0,0.0,5.0,6.0,12.0,12.0,9.0,9.0,19.0,0.0,1.0,6.0,5.0,5.0,11.0,5.0,10.0,8.0,1.0,10.0,2.0,7.0,9.0,3.0,5.0,10.0,0.0,5.0,0.0,3.0,2.0,2.0,3.0,2.0,2.0,3.0,0.0,0.0,4.0,1.0,3.0,4.0,8.0,1.0,1.0,4.0,0.0,0.0,5.0,7.0,7.0,6.0,1.0,2.0,7.0,5.0,5.0,4.0,11.0,,3.0,4.0,7.0,14.0,13.0,0.0,9.0,8.0,12.0,10.0,11.0,16.0,1.0,12.0,2.0,2.0,3.0,11.0,1.0,6.0,18.0,4.0,5.0,0.0,34.0,9.0,7.0,0.0,11.0,2.0,9.0,11.0,0.0,58.0,3.0,3.0,10.0,11.0,0.0,4.0,7.0,0.0,7.0,15.0,1.0,5.0,4.0,10.0,1.0,2.0,2.0,7.0,,24.0,4.0,7.0,1.0,15.0,6.0,4.0,15.0,3.0,0.0,7.0,13.0,6.0,1.0,6.0,9.0,4.0,0.0,0.0,0.0,23.0,2.0,10.0,10.0,4.0,2.0,3.0,5.0,5.0,2.0,1.0,4.0,0.0,20.0,14.0,3.0,,3.0,4.0,0.0,17.0,5.0,6.0,16.0,4.0,5.0,8.0,10.0,13.0,10.0,17.0,3.0,18.0,3.0,14.0,6.0,4.0,4.0,0.0,10.0,14.0,5.0,6.0,6.0,4.0,6.0,2.0,8.0,3.0,7.0,,19.0,6.0,4.0,7.0,9.0,12.0,8.0,7.0,15.0,12.0,10.0,15.0,17.0,13.0,2.0,7.0,4.0,6.0,3.0,3.0,5.0,6.0,15.0,17.0,8.0,1.0,4.0,0.0,12.0,4.0,13.0,4.0,18.0,7.0,42.0,20.0,19.0,8.0,17.0,9.0,4.0,2.0,12.0,4.0,5.0,3.0,12.0,9.0,7.0,21.0,7.0,0.0,20.0,17.0,11.0,14.0,10.0,23.0,6.0,7.0,9.0,9.0,8.0,15.0,10.0,10.0,5.0,1.0,7.0,13.0,3.0,12.0,0.0,5.0,19.0,8.0,4.0,14.0,6.0,2.0,0.0,2.0,0.0,17.0,8.0,15.0,18.0,12.0,9.0,0.0,5.0,10.0,6.0,4.0,1.0,9.0,8.0,6.0,,21.0,10.0,4.0,17.0,14.0,2.0,2.0,14.0,10.0,6.0,2.0,2.0,8.0,0.0,9.0,10.0,6.0,,14.0,12.0,14.0,2.0,1.0,2.0,12.0,6.0,10.0,14.0,16.0,7.0,1.0,12.0,11.0,5.0,4.0,0.0,1.0,7.0,4.0,5.0,15.0,8.0,6.0,2.0,7.0,,12.0,14.0,11.0,15.0,6.0,3.0,10.0,11.0,11.0,2.0,14.0,0.0,11.0,1.0,1.0,8.0,4.0,7.0,11.0,6.0,5.0,4.0,8.0,4.0,15.0,7.0,7.0,17.0,1.0,17.0,16.0,16.0,8.0,1.0,13.0,8.0,13.0,8.0,2.0,9.0,11.0,4.0,18.0,1.0,25.0,13.0,2.0,1.0,9.0,4.0,12.0,11.0,14.0,4.0,19.0,15.0,4.0,11.0,5.0,15.0,23.0,18.0,1.0,2.0,6.0,21.0,5.0,1.0,17.0,3.0,10.0,7.0,16.0,9.0,13.0,1.0,3.0,2.0,14.0,14.0,,20.0,10.0,6.0,2.0,7.0,0.0,7.0,2.0,1.0,3.0,6.0,,3.0,1.0,3.0,8.0,9.0,3.0,4.0,10.0,5.0,13.0,10.0,11.0,10.0,2.0,28.0,9.0,5.0,10.0,13.0,8.0,5.0,8.0,6.0,4.0,11.0,6.0,21.0,0.0,1.0,1.0,4.0,10.0,2.0,4.0,5.0,3.0,4.0,8.0,13.0,14.0,12.0,,1.0,8.0,16.0,1.0,0.0,6.0,10.0,10.0,17.0,2.0,10.0,19.0,5.0,8.0,4.0,15.0,7.0,5.0,3.0,11.0,6.0,6.0,7.0,5.0,1.0,18.0,13.0,,8.0,12.0,9.0,4.0,7.0,12.0,8.0,22.0,2.0,23.0,3.0,8.0,0.0,3.0,3.0,21.0,3.0,8.0,1.0,3.0,0.0,2.0,5.0,0.0,8.0,1.0,8.0,9.0,1.0,11.0,1.0,4.0,6.0,,,,,,,,,,,,,,,,,,,,,,,,,,,,,,,,,,,,,,,,,,,,,,,,,,,0.0,2.0,3.0,3.0,5.0,2.0,5.0,3.0,0.0,2.0,5.0,4.0,0.0,1.0,4.0,0.0,3.0,5.0,5.0,4.0,3.0,14.0,0.0,10.0,15.0,8.0,6.0,24.0,1.0,1.0,8.0,3.0,24.0,14.0,12.0,9.0,8.0,3.0,6.0,13.0,24.0,6.0,8.0,11.0,4.0,8.0,13.0,1.0,16.0,7.0,9.0,9.0,15.0,19.0,19.0,14.0,17.0,1.0,10.0,18.0,10.0,2.0,13.0,11.0,6.0,15.0,12.0,11.0,1.0,8.0,6.0,26.0,4.0,26.0,14.0,15.0,5.0,8.0,16.0,12.0,15.0,16.0,14.0,11.0,4.0,11.0,13.0,11.0,10.0,7.0,12.0,21.0,20.0,23.0,10.0,19.0,14.0,13.0,7.0,21.0,19.0,4.0,15.0,11.0,8.0,2.0,27.0,4.0,10.0,5.0,10.0,1.0,15.0,9.0,15.0,29.0,9.0,17.0,16.0,18.0,13.0,21.0,6.0,12.0,16.0,11.0,8.0,11.0,3.0,15.0,21.0,19.0,8.0,12.0,5.0,6.0,4.0,11.0,10.0,8.0,9.0,11.0,22.0,8.0,5.0,9.0,19.0,5.0,9.0,10.0,10.0,17.0,3.0,1.0,13.0,16.0,7.0,1.0,18.0,29.0,30.0,12.0,7.0,9.0,9.0,11.0,7.0,12.0,13.0,8.0,8.0,10.0,21.0,14.0,18.0,1.0,4.0,5.0,7.0,15.0,12.0,14.0,9.0,12.0,11.0,4.0,19.0,5.0,4.0,24.0,16.0,14.0,15.0,19.0,6.0,3.0,22.0,19.0,22.0,5.0,5.0,19.0,10.0,8.0,14.0,4.0,18.0,12.0,14.0,3.0,13.0,5.0,35.0,16.0,14.0,13.0,12.0,8.0,17.0,7.0,9.0,11.0,13.0,5.0,9.0,15.0,13.0,3.0,20.0,27.0,17.0,16.0,16.0,9.0,9.0,3.0,18.0,12.0,15.0,7.0,19.0,7.0,6.0,9.0,9.0,1.0,13.0,20.0,10.0,21.0,3.0,9.0,7.0,17.0,6.0,14.0,7.0,3.0,8.0,9.0,18.0,19.0,10.0,14.0,18.0,6.0,8.0,10.0,10.0,6.0,11.0,14.0,15.0,14.0,12.0,17.0,11.0,12.0,13.0,11.0,15.0,9.0,1.0,9.0,8.0,6.0,7.0,13.0,9.0,6.0,10.0,8.0,19.0,24.0,10.0,12.0,12.0,14.0,7.0,15.0,13.0,12.0,8.0,1.0,16.0,8.0,18.0,12.0,10.0,16.0,7.0,0.0,11.0,6.0,11.0,0.0,5.0,13.0,12.0,6.0,15.0,7.0,2.0,2.0,2.0,10.0,11.0,14.0,13.0,3.0,5.0,10.0,11.0,15.0,10.0,18.0,7.0,0.0,10.0,14.0,10.0,16.0,8.0,19.0,23.0,2.0,0.0,8.0,4.0,12.0,2.0,0.0,3.0,0.0,0.0,0.0,3.0,14.0,1.0,14.0,16.0,10.0,4.0,7.0,11.0,14.0,4.0,2.0,15.0,0.0,1.0,6.0,8.0,13.0,13.0,9.0,3.0,3.0,15.0,23.0,8.0,3.0,12.0,4.0,12.0,9.0,18.0,5.0,5.0,10.0,23.0,3.0,15.0,10.0,2.0,10.0,12.0,1.0,21.0,3.0,10.0,23.0,1.0,6.0,8.0,8.0,10.0,11.0,10.0,10.0,2.0,1.0,0.0,27.0,5.0,6.0,9.0,11.0,17.0,1.0,0.0,6.0,1.0,12.0,6.0,3.0,9.0,4.0,13.0,4.0,11.0,13.0,2.0,20.0,21.0,12.0,3.0,0.0,5.0,1.0,0.0,1.0,7.0,1.0,6.0,14.0,1.0,3.0,0.0,2.0,7.0,4.0,1.0,9.0,2.0,0.0,5.0,3.0,0.0,7.0,4.0,1.0,0.0,8.0,0.0,0.0,4.0,4.0,5.0,5.0,8.0,17.0,0.0,6.0,0.0,8.0,1.0,0.0,2.0,0.0,1.0,0.0,7.0,8.0,0.0,6.0,0.0,2.0,1.0,0.0,6.0,3.0,0.0,0.0,0.0,2.0,4.0,9.0,3.0,0.0,6.0,4.0,28.0,17.0,0.0,3.0,10.0,1.0,1.0,0.0,4.0,6.0,2.0,1.0,8.0,2.0,3.0,13.0,8.0,14.0,2.0,6.0,5.0,15.0,7.0,0.0,7.0,8.0,1.0,0.0,0.0,5.0,0.0,2.0,0.0,7.0,0.0,3.0,9.0,14.0,12.0,18.0,14.0,3.0,14.0,12.0,11.0,9.0,2.0,9.0,0.0,13.0,19.0,10.0,1.0,0.0,3.0,0.0,0.0,0.0,5.0,11.0,5.0,0.0,4.0,18.0,0.0,0.0,11.0,6.0,18.0,9.0,5.0,7.0,7.0,5.0,2.0,4.0,0.0,2.0,5.0,1.0,5.0,4.0,12.0,9.0,7.0,4.0,7.0,1.0,11.0,0.0,8.0,7.0,1.0,5.0,0.0,2.0,3.0,7.0,15.0,6.0,1.0,1.0,5.0,0.0,10.0,1.0,3.0,2.0,10.0,8.0,7.0,3.0,6.0,1.0,1.0,5.0,3.0,10.0,3.0,5.0,4.0,1.0,2.0,0.0,17.0,4.0,1.0,9.0,7.0,10.0,10.0,1.0,0.0,2.0,2.0,2.0,8.0,8.0,1.0,6.0,13.0,10.0,3.0,1.0,1.0,8.0,5.0,18.0,0.0,1.0,2.0,0.0,10.0,0.0,1.0,4.0,5.0,13.0,10.0,0.0,1.0,0.0,16.0,0.0,9.0,0.0,1.0,5.0,2.0,4.0,2.0,9.0,5.0,16.0,6.0,9.0,0.0,5.0,0.0,9.0,15.0,0.0,3.0,3.0,1.0,3.0,1.0,1.0,0.0,0.0,4.0,18.0,6.0,1.0,0.0,23.0,9.0,0.0,5.0,10.0,13.0,13.0,6.0,2.0,5.0,4.0,13.0,7.0,9.0,7.0,0.0,8.0,10.0,4.0,21.0,13.0,7.0,46.0,5.0,9.0,0.0,2.0,1.0,2.0,0.0,0.0,0.0,0.0,9.0,6.0,4.0,0.0,7.0,8.0,7.0,16.0,8.0,6.0,17.0,4.0,29.0,3.0,7.0,2.0,3.0,4.0,14.0,22.0,0.0,14.0,16.0,0.0,0.0,2.0,3.0,5.0,3.0,0.0,6.0,9.0,0.0,5.0,4.0,6.0,1.0,0.0,0.0,1.0,1.0,1.0,7.0,1.0,0.0,1.0,0.0,1.0,0.0,1.0,0.0,0.0,0.0,1.0,5.0,1.0,1.0,4.0,8.0,2.0,6.0,3.0,10.0,5.0,7.0,8.0,13.0,3.0,1.0,5.0,6.0,2.0,7.0,4.0,34.0,5.0,9.0,1.0,4.0,3.0,8.0,2.0,3.0,1.0,3.0,8.0,7.0,7.0,8.0,8.0,7.0,5.0,6.0,5.0,13.0,3.0,4.0,6.0,15.0,7.0,12.0,2.0,11.0,9.0,8.0,2.0,7.0,8.0,10.0,3.0,0.0,0.0,2.0,0.0,0.0,1.0,1.0,6.0,13.0,9.0,3.0,0.0,3.0,0.0,0.0,6.0,0.0,0.0,1.0,0.0,7.0,0.0,3.0,5.0,9.0,0.0,5.0,3.0,5.0,14.0,11.0,0.0,2.0,11.0,1.0,7.0,4.0,1.0,4.0,7.0,5.0,2.0,7.0,4.0,5.0,3.0,0.0,6.0,6.0,8.0,4.0,6.0,4.0,7.0,4.0,4.0,4.0,6.0,2.0,9.0,3.0,4.0,3.0,7.0,0.0,4.0,4.0,7.0,5.0,3.0,7.0,4.0,4.0,0.0,10.0,9.0,15.0,6.0,7.0,4.0,6.0,1.0,3.0,19.0,5.0,0.0,6.0,9.0,9.0,12.0,5.0,14.0,13.0,2.0,4.0,7.0,14.0,2.0,5.0,4.0,3.0,7.0,7.0,1.0,7.0,3.0,4.0,4.0,4.0,5.0,5.0,6.0,6.0,8.0,7.0,8.0,6.0,7.0,5.0,3.0,11.0,13.0,6.0,16.0,8.0,5.0,8.0,10.0,11.0,6.0,4.0,13.0,6.0,12.0,8.0,10.0,12.0,12.0,4.0,5.0,4.0,8.0,6.0,7.0,14.0,5.0,7.0,10.0,7.0,4.0,5.0,10.0,9.0,6.0,10.0,9.0,11.0,9.0,8.0,6.0,13.0,3.0,2.0,13.0,20.0,1.0,9.0,6.0,14.0,5.0,11.0,15.0,7.0,7.0,8.0,6.0,2.0,17.0,11.0,6.0,10.0,6.0,7.0,8.0,7.0,7.0,10.0,6.0,13.0,8.0,5.0,7.0,10.0,9.0,8.0,5.0,12.0,4.0,8.0,7.0,1.0,12.0,13.0,7.0,7.0,9.0,9.0,8.0,11.0,9.0,12.0,3.0,10.0,2.0,10.0,10.0,1.0,5.0,8.0,14.0,4.0,5.0,9.0,10.0,6.0,3.0,1.0,10.0,7.0,9.0,5.0,9.0,6.0,8.0,9.0,2.0,8.0,5.0,11.0,8.0,6.0,9.0,11.0,12.0,5.0,7.0,15.0,18.0,11.0,5.0,11.0,7.0,16.0,9.0,12.0,4.0,7.0,5.0,18.0,15.0,6.0,3.0,7.0,7.0,6.0,10.0,6.0,9.0,10.0,6.0,11.0,7.0,9.0,5.0,5.0,8.0,9.0,1.0,5.0,9.0,5.0,6.0,5.0,9.0,6.0,3.0,2.0,7.0,6.0,7.0,6.0,13.0,4.0,3.0,7.0,10.0,12.0,10.0,7.0,19.0,9.0,8.0,11.0,8.0,3.0,8.0,5.0,5.0,8.0,8.0,6.0,8.0,6.0,4.0,3.0,7.0,5.0,7.0,15.0,0.0,7.0,0.0,8.0,6.0,3.0,2.0,1.0,2.0,2.0,1.0,1.0,4.0,8.0,4.0,3.0,4.0,0.0,2.0,3.0,9.0,0.0,1.0,1.0,1.0,5.0,4.0,0.0,0.0,10.0,10.0,1.0,2.0,5.0,5.0,3.0,3.0,0.0,5.0,3.0,5.0,0.0,5.0,5.0,5.0,2.0,3.0,5.0,3.0,5.0,2.0,0.0,5.0,2.0,3.0,5.0,4.0,0.0,2.0,0.0,1.0,4.0,3.0,2.0,2.0,5.0,5.0,4.0,5.0,3.0,1.0,5.0,5.0,5.0,5.0,1.0,5.0,2.0,0.0,5.0,5.0,0.0,0.0,5.0,5.0,5.0,1.0,5.0,5.0,2.0,4.0,5.0,2.0,5.0,5.0,5.0,4.0,5.0,5.0,3.0,5.0,4.0,5.0,5.0,5.0,5.0,5.0,5.0,0.0,3.0,5.0,5.0,1.0,5.0,2.0,5.0,5.0,5.0,4.0,0.0,2.0,0.0,1.0,1.0,0.0,3.0,0.0,0.0,0.0,0.0,5.0,2.0,6.0,1.0,1.0,0.0,1.0,6.0,1.0,0.0,6.0,0.0,1.0,6.0,0.0,0.0,0.0,2.0,2.0,1.0,0.0,0.0,2.0,3.0,14.0,0.0,2.0,3.0,0.0,1.0,16.0,7.0,8.0,8.0,20.0,14.0,17.0,11.0,20.0,4.0,6.0,15.0,11.0,6.0,2.0,9.0,8.0,7.0,10.0,3.0,13.0,19.0,8.0,11.0,14.0,0.0,0.0,4.0,0.0,6.0,10.0,6.0,3.0,12.0,2.0,4.0,13.0,12.0,2.0,4.0,4.0,18.0,5.0,8.0,12.0,1.0,4.0,1.0,14.0,,5.0,12.0,23.0,4.0,6.0,1.0,16.0,13.0,11.0,10.0,5.0,6.0,24.0,2.0,10.0,12.0,13.0,7.0,15.0,16.0,13.0,3.0,19.0,1.0,13.0,20.0,6.0,5.0,21.0,28.0,37.0,9.0,14.0,3.0,9.0,3.0,9.0,9.0,8.0,3.0,4.0,6.0,5.0,3.0,4.0,7.0,15.0,9.0,2.0,22.0,9.0,11.0,8.0,8.0,17.0,7.0,4.0,3.0,13.0,19.0,18.0,17.0,15.0,5.0,15.0,7.0,7.0,0.0,8.0,9.0,11.0,17.0,6.0,13.0,0.0,7.0,5.0,14.0,4.0,22.0,14.0,2.0,5.0,19.0,16.0,2.0,6.0,0.0,7.0,7.0,11.0,14.0,7.0,12.0,0.0,1.0,8.0,11.0,8.0,12.0,6.0,5.0,20.0,14.0,21.0,7.0,16.0,11.0,25.0,4.0,22.0,5.0,4.0,15.0,16.0,19.0,9.0,9.0,7.0,10.0,2.0,8.0,4.0,8.0,2.0,11.0,14.0,23.0,13.0,0.0,12.0,1.0,6.0,22.0,13.0,3.0,6.0,7.0,0.0,9.0,18.0,9.0,0.0,6.0,3.0,13.0,3.0,18.0,10.0,20.0,8.0,11.0,16.0,0.0,10.0,0.0,11.0,16.0,7.0,2.0,1.0,2.0,16.0,7.0,12.0,6.0,14.0,7.0,5.0,9.0,3.0,14.0,8.0,4.0,8.0,8.0,10.0,9.0,11.0,14.0,10.0,11.0,8.0,19.0,18.0,13.0,10.0,8.0,0.0,7.0,8.0,8.0,21.0,11.0,16.0,8.0,2.0,7.0,5.0,11.0,0.0,9.0,9.0,10.0,10.0,5.0,18.0,11.0,9.0,4.0,5.0,10.0,10.0,2.0,0.0,4.0,6.0,8.0,3.0,8.0,0.0,5.0,3.0,9.0,19.0,6.0,16.0,9.0,6.0,3.0,10.0,8.0,15.0,12.0,6.0,4.0,2.0,18.0,9.0,18.0,6.0,11.0,24.0,5.0,11.0,0.0,9.0,9.0,8.0,12.0,10.0,11.0,10.0,9.0,18.0,3.0,9.0,14.0,11.0,14.0,1.0,5.0,13.0,12.0,15.0,22.0,20.0,8.0,17.0,13.0,12.0,20.0,2.0,2.0,7.0,20.0,7.0,13.0,8.0,8.0,22.0,26.0,30.0,2.0,6.0,10.0,3.0,2.0,0.0,12.0,8.0,4.0,24.0,10.0,4.0,5.0,7.0,9.0,13.0,15.0,9.0,18.0,1.0,9.0,9.0,1.0,5.0,20.0,9.0,9.0,28.0,22.0,2.0,3.0,35.0,14.0,0.0,17.0,6.0,15.0,10.0,7.0,4.0,17.0,6.0,16.0,9.0,5.0,4.0,4.0,9.0,14.0,4.0,10.0,2.0,12.0,23.0,13.0,9.0,11.0,21.0,8.0,7.0,8.0,12.0,5.0,7.0,16.0,10.0,15.0,18.0,17.0,14.0,3.0,11.0,8.0,16.0,14.0,14.0,3.0,12.0,14.0,2.0,9.0,6.0,10.0,11.0,13.0,9.0,4.0,18.0,6.0,3.0,15.0,15.0,12.0,6.0,13.0,9.0,5.0,5.0,10.0,14.0,20.0,19.0,3.0,1.0,4.0,5.0,22.0,9.0,0.0,13.0,13.0,4.0,13.0,1.0,11.0,6.0,5.0,24.0,8.0,3.0,13.0,9.0,0.0,0.0,14.0,0.0,3.0,17.0,4.0,18.0,5.0,1.0,2.0,0.0,9.0,1.0,12.0,5.0,1.0,9.0,11.0,8.0,0.0,9.0,20.0,12.0,16.0,28.0,7.0,8.0,4.0,1.0,14.0,8.0,1.0,6.0,13.0,3.0,9.0,12.0,9.0,3.0,6.0,1.0,18.0,14.0,2.0,13.0,17.0,1.0,1.0,4.0,13.0,6.0,0.0,7.0,0.0,14.0,5.0,10.0,5.0,8.0,6.0,14.0,0.0,9.0,8.0,6.0,0.0,13.0,4.0,12.0,11.0,6.0,11.0,15.0,8.0,18.0,12.0,5.0,11.0,26.0,14.0,9.0,7.0,17.0,23.0,8.0,13.0,16.0,17.0,6.0,11.0,12.0,11.0,2.0,23.0,6.0,5.0,0.0,1.0,,9.0,5.0,2.0,20.0,9.0,0.0,19.0,13.0,16.0,2.0,5.0,8.0,5.0,2.0,16.0,9.0,4.0,2.0,5.0,10.0,8.0,3.0,4.0,5.0,9.0,7.0,12.0,6.0,10.0,0.0,0.0,10.0,12.0,12.0,5.0,12.0,10.0,2.0,13.0,5.0,0.0,8.0,8.0,22.0,3.0,18.0,18.0,7.0,4.0,13.0,0.0,7.0,13.0,11.0,9.0,8.0,25.0,17.0,9.0,7.0,2.0,0.0,8.0,1.0,17.0,13.0,5.0,13.0,6.0,7.0,2.0,7.0,13.0,11.0,13.0,8.0,11.0,6.0,11.0,18.0,9.0,2.0,5.0,7.0,10.0,16.0,9.0,7.0,9.0,17.0,12.0,15.0,10.0,9.0,6.0,9.0,0.0,16.0,11.0,5.0,8.0,5.0,4.0,13.0,15.0,12.0,6.0,11.0,13.0,7.0,6.0,0.0,5.0,2.0,6.0,8.0,4.0,12.0,15.0,0.0,1.0,12.0,7.0,8.0,6.0,6.0,9.0,12.0,7.0,9.0,12.0,10.0,3.0,12.0,14.0,8.0,3.0,14.0,3.0,9.0,9.0,9.0,21.0,3.0,15.0,12.0,20.0,11.0,18.0,13.0,4.0,18.0,7.0,10.0,14.0,3.0,9.0,18.0,11.0,15.0,13.0,14.0,17.0,6.0,7.0,11.0,9.0,17.0,11.0,16.0,6.0,7.0,6.0,10.0,18.0,19.0,5.0,7.0,12.0,7.0,6.0,3.0,8.0,6.0,13.0,11.0,13.0,5.0,14.0,13.0,7.0,13.0,21.0,11.0,5.0,9.0,10.0,6.0,8.0,2.0,16.0,7.0,10.0,2.0,0.0,1.0,10.0,7.0,7.0,7.0,1.0,5.0,4.0,4.0,1.0,0.0,9.0,16.0,7.0,4.0,11.0,6.0,9.0,15.0,11.0,4.0,0.0,3.0,16.0,10.0,9.0,8.0,9.0,4.0,7.0,7.0,1.0,0.0,6.0,0.0,5.0,7.0,12.0,12.0,6.0,8.0,0.0,9.0,11.0,17.0,5.0,15.0,14.0,6.0,3.0,6.0,16.0,14.0,14.0,1.0,10.0,5.0,4.0,6.0,4.0,2.0,0.0,4.0,8.0,4.0,6.0,1.0,6.0,8.0,0.0,5.0,7.0,12.0,3.0,7.0,5.0,15.0,16.0,7.0,4.0,3.0,13.0,6.0,11.0,4.0,3.0,7.0,0.0,9.0,9.0,7.0,2.0,16.0,4.0,4.0,13.0,9.0,11.0,9.0,3.0,2.0,4.0,3.0,7.0,18.0,12.0,6.0,29.0,9.0,1.0,4.0,0.0,10.0,11.0,3.0,17.0,7.0,10.0,2.0,8.0,10.0,0.0,0.0,11.0,2.0,5.0,5.0,7.0,6.0,2.0,3.0,4.0,1.0,11.0,3.0,9.0,9.0,6.0,4.0,8.0,0.0,0.0,8.0,8.0,4.0,6.0,8.0,18.0,9.0,6.0,0.0,4.0,3.0,8.0,5.0,8.0,4.0,12.0,13.0,18.0,13.0,11.0,2.0,6.0,6.0,17.0,10.0,12.0,3.0,8.0,1.0,8.0,2.0,12.0,12.0,3.0,11.0,9.0,7.0,1.0,5.0,0.0,5.0,0.0,6.0,0.0,2.0,5.0,1.0,10.0,5.0,0.0,10.0,4.0,6.0,5.0,16.0,2.0,10.0,7.0,17.0,12.0,2.0,1.0,10.0,4.0,7.0,8.0,2.0,4.0,8.0,6.0,0.0,7.0,10.0,5.0,1.0,9.0,12.0,10.0,4.0,9.0,13.0,5.0,0.0,15.0,1.0,9.0,11.0,2.0,8.0,2.0,3.0,5.0,6.0,0.0,5.0,13.0,6.0,3.0,12.0,12.0,9.0,4.0,4.0,0.0,8.0,2.0,0.0,3.0,9.0,8.0,1.0,1.0,9.0,12.0,7.0,12.0,12.0,12.0,6.0,0.0,7.0,0.0,12.0,13.0,0.0,10.0,10.0,7.0,7.0,13.0,8.0,0.0,15.0,0.0,1.0,15.0,4.0,15.0,16.0,13.0,1.0,0.0,0.0,0.0,0.0,0.0,2.0,5.0,3.0,3.0,1.0,0.0,3.0,1.0,0.0,1.0,10.0,0.0,4.0,0.0,1.0,6.0,0.0,5.0,0.0,0.0,0.0,0.0,0.0,0.0,5.0,1.0,0.0,0.0,0.0,0.0,0.0,4.0,1.0,1.0,1.0,0.0,0.0,2.0,0.0,0.0,0.0,1.0,2.0,3.0,2.0,4.0,3.0,0.0,1.0,0.0,3.0,2.0,0.0,0.0,0.0,0.0,1.0,0.0,0.0,2.0,2.0,0.0,1.0,0.0,0.0,2.0,0.0,2.0,2.0,0.0,0.0,0.0,0.0,0.0,1.0,0.0,3.0,0.0,1.0,4.0,2.0,0.0,0.0,0.0,0.0,0.0,0.0,3.0,1.0,1.0,1.0,0.0,0.0,3.0,8.0,12.0,1.0,2.0,2.0,0.0,3.0,6.0,9.0,2.0,3.0,10.0,13.0,10.0,9.0,6.0,2.0,5.0,4.0,11.0,9.0,8.0,7.0,7.0,9.0,1.0,0.0,3.0,1.0,4.0,4.0,8.0,4.0,9.0,0.0,9.0,13.0,9.0,6.0,7.0,7.0,2.0,9.0,0.0,1.0,3.0,3.0,2.0,2.0,4.0,3.0,4.0,6.0,5.0,2.0,2.0,8.0,3.0,5.0,3.0,5.0,2.0,1.0,5.0,1.0,2.0,6.0,3.0,3.0,5.0,4.0,1.0,3.0,8.0,6.0,3.0,5.0,7.0,1.0,3.0,10.0,3.0,4.0,5.0,4.0,0.0,3.0,5.0,5.0,4.0,0.0,1.0,8.0,0.0,0.0,4.0,2.0,4.0,5.0,2.0,0.0,3.0,2.0,3.0,6.0,7.0,1.0,2.0,4.0,4.0,0.0,2.0,2.0,4.0,0.0,0.0,2.0,7.0,6.0,7.0,5.0,2.0,2.0,4.0,9.0,3.0,3.0,3.0,2.0,2.0,5.0,6.0,6.0,6.0,4.0,0.0,5.0,3.0,5.0,4.0,4.0,4.0,0.0,3.0,2.0,11.0,3.0,7.0,14.0,5.0,11.0,7.0,6.0,3.0,3.0,3.0,4.0,4.0,2.0,12.0,7.0,3.0,6.0,0.0,1.0,8.0,3.0,3.0,0.0,2.0,7.0,0.0,1.0,1.0,1.0,3.0,2.0,0.0,0.0,2.0,0.0,2.0,7.0,1.0,1.0,6.0,0.0,0.0,0.0,0.0,0.0,4.0,8.0,11.0,6.0,5.0,4.0,5.0,4.0,6.0,8.0,4.0,6.0,5.0,6.0,3.0,4.0,9.0,7.0,4.0,6.0,7.0,6.0,4.0,7.0,8.0,5.0,8.0,5.0,12.0,3.0,13.0,5.0,7.0,6.0,5.0,5.0,5.0,3.0,9.0,3.0,7.0,4.0,5.0,9.0,6.0,2.0,2.0,9.0,6.0,6.0,13.0,4.0,2.0,4.0,6.0,4.0,6.0,8.0,8.0,5.0,5.0,6.0,2.0,7.0,7.0,3.0,6.0,6.0,2.0,3.0,10.0,4.0,2.0,7.0,14.0,6.0,8.0,2.0,11.0,2.0,3.0,6.0,8.0,2.0,6.0,3.0,4.0,7.0,5.0,2.0,4.0,5.0,10.0,7.0,5.0,6.0,6.0,8.0,5.0,3.0,3.0,2.0,4.0,2.0,6.0,6.0,5.0,5.0,6.0,7.0,4.0,3.0,4.0,5.0,4.0,4.0,0.0,0.0,4.0,4.0,5.0,5.0,5.0,5.0,5.0,5.0,4.0,4.0,5.0,5.0,5.0,4.0,4.0,3.0,3.0,5.0,2.0,5.0,5.0,0.0,2.0,4.0,5.0,3.0,4.0,3.0,4.0,5.0,0.0,7.0,1.0,0.0,2.0,0.0,1.0,5.0,6.0,0.0,13.0,0.0,2.0,0.0,14.0,3.0,2.0,1.0,0.0,0.0,0.0,7.0,1.0,0.0,6.0,0.0,2.0,3.0,8.0,3.0,9.0,8.0,0.0,2.0,10.0,4.0,6.0,0.0,0.0,13.0,8.0,0.0,16.0,2.0,8.0,16.0,0.0,1.0,4.0,0.0,0.0,0.0,11.0,0.0,3.0,1.0,3.0,0.0,17.0,0.0,2.0,0.0,12.0,0.0,3.0,7.0,0.0,0.0,0.0,3.0,1.0,1.0,5.0,0.0,0.0,4.0,2.0,0.0,0.0,0.0,4.0,13.0,1.0,12.0,0.0,4.0,1.0,2.0,1.0,2.0,0.0,0.0,0.0,0.0,0.0,4.0,7.0,5.0,4.0,0.0,3.0,9.0,11.0,5.0,8.0,2.0,9.0,6.0,2.0,5.0,7.0,6.0,20.0,8.0,7.0,5.0,8.0,3.0,2.0,3.0,3.0,4.0,3.0,0.0,0.0,4.0,11.0,6.0,0.0,0.0,0.0,4.0,10.0,1.0,0.0,6.0,2.0,5.0,8.0,0.0,9.0,1.0,2.0,4.0,4.0,9.0,3.0,6.0,3.0,6.0,7.0,10.0,10.0,0.0,0.0,8.0,7.0,4.0,5.0,5.0,1.0,11.0,0.0,6.0,17.0,2.0,10.0,6.0,3.0,2.0,1.0,9.0,8.0,12.0,15.0,5.0,4.0,14.0,5.0,10.0,7.0,14.0,4.0,13.0,3.0,14.0,9.0,10.0,7.0,4.0,6.0,9.0,9.0,3.0,8.0,8.0,3.0,1.0,15.0,1.0,3.0,8.0,3.0,5.0,13.0,9.0,10.0,13.0,8.0,3.0,5.0,11.0,14.0,8.0,13.0,0.0,3.0,10.0,5.0,10.0,8.0,12.0,21.0,19.0,2.0,4.0,0.0,18.0,7.0,7.0,8.0,4.0,3.0,8.0,10.0,0.0,38.0,0.0,7.0,0.0,13.0,5.0,7.0,16.0,33.0,15.0,0.0,1.0,8.0,25.0,0.0,12.0,1.0,1.0,0.0,1.0,0.0,0.0,0.0,1.0,24.0,27.0,2.0,0.0,0.0,1.0,6.0,25.0,18.0,12.0,17.0,12.0,4.0,10.0,3.0,13.0,5.0,0.0,2.0,1.0,0.0,5.0,2.0,9.0,10.0,15.0,0.0,1.0,2.0,5.0,2.0,1.0,2.0,13.0,13.0,11.0,0.0,12.0,0.0,5.0,18.0,2.0,0.0,20.0,3.0,5.0,0.0,19.0,0.0,25.0,0.0,3.0,4.0,23.0,24.0,3.0,0.0,17.0,0.0,6.0,10.0,9.0,0.0,8.0,27.0,2.0,18.0,9.0,4.0,9.0,12.0,2.0,0.0,9.0,0.0,0.0,11.0,3.0,0.0,0.0,30.0,14.0,2.0,1.0,14.0,1.0,15.0,1.0,9.0,0.0,12.0,2.0,0.0,19.0,0.0,0.0,5.0,9.0,0.0,14.0,14.0,15.0,20.0,20.0,24.0,0.0,0.0,7.0,16.0,13.0,10.0,2.0,12.0,6.0,14.0,7.0,0.0,18.0,9.0,15.0,0.0,8.0,4.0,0.0,0.0,6.0,1.0,0.0,5.0,14.0,4.0,9.0,0.0,10.0,28.0,9.0,1.0,11.0,11.0,0.0,22.0,10.0,23.0,0.0,8.0,1.0,5.0,13.0,14.0,3.0,2.0,17.0,9.0,0.0,6.0,0.0,9.0,1.0,0.0,1.0,25.0,3.0,6.0,5.0,6.0,9.0,13.0,0.0,27.0,13.0,7.0,12.0,21.0,2.0,3.0,7.0,2.0,1.0,3.0,3.0,6.0,1.0,0.0,29.0,3.0,4.0,2.0,9.0,0.0,4.0,1.0,17.0,5.0,0.0,20.0,17.0,0.0,0.0,2.0,0.0,17.0,20.0,11.0,8.0,13.0,13.0,15.5,6.0,4.0,2.0,0.0,26.0,11.0,2.0,0.0,38.0,1.0,25.0,1.0,6.0,18.0,34.0,0.0,1.0,0.0,11.0,19.0,25.0,0.0,0.0,4.0,6.0,5.0,21.0,19.0,18.0,41.0,12.0,2.0,15.0,13.0,0.0,11.0,5.0,2.0,14.0,1.0,3.0,10.0,19.0,7.0,1.0,0.0,7.0,50.0,44.0,10.0,19.0,3.0,29.0,7.0,22.0,0.0,3.0,22.0,7.0,18.0,37.0,19.0,0.0,11.0,11.0,3.0,2.0,0.0,2.0,0.0,3.0,2.0,40.0,41.0,5.0,2.0,0.0,2.0,9.0,8.0,16.0,12.0,0.0,3.0,0.0,10.0,1.0,7.0,12.0,1.0,18.0,13.0,6.0,1.0,26.0,0.0,36.0,6.0,3.0,11.0,30.0,5.0,11.0,10.0,0.0,1.0,1.0,0.0,11.0,22.0,19.0,23.0,24.0,29.0,0.0,14.0,13.0,18.0,0.0,22.0,1.0,6.0,19.0,3.0,6.0,0.0,4.0,14.0,16.0,3.0,1.0,0.0,10.0,0.0,8.0,0.0,32.0,5.0,6.0,4.0,23.0,12.0,11.0,12.0,10.0,11.0,2.0,2.0,6.0,14.0,8.0,10.0,10.0,0.0,2.0,0.0,0.0,2.0,0.0,2.0,0.0,0.0,2.0,1.0,1.0,0.0,1.0,1.0,1.0,2.0,0.0,2.0,5.0,1.0,0.0,3.0,0.0,0.0,2.0,2.0,0.0,0.0,1.0,0.0,1.0,0.0,0.0,0.0,0.0,0.0,0.0,0.0,2.0,1.0,1.0,0.0,0.0,2.0,2.0,2.0,1.0,1.0,0.0,0.0,0.0,3.0,0.0,0.0,2.0,1.0,0.0,0.0,0.0,0.0,1.0,0.0,0.0,1.0,2.0,1.0,2.0,14.0,8.0,9.0,11.0,2.0,8.0,4.0,9.0,12.0,13.0,11.0,18.0,5.0,13.0,10.0,15.0,13.0,6.0,5.0,3.0,2.0,12.0,9.0,6.0,8.0,5.0,8.0,9.0,7.0,7.0,6.0,9.0,28.0,7.0,11.0,8.0,11.0,11.0,9.0,3.0,13.0,21.0,11.0,10.0,6.0,6.0,5.0,8.0,0.0,0.0,4.0,0.0,2.0,4.0,3.0,2.0,4.0,3.0,4.0,4.0,7.0,9.0,9.0,7.0,8.0,6.0,8.0,4.0,0.0,5.0,5.0,13.0,21.0,1.0,6.0,13.0,16.0,9.0,11.0,5.0,22.0,4.0,5.0,20.0,3.0,10.0,8.0,1.0,2.0,5.0,3.0,12.0,14.0,15.0,7.0,13.0,9.0,1.0,0.0,16.0,16.0,12.0,3.0,6.0,4.0,6.0,1.0,10.0,9.0,2.0,3.0,4.0,3.0,5.0,6.0,9.0,2.0,15.0,10.0,8.0,0.0,6.0,8.0,10.0,13.0,13.0,2.0,4.0,4.0,2.0,9.0,12.0,9.0,6.0,6.0,6.0,0.0,2.0,3.0,11.0,5.0,3.0,6.0,1.0,2.0,4.0,8.0,5.0,11.0,1.0,0.0,4.0,7.0,8.0,13.0,2.0,3.0,7.0,6.0,5.0,6.0,6.0,1.0,4.0,5.0,5.0,7.0,13.0,4.0,3.0,5.0,3.0,14.0,7.0,4.0,16.0,5.0,9.0,4.0,5.0,6.0,4.0,4.0,11.0,9.0,11.0,11.0,9.0,2.0,11.0,2.0,9.0,4.0,10.0,3.0,9.0,6.0,7.0,8.0,11.0,13.0,4.0,8.0,1.0,8.0,11.0,7.0,4.0,15.0,5.0,6.0,12.0,2.0,6.0,0.0,11.0,7.0,7.0,5.0,9.0,11.0,,2.0,8.0,10.0,0.0,0.0,6.0,5.0,3.0,6.0,0.0,5.0,3.0,2.0,11.0,9.0,7.0,6.0,9.0,10.0,4.0,8.0,10.0,10.0,3.0,5.0,7.0,8.0,13.0,13.0,14.0,9.0,5.0,5.0,5.0,6.0,10.0,11.0,6.0,5.0,5.0,4.0,6.0,0.0,6.0,11.0,15.0,7.0,9.0,2.0,10.0,5.0,11.0,8.0,1.0,1.0,2.0,3.0,10.0,7.0,3.0,9.0,2.0,1.0,6.0,11.0,4.0,5.0,2.0,5.0,0.0,1.0,2.0,5.0,22.0,10.0,11.0,3.0,11.0,6.0,15.0,12.0,10.0,7.0,3.0,7.0,9.0,3.0,8.0,3.0,12.0,14.0,9.0,2.0,4.0,2.0,6.0,6.0,13.0,9.0,5.0,8.0,14.0,5.0,2.0,4.0,10.0,2.0,1.0,10.0,13.0,7.0,3.0,5.0,0.0,4.0,6.0,8.0,2.0,2.0,6.0,8.0,13.0,10.0,6.0,10.0,2.0,10.0,1.0,2.0,10.0,5.0,6.0,10.0,7.0,10.0,7.0,13.0,5.0,5.0,12.0,3.0,6.0,11.0,11.0,8.0,4.0,6.0,3.0,3.0,3.0,0.0,6.0,2.0,4.0,6.0,3.0,8.0,7.0,3.0,6.0,14.0,4.0,10.0,8.0,2.0,6.0,6.0,6.0,5.0,12.0,10.0,10.0,7.0,6.0,7.0,5.0,4.0,10.0,9.0,5.0,14.0,9.0,13.0,7.0,0.0,1.0,10.0,4.0,9.0,12.0,2.0,7.0,9.0,9.0,8.0,3.0,0.0,13.0,15.0,11.0,5.0,20.0,10.0,3.0,3.0,7.0,2.0,14.0,9.0,7.0,6.0,18.0,0.0,2.0,13.0,10.0,6.0,1.0,9.0,4.0,9.0,7.0,12.0,8.0,8.0,8.0,5.0,8.0,9.0,11.0,6.0,3.0,8.0,15.0,13.0,7.0,5.0,4.0,10.0,1.0,6.0,10.0,7.0,4.0,4.0,16.0,7.0,9.0,13.0,4.0,3.0,7.0,8.0,1.0,4.0,18.0,5.0,4.0,8.0,2.0,7.0,9.0,6.0,9.0,7.0,10.0,7.0,10.0,5.0,6.0,10.0,9.0,6.0,7.0,6.0,12.0,2.0,5.0,13.0,5.0,9.0,9.0,11.0,13.0,11.0,6.0,8.0,11.0,10.0,10.0,6.0,5.0,6.0,8.0,6.0,7.0,6.0,1.0,7.0,8.0,7.0,17.0,10.0,10.0,0.0,12.0,10.0,7.0,4.0,3.0,3.0,11.0,10.0,5.0,9.0,19.0,7.0,14.0,7.0,7.0,6.0,7.0,3.0,4.0,17.0,12.0,6.0,11.0,8.0,4.0,7.0,8.0,9.0,5.0,5.0,7.0,0.0,13.0,7.0,3.0,8.0,10.0,12.0,1.0,6.0,12.0,6.0,5.0,9.0,10.0,5.0,4.0,6.0,4.0,2.0,6.0,5.0,5.0,12.0,2.0,5.0,1.0,12.0,18.0,8.0,9.0,4.0,7.0,6.0,6.0,1.0,11.0,13.0,11.0,0.0,3.0,3.0,11.0,8.0,7.0,6.0,4.0,8.0,6.0,3.0,11.0,7.0,0.0,1.0,11.0,5.0,1.0,7.0,12.0,13.0,16.0,12.0,2.0,7.0,10.0,5.0,5.0,0.0,0.0,0.0,0.0,0.0,0.0,0.0,0.0,1.0,0.0,3.0,4.0,0.0,4.0,3.0,2.0,3.0,8.0,5.0,8.0,3.0,2.0,7.0,4.0,16.0,9.0,5.0,3.0,3.0,4.0,2.0,5.0,2.0,4.0,5.0,2.0,3.0,4.0,4.0,3.0,4.0,8.0,2.0,2.0,2.0,2.0,2.0,0.0,1.0,2.0,2.0,3.0,2.0,2.0,3.0,2.0,2.0,2.0,2.0,2.0,3.0,3.0,2.0,3.0,5.0,4.0,2.0,4.0,2.0,2.0,2.0,3.0,4.0,3.0,0.0,0.0,4.0,3.0,3.0,4.0,4.0,4.0,5.0,3.0,2.0,1.0,0.0,3.0,0.0,2.0,4.0,4.0,2.0,3.0,3.0,2.0,4.0,2.0,3.0,0.0,4.0,3.0,3.0,2.0,0.0,2.0,3.0,2.0,1.0,2.0,2.0,1.0,2.0,3.0,2.0,2.0,2.0,2.0,2.0,2.0,3.0,2.0,3.0,4.0,2.0,3.0,5.0,2.0,3.0,1.0,3.0,5.0,2.0,0.0,1.0,3.0,4.0,2.0,6.0,4.0,2.0,1.0,9.0,4.0,7.0,5.0,3.0,3.0,4.0,5.0,4.0,5.0,5.0,7.0,11.0,6.0,6.0,5.0,4.0,4.0,7.0,5.0,6.0,4.0,1.0,0.0,10.0,0.0,1.0,6.0,9.0,0.0,0.0,4.0,6.0,0.0,0.0,0.0,8.0,3.0,8.0,4.0,2.0,0.0,5.0,5.0,4.0,3.0,0.0,0.0,0.0,3.0,0.0,3.0,10.0,2.0,8.0,8.0,0.0,0.0,7.0,5.0,5.0,5.0,5.0,5.0,4.0,5.0,5.0,5.0,3.0,8.0,6.0,4.0,9.0,7.0,2.0,4.0,3.0,10.0,4.0,8.0,6.0,7.0,6.0,6.0,7.0,7.0,6.0,4.0,10.0,6.0,6.0,9.0,12.0,6.0,7.0,6.0,6.0,2.0,5.0,2.0,4.0,6.0,8.0,7.0,6.0,10.0,3.0,7.0,10.0,9.0,8.0,4.0,7.0,5.0,8.0,4.0,5.0,5.0,10.0,4.0,6.0,12.0,11.0,7.0,3.0,,,,,,,,,,,,,,,,,,,,,,,,,,,,,,,,,,,,,,,,,,,,,,,,,,,,,,,,,,,,,,,,,,,,,,,,,,,,,,,,,,,,,,,,,,,,,,,,,,,,,,,,,,,,,,,,,,,,,,,,,,,,,,,,,,,,,,,,,,,,,,,,,,,,17.0,18.0,20.0,29.0,2.0,11.0,39.0,20.0,21.0,14.0,2.0,16.0,15.0,0.0,19.0,8.0,12.0,17.0,14.0,38.0,23.0,17.0,0.0,20.0,37.0,30.0,16.0,9.0,6.0,32.0,17.0,20.0,17.0,7.0,7.0,21.0,8.0,18.0,18.0,22.0,2.0,17.0,13.0,25.0,13.0,6.0,6.0,2.0,8.0,25.0,25.0,22.0,17.0,3.0,0.0,0.0,0.0,13.0,26.0,2.0,13.0,2.0,12.0,19.0,18.0,13.0,16.0,9.0,18.0,16.0,23.0,31.0,17.0,10.0,3.0,17.0,17.0,33.0,11.0,23.0,9.0,6.0,5.0,15.0,1.0,15.0,12.0,30.0,27.0,11.0,3.0,7.0,22.0,6.0,0.0,13.0,15.0,16.0,22.0,6.0,9.0,13.0,19.0,15.0,5.0,5.0,4.0,1.0,2.0,1.0,13.0,7.0,9.0,1.0,1.0,6.0,30.0,1.0,0.0,1.0,15.0,11.0,23.0,20.0,0.0,4.0,8.0,4.0,0.0,0.0,22.0,20.0,24.0,30.0,6.0,11.0,9.0,3.0,3.0,8.0,0.0,37.0,3.0,7.0,0.0,7.0,12.0,21.0,6.0,26.0,27.0,15.0,20.0,23.0,6.0,21.0,4.0,9.0,25.0,1.0,15.0,6.0,8.0,16.0,36.0,5.0,6.0,7.0,34.0,2.0,13.0,0.0,0.0,10.0,17.0,23.0,23.0,6.0,19.0,5.0,0.0,20.0,2.0,18.0,5.0,7.0,18.0,5.0,0.0,0.0,3.0,4.0,43.0,17.0,23.0,19.0,2.0,13.0,25.0,0.0,16.0,8.0,12.0,9.0,4.0,21.0,9.0,5.0,12.0,10.0,25.0,7.0,22.0,8.0,10.0,20.0,8.0,20.0,19.0,8.0,23.0,3.0,17.0,22.0,21.0,10.0,14.0,17.0,17.0,32.0,22.0,37.0,23.0,19.0,25.0,22.0,33.0,12.0,1.0,9.0,22.0,8.0,11.0,2.0,5.0,5.0,7.0,13.0,5.0,29.0,20.0,19.0,21.0,15.0,17.0,8.0,16.0,6.0,15.0,18.0,21.0,19.0,20.0,5.0,43.0,2.0,3.0,1.0,19.0,12.0,0.0,23.0,26.0,20.0,8.0,8.0,11.0,8.0,12.0,17.0,4.0,11.0,50.0,11.0,1.0,5.0,6.0,30.0,13.0,21.0,18.0,1.0,12.0,23.0,2.0,4.0,4.0,5.0,21.0,21.0,18.0,9.0,9.0,7.0,8.0,26.0,23.0,9.0,63.0,17.0,8.0,33.0,22.0,25.0,23.0,23.0,18.0,2.0,25.0,16.0,24.0,24.0,28.0,30.0,20.0,29.0,19.0,27.0,16.0,4.0,25.0,11.0,33.0,6.0,16.0,13.0,18.0,7.0,10.0,17.0,13.0,40.0,34.0,10.0,9.0,2.0,9.0,1.0,11.0,26.0,5.0,0.0,14.0,51.0,5.0,10.0,10.0,13.0,1.0,0.0,18.0,16.0,22.0,16.0,13.0,15.0,18.0,24.0,3.0,41.0,8.0,35.0,,0.0,2.0,28.0,29.0,37.0,5.0,7.0,1.0,3.0,0.0,0.0,1.0,6.0,1.0,15.0,10.0,9.0,14.0,5.0,0.0,0.0,1.0,18.0,5.0,17.0,2.0,1.0,7.0,20.0,2.0,6.0,14.0,16.0,26.0,0.0,31.0,6.0,1.0,5.0,18.0,9.0,1.0,7.0,11.0,4.0,35.0,0.0,25.0,2.0,1.0,23.0,23.0,2.0,22.0,16.0,34.0,31.0,32.0,16.0,0.0,29.0,16.0,3.0,8.0,8.0,3.0,11.0,11.0,11.0,5.0,11.0,8.0,0.0,17.0,0.0,7.0,8.0,1.0,2.0,9.0,0.0,5.0,8.0,4.0,7.0,22.0,30.0,4.0,8.0,10.0,7.0,2.0,16.0,9.0,5.0,15.0,0.0,1.0,2.0,1.0,12.0,4.0,12.0,16.0,13.0,9.0,10.0,19.0,8.0,3.0,22.0,7.0,6.0,15.0,37.0,28.0,44.0,21.0,21.0,18.0,7.0,1.0,2.0,0.0,21.0,1.0,0.0,4.0,14.0,6.0,8.0,19.0,39.0,17.0,23.0,22.0,5.0,20.0,4.0,11.0,4.0,12.0,8.0,7.0,22.0,13.0,6.0,10.0,6.0,25.0,15.0,25.0,32.0,15.0,7.0,19.0,3.0,4.0,20.0,9.0,15.0,12.0,0.0,27.0,24.0,17.0,16.0,8.0,1.0,9.0,6.0,8.0,13.0,1.0,7.0,3.0,25.0,0.0,3.0,15.0,26.0,1.0,22.0,17.0,12.0,25.0,3.0,16.0,15.0,2.0,7.0,17.0,25.0,17.0,13.0,13.0,7.0,4.0,19.0,5.0,19.0,14.0,2.0,2.0,7.0,2.0,13.0,0.0,8.0,5.0,2.0,1.0,23.0,9.0,30.0,10.0,21.0,8.0,17.0,11.0,23.0,17.0,21.0,34.0,2.0,0.0,9.0,3.0,16.0,15.0,20.0,6.0,20.0,0.0,19.0,9.0,6.0,11.0,3.0,11.0,12.0,3.0,2.0,0.0,5.0,4.0,12.0,21.0,9.0,4.0,3.0,18.0,11.0,1.0,9.0,12.0,22.0,19.0,13.0,0.0,23.0,16.0,7.0,20.0,2.0,2.0,0.0,7.0,4.0,15.0,6.0,10.0,4.0,19.0,12.0,25.0,11.0,29.0,14.0,10.0,18.0,4.0,0.0,30.0,1.0,10.0,0.0,2.0,0.0,3.0,0.0,25.0,13.0,13.0,5.0,21.0,22.0,8.0,8.0,22.0,23.0,2.0,15.0,4.0,2.0,3.0,0.0,30.0,16.0,3.0,27.0,0.0,0.0,13.0,5.0,7.0,35.0,16.0,7.0,5.0,16.0,21.0,22.0,17.0,32.0,23.0,9.0,10.0,0.0,0.0,5.0,20.0,9.0,15.0,27.0,2.0,23.0,7.0,9.0,23.0,19.0,3.0,18.0,27.0,21.0,24.0,13.0,15.0,0.0,14.0,0.0,20.0,1.0,19.0,50.0,6.0,9.0,13.0,4.0,1.0,1.0,6.0,7.0,16.0,1.0,16.0,13.0,20.0,6.0,11.0,44.0,0.0,30.0,16.0,20.0,15.0,0.0,2.0,5.0,0.0,3.0,2.0,1.0,39.0,6.0,16.0,5.0,2.0,2.0,15.0,0.0,0.0,0.0,0.0,24.0,16.0,0.0,22.0,16.0,14.0,0.0,8.0,32.0,4.0,13.0,0.0,18.0,60.0,19.0,22.0,17.0,5.0,4.0,18.0,8.0,24.0,8.0,2.0,22.0,7.0,12.0,0.0,2.0,4.0,0.0,8.0,19.0,4.0,19.0,16.0,0.0,11.0,0.0,0.0,23.0,4.0,14.0,2.0,1.0,4.0,9.0,29.0,8.0,16.0,8.0,18.0,11.0,13.0,19.0,6.0,20.0,9.0,10.0,19.0,3.0,33.0,5.0,3.0,29.0,18.0,5.0,1.0,5.0,15.0,1.0,8.0,3.0,5.0,7.0,1.0,6.0,2.0,9.0,12.0,5.0,0.0,16.0,7.0,8.0,7.0,2.0,2.0,5.0,39.0,14.0,1.0,0.0,0.0,1.0,0.0,8.0,11.0,3.0,5.0,9.0,13.0,0.0,5.0,1.0,27.0,4.0,2.0,2.0,10.0,16.0,12.0,6.0,3.0,13.0,14.0,7.0,12.0,3.0,3.0,13.0,13.0,3.0,4.0,2.0,0.0,1.0,16.0,7.5,13.0,13.0,8.0,7.0,7.0,1.0,11.0,1.0,15.0,13.0,9.0,16.0,6.0,9.0,0.0,20.0,3.0,3.0,1.0,1.0,36.0,2.0,0.0,1.0,16.0,1.0,6.0,5.0,17.0,0.0,42.0,1.0,6.0,8.0,1.0,5.0,13.0,1.0,1.0,13.0,2.0,10.0,19.0,14.0,3.0,49.0,11.0,1.0,3.0,4.0,3.0,28.0,0.0,4.0,3.0,13.0,3.0,10.0,16.0,4.0,3.0,1.0,9.0,19.0,5.0,22.0,6.0,6.0,36.0,7.0,20.0,1.0,7.0,11.0,15.0,9.0,14.0,7.0,4.0,11.0,2.0,2.0,16.0,17.0,3.0,2.0,4.0,11.0,5.0,3.0,12.0,5.0,0.0,9.0,12.0,1.0,14.0,3.0,9.0,1.0,1.0,27.0,12.0,5.0,2.0,6.0,3.0,12.0,2.0,2.0,1.0,1.0,5.0,0.0,8.0,8.0,11.0,4.0,10.0,0.0,28.0,39.0,14.0,4.0,13.0,9.0,7.0,4.0,5.0,17.0,24.0,1.0,1.0,12.0,3.0,8.0,5.0,28.0,3.0,8.0,35.0,20.0,10.0,11.0,1.0,10.0,33.0,15.0,8.0,1.0,9.0,11.0,52.0,0.0,2.0,6.0,1.0,7.0,17.0,13.0,5.0,8.0,35.0,7.0,4.0,49.0,1.0,5.0,1.0,11.0,8.0,4.0,1.0,6.0,2.0,10.0,13.0,2.0,30.0,13.0,2.0,15.0,6.0,9.0,25.0,13.0,0.0,1.0,3.0,18.0,10.0,10.0,0.0,19.0,21.0,6.0,6.0,10.0,28.0,16.0,6.0,10.0,14.0,7.0,14.0,6.0,15.0,19.0,0.0,17.0,1.0,3.0,26.0,0.0,0.0,9.0,2.0,4.0,2.0,10.0,0.0,17.0,11.0,1.0,18.0,9.0,17.0,1.0,2.0,2.0,12.0,17.0,1.0,1.0,10.0,6.0,1.0,38.0,6.0,38.0,0.0,0.0,0.0,10.0,5.0,0.0,4.0,5.0,13.0,9.0,11.0,0.0,1.0,2.0,1.0,12.0,17.0,17.0,38.0,3.0,18.0,0.0,19.0,5.0,9.0,1.0,16.0,23.0,7.0,3.0,0.0,12.0,0.0,11.0,2.0,69.0,3.0,14.0,0.0,10.0,2.0,9.0,19.0,6.0,0.0,16.0,4.0,1.0,9.0,2.0,7.0,1.0,5.0,1.0,11.0,50.0,14.0,19.0,0.0,8.0,0.0,5.0,2.0,9.0,2.0,8.0,6.0,10.0,15.0,6.0,7.0,18.0,2.0,10.0,16.0,15.0,3.0,8.0,0.0,2.0,15.0,25.0,1.0,3.0,1.0,4.0,20.0,17.0,12.0,10.0,0.0,0.0,0.0,3.0,0.0,22.0,8.0,0.0,2.0,7.0,9.0,4.0,1.0,5.0,20.0,42.0,1.0,4.0,3.0,0.0,71.0,17.0,0.0,8.0,21.0,17.0,6.0,3.0,47.0,1.0,24.0,6.0,13.0,9.0,24.0,14.0,0.0,1.0,1.0,2.0,3.0,2.0,3.0,11.0,17.0,1.0,2.0,12.0,2.0,3.0,5.0,7.0,12.0,6.0,14.0,2.0,3.0,4.0,1.0,3.0,4.0,5.0,7.0,15.0,10.0,17.0,20.0,4.0,10.0,3.0,9.0,14.0,13.0,13.0,15.0,9.0,8.0,11.0,16.0,1.0,3.0,5.0,12.0,11.0,0.0,9.0,5.0,10.0,4.0,14.0,18.0,6.0,18.0,16.0,16.0,30.0,12.0,9.0,26.0,0.0,13.0,17.0,19.0,23.0,17.0,25.0,18.0,19.0,7.0,31.0,8.0,16.0,8.0,22.0,20.0,23.0,17.0,12.0,15.0,12.0,5.0,2.0,4.0,0.0,15.0,0.0,0.0,11.0,11.0,0.0,11.0,20.0,0.0,2.0,0.0,3.0,6.0,0.0,5.0,18.0,16.0,10.0,22.0,1.0,13.0,0.0,13.0,1.0,2.0,0.0,1.0,17.0,1.0,4.0,0.0,8.0,10.0,19.0,6.0,1.0,7.0,3.0,5.0,8.0,14.0,12.0,6.0,7.0,6.0,13.0,16.0,20.0,1.0,18.0,0.0,1.0,8.0,2.0,11.0,13.0,15.0,5.0,3.0,19.0,8.0,0.0,9.0,6.0,17.0,25.0,0.0,15.0,23.0,13.0,13.0,13.0,15.0,15.0,9.0,12.0,16.0,26.0,16.0,18.0,3.0,19.0,11.0,7.0,16.0,6.0,4.0,,,,,,,,,,,,,,,,,,,,,,,,,,,,,,,,,,,,,,,,,,,,,,,,,,,,,,,,,,,,,,,,,,,,,,,,,,,,,,,,,,,,,,,,,,,,,,,,,,,,,,,,,,,,,,,,,,,,,,,,,0.0,0.0,0.0,0.0,13.0,9.0,14.0,7.0,11.0,9.0,0.0,10.0,9.0,16.0,3.0,5.0,6.0,8.0,14.0,5.0,2.0,4.0,3.0,13.0,0.0,6.0,8.0,10.0,6.0,3.0,2.0,7.0,11.0,12.0,7.0,1.0,16.0,8.0,15.0,3.0,10.0,11.0,15.0,13.0,4.0,11.0,2.0,9.0,8.0,11.0,8.0,11.0,5.0,9.0,0.0,0.0,0.0,0.0,0.0,0.0,0.0,7.0,8.0,9.0,5.0,6.0,9.0,13.0,7.0,4.0,5.0,6.0,4.0,5.0,5.0,12.0,7.0,6.0,7.0,12.0,5.0,5.0,4.0,4.0,4.0,10.0,9.0,12.0,9.0,3.0,4.0,8.0,6.0,8.0,6.0,3.0,9.0,5.0,4.0,6.0,7.0,7.0,3.0,6.0,8.0,5.0,4.0,6.0,8.0,7.0,9.0,8.0,8.0,5.0,6.0,6.0,5.0,4.0,4.0,5.0,11.0,10.0,5.0,7.0,4.0,4.0,6.0,6.0,6.0,8.0,4.0,6.0,8.0,11.0,8.0,4.0,9.0,2.0,10.0,14.0,3.0,11.0,7.0,6.0,13.0,4.0,7.0,5.0,4.0,8.0,6.0,12.0,9.0,5.0,5.0,3.0,7.0,8.0,5.0,10.0,7.0,4.0,0.0,0.0,1.0,1.0,2.0,2.0,2.0,0.0,1.0,0.0,0.0,0.0,3.0,0.0,0.0,2.0,0.0,0.0,4.0,6.0,9.0,8.0,8.0,13.0,4.0,7.0,6.0,4.0,0.0,13.0,9.0,0.0,14.0,5.0,1.0,16.0,0.0,15.0,7.0,6.0,14.0,1.0,9.0,10.0,2.0,1.0,16.0,5.0,5.0,0.0,6.0,8.0,5.0,5.0,3.0,10.0,8.0,7.0,10.0,4.0,0.0,15.0,13.0,8.0,7.0,10.0,12.0,7.0,5.0,6.0,9.0,18.0,11.0,11.0,7.0,3.0,6.0,6.0,5.0,1.0,12.0,7.0,8.0,8.0,9.0,1.0,3.0,10.0,8.0,4.0,19.0,3.0,9.0,9.0,9.0,0.0,9.0,14.0,6.0,,,,,,,13.0,2.0,3.0,10.0,8.0,8.0,4.0,12.0,3.0,11.0,0.0,0.0,0.0,0.0,0.0,0.0,0.0,0.0,0.0,7.0,4.0,10.0,4.0,7.0,18.0,16.0,9.0,9.0,16.0,0.0,13.0,2.0,11.0,11.0,11.0,8.0,10.0,14.0,4.0,5.0,10.0,14.0,6.0,9.0,6.0,11.0,5.0,6.0,4.0,0.0,5.0,9.0,7.0,2.0,7.0,12.0,0.0,0.0,0.0,0.0,0.0,0.0,0.0,0.0,0.0,0.0,0.0,0.0,0.0,0.0,0.0,0.0,0.0,0.0,0.0,0.0,0.0,20.0,16.0,,,,,,,,,,,,,,,,,,,,,,,,,,,,12.0,10.0,4.0,5.0,10.0,8.0,10.0,10.0,7.0,9.0,10.0,12.0,8.0,8.0,6.0,9.0,7.0,5.0,9.0,4.0,7.0,8.0,7.0,4.0,3.0,6.0,6.0,9.0,10.0,2.0,6.0,5.0,8.0,6.0,4.0,4.0,9.0,10.0,7.0,4.0,7.0,5.0,5.0,6.0,3.0,5.0,7.0,8.0,3.0,9.0,6.0,8.0,8.0,4.0,9.0,0.0,6.0,0.0,8.0,5.0,5.0,6.0,6.0,5.0,6.0,10.0,6.0,6.0,10.0,4.0,5.0,4.0,7.0,10.0,5.0,4.0,8.0,5.0,13.0,9.0,6.0,6.0,3.0,3.0,6.0,13.0,11.0,1.0,9.0,7.0,9.0,0.0,12.0,12.0,4.0,6.0,8.0,4.0,6.0,5.0,19.0,2.0,4.0,2.0,8.0,11.0,10.0,9.0,15.0,7.0,2.0,5.0,9.0,11.0,7.0,5.0,9.0,7.0,4.0,9.0,6.0,7.0,2.0,4.0,11.0,2.0,10.0,6.0,9.0,1.0,8.0,11.0,11.0,11.0,4.0,5.0,5.0,5.0,6.0,6.0,9.0,10.0,2.0,6.0,2.0,3.0,3.0,6.0,7.0,9.0,18.0,1.0,,,,,,,,,,,,,,,,,,,,,,,7.0,8.0,2.0,0.0,1.0,1.0,1.0,0.0,8.0,11.0,6.0,6.0,22.0,0.0,6.0,6.0,6.0,1.0,4.0,4.0,10.0,10.0,7.0,10.0,8.0,4.0,9.0,14.0,2.0,9.0,4.0,17.0,13.0,4.0,3.0,3.0,11.0,6.0,6.0,0.0,6.0,6.0,3.0,12.0,3.0,0.0,14.0,14.0,3.0,21.0,11.0,3.0,11.0,17.0,13.0,23.0,28.0,7.0,12.0,18.0,4.0,4.0,9.0,10.0,5.0,9.0,14.0,15.0,10.0,1.0,4.0,9.0,9.0,9.0,9.0,10.0,8.0,4.0,8.0,10.0,7.0,13.0,19.0,0.0,3.0,22.0,19.0,1.0,14.0,1.0,2.0,3.0,2.0,1.0,3.0,11.0,2.0,12.0,6.0,2.0,3.0,0.0,1.0,2.0,5.0,10.0,3.0,4.0,6.0,4.0,6.0,9.0,9.0,20.0,15.0,10.0,9.0,12.0,7.0,0.0,8.0,23.0,23.0,6.0,18.0,3.0,10.0,5.0,17.0,3.0,8.0,17.0,6.0,8.0,8.0,8.0,13.0,6.0,10.0,13.0,13.0,12.0,7.0,24.0,0.0,21.0,0.0,2.0,0.0,15.0,10.0,6.0,9.0,5.0,8.0,1.0,4.0,8.0,10.0,8.0,2.0,4.0,4.0,0.0,12.0,2.0,5.0,7.0,5.0,12.0,7.0,3.0,5.0,9.0,12.0,13.0,17.0,7.0,7.0,14.0,6.0,2.0,16.0,21.0,4.0,15.0,0.0,12.0,1.0,1.0,15.0,0.0,0.0,4.0,6.0,0.0,5.0,3.0,5.0,2.0,0.0,9.0,13.0,4.0,0.0,3.0,2.0,7.0,3.0,3.0,4.0,4.0,9.0,6.0,0.0,11.0,6.0,14.0,11.0,6.0,3.0,4.0,15.0,8.0,5.0,9.0,4.0,17.0,8.0,1.0,1.0,23.0,2.0,2.0,4.0,2.0,15.0,6.0,9.0,4.0,1.0,0.0,13.0,12.0,7.0,1.0,3.0,8.0,3.0,3.0,4.0,7.0,5.0,4.0,5.0,9.0,1.0,1.0,0.0,18.0,2.0,1.0,1.0,4.0,10.0,5.0,12.0,5.0,2.0,16.0,5.0,1.0,14.0,12.0,7.0,4.0,8.0,1.0,0.0,4.0,8.0,6.0,4.0,1.0,3.0,8.0,5.0,6.0,4.0,12.0,11.0,7.0,4.0,4.0,8.0,4.0,7.0,9.0,4.0,7.0,17.0,3.0,4.0,2.0,8.0,2.0,2.0,3.0,1.0,0.0,12.0,6.0,12.0,4.0,1.0,14.0,16.0,23.0,1.0,6.0,19.0,12.0,13.0,14.0,14.0,4.0,2.0,3.0,12.0,5.0,1.0,10.0,1.0,1.0,16.0,2.0,6.0,13.0,7.0,14.0,9.0,6.0,5.0,14.0,18.0,10.0,3.0,14.0,14.0,10.0,11.0,13.0,9.0,5.0,20.0,8.0,6.0,12.0,16.0,7.0,0.0,5.0,5.0,11.0,3.0,5.0,7.0,22.0,6.0,5.0,16.0,3.0,0.0,4.0,13.0,22.0,4.0,15.0,22.0,1.0,5.0,2.0,0.0,11.0,3.0,9.0,0.0,7.0,5.0,11.0,6.0,1.0,8.0,1.0,18.0,11.0,10.0,14.0,8.0,12.0,11.0,1.0,3.0,3.0,1.0,11.0,2.0,12.0,3.0,0.0,4.0,4.0,7.0,3.0,1.0,0.0,1.0,11.0,8.0,9.0,2.0,2.0,0.0,1.0,4.0,5.0,8.0,21.0,3.0,10.0,2.0,6.0,5.0,8.0,7.0,2.0,4.0,6.0,7.0,3.0,3.0,8.0,5.0,17.0,3.0,0.0,1.0,4.0,7.0,0.0,16.0,13.0,8.0,1.0,7.0,1.0,7.0,1.0,6.0,1.0,3.0,4.0,4.0,0.0,9.0,4.0,12.0,12.0,11.0,4.0,8.0,0.0,1.0,4.0,19.0,17.0,15.0,7.0,22.0,15.0,6.0,4.0,20.0,5.0,13.0,18.0,6.0,2.0,3.0,6.0,16.0,10.0,2.0,6.0,13.0,6.0,2.0,13.0,10.0,2.0,10.0,16.0,16.0,16.0,12.0,11.0,6.0,18.0,11.0,8.0,2.0,5.0,5.0,0.0,3.0,3.0,0.0,9.0,2.0,1.0,2.0,9.0,4.0,5.0,1.0,15.0,2.0,9.0,5.0,3.0,5.0,1.0,9.0,6.0,28.0,0.0,4.0,12.0,10.0,6.0,2.0,1.0,10.0,8.0,2.0,2.0,31.0,3.0,4.0,14.0,3.0,8.0,8.0,18.0,3.0,10.0,11.0,0.0,1.0,8.0,1.0,6.0,6.0,9.0,4.0,12.0,0.0,1.0,8.0,0.0,6.0,3.0,0.0,4.0,12.0,12.0,6.0,3.0,9.0,12.0,10.0,1.0,6.0,18.0,15.0,12.0,9.0,21.0,9.0,1.0,18.0,18.0,6.0,6.0,6.0,15.0,8.0,3.0,11.0,7.0,16.0,13.0,16.0,5.0,5.0,6.0,7.0,1.0,0.0,3.0,0.0,4.0,3.0,0.0,0.0,0.0,0.0,0.0,2.0,1.0,0.0,4.25,9.0,1.0,7.0,0.0,0.0,2.0,2.0,1.0,1.0,3.0,1.0,1.0,1.0,2.0,4.0,6.0,2.0,0.0,2.0,0.0,0.0,2.0,0.0,0.0,3.0,0.0,1.0,4.0,1.0,0.0,3.0,4.0,5.0,50.0,50.0,30.0,30.0,40.0,8.0,7.0,11.0,5.0,11.0,9.0,6.0,14.0,22.0,31.0,10.0,7.0,17.0,12.0,11.0,9.0,18.0,10.0,9.0,8.0,14.0,27.0,12.0,3.0,5.0,10.0,15.0,12.0,15.0,3.0,8.0,4.0,2.0,23.0,16.0,3.0,15.0,15.0,11.0,14.0,6.0,8.0,18.0,17.0,12.0,5.0,11.0,15.0,17.0,9.0,7.0,9.0,16.0,24.0,18.0,16.0,14.0,15.0,10.0,15.0,0.0,5.0,22.0,19.0,23.0,14.0,17.0,13.0,19.0,13.0,4.0,6.0,11.0,15.0,17.0,14.0,8.0,10.0,6.0,21.0,31.0,10.0,12.0,1.0,24.0,15.0,14.0,1.0,22.0,6.0,11.0,2.0,16.0,11.0,11.0,12.0,8.0,13.0,6.0,14.0,3.0,7.0,4.0,5.0,5.0,1.0,13.0,5.0,6.0,4.0,6.0,9.0,7.0,11.0,4.0,14.0,6.0,15.0,19.0,17.0,24.0,3.0,5.0,6.0,5.0,3.0,8.0,8.0,17.0,6.0,4.0,0.0,3.0,3.0,7.0,4.0,4.0,5.0,15.0,5.0,6.0,7.0,7.0,6.0,5.0,6.0,4.0,6.0,4.0,20.0,4.0,7.0,8.0,4.0,4.0,0.0,3.0,5.0,21.0,8.0,3.0,2.0,7.0,25.0,19.0,16.0,7.0,13.0,17.0,26.0,4.0,21.0,28.0,31.0,25.0,31.0,32.0,24.0,22.0,31.0,15.0,22.0,31.0,31.0,28.0,14.0,17.0,13.0,5.0,8.0,33.0,17.0,8.0,3.0,4.0,6.0,3.0,15.0,12.0,8.0,30.0,4.0,9.0,15.0,11.0,14.0,27.0,23.0,11.0,10.0,32.0,12.0,2.0,2.0,4.0,4.0,12.0,4.0,5.0,7.0,7.0,3.0,8.0,6.0,13.0,9.0,6.0,4.0,5.0,16.0,13.0,9.0,15.0,12.0,9.0,3.0,15.0,4.0,5.0,7.0,5.0,17.0,8.0,7.0,4.0,10.0,4.0,3.0,5.0,11.0,4.0,14.0,19.0,18.0,18.0,25.0,14.0,7.0,7.0,6.0,4.0,3.0,5.0,18.0,11.0,10.0,3.0,7.0,5.0,6.0,3.0,11.0,3.0,12.0,8.0,4.0,2.0,10.0,10.0,15.0,3.0,4.0,4.0,4.0,11.0,5.0,4.0,5.0,4.0,5.0,13.0,9.0,4.0,13.0,7.0,13.0,12.0,12.0,7.0,4.0,9.0,26.0,13.0,4.0,7.0,5.0,10.0,6.0,5.0,4.0,6.0,13.0,15.0,7.0,13.0,11.0,5.0,8.0,14.0,5.0,2.0,14.0,22.0,11.0,4.0,7.0,10.0,14.0,19.0,6.0,3.0,14.0,14.0,17.0,14.0,4.0,4.0,4.0,6.0,5.0,9.0,4.0,2.0,5.0,10.0,15.0,9.0,5.0,15.0,13.0,28.0,12.0,13.0,12.0,12.0,10.0,9.0,4.0,13.0,8.0,3.0,10.0,9.0,0.0,9.0,7.0,24.0,16.0,20.0,12.0,18.0,5.0,5.0,1.0,3.0,3.0,4.0,9.0,4.0,1.0,1.0,0.0,11.0,9.0,9.0,12.0,5.0,5.0,6.0,8.0,7.0,5.0,16.0,7.0,9.0,15.0,6.0,4.0,5.0,7.0,17.0,12.0,2.0,11.0,16.0,4.0,11.0,18.0,3.0,18.0,21.0,9.0,6.0,13.0,10.0,11.0,4.0,8.0,7.0,7.0,12.0,21.0,14.0,14.0,8.0,10.0,7.0,9.0,16.0,1.0,5.0,19.0,19.0,11.0,6.0,16.0,8.0,7.0,7.0,9.0,7.0,6.0,6.0,13.0,9.0,11.0,8.0,6.0,10.0,3.0,17.0,16.0,12.0,11.0,6.0,15.0,10.0,6.0,7.0,4.0,4.0,6.0,14.0,16.0,9.0,12.0,5.0,17.0,16.0,18.0,20.0,6.0,3.0,3.0,3.0,4.0,5.0,9.0,3.0,10.0,1.0,0.0,5.0,11.0,2.0,1.0,1.0,1.0,0.0,3.0,3.0,2.0,2.0,1.0,0.0,7.0,0.0,0.0,0.0,2.0,7.0,1.0,2.0,0.0,0.0,4.0,0.0,3.0,0.0,0.0,0.0,0.0,0.0,3.0,3.0,2.0,8.0,1.0,1.0,11.0,4.0,0.0,0.0,2.0,1.0,3.0,5.0,1.0,15.0,0.0,1.0,1.0,0.0,0.0,4.0,0.0,0.0,0.0,15.0,0.0,0.0,4.0,1.0,0.0,1.0,7.0,1.0,0.0,0.0,1.0,1.0,0.0,0.0,0.0,0.0,0.0,1.0,7.0,0.0,7.0,0.0,1.0,0.0,0.0,1.0,1.0,1.0,3.0,0.0,0.0,0.0,0.0,12.0,2.0,0.0,0.0,12.0,0.0,0.0,3.0,1.0,2.0,4.0,0.0,0.0,0.0,19.0,0.0,1.0,10.0,0.0,0.0,3.0,0.0,0.0,0.0,0.0,0.0,2.0,0.0,0.0,0.0,2.0,2.0,2.0,0.0,1.0,0.0,0.0,0.0,9.0,3.0,0.0,0.0,4.0,11.0,0.0,3.0,1.0,2.0,1.0,1.0,0.0,1.0,2.0,0.0,1.0,0.0,8.0,7.0,12.0,3.0,0.0,6.0,0.0,1.0,0.0,4.0,5.0,0.0,2.0,0.0,11.0,0.0,2.0,0.0,0.0,0.0,1.0,4.0,0.0,0.0,0.0,3.0,1.0,0.0,0.0,1.0,1.0,1.0,1.0,1.0,0.0,0.0,1.0,0.0,0.0,0.0,1.0,0.0,0.0,1.0,0.0,0.0,0.0,0.0,0.0,8.0,1.0,1.0,0.0,6.0,0.0,2.0,3.0,8.0,4.0,2.0,0.0,5.0,2.0,8.0,3.0,11.0,1.0,0.0,8.0,5.0,3.0,7.0,0.0,0.0,0.0,10.0,12.0,1.0,0.0,0.0,0.0,1.0,0.0,0.0,0.0,2.0,1.0,13.0,1.0,0.0,0.0,0.0,3.0,2.0,0.0,1.0,2.0,1.0,0.0,1.0,3.0,1.0,1.0,0.0,1.0,5.0,1.0,1.0,0.0,1.0,3.0,7.0,0.0,1.0,0.0,5.0,3.0,0.0,3.0,9.0,1.0,6.0,2.0,1.0,0.0,1.0,1.0,2.0,1.0,3.0,4.0,7.0,12.0,0.0,6.0,0.0,5.0,2.0,0.0,3.0,2.0,5.0,0.0,0.0,0.0,0.0,0.0,1.0,0.0,0.0,0.0,16.0,10.0,10.0,3.0,0.0,2.0,0.0,9.0,0.0,16.0,1.0,3.0,7.0,1.0,0.0,1.0,2.0,8.0,5.0,0.0,9.0,2.0,3.0,15.0,2.0,0.0,1.0,7.0,9.0,1.0,1.0,0.0,3.0,0.0,11.0,3.0,7.0,1.0,0.0,0.0,0.0,4.0,0.0,0.0,8.0,0.0,3.0,4.0,10.0,12.0,3.0,16.0,2.0,1.0,0.0,8.0,0.0,7.0,3.0,1.0,1.0,0.0,19.0,1.0,0.0,0.0,5.0,9.0,5.0,3.0,0.0,0.0,1.0,0.0,4.0,1.0,5.0,0.0,0.0,6.0,0.0,0.0,1.0,3.0,1.0,19.0,7.0,3.0,2.0,0.0,4.0,4.0,3.0,0.0,2.0,0.0,0.0,2.0,0.0,9.0,5.0,7.0,3.0,3.0,7.0,10.0,9.0,7.0,11.0,10.0,11.0,10.0,6.0,10.0,0.0,0.0,0.0,0.0,0.0,0.0,0.0,0.0,0.0,0.0,0.0,3.0,0.0,13.0,2.0,14.0,3.0,7.0,1.0,1.0,12.0,13.0,2.0,8.0,7.0,1.0,8.0,3.0,4.0,15.0,0.0,6.0,7.0,1.0,6.0,5.0,0.0,12.0,1.0,10.0,3.0,2.0,3.0,3.0,3.0,5.0,0.0,19.0,1.0,0.0,8.0,13.0,6.0,2.0,6.0,17.0,1.0,2.0,17.0,3.0,14.0,5.0,2.0,3.0,12.0,0.0,7.0,16.0,3.0,17.0,1.0,0.0,3.0,0.0,19.0,2.0,1.0,1.0,16.0,1.0,6.0,7.0,17.0,11.0,2.0,0.0,10.0,1.0,16.0,6.0,5.0,3.0,4.0,3.0,3.0,0.0,8.0,0.0,3.0,6.0,7.0,0.0,0.0,23.0,15.0,23.0,1.0,8.0,19.0,0.0,1.0,2.0,5.0,6.0,2.0,2.0,8.0,1.0,0.0,0.0,2.0,14.0,7.0,1.0,12.0,0.0,3.0,0.0,16.0,0.0,0.0,4.0,8.0,3.0,1.0,2.0,1.0,0.0,0.0,3.0,3.0,5.0,0.0,3.0,4.0,0.0,10.0,9.0,0.0,15.0,5.0,22.0,2.0,4.0,6.0,4.0,0.0,3.0,7.0,3.0,0.0,0.0,6.0,14.0,6.0,10.0,8.0,1.0,7.0,6.0,10.0,0.0,1.0,1.0,6.0,7.0,6.0,3.0,3.0,0.0,11.0,0.0,14.0,0.0,0.0,22.0,5.0,3.0,2.0,5.0,22.0,19.0,0.0,9.0,7.0,4.0,2.0,13.0,4.0,8.0,0.0,0.0,0.0,16.0,0.0,13.0,0.0,0.0,23.0,0.0,3.0,13.0,15.0,5.0,18.0,20.0,9.0,5.0,4.0,9.0,1.0,0.0,3.0,0.0,1.0,1.0,2.0,2.0,11.0,0.0,14.0,11.0,3.0,2.0,3.0,17.0,7.0,2.0,0.0,6.0,15.0,14.0,3.0,4.0,2.0,12.0,6.0,12.0,0.0,9.0,0.0,2.0,1.0,0.0,12.0,0.0,2.0,8.0,14.0,22.0,15.0,0.0,15.0,1.0,8.0,3.0,4.0,5.0,7.0,8.0,6.0,11.0,1.0,3.0,0.0,4.0,3.0,1.0,0.0,12.0,5.0,1.0,4.0,2.0,0.0,2.0,0.0,0.0,6.0,10.0,0.0,3.0,3.0,10.0,15.0,0.0,2.0,4.0,2.0,1.0,0.0,0.0,0.0,3.0,0.0,1.0,5.0,1.0,0.0,3.0,7.0,1.0,14.0,5.0,1.0,1.0,14.0,16.0,17.0,1.0,0.0,3.0,6.0,5.0,0.0,1.0,1.0,0.0,4.0,0.0,3.0,3.0,24.0,0.0,2.0,3.0,14.0,8.0,0.0,2.0,2.0,13.0,8.0,8.0,0.0,2.0,2.0,4.0,1.0,5.0,19.0,4.0,2.0,3.0,5.0,7.0,1.0,1.0,0.0,7.0,4.0,11.0,3.0,1.0,14.0,2.0,2.0,2.0,23.0,4.0,19.0,19.0,5.0,5.0,0.0,2.0,15.0,4.0,16.0,2.0,1.0,11.0,2.0,5.0,8.0,6.0,6.0,13.0,4.0,5.0,8.0,6.0,5.0,6.0,5.0,3.0,12.0,8.0,6.0,6.0,6.0,5.0,9.0,8.0,0.0,11.0,6.0,5.0,7.0,6.0,5.0,8.0,4.0,4.0,14.0,9.0,6.0,8.0,6.0,8.0,15.0,10.0,10.0,4.0,5.0,6.0,5.0,4.0,5.0,5.0,5.0,0.0,5.0,0.0,5.0,0.0,5.0,5.0,5.0,0.0,5.0,5.0,2.0,5.0,0.0,3.0,3.0,5.0,5.0,3.0,5.0,5.0,5.0,1.0,5.0,2.0,0.0,2.0,1.0,2.0,5.0,2.0,5.0,5.0,3.0,0.0,5.0,2.0,5.0,5.0,5.0,3.0,2.0,5.0,5.0,3.0,5.0,0.0,3.0,2.0,0.0,0.0,0.0,1.0,0.0,1.0,4.0,1.0,5.0,0.0,0.0,0.0,5.0,0.0,0.0,0.0,0.0,3.0,0.0,0.0,1.0,0.0,0.0,4.0,1.0,4.0,1.0,0.0,5.0,0.0,1.0,3.0,1.0,0.0,1.0,2.0,0.0,1.0,,,,,,,,,,,,,,,,,,,,,,,,,,,,,,,,,,,,,,,,,,,,,,,,,,,,,,,,,,,,,,,,,,,,,,,,,,,,,,,,,,,,,,,,,,,,,,,,,,,,,8.0,12.0,10.0,11.0,4.0,12.0,9.0,11.0,14.0,7.0,10.0,14.0,11.0,4.0,0.0,10.0,15.0,9.0,11.0,4.0,3.0,11.0,9.0,9.0,5.0,6.0,10.0,11.0,11.0,14.0,22.0,12.0,14.0,1.0,3.0,5.0,5.0,5.0,5.0,5.0,5.0,4.0,5.0,5.0,4.0,0.0,0.0,0.0,1.0,2.0,0.0,0.0,2.0,2.0,0.0,0.0,0.0,6.0,1.0,11.0,6.0,9.0,7.0,10.0,1.0,1.0,0.0,3.0,10.0,6.0,3.0,2.0,1.0,1.0,1.0,2.0,12.0,2.0,4.0,7.0,6.0,4.0,15.0,15.0,8.0,1.0,7.0,6.0,2.0,0.0,4.0,3.0,9.0,14.0,10.0,2.0,7.0,9.0,1.0,8.0,6.0,8.0,7.0,9.0,6.0,1.0,1.0,8.0,3.0,18.0,3.0,2.0,2.0,6.0,2.0,0.0,5.0,14.0,6.0,7.0,6.0,4.0,1.0,6.0,3.0,12.0,7.0,5.0,4.0,2.0,0.0,4.0,0.0,18.0,12.0,2.0,2.0,13.0,8.0,18.0,9.0,4.0,10.0,4.0,4.0,12.0,3.0,14.0,7.0,2.0,9.0,8.0,5.0,0.0,1.0,5.0,6.0,3.0,5.0,4.0,7.0,1.0,0.0,0.0,5.0,2.0,1.0,0.0,4.0,5.0,1.0,1.0,1.0,1.0,0.0,4.0,7.0,0.0,0.0,5.0,5.0,4.0,4.0,5.0,0.0,0.0,4.0,5.0,4.0,5.0,3.0,5.0,4.0,4.0,5.0,4.0,3.0,5.0,2.0,1.0,4.0,4.0,2.0,4.0,4.0,1.0,4.0,5.0,1.0,0.0,11.0,5.0,7.0,3.0,8.0,13.0,14.0,7.0,7.0,8.0,1.0,1.0,0.0,0.0,0.0,0.0,3.0,1.0,4.0,2.0,0.0,2.0,3.0,4.0,1.0,4.0,4.0,2.0,5.0,7.0,3.0,2.0,0.0,1.0,0.0,0.0,0.0,2.0,0.0,1.0,2.0,2.0,3.0,1.0,1.0,2.0,5.0,2.0,4.0,0.0,1.0,4.0,5.0,0.0,0.0,1.0,4.0,0.0,1.0,7.0,0.0,6.0,5.0,6.0,1.0,2.0,8.0,4.0,0.0,1.0,0.0,6.0,1.0,2.0,3.0,5.0,6.0,2.0,10.0,9.0,3.0,0.0,1.0,6.0,0.0,2.0,0.0,0.0,4.0,1.0,2.0,1.0,5.0,5.0,0.0,0.0,6.0,3.0,5.0,10.0,6.0,2.0,3.0,6.0,5.0,3.0,11.0,3.0,3.0,7.0,7.0,5.0,11.0,7.0,5.0,5.0,6.0,5.0,4.0,5.0,11.0,8.0,7.0,3.0,5.0,6.0,0.0,6.0,6.0,11.0,10.0,3.0,12.0,12.0,8.0,0.0,11.0,4.0,9.0,8.0,4.0,5.0,2.0,7.0,9.0,2.0,0.0,8.0,10.0,4.0,2.0,6.0,5.0,8.0,4.0,8.0,4.0,8.0,5.0,1.0,0.0,0.0,3.0,2.0,1.0,3.0,7.0,0.0,7.0,3.0,2.0,0.0,1.0,4.0,3.0,4.0,0.0,5.0,2.0,7.0,1.0,5.0,1.0,0.0,10.0,1.0,0.0,5.0,1.0,2.0,5.0,2.0,2.0,3.0,2.0,1.0,4.0,5.0,4.0,2.0,7.0,0.0,6.0,4.0,3.0,0.0,15.0,6.0,5.0,3.0,2.0,1.0,2.0,4.0,4.0,4.0,1.0,0.0,0.0,3.0,0.0,4.0,3.0,0.0,3.0,0.0,11.0,5.0,8.0,5.0,9.0,1.0,1.0,0.0,1.0,2.0,1.0,3.0,0.0,1.0,1.0,0.0,2.0,1.0,5.0,1.0,2.0,3.0,4.0,0.0,3.0,3.0,2.0,4.0,3.0,2.0,3.0,6.0,2.0,6.0,9.0,6.0,5.0,10.0,5.0,3.0,5.0,3.0,7.0,5.0,7.0,3.0,5.0,5.0,6.0,5.0,6.0,4.0,3.0,3.0,5.0,2.0,5.0,4.0,4.0,2.0,5.0,3.0,4.0,8.0,1.0,3.0,0.0,6.0,2.0,3.0,3.0,3.0,5.0,5.0,3.0,1.0,2.0,5.0,6.0,3.0,3.0,4.0,0.0,7.0,5.0,3.0,2.0,10.0,3.0,8.0,3.0,6.0,6.0,6.0,3.0,4.0,4.0,1.0,4.0,7.0,4.0,5.0,7.0,4.0,4.0,4.0,8.0,5.0,5.0,3.0,10.0,3.0,10.0,5.0,2.0,2.0,8.0,2.0,4.0,4.0,5.0,3.0,4.0,10.0,7.0,7.0,4.0,7.0,11.0,5.0,5.0,6.0,7.0,0.0,7.0,13.0,8.0,0.0,8.0,1.0,3.0,4.0,3.0,5.0,7.0,8.0,3.0,3.0,6.0,6.0,10.0,4.0,6.0,4.0,3.0,0.0,3.0,8.0,5.0,8.0,6.0,3.0,12.0,9.0,0.0,6.0,6.0,6.0,5.0,7.0,9.0,7.0,2.0,5.0,4.0,8.0,5.0,5.0,8.0,6.0,7.0,2.0,10.0,4.0,5.0,8.0,6.0,1.0,5.0,2.0,6.0,14.0,10.0,10.0,4.0,6.0,9.0,4.0,1.0,7.0,4.0,11.0,10.0,14.0,6.0,6.0,7.0,0.0,7.0,9.0,5.0,1.0,4.0,14.0,8.0,8.0,15.0,5.0,9.0,11.0,11.0,8.0,10.0,16.0,9.0,8.0,12.0,17.0,16.0,8.0,15.0,2.0,7.0,22.0,10.0,4.0,4.0,9.0,13.0,11.0,17.0,1.0,4.0,12.0,2.0,7.0,16.0,6.0,17.0,13.0,15.0,7.0,15.0,1.0,5.0,4.0,4.0,7.0,6.0,4.0,4.0,3.0,1.0,5.0,2.0,19.0,4.0,2.0,2.0,2.0,12.0,13.0,5.0,13.0,7.0,10.0,3.0,19.0,3.0,9.0,0.0,4.0,4.0,8.0,8.0,11.0,2.0,6.0,10.0,4.0,16.0,13.0,8.0,10.0,11.0,26.0,21.0,12.0,10.0,14.0,1.0,9.0,9.0,15.0,15.0,18.0,11.0,12.0,9.0,3.0,6.0,31.0,13.0,8.0,9.0,17.0,7.0,5.0,8.0,12.0,1.0,6.0,18.0,9.0,5.0,12.0,8.0,3.0,9.0,18.0,2.0,3.0,8.0,4.0,2.0,4.0,11.0,9.0,6.0,3.0,2.0,7.0,2.0,7.0,2.0,1.0,8.0,3.0,9.0,6.0,8.0,5.0,4.0,5.0,4.0,3.0,9.0,1.0,4.0,16.0,2.0,0.0,2.0,8.0,0.0,1.0,0.0,0.0,3.0,2.0,2.0,3.0,3.0,2.0,1.0,5.0,4.0,0.0,0.0,0.0,1.0,1.0,0.0,0.0,1.0,3.0,9.0,7.0,3.0,7.0,0.0,4.0,0.0,0.0,0.0,9.0,1.0,3.0,4.0,1.0,1.0,0.0,0.0,0.0,5.0,2.0,0.0,0.0,1.0,8.0,0.0,4.0,3.0,3.0,2.0,1.0,0.0,3.0,0.0,3.0,0.0,2.0,4.0,6.0,12.0,1.0,1.0,3.0,4.0,0.0,1.0,1.0,5.0,2.0,0.0,1.0,0.0,0.0,0.0,1.0,3.0,1.0,2.0,1.0,2.0,3.0,0.0,1.0,0.0,0.0,0.0,8.0,0.0,0.0,0.0,0.0,1.0,0.0,0.0,1.0,5.0,5.0,5.0,5.0,5.0,5.0,1.0,0.0,2.0,0.0,0.0,1.0,0.0,1.0,0.0,1.0,1.0,0.0,0.0,0.0,0.0,1.0,1.0,0.0,2.0,3.0,13.0,6.0,8.0,8.0,34.0,10.0,22.0,7.0,12.0,7.0,11.0,14.0,7.0,8.0,8.0,5.0,2.0,35.0,0.0,7.0,15.0,10.0,12.0,4.0,4.0,6.0,1.0,10.0,4.0,7.0,5.0,3.0,1.0,4.0,5.0,13.0,2.0,12.0,8.0,6.0,15.0,0.0,9.0,3.0,2.0,5.0,3.0,5.0,5.0,5.0,4.0,5.0,5.0,3.0,4.0,5.0,5.0,5.0,5.0,5.0,5.0,2.0,5.0,5.0,5.0,1.0,3.0,5.0,2.0,3.0,5.0,5.0,5.0,5.0,5.0,0.0,5.0,2.0,5.0,5.0,3.0,0.0,4.0,4.0,3.0,0.0,5.0,4.0,2.0,3.0,1.0,5.0,5.0,1.0,5.0,5.0,5.0,1.0,5.0,5.0,5.0,5.0,5.0,5.0,5.0,5.0,0.0,5.0,1.0,0.0,0.0,4.0,5.0,5.0,4.0,3.0,1.0,5.0,2.0,1.0,5.0,2.0,4.0,0.0,2.0,4.0,5.0,5.0,0.0,5.0,1.0,1.0,5.0,2.0,5.0,5.0,2.0,5.0,2.0,1.0,2.0,5.0,5.0,3.0,5.0,4.0,1.0,0.0,5.0,0.0,5.0,5.0,3.0,2.0,5.0,0.0,5.0,5.0,3.0,5.0,3.0,12.0,17.0,8.0,7.0,17.0,11.0,3.0,4.0,11.0,5.0,16.0,17.0,15.0,18.0,11.0,2.0,2.0,5.0,5.0,2.0,5.0,5.0,5.0,2.0,1.0,5.0,5.0,5.0,4.0,5.0,5.0,3.0,5.0,5.0,5.0,5.0,5.0,5.0,5.0,5.0,5.0,4.0,5.0,2.0,5.0,5.0,0.0,0.0,0.0,3.0,5.0,3.0,5.0,5.0,5.0,3.0,5.0,5.0,5.0,5.0,5.0,5.0,1.0,3.0,2.0,0.0,4.0,4.0,4.0,5.0,5.0,4.0,5.0,5.0,5.0,1.0,5.0,2.0,2.0,5.0,5.0,3.0,1.0,0.0,5.0,4.0,3.0,5.0,5.0,5.0,5.0,5.0,5.0,5.0,5.0,5.0,1.0,5.0,5.0,0.0,5.0,4.0,5.0,5.0,5.0,5.0,5.0,5.0,1.0,5.0,1.0,5.0,5.0,5.0,5.0,5.0,5.0,0.0,5.0,5.0,0.0,5.0,5.0,4.0,5.0,4.0,8.0,11.0,5.0,11.0,9.0,3.0,10.0,4.0,4.0,5.0,10.0,7.0,0.0,2.0,10.0,6.0,2.0,13.0,10.0,13.0,15.0,5.0,7.0,13.0,4.0,10.0,6.0,8.0,2.0,4.0,6.0,3.0,6.0,18.0,2.0,4.0,3.0,6.0,6.0,5.0,7.0,7.0,5.0,8.0,11.0,7.0,4.0,9.0,9.0,2.0,9.0,1.0,0.0,11.0,9.0,2.0,2.0,7.0,5.0,9.0,10.0,9.0,8.0,7.0,0.0,1.0,0.0,8.0,1.0,5.0,0.0,2.0,8.0,4.0,11.0,9.0,2.0,8.0,1.0,6.0,7.0,10.0,7.0,0.0,2.0,7.0,3.0,2.0,3.0,10.0,5.0,7.0,3.0,5.0,5.0,9.0,6.0,7.0,2.0,8.0,13.0,8.0,5.0,0.0,6.0,9.0,7.0,5.0,8.0,7.0,9.0,0.0,6.0,3.0,5.0,10.0,2.0,9.0,10.0,2.0,5.0,11.0,6.0,0.0,7.0,2.0,15.0,10.0,8.0,6.0,6.0,13.0,6.0,9.0,13.0,10.0,2.0,5.0,9.0,5.0,9.0,8.0,6.0,7.0,12.0,5.0,9.0,9.0,11.0,7.0,11.0,1.0,3.0,6.0,14.0,10.0,0.0,10.0,6.0,4.0,3.0,3.0,10.0,6.0,4.0,7.0,3.0,4.0,5.0,0.0,2.0,5.0,15.0,4.0,13.0,10.0,1.0,12.0,11.0,7.0,9.0,8.0,4.0,4.0,7.0,6.0,4.0,6.0,6.0,6.0,12.0,5.0,9.0,9.0,12.0,7.0,10.0,3.0,6.0,8.0,8.0,4.0,4.0,7.0,4.0,0.0,0.0,0.0,0.0,0.0,13.0,17.0,8.0,2.0,4.0,6.0,10.0,35.0,24.0,13.0,3.0,7.0,11.0,20.0,10.0,5.0,8.0,0.0,9.0,8.0,8.0,3.0,4.0,7.0,3.0,7.0,6.0,0.0,15.0,2.0,5.0,6.0,5.0,6.0,5.0,0.0,3.0,7.0,3.0,10.0,8.0,5.0,5.0,5.0,2.0,9.0,11.0,8.0,7.0,4.0,6.0,3.0,9.0,5.0,4.0,2.0,2.0,8.0,11.0,12.0,3.0,3.0,8.0,18.0,14.0,1.0,7.0,10.0,14.0,7.0,3.0,3.0,6.0,7.0,7.0,1.0,8.0,7.0,2.0,7.0,3.0,7.0,4.0,3.0,1.0,9.0,4.0,10.0,5.0,3.0,5.0,5.0,5.0,4.0,7.0,6.0,1.0,7.0,2.0,7.0,6.0,10.0,7.0,12.0,16.0,12.0,8.0,5.0,9.0,14.0,9.0,13.0,6.0,8.0,4.0,4.0,5.0,7.0,13.0,7.0,23.0,8.0,6.0,11.0,6.0,6.0,3.0,9.0,7.0,9.0,8.0,,7.0,6.0,4.0,7.0,3.0,4.0,7.0,7.0,7.0,13.0,7.0,16.0,3.0,7.0,3.0,6.0,8.0,5.0,12.0,2.0,0.0,11.0,6.0,7.0,4.0,2.0,0.0,1.0,0.0,0.0,0.0,0.0,0.0,1.0,6.0,0.0,3.0,0.0,9.0,0.0,7.0,10.0,7.0,15.0,10.0,15.0,14.0,10.0,14.0,8.0,14.0,16.0,7.0,6.0,8.0,8.0,1.0,1.0,1.0,9.0,8.0,7.0,6.0,8.0,3.0,12.0,16.0,12.0,5.0,0.0,8.0,4.0,13.0,17.0,7.0,4.0,7.0,14.0,12.0,7.0,14.0,2.0,11.0,9.0,7.0,11.0,1.0,3.0,6.0,7.0,14.0,8.0,10.0,9.0,13.0,12.0,0.0,4.0,5.0,7.0,6.0,1.0,4.0,8.0,7.0,7.0,9.0,5.0,2.0,2.0,4.0,9.0,1.0,5.0,5.0,12.0,0.0,6.0,3.0,0.0,12.0,2.0,3.0,8.0,14.0,3.0,6.0,7.0,2.0,6.0,10.0,3.0,5.0,0.0,2.0,5.0,0.0,2.0,0.0,3.0,6.0,1.0,2.0,2.0,4.0,8.0,1.0,6.0,8.0,7.0,6.0,12.0,9.0,13.0,22.0,6.0,8.0,17.0,10.0,10.0,21.0,13.0,12.0,10.0,11.0,10.0,9.0,14.0,12.0,13.0,12.0,0.0,0.0,9.0,13.0,13.0,13.0,12.0,12.0,7.0,12.0,14.0,16.0,17.0,5.0,24.0,0.0,13.0,7.0,12.0,8.0,0.0,18.0,12.0,24.0,0.0,5.0,13.0,10.0,17.0,5.0,12.0,7.0,12.0,14.0,11.0,9.0,5.0,18.0,13.0,17.0,17.0,19.0,16.0,8.0,6.0,9.0,8.0,10.0,6.0,15.0,13.0,7.0,14.0,15.0,16.0,10.0,17.0,11.0,9.0,7.0,18.0,14.0,18.0,17.0,17.0,15.0,23.0,18.0,23.0,12.0,11.0,15.0,20.0,17.0,18.0,17.0,10.0,12.0,21.0,12.0,11.0,9.0,8.0,11.0,18.0,16.0,17.0,21.0,12.0,9.0,17.0,11.0,11.0,9.0,11.0,9.0,12.0,7.0,17.0,15.0,9.0,13.0,13.0,3.0,12.0,15.0,13.0,10.0,11.0,15.0,6.0,22.0,8.0,11.0,17.0,13.0,14.0,5.0,14.0,9.0,11.0,13.0,13.0,17.0,12.0,13.0,8.0,12.0,4.0,6.0,17.0,5.0,6.0,0.0,0.0,4.0,1.0,8.0,10.0,9.0,12.0,7.0,3.0,5.0,14.0,12.0,4.0,2.0,11.0,4.0,15.0,9.0,12.0,5.0,9.0,8.0,9.0,8.0,6.0,8.0,4.0,12.0,6.0,20.0,12.0,6.0,7.0,7.0,17.0,9.0,8.0,11.0,3.0,12.0,6.0,6.0,5.0,6.0,16.0,7.0,4.0,2.0,2.0,4.0,3.0,3.0,2.0,0.0,0.0,9.0,0.0,0.0,0.0,1.0,0.0,0.0,0.0,0.0,18.0,4.0,10.0,9.0,5.0,11.0,24.0,10.0,12.0,3.0,7.0,4.0,25.0,7.0,1.0,5.0,10.0,2.0,14.0,22.0,14.0,3.0,12.0,12.0,9.0,3.0,18.0,12.0,4.0,7.0,7.0,6.0,2.0,9.0,8.0,4.0,12.0,11.0,22.0,1.0,7.0,3.0,1.0,1.0,3.0,10.0,2.0,3.0,6.0,6.0,6.0,7.0,10.0,13.0,9.0,17.0,9.0,6.0,7.0,12.0,11.0,12.0,8.0,7.0,14.0,10.0,9.0,1.0,5.0,11.0,13.0,11.0,8.0,8.0,12.0,8.0,7.0,13.0,14.0,13.0,10.0,7.0,0.0,4.0,6.0,9.0,14.0,12.0,10.0,9.0,9.0,11.0,10.0,7.0,11.0,1.0,3.0,10.0,3.0,13.0,10.0,8.0,6.0,12.0,11.0,3.0,9.0,2.0,9.0,9.0,7.0,8.0,7.0,6.0,11.0,12.0,8.0,26.0,2.0,13.0,15.0,5.0,11.0,6.0,6.0,8.0,11.0,16.0,16.0,9.0,9.0,4.0,14.0,8.0,3.0,11.0,8.0,12.0,14.0,5.0,18.0,9.0,13.0,11.0,9.0,5.0,5.0,4.0,10.0,23.0,15.0,1.0,5.0,5.0,7.0,11.0,10.0,10.0,7.0,7.0,4.0,6.0,7.0,5.0,8.0,16.0,9.0,8.0,4.0,15.0,5.0,7.0,7.0,18.0,6.0,2.0,2.0,7.0,7.0,6.0,8.0,2.0,8.0,7.0,5.0,3.0,13.0,4.0,8.0,6.0,3.0,5.0,14.0,4.0,3.0,12.0,6.0,5.0,0.0,4.0,9.0,4.0,1.0,0.0,3.0,5.0,1.0,0.0,3.0,4.0,4.0,4.0,0.0,3.0,3.0,13.0,0.0,9.0,7.0,5.0,6.0,0.0,0.0,0.0,0.0,1.0,2.0,3.0,2.0,0.0,1.0,4.0,3.0,2.0,0.0,0.0,4.0,3.0,0.0,2.0,1.0,0.0,0.0,0.0,3.0,0.0,3.0,0.0,0.0,5.0,0.0,5.0,2.0,4.0,5.0,2.0,6.0,6.0,2.0,5.0,5.0,1.0,0.0,4.0,4.0,4.0,0.0,4.0,5.0,1.0,3.0,0.0,0.0,0.0,0.0,0.0,0.0,0.0,0.0,0.0,0.0,0.0,0.0,0.0,0.0,0.0,3.0,0.0,0.0,6.0,0.0,5.0,1.0,4.0,4.0,2.0,5.0,0.0,2.0,0.0,4.0,2.0,3.0,1.0,3.0,2.0,1.0,0.0,0.0,0.0,0.0,0.0,0.0,0.0,2.0,0.0,0.0,1.0,0.0,2.0,12.0,8.0,14.0,16.0,20.0,7.0,8.0,13.0,3.0,18.0,0.0,9.0,1.0,2.0,22.0,4.0,2.0,0.0,4.0,4.0,9.0,12.0,10.0,23.0,5.0,7.0,11.0,1.0,1.0,11.0,14.0,13.0,13.0,10.0,4.0,19.0,15.0,13.0,13.0,18.0,4.0,54.0,8.0,7.0,19.0,1.0,1.0,8.0,0.0,4.0,7.0,5.0,8.0,11.0,14.0,17.0,5.0,4.0,7.0,13.0,19.0,0.0,15.0,19.0,18.0,17.0,17.0,8.0,16.0,0.0,4.0,10.0,12.0,15.0,4.0,9.0,2.0,7.0,3.0,4.0,12.0,15.0,4.0,6.0,3.0,0.0,6.0,5.0,1.0,10.0,6.0,5.0,9.0,18.0,4.0,4.0,14.0,5.0,11.0,1.0,18.0,16.0,4.0,15.0,4.0,1.0,3.0,2.0,3.0,8.0,5.0,10.0,6.0,9.0,22.0,15.0,13.0,5.0,10.0,0.0,2.0,11.0,6.0,13.0,11.0,9.0,0.0,13.0,2.0,5.0,1.0,11.0,8.0,1.0,2.0,0.0,17.0,2.0,7.0,13.0,8.0,11.0,9.0,13.0,8.0,13.0,12.0,3.0,1.0,9.0,6.0,11.0,6.0,27.0,10.0,5.0,0.0,3.0,5.0,2.0,12.0,1.0,4.0,2.0,3.0,9.0,3.0,9.0,5.0,11.0,7.0,6.0,2.0,8.0,4.0,8.0,3.0,6.0,12.0,15.0,10.0,9.0,11.0,10.0,12.0,9.0,6.0,1.0,4.0,1.0,0.0,0.0,0.0,0.0,0.0,0.0,0.0,0.0,0.0,0.0,0.0,0.0,0.0,0.0,0.0,0.0,0.0,0.0,0.0,0.0,0.0,0.0,0.0,0.0,0.0,0.0,0.0,0.0,0.0,0.0,0.0,0.0,0.0,0.0,0.0,0.0,0.0,0.0,0.0,0.0,0.0,0.0,0.0,0.0,0.0,0.0,0.0,0.0,0.0,0.0,0.0,0.0,0.0,0.0,0.0,0.0,0.0,0.0,0.0,0.0,0.0,3.0,1.0,0.0,0.0,3.0,0.0,1.0,0.0,0.0,0.0,4.0,0.0,0.0,0.0,0.0,0.0,0.0,0.0,0.0,0.0,0.0,0.0,0.0,0.0,0.0,0.0,0.0,0.0,0.0,0.0,0.0,0.0,0.0,0.0,0.0,0.0,0.0,0.0,0.0,0.0,0.0,0.0,0.0,0.0,0.0,0.0,0.0,1.0,5.0,0.0,0.0,2.0,0.0,0.0,5.0,,3.0,,,4.0,5.0,5.0,0.0,2.0,5.0,0.0,0.0,2.0,1.0,4.0,,0.0,3.0,7.0,1.0,1.0,1.0,0.0,0.0,0.0,4.0,2.0,5.0,,1.0,1.0,5.0,0.0,2.0,2.0,0.0,1.0,4.0,1.0,0.0,5.0,5.0,4.0,3.0,4.0,4.0,2.0,4.0,1.0,2.0,0.0,3.0,0.0,3.0,2.0,1.0,3.0,2.0,4.0,5.0,1.0,5.0,2.0,27.0,5.0,1.0,5.0,3.0,5.0,5.0,4.0,3.0,5.0,0.0,2.0,0.0,2.0,3.0,5.0,5.0,1.0,5.0,2.0,0.0,0.0,5.0,,,3.0,5.0,5.0,5.0,5.0,3.0,5.0,4.0,3.0,5.0,4.0,5.0,4.0,0.0,3.0,2.0,4.0,0.0,0.0,0.0,2.0,3.0,5.0,0.0,1.0,1.0,1.0,5.0,5.0,2.0,1.0,2.0,4.0,4.0,5.0,1.0,1.0,4.0,4.0,5.0,5.0,5.0,5.0,5.0,2.0,0.0,5.0,5.0,3.0,0.0,3.0,5.0,5.0,0.0,1.0,3.0,0.0,1.0,2.0,4.0,0.0,5.0,2.0,0.0,5.0,3.0,1.0,3.0,1.0,1.0,1.0,0.0,,,2.0,4.0,,4.0,4.0,0.0,2.0,3.0,0.0,4.0,2.0,0.0,1.0,5.0,5.0,3.0,3.0,3.0,4.0,0.0,31.0,0.0,2.0,5.0,1.0,0.0,3.0,,5.0,2.0,4.0,0.0,4.0,7.0,1.0,1.0,3.0,3.0,0.0,2.0,5.0,5.0,4.0,4.0,0.0,0.0,0.0,5.0,1.0,5.0,1.0,0.0,0.0,0.0,0.0,5.0,1.0,1.0,0.0,1.0,1.0,2.0,2.0,4.0,0.0,0.0,0.0,0.0,0.0,10.0,5.0,3.0,1.0,10.0,5.0,0.0,1.0,5.0,0.0,1.0,5.0,5.0,27.0,26.0,,9.0,3.0,3.0,5.0,2.0,3.0,3.0,5.0,0.0,0.0,2.0,1.0,9.0,2.0,3.0,0.0,0.0,1.0,6.0,0.0,3.0,6.0,1.0,4.0,,15.0,5.0,9.0,14.0,3.0,4.0,1.0,1.0,5.0,5.0,5.0,5.0,5.0,4.0,0.0,3.0,,0.0,3.0,3.0,2.0,3.0,0.0,2.0,0.0,5.0,2.0,15.0,0.0,0.0,5.0,3.0,1.0,0.0,5.0,1.0,1.0,3.0,4.0,3.0,0.0,1.0,2.0,1.0,0.0,2.0,0.0,5.0,1.0,1.0,10.0,2.0,3.0,5.0,1.0,0.0,,5.0,1.0,5.0,5.0,3.0,5.0,2.0,0.0,5.0,,,2.0,6.0,2.0,5.0,5.0,0.0,5.0,4.0,0.0,6.0,0.0,4.0,4.0,0.0,,1.0,5.0,2.0,7.0,5.0,4.0,0.0,,3.0,4.0,5.0,3.0,0.0,0.0,0.0,3.0,1.0,1.0,1.0,0.0,0.0,2.0,1.0,2.0,0.0,0.0,0.0,0.0,0.0,4.0,3.0,3.0,5.0,0.0,0.0,3.0,5.0,17.0,1.0,3.0,1.0,5.0,3.0,5.0,5.0,0.0,2.0,3.0,1.0,0.0,2.0,5.0,2.0,5.0,3.0,10.0,17.0,5.0,5.0,6.0,5.0,0.0,0.0,11.0,9.0,0.0,36.0,5.0,5.0,2.0,,,1.0,4.0,5.0,5.0,11.0,3.0,,0.0,1.0,5.0,0.0,0.0,1.0,1.0,5.0,5.0,3.0,1.0,5.0,5.0,4.0,5.0,3.0,0.0,1.0,4.0,0.0,5.0,4.0,4.0,7.0,1.0,5.0,5.0,0.0,4.0,5.0,0.0,0.0,0.0,5.0,3.0,3.0,2.0,3.0,5.0,0.0,5.0,2.0,0.0,0.0,0.0,0.0,5.0,5.0,5.0,2.0,1.0,2.0,5.0,2.0,0.0,2.0,5.0,5.0,0.0,0.0,5.0,4.0,5.0,3.0,5.0,5.0,5.0,5.0,0.0,5.0,5.0,3.0,5.0,1.0,4.0,,5.0,5.0,5.0,5.0,4.0,0.0,5.0,4.0,3.0,1.0,5.0,3.0,5.0,1.0,3.0,4.0,5.0,3.0,5.0,2.0,3.0,5.0,4.0,0.0,1.0,5.0,1.0,,0.0,5.0,5.0,0.0,0.0,2.0,9.0,5.0,5.0,5.0,0.0,5.0,5.0,5.0,5.0,5.0,5.0,5.0,5.0,5.0,3.0,5.0,4.0,5.0,5.0,0.0,0.0,5.0,0.0,1.0,0.0,3.0,3.0,2.0,,,,5.0,5.0,,,0.0,4.0,1.0,0.0,1.0,3.0,4.0,2.0,0.0,2.0,3.0,0.0,1.0,0.0,2.0,5.0,0.0,5.0,5.0,3.0,5.0,6.0,1.0,6.0,2.0,1.0,3.0,,,2.0,2.0,0.0,4.0,2.0,5.0,3.0,3.0,5.0,1.0,1.0,5.0,4.0,5.0,4.0,0.0,0.0,1.0,0.0,2.0,0.0,5.0,0.0,5.0,5.0,1.0,2.0,1.0,0.0,5.0,5.0,5.0,4.0,5.0,2.0,3.0,5.0,2.0,3.0,2.0,2.0,1.0,5.0,5.0,5.0,2.0,0.0,0.0,2.0,0.0,0.0,5.0,1.0,4.0,1.0,2.0,5.0,5.0,5.0,3.0,,4.0,5.0,3.0,3.0,,4.0,4.0,1.0,5.0,5.0,0.0,0.0,5.0,5.0,4.0,5.0,0.0,0.0,0.0,4.0,2.0,1.0,5.0,4.0,5.0,5.0,5.0,4.0,2.0,5.0,4.0,5.0,,,,4.0,2.0,2.0,3.0,1.0,2.0,11.0,4.0,4.0,1.0,3.0,0.0,3.0,0.0,0.0,4.0,0.0,1.0,1.0,1.0,4.0,2.0,0.0,2.0,5.0,5.0,3.0,4.0,5.0,3.0,5.0,2.0,5.0,5.0,5.0,0.0,3.0,,,,0.0,4.0,5.0,5.0,5.0,5.0,0.0,6.0,2.0,5.0,0.0,1.0,1.0,5.0,0.0,0.0,4.0,5.0,5.0,,0.0,,4.0,1.0,1.0,5.0,3.0,5.0,4.0,0.0,2.0,0.0,1.0,2.0,4.0,3.0,4.0,5.0,,0.0,5.0,5.0,0.0,4.0,2.0,0.0,3.0,0.0,0.0,0.0,1.0,1.0,5.0,5.0,3.0,0.0,3.0,0.0,5.0,0.0,4.0,1.0,5.0,2.0,4.0,4.0,0.0,2.0,5.0,0.0,0.0,5.0,5.0,0.0,4.0,1.0,3.0,2.0,0.0,7.0,,,0.0,0.0,2.0,0.0,0.0,0.0,5.0,5.0,3.0,4.0,5.0,1.0,0.0,3.0,3.0,4.0,5.0,3.0,0.0,2.0,5.0,0.0,4.0,3.0,2.0,2.0,1.0,4.0,3.0,2.0,0.0,5.0,3.0,5.0,,,,,5.0,0.0,2.0,4.0,5.0,0.0,5.0,5.0,0.0,2.0,0.0,0.0,1.0,0.0,1.0,5.0,0.0,0.0,0.0,5.0,0.0,1.0,0.0,0.0,0.0,0.0,0.0,0.0,0.0,0.0,4.0,2.0,5.0,,5.0,0.0,6.0,0.0,3.0,5.0,2.0,0.0,1.0,1.0,5.0,6.0,4.0,5.0,5.0,1.0,,1.0,2.0,1.0,1.0,5.0,5.0,2.0,1.0,3.0,,,1.0,3.0,0.0,2.0,5.0,2.0,5.0,2.0,0.0,5.0,3.0,,0.0,5.0,3.0,4.0,0.0,5.0,4.0,1.0,4.0,0.0,0.0,1.0,4.0,3.0,1.0,4.0,4.0,1.0,5.0,2.0,2.0,1.0,5.0,1.0,5.0,1.0,5.0,0.0,0.0,5.0,5.0,9.0,2.0,5.0,2.0,5.0,5.0,5.0,5.0,0.0,1.0,3.0,5.0,1.0,4.0,5.0,2.0,0.0,5.0,3.0,5.0,5.0,5.0,3.0,4.0,,,0.0,6.0,3.0,5.0,0.0,,1.0,,5.0,0.0,0.0,0.0,6.0,3.3333333333333335,2.0,0.0,2.0,2.0,1.0,3.0,1.0,5.0,1.0,2.0,2.0,0.0,0.0,0.0,2.0,0.0,4.0,3.0,5.0,5.0,1.0,2.0,0.0,5.0,0.0,1.0,0.0,2.0,0.0,0.0,0.0,3.0,5.0,0.0,3.0,2.0,4.0,3.0,5.0,4.0,2.0,0.0,1.0,0.0,0.0,4.0,2.0,1.0,1.0,1.0,4.0,1.0,1.0,3.0,5.0,2.0,5.0,4.0,2.0,2.0,2.0,0.0,0.0,1.0,0.0,0.0,2.0,0.0,1.0,5.0,4.0,0.0,0.0,5.0,1.0,5.0,5.0,0.0,2.0,9.0,10.0,0.0,0.0,0.0,1.0,1.0,5.0,1.0,3.0,2.0,5.0,,,0.0,4.0,1.0,3.0,5.0,5.0,,5.0,0.0,,5.0,5.0,1.0,3.0,1.0,2.0,4.0,1.0,7.0,6.0,1.0,5.0,3.0,4.0,3.0,3.0,2.0,3.0,3.0,1.0,2.0,1.0,3.0,1.0,1.0,5.0,2.0,0.0,3.0,2.0,2.0,2.0,5.0,1.0,3.0,5.0,0.0,0.0,1.0,4.0,5.0,3.0,2.0,1.0,4.0,5.0,1.0,5.0,4.0,2.0,5.0,2.0,12.0,,0.0,4.0,5.0,5.0,6.0,4.0,5.0,1.0,6.0,3.0,5.0,0.0,0.0,4.0,5.0,6.0,5.0,4.0,3.0,4.0,2.0,2.0,2.0,,,0.0,5.0,0.0,0.0,4.0,2.0,5.0,6.0,4.0,4.0,,,4.0,4.0,5.0,1.0,5.0,5.0,12.0,2.0,0.0,7.0,13.0,9.0,4.0,4.0,0.0,,,2.0,5.0,0.0,,2.0,5.0,5.0,5.0,5.0,0.0,1.0,5.0,5.0,3.0,5.0,2.0,1.0,5.0,5.0,3.0,5.0,5.0,5.0,4.0,5.0,4.0,3.0,5.0,4.0,2.0,1.0,1.0,0.0,0.0,1.0,1.0,2.0,1.0,5.0,4.0,1.0,5.0,1.0,5.0,2.0,4.0,,3.0,3.0,3.0,3.0,5.0,4.0,5.0,5.0,4.0,3.5,14.0,10.0,3.0,3.0,0.0,2.0,0.0,4.0,3.0,4.0,4.0,3.0,5.0,2.0,1.0,5.0,0.0,,,,1.0,0.0,0.0,10.0,4.0,,5.0,5.0,5.0,5.0,5.0,5.0,,,,,5.0,1.0,2.0,1.0,4.0,4.0,5.0,4.0,,0.0,3.0,0.0,2.0,,0.0,1.0,1.0,0.0,3.0,5.0,3.0,4.0,0.0,3.0,5.0,5.0,1.0,2.0,3.0,5.0,4.0,5.0,5.0,5.0,3.0,4.0,3.0,5.0,0.0,5.0,3.0,3.0,0.0,5.0,1.0,5.0,1.0,1.0,0.0,5.0,0.0,5.0,5.0,5.0,2.0,2.0,0.0,5.0,0.0,5.0,5.0,5.0,5.0,5.0,4.0,5.0,5.0,5.0,2.0,2.0,1.0,5.0,5.0,5.0,3.0,0.0,3.0,2.0,3.0,0.0,0.0,0.0,0.0,0.0,0.0,0.0,0.0,4.0,0.0,5.0,0.0,1.0,3.0,2.0,5.0,3.0,5.0,5.0,0.0,2.0,5.0,,,10.0,6.0,,4.0,7.0,2.0,12.0,7.0,1.0,2.0,2.0,5.0,2.0,5.0,,0.0,0.0,0.0,2.0,,5.0,3.0,2.0,2.0,2.0,2.0,5.0,0.0,5.0,2.0,4.0,1.0,4.0,1.0,2.0,4.0,1.0,2.0,5.0,1.0,0.0,5.0,5.0,5.0,5.0,4.0,4.0,,27.0,5.0,0.0,3.0,5.0,5.0,5.0,2.0,1.0,2.0,0.0,5.0,2.0,3.0,,6.0,1.0,0.0,3.0,5.0,5.0,3.0,2.0,4.0,1.0,1.0,0.0,0.0,0.0,0.0,1.0,4.0,4.0,5.0,1.0,2.0,3.0,3.0,5.0,3.0,3.0,5.0,5.0,5.0,4.0,2.0,2.0,5.0,5.0,5.0,5.0,5.0,2.0,5.0,0.0,7.0,1.0,1.0,,,,5.0,5.0,3.0,3.0,1.0,2.0,2.0,2.0,5.0,0.0,2.0,0.0,0.0,0.0,2.0,0.0,0.0,0.0,0.0,2.0,0.0,0.0,1.0,0.0,1.0,0.0,0.0,3.0,5.0,0.0,2.0,5.0,2.0,,,4.0,5.0,2.0,5.0,5.0,2.0,5.0,5.0,1.0,4.0,3.0,3.0,4.0,2.0,5.0,3.0,3.0,5.0,2.0,4.0,5.0,5.0,3.0,4.0,5.0,4.0,3.0,0.0,0.0,0.0,0.0,0.0,0.0,0.0,0.0,0.0,0.0,0.0,0.0,0.0,0.0,1.0,0.0,0.0,0.0,5.0,5.0,5.0,5.0,0.0,5.0,3.0,5.0,5.0,5.0,3.0,5.0,5.0,4.0,3.0,5.0,6.0,1.0,0.0,3.0,0.0,5.0,4.0,0.0,0.0,0.0,0.0,0.0,0.0,0.0,0.0,0.0,0.0,0.0,0.0,0.0,8.0,0.0,0.0,0.0,0.0,0.0,0.0,0.0,5.0,9.0,6.0,0.0,0.0,0.0,0.0,0.0,0.0,2.0,1.0,2.5714285714285716,0.0,0.0,3.0,0.0,1.5,7.0,3.0,6.0,6.0,0.0,1.0,1.0,1.0,8.0,6.0,5.0,5.0,0.0,0.0,0.0,0.0,0.0,4.0,0.0,2.0,0.0,3.0,0.0,0.0,5.0,0.0,7.0,5.0,1.0,7.0,0.0,1.5,0.0,0.0,0.0,0.0,7.0,0.0,6.0,4.0,4.0,0.0,3.0,0.0,0.0,2.0,3.0,3.0,4.0,0.0,1.0,3.0,2.5,2.0,0.0,9.0,1.8333333333333333,0.0,0.0,5.0,0.0,1.0,0.0,3.0,10.0,0.0,5.0,5.0,8.0,0.0,0.0,0.0,4.0,0.0,5.0,5.0,7.0,0.0,6.0,7.0,0.0,4.0,0.0,1.0,0.0,0.0,5.0,2.0,0.0,0.0,12.0,0.0,1.0,5.0,0.0,0.0,5.0,0.0,0.0,2.0,5.0,0.0,6.0,0.0,0.0,1.0,1.0,0.0,0.0,2.5,1.0,0.0,1.0,2.0,0.0,6.0,0.0,4.0,0.0,2.0,0.0,0.0,0.0,1.0,0.0,5.0,0.0,0.0,0.0,0.0,2.0,2.0,6.0,4.0,7.0,5.0,0.0,3.0,6.0,6.0,3.0,0.0,4.0,0.0,0.0,2.0,1.0,0.0,0.0,6.0,3.0,7.0,1.0,5.0,0.0,3.0,3.0,6.0,0.0,0.0,0.0,7.0,4.0,0.0,2.0,0.0,0.0,1.0,6.0,6.0,0.0,0.0,2.0,9.0,5.0,0.0,0.0,2.0,0.0,0.0,1.5,5.0,0.0,0.0,2.0,3.0,0.0,0.0,3.0,6.0,0.0,0.0,5.0,2.0,4.0,0.0,5.0,1.5,7.0,0.0,6.0,2.0,2.0,4.0,2.0,10.0,0.0,4.0,0.0,8.0,5.0,0.0,2.0,0.0,0.0,3.0,4.0,4.0,1.0,0.0,4.0,6.0,0.0,0.0,2.0,0.0,0.0,0.0,0.0,6.0,3.0,0.0,0.0,2.0,3.0,1.5,0.0,0.0,0.0,3.0,1.0,1.0,2.0,4.0,4.0,2.0,3.0,0.0,5.0,2.0,3.0,5.0,5.0,5.0,0.0,0.0,5.0,5.0,0.0,4.0,5.0,3.0,2.0,5.0,16.0,8.0,20.0,4.0,3.0,2.0,8.0,8.0,4.0,7.0,3.0,5.0,3.0,4.0,13.0,3.0,4.0,9.0,9.0,7.0,11.0,11.0,12.0,3.0,6.0,10.0,5.0,5.0,5.0,2.0,5.0,2.0,5.0,10.0,9.0,9.0,17.0,4.0,12.0,2.0,10.0,2.0,16.0,2.0,3.0,12.0,3.0,2.0,21.0,9.0,4.0,12.0,12.0,16.0,5.0,5.0,3.0,1.0,4.0,3.0,5.0,3.0,7.0,1.0,3.0,3.0,2.0,5.0,7.0,6.0,9.0,7.0,12.0,2.0,2.0,7.0,3.0,7.0,5.0,9.0,14.0,13.0,8.0,3.0,9.0,6.0,3.0,5.0,3.0,5.0,2.0,2.0,3.0,10.0,12.0,11.0,11.0,7.0,8.0,9.0,21.0,9.0,13.0,9.0,5.0,3.0,10.0,13.0,4.0,5.0,7.0,5.0,4.0,4.0,6.0,9.0,5.0,7.0,12.0,14.0,8.0,11.0,10.0,7.0,14.0,4.0,6.0,4.0,3.0,2.0,9.0,6.0,2.0,5.0,5.0,4.0,2.0,10.0,0.0,3.0,0.0,0.0,3.0,0.0,4.0,0.0,0.0,1.0,3.0,1.0,5.0,4.0,3.0,2.0,11.0,8.0,14.0,8.0,0.0,0.0,0.0,0.0,0.0,0.0,0.0,0.0,0.0,0.0,0.0,0.0,0.0,0.0,0.0,0.0,0.0,0.0,4.0,9.0,3.0,2.0,1.0,5.0,5.0,5.0,5.0,5.0,5.0,0.0,1.0,2.0,1.0,0.0,2.0,7.0,0.0,5.0,5.0,5.0,4.0,5.0,5.0,5.0,0.0,5.0,4.0,4.0,5.0,5.0,13.0,17.0,12.0,4.0,2.0,9.0,7.0,19.0,4.0,15.0,13.0,7.0,10.0,9.0,0.0,7.0,8.0,5.0,1.0,9.0,13.0,3.0,8.0,4.0,8.0,9.0,12.0,,14.0,14.0,5.0,5.0,5.0,5.0,5.0,5.0,5.0,5.0,5.0,5.0,5.0,5.0,5.0,5.0,5.0,5.0,5.0,3.0,5.0,5.0,5.0,5.0,5.0,5.0,0.0,,,6.0,8.0,5.0,0.0,3.0,2.0,2.0,11.0,2.0,3.0,2.0,4.0,4.0,2.0,5.0,4.0,1.0,0.0,0.0,1.0,2.0,6.0,5.0,5.0,0.0,1.0,2.0,3.0,0.0,2.0,1.0,1.0,4.0,5.0,3.0,3.0,4.0,2.0,4.0,0.0,0.0,2.0,4.0,6.0,2.0,3.0,5.0,7.0,0.0,5.0,2.0,4.0,1.0,8.0,8.0,3.0,1.0,2.0,1.0,2.0,1.0,0.0,1.0,4.0,1.0,1.0,2.0,1.0,1.0,0.0,1.0,3.0,0.0,0.0,1.0,2.0,0.0,1.0,3.0,1.0,0.0,5.0,4.0,4.0,7.0,1.0,3.0,3.0,2.0,0.0,2.0,3.0,2.0,5.0,4.0,3.0,4.0,2.0,3.0,2.0,1.0,0.0,4.0,0.0,2.0,2.0,0.0,1.0,0.0,4.0,3.0,1.0,0.0,2.0,3.0,8.0,6.0,4.0,0.0,3.0,7.0,3.0,3.0,4.0,1.0,4.0,3.0,0.0,0.0,1.0,0.0,0.0,0.0,0.0,0.0,0.0,0.0,0.0,0.0,0.0,0.0,0.0,0.0,0.0,0.0,0.0,0.0,0.0,0.0,0.0,0.0,0.0,0.0,0.0,0.0,0.0,0.0,0.0,0.0,0.0,1.0,0.0,0.0,0.0,0.0,0.0,0.0,0.0,1.0,5.0,1.0,0.0,0.0,0.0,0.0,0.0,5.0,5.0,5.0,5.0,5.0,2.0,5.0,2.0,5.0,1.0,5.0,5.0,5.0,2.0,4.5,2.0,5.0,5.0,5.0,4.0,5.0,5.0,5.0,5.0,5.0,5.0,8.0,4.0,10.0,8.0,6.0,8.0,10.0,5.0,9.0,3.0,8.0,8.0,6.0,4.0,8.0,6.0,7.0,8.0,10.0,6.0,8.0,7.0,5.0,7.0,8.0,6.0,7.0,3.0,10.0,10.0,8.0,9.0,8.0,7.0,8.0,3.0,3.0,8.0,11.0,2.0,7.0,5.0,6.0,9.0,7.0,10.0,7.0,6.0,4.0,5.0,0.0,11.0,10.0,8.0,10.0,10.0,8.0,8.0,6.0,9.0,9.0,7.0,5.0,4.0,6.0,4.0,7.0,7.0,7.0,10.0,8.0,6.0,7.0,5.0,7.0,8.0,5.0,11.0,6.0,6.0,10.0,6.0,7.0,8.0,11.0,8.0,0.0,14.0,8.0,9.0,10.0,7.0,6.0,8.0,5.0,9.0,6.0,8.0,7.0,8.0,5.0,8.0,10.0,7.0,6.0,8.0,9.0,10.0,9.0,8.0,9.0,6.0,7.0,10.0,8.0,9.0,11.0,8.0,8.0,8.0,7.0,3.0,5.0,6.0,2.0,2.0,6.0,4.0,3.0,2.0,6.0,6.0,1.0,4.0,4.0,1.0,3.0,2.0,6.0,8.0,2.0,8.0,3.0,4.0,4.0,4.0,4.0,7.0,5.0,4.0,0.0,3.0,6.0,4.0,2.0,3.0,7.0,9.0,8.0,7.0,10.0,15.0,7.0,7.0,10.0,4.0,8.0,6.0,7.0,9.0,5.0,15.0,17.0,5.0,6.0,10.0,8.0,15.0,13.0,13.0,12.0,6.0,16.0,10.0,6.0,6.0,12.0,4.0,17.0,5.0,12.0,7.0,5.0,11.0,14.0,6.0,3.0,13.0,8.0,11.0,13.0,12.0,7.0,5.0,4.0,9.0,6.0,10.0,13.0,12.0,8.0,7.0,7.0,5.0,9.0,8.0,6.0,13.0,10.0,6.0,0.0,0.0,0.0,0.0,0.0,0.0,0.0,0.0,0.0,0.0,3.0,2.0,2.0,6.0,4.0,0.0,0.0,7.0,9.0,11.0,1.0,0.0,0.0,2.0,1.0,1.0,0.0,0.0,0.0,2.0,3.0,1.0,3.0,2.0,2.0,1.0,4.0,3.0,0.0,5.0,0.0,0.0,0.0,1.0,3.0,0.0,0.0,0.0,3.0,9.0,0.0,18.0,23.0,3.0,7.0,46.0,6.0,13.0,3.0,17.0,4.0,8.0,15.0,22.0,3.0,24.0,16.0,0.0,2.0,2.0,30.0,24.0,7.0,0.0,27.0,18.0,9.0,18.0,7.0,0.0,22.0,0.0,0.0,5.0,21.0,0.0,41.0,5.0,18.0,8.0,0.0,25.0,26.0,10.0,0.0,21.0,24.0,24.0,1.0,5.0,8.0,27.0,2.0,13.0,0.0,6.0,32.0,1.0,25.0,31.0,3.0,3.0,6.0,3.0,5.0,7.0,22.0,9.0,5.0,6.0,8.0,2.0,20.0,13.0,1.0,14.0,20.0,12.0,13.0,1.0,21.0,45.0,11.0,13.0,1.0,0.0,24.0,3.0,3.0,1.0,34.0,9.0,3.0,0.0,16.0,10.0,2.0,5.0,2.0,32.0,15.0,34.0,4.0,0.0,28.0,20.0,5.0,9.0,1.0,2.0,25.0,3.0,1.0,2.0,7.0,8.0,11.0,0.0,3.0,7.0,20.0,10.0,9.0,12.0,4.0,3.0,1.0,12.0,42.0,1.0,18.0,0.0,3.0,31.0,8.0,29.0,18.0,31.0,19.0,0.0,8.0,3.0,1.0,4.0,3.0,0.0,12.0,7.0,12.0,16.0,2.0,11.0,0.0,1.0,0.0,2.0,23.0,19.0,11.0,37.0,17.0,1.0,1.0,1.0,1.0,9.0,2.0,7.0,15.0,4.0,2.0,33.0,14.0,4.0,12.0,4.0,12.0,9.0,14.0,10.0,4.0,14.0,22.0,20.0,12.0,0.0,9.0,9.0,14.0,31.0,20.0,16.0,1.0,13.0,14.0,3.0,1.0,1.0,4.0,13.0,1.0,5.0,2.0,6.0,1.0,1.0,2.0,0.0,5.0,9.0,24.0,0.0,17.0,24.0,16.0,1.0,1.0,3.0,15.0,1.0,4.0,9.0,5.0,17.0,9.0,0.0,10.0,8.0,8.0,1.0,10.0,14.0,18.0,11.0,0.0,1.0,19.0,1.0,5.0,1.0,10.0,0.0,16.0,11.0,14.0,16.0,2.0,3.0,8.0,24.0,1.0,1.0,8.0,19.0,22.0,0.0,0.0,0.0,16.0,0.0,9.0,3.0,1.0,7.0,8.0,1.0,6.0,19.0,17.0,7.0,1.0,25.0,13.0,1.0,17.0,14.0,9.0,17.0,6.0,21.0,9.0,1.0,4.0,3.0,26.0,25.0,1.0,12.0,13.0,22.0,4.0,5.0,4.0,8.0,24.0,14.0,0.0,1.0,16.0,5.0,6.0,8.0,2.0,11.0,9.0,3.0,11.0,11.0,0.0,0.0,14.0,14.0,8.0,7.0,7.0,0.0,11.0,2.0,21.0,1.0,3.0,8.0,13.0,17.0,18.0,19.0,13.0,27.0,17.0,10.0,5.0,0.0,4.0,26.0,8.0,8.0,12.0,11.0,20.0,3.0,30.0,4.0,4.0,7.0,6.0,0.0,2.0,4.0,2.0,4.0,5.0,8.0,9.0,8.0,8.0,16.0,0.0,9.0,17.0,4.0,1.0,6.0,13.0,23.0,35.0,0.0,15.0,0.0,18.0,10.0,6.0,3.0,16.0,7.0,18.0,35.0,5.0,4.0,17.0,7.0,13.0,2.0,0.0,8.0,6.0,4.0,18.0,14.0,2.0,7.0,8.0,0.0,24.0,24.0,5.0,17.0,12.0,0.0,24.0,21.0,9.0,3.0,0.0,7.0,1.0,15.0,2.0,31.0,9.0,5.0,3.0,14.0,6.0,4.0,1.0,13.0,1.0,4.0,7.0,7.0,2.0,21.0,2.0,3.0,1.0,11.0,7.0,5.0,12.0,3.0,10.0,3.0,3.0,9.0,5.0,31.0,21.0,3.0,2.0,5.0,2.0,16.0,16.0,17.0,6.0,3.0,18.0,0.0,1.0,6.0,11.0,0.0,2.0,17.0,19.0,8.0,9.0,0.0,8.0,13.0,18.0,0.0,0.0,1.0,3.0,6.0,0.0,17.0,3.0,16.0,11.0,4.0,3.0,9.0,35.0,6.0,0.0,1.0,6.0,28.0,2.0,19.0,4.0,2.0,5.0,6.0,0.0,3.0,16.0,4.0,6.0,0.0,16.0,17.0,24.0,8.0,12.0,4.0,11.0,14.0,12.0,1.0,33.0,20.0,2.0,17.0,0.0,0.0,3.0,1.0,12.0,3.0,10.0,0.0,3.0,0.0,6.0,12.0,4.0,9.0,4.0,0.0,2.0,19.0,1.0,20.0,35.0,2.0,6.0,0.0,1.0,0.0,0.0,24.0,2.0,20.0,9.0,14.0,0.0,28.0,1.0,10.0,9.0,1.0,1.0,13.0,0.0,13.0,2.0,13.0,6.0,11.0,23.0,0.0,23.0,28.0,5.0,26.0,0.0,0.0,5.0,12.0,21.0,21.0,4.0,15.0,0.0,9.0,14.0,15.0,10.0,8.0,6.0,6.0,1.0,3.0,17.0,4.0,10.0,1.0,0.0,18.0,1.0,0.0,16.0,3.0,1.0,6.0,24.0,2.0,0.0,1.0,0.0,12.0,16.0,6.0,14.0,4.0,0.0,22.0,0.0,1.0,6.0,15.0,4.0,3.0,8.0,5.0,7.0,7.0,2.0,1.0,13.0,24.0,4.0,3.0,1.0,7.0,1.0,32.0,0.0,24.0,1.0,10.0,5.0,2.0,0.0,3.0,19.0,0.0,2.0,5.0,1.0,1.0,3.0,2.0,16.0,1.0,17.0,23.0,15.0,1.0,3.0,0.0,0.0,11.0,0.0,6.0,0.0,2.0,4.0,3.0,6.0,4.0,0.0,4.0,4.0,16.0,0.0,6.0,5.0,22.0,9.0,2.0,4.0,11.0,2.0,2.0,22.0,8.0,7.0,1.0,2.0,25.0,0.0,0.0,7.0,2.0,0.0,0.0,9.0,0.0,1.0,0.0,0.0,7.0,4.0,3.0,39.0,19.0,7.0,1.0,1.0,4.0,14.0,7.0,4.0,0.0,5.0,8.0,8.0,1.0,0.0,24.0,17.0,13.0,5.0,14.0,0.0,15.0,3.0,3.0,20.0,14.0,5.0,21.0,6.0,7.0,1.0,10.0,3.0,13.0,1.0,0.0,12.0,18.0,0.0,9.0,0.0,1.0,31.0,1.0,3.0,24.0,0.0,4.0,4.0,20.0,4.0,24.0,1.0,0.0,4.0,1.0,5.0,32.0,9.0,23.0,22.0,1.0,19.0,9.0,0.0,23.0,28.0,0.0,11.0,14.0,8.0,34.0,18.0,3.0,21.0,16.0,8.0,20.0,1.0,23.0,7.0,1.0,1.0,18.0,3.0,15.0,2.0,4.0,2.0,4.0,2.0,13.0,1.0,4.0,4.0,5.0,4.0,5.0,5.0,5.0,1.0,3.0,5.0,5.0,3.0,5.0,5.0,5.0,5.0,5.0,4.0,5.0,5.0,5.0,1.0,2.0,0.0,5.0,3.0,5.0,4.0,5.0,2.0,4.0,2.0,3.0,2.0,3.0,1.0,4.0,0.0,5.0,2.0,0.0,1.0,2.0,1.0,0.0,0.0,0.0,0.0,0.0,0.0,0.0,0.0,0.0,4.0,1.0,2.0,0.0,3.0,0.0,3.0,3.0,0.0,0.0,7.0,7.0,18.0,9.0,21.0,3.0,1.0,18.0,17.0,1.0,8.0,10.0,6.0,6.0,3.0,0.0,2.0,0.0,10.0,6.0,6.0,15.0,4.0,0.0,19.0,7.0,12.0,15.0,14.0,4.0,0.0,5.0,4.0,6.0,8.0,5.0,4.0,4.0,2.0,28.0,0.0,0.0,0.0,6.0,1.0,0.0,1.0,1.0,5.0,1.0,0.0,20.0,14.0,0.0,4.0,10.0,9.0,4.0,12.0,10.0,20.0,15.0,17.0,8.0,0.0,3.0,16.0,2.0,8.0,27.0,11.0,5.0,11.0,4.0,17.0,16.0,10.0,1.0,4.0,15.0,14.0,13.0,4.0,16.0,19.0,2.0,21.0,5.0,4.0,1.0,0.0,5.0,0.0,5.0,4.0,5.0,6.0,11.0,30.0,9.0,36.0,13.0,18.0,4.0,19.0,5.0,9.0,15.0,14.0,17.0,13.0,1.0,7.0,24.0,13.0,3.0,12.0,18.0,8.0,15.0,13.0,18.0,16.0,18.0,14.0,22.0,12.0,15.0,8.0,17.0,20.0,18.0,14.0,7.0,14.0,16.0,18.0,12.0,15.0,5.0,18.0,12.0,11.0,19.0,9.0,17.0,6.0,1.0,0.0,4.0,4.0,4.0,21.0,10.0,15.0,16.0,6.0,10.0,16.0,1.0,13.0,4.0,2.0,16.0,13.0,10.0,13.0,18.0,5.0,5.0,11.0,7.0,5.0,18.0,0.0,3.0,13.0,2.0,12.0,2.0,10.0,15.0,17.0,12.0,12.0,18.0,15.0,6.0,5.0,5.0,3.0,3.0,15.0,14.0,16.0,13.0,20.0,18.0,9.0,16.0,12.0,11.0,13.0,5.0,8.0,12.0,13.0,2.0,6.0,1.0,12.0,11.0,6.0,10.0,11.0,1.0,14.0,14.0,3.0,1.0,7.0,2.0,7.0,4.0,2.0,6.0,15.0,15.0,15.0,8.0,6.0,0.0,1.0,5.0,1.0,13.0,12.0,19.0,6.0,13.0,11.0,11.0,25.0,15.0,10.0,11.0,5.0,1.0,8.0,6.0,6.0,1.0,8.0,13.0,26.0,17.0,0.0,0.0,0.0,0.0,0.0,0.0,0.0,0.0,0.0,0.0,0.0,0.0,0.0,0.0,0.0,0.0,0.0,0.0,0.0,0.0,0.0,0.0,0.0,0.0,0.0,0.0,0.0,0.0,0.0,0.0,0.0,0.0,0.0,0.0,0.0,0.0,0.0,0.0,0.0,0.0,0.0,0.0,0.0,0.0,0.0,0.0,0.0,0.0,0.0,0.0,0.0,0.0,0.0,0.0,0.0,0.0,0.0,5.0,1.0,5.0,1.0,0.0,2.0,2.0,1.0,5.0,1.0,2.0,5.0,3.0,2.0,0.0,1.0,5.0,1.0,1.0,3.0,2.0,2.0,2.0,2.0,4.0,1.0,5.0,5.0,5.0,2.0,4.0,5.0,5.0,5.0,5.0,1.0,5.0,5.0,5.0,5.0,3.0,5.0,5.0,5.0,5.0,3.0,0.0,5.0,5.0,5.0,5.0,2.0,5.0,5.0,1.0,4.0,4.0,2.0,5.0,4.0,5.0,5.0,5.0,5.0,5.0,3.0,5.0,5.0,5.0,5.0,4.0,5.0,5.0,5.0,5.0,5.0,4.0,5.0,7.0,6.0,3.0,7.0,1.0,1.0,6.0,4.0,2.0,5.0,3.0,1.0,1.0,5.0,6.0,1.0,3.0,5.0,2.0,5.0,5.0,5.0,5.0,5.0,5.0,5.0,1.0,5.0,4.0,5.0,5.0,5.0,5.0,5.0,5.0,5.0,5.0,2.0,2.0,5.0,5.0,5.0,3.0,5.0,5.0,5.0,5.0,5.0,5.0,5.0,2.0,4.0,5.0,5.0,5.0,5.0,5.0,5.0,5.0,5.0,5.0,5.0,5.0,4.0,5.0,5.0,3.0,2.0,13.0,6.0,7.0,7.0,,1.0,3.0,3.0,0.0,3.0,2.0,3.0,3.0,4.0,4.0,5.0,1.0,10.0,3.0,4.0,10.0,15.0,4.0,4.0,10.0,1.0,1.0,3.0,0.0,1.0,5.0,1.0,6.0,8.0,2.0,5.0,2.0,3.0,3.0,5.0,9.0,2.0,0.0,1.0,2.0,3.0,4.0,7.0,4.0,6.0,3.0,3.0,5.0,3.0,1.0,0.0,1.0,2.0,16.0,1.0,4.0,2.0,10.0,3.0,0.0,1.0,0.0,6.0,0.0,3.0,9.0,4.0,0.0,2.0,0.0,0.0,3.0,4.0,6.0,6.0,1.0,7.0,1.0,3.0,0.0,1.0,9.0,2.0,3.0,0.0,4.0,1.0,6.0,1.0,9.0,4.0,4.0,2.0,1.0,2.0,1.0,3.0,1.0,6.0,1.0,2.0,5.0,7.0,2.0,1.0,0.0,1.0,4.0,7.0,0.0,8.0,7.0,4.0,1.0,2.0,2.0,6.0,2.0,1.0,0.0,2.0,1.0,1.0,5.0,5.0,6.0,6.0,6.0,5.0,2.0,2.0,2.0,2.0,5.0,3.0,2.0,4.0,4.0,10.0,6.0,0.0,0.0,1.0,0.0,8.0,11.0,22.0,17.0,8.0,16.0,7.0,6.0,17.0,5.0,6.0,6.0,5.0,4.0,2.0,6.0,8.0,4.0,2.0,4.0,4.0,10.0,3.0,8.0,8.0,4.0,2.0,1.0,5.0,1.0,4.0,1.0,3.0,7.0,7.0,10.0,5.0,17.0,3.0,8.0,21.0,51.0,11.0,0.0,15.0,23.0,19.0,19.0,5.0,8.0,21.0,14.0,7.0,15.0,8.0,9.0,21.0,10.0,28.0,22.0,9.0,25.0,21.0,13.0,1.0,13.0,2.0,16.0,11.0,58.0,17.0,15.0,14.0,5.0,5.0,5.0,3.0,5.0,1.0,4.0,5.0,5.0,5.0,5.0,5.0,1.0,5.0,1.0,5.0,5.0,1.0,4.0,5.0,5.0,5.0,1.0,5.0,5.0,5.0,5.0,5.0,5.0,4.0,2.0,5.0,5.0,2.0,5.0,5.0,5.0,5.0,5.0,5.0,5.0,5.0,5.0,4.0,4.0,17.0,1.0,0.0,16.0,0.0,0.0,0.0,18.0,10.0,7.0,0.0,0.0,3.0,9.0,6.0,1.0,1.0,5.0,0.0,28.0,39.0,32.0,12.0,19.0,0.0,2.0,0.0,0.0,4.0,0.0,2.0,0.0,25.0,0.0,14.0,6.0,16.0,12.0,15.0,3.0,1.0,16.0,20.0,0.0,20.0,17.0,2.0,27.0,21.0,5.0,9.0,3.0,14.0,3.0,0.0,21.0,20.0,18.0,40.0,2.0,2.0,7.0,1.0,0.0,0.0,1.0,3.0,30.0,27.0,10.0,7.0,5.0,10.0,6.0,7.0,6.0,3.0,6.0,3.0,7.0,3.0,3.0,3.0,14.0,14.0,5.0,5.0,5.0,5.0,5.0,5.0,5.0,1.0,2.0,16.0,8.0,10.0,5.0,14.0,5.0,6.0,18.0,11.0,10.0,3.0,0.0,3.0,3.0,2.0,3.0,0.0,0.0,0.0,4.0,3.0,2.0,2.0,2.0,2.0,3.0,2.0,0.0,7.0,2.0,3.0,5.0,2.0,16.0,2.0,45.0,6.0,2.0,2.0,2.0,2.0,5.0,4.0,0.0,0.0,0.0,0.0,1.0,2.0,2.0,1.0,2.0,1.0,0.0,1.0,0.0,0.0,1.0,0.0,0.0,0.0,2.0,1.0,1.0,0.0,1.0,1.0,1.0,0.0,0.0,1.0,1.0,1.0,1.0,2.0,1.0,0.0,0.0,1.0,0.0,2.0,2.0,0.0,1.0,5.0,1.0,1.0,1.0,1.0,1.0,2.0,1.0,0.0,1.0,1.0,0.0,1.0,2.0,1.0,1.0,1.0,0.0,3.0,1.0,0.0,0.0,1.0,1.0,1.0,1.0,0.0,1.0,0.0,0.0,1.0,0.0,1.0,0.0,0.0,1.0,0.0,1.0,0.0,1.0,1.0,1.0,2.0,0.0,4.0,3.0,2.0,3.0,0.0,7.0,0.0,4.0,1.0,9.0,0.0,2.0,1.0,0.0,0.0,0.0,0.0,1.0,0.0,1.0,1.0,0.0,0.0,0.0,2.0,1.0,1.0,4.0,1.0,1.0,2.0,2.0,7.0,0.0,2.0,0.0,0.0,2.0,4.0,0.0,2.0,1.0,1.0,1.0,2.0,1.0,2.0,0.0,7.0,2.0,0.0,0.0,1.0,1.0,0.0,2.0,2.0,0.0,1.0,4.0,3.0,0.0,0.0,9.0,7.0,1.0,0.0,0.0,0.0,0.0,1.0,1.0,1.0,4.0,0.0,0.0,0.0,2.0,0.0,1.0,0.0,0.0,1.0,0.0,0.0,0.0,0.0,4.0,0.0,2.0,1.0,1.0,2.0,1.0,11.0,1.0,0.0,0.0,0.0,0.0,0.0,2.0,1.0,2.0,4.0,0.0,0.0,4.0,0.0,10.0,0.0,0.0,0.0,0.0,0.0,0.0,2.0,1.0,0.0,7.0,0.0,0.0,5.0,0.0,3.0,0.0,0.0,0.0,1.0,0.0,0.0,0.0,0.0,0.0,0.0,0.0,6.0,4.0,1.0,2.0,6.0,2.0,4.0,2.0,7.0,2.0,2.0,2.0,2.0,3.0,5.0,8.0,6.0,5.0,2.0,4.0,2.0,2.0,3.0,3.0,4.0,5.0,4.0,0.0,6.0,3.0,3.0,15.0,14.0,9.0,9.0,15.0,11.0,12.0,6.0,7.0,9.0,17.0,8.0,11.0,10.0,9.0,9.0,8.0,5.0,5.0,5.0,5.0,5.0,5.0,5.0,2.0,5.0,2.0,2.0,2.0,3.0,0.0,3.0,3.0,0.0,9.0,1.0,4.0,6.0,0.0,6.0,2.0,1.0,1.0,5.0,4.0,0.0,5.0,3.0,2.0,5.0,4.0,6.0,4.0,4.0,6.0,11.0,2.0,2.0,3.0,2.0,4.0,1.0,6.0,3.0,4.0,3.0,3.0,5.0,3.0,0.0,2.0,9.0,0.0,0.0,1.0,0.0,7.0,0.0,5.0,2.0,5.0,5.0,5.0,4.0,3.0,0.0,5.0,5.0,2.0,5.0,0.0,5.0,5.0,5.0,5.0,5.0,5.0,5.0,3.0,5.0,4.0,1.0,0.0,4.0,4.0,5.0,5.0,5.0,3.0,5.0,5.0,5.0,5.0,1.0,5.0,5.0,5.0,4.0,5.0,4.0,4.0,2.0,4.0,5.0,5.0,5.0,5.0,4.0,5.0,5.0,4.0,5.0,2.0,4.0,4.0,4.0,5.0,5.0,5.0,5.0,5.0,2.0,5.0,4.0,5.0,4.0,5.0,4.0,5.0,5.0,4.0,5.0,4.0,5.0,5.0,5.0,5.0,5.0,4.0,5.0,4.0,5.0,5.0,4.0,5.0,5.0,4.0,4.0,5.0,3.0,4.0,3.0,5.0,5.0,5.0,5.0,5.0,5.0,5.0,5.0,3.0,5.0,5.0,4.0,5.0,2.0,5.0,4.0,3.0,5.0,2.0,5.0,5.0,5.0,5.0,4.0,0.0,5.0,0.0,0.0,0.0,0.0,7.0,4.0,10.0,10.0,28.0,25.0,13.0,6.0,17.0,13.0,4.0,3.0,4.0,4.0,5.0,6.0,9.0,21.0,31.0,8.0,15.0,20.0,18.0,30.0,13.0,14.0,9.0,26.0,19.0,28.0,5.0,6.0,5.0,3.0,23.0,3.0,7.0,15.0,11.0,16.0,16.0,8.0,6.0,15.0,3.0,8.0,20.0,20.0,3.0,15.0,3.0,12.0,3.0,10.0,6.0,1.0,10.0,12.0,3.0,9.0,5.0,6.0,11.0,0.0,7.0,17.0,16.0,1.0,19.0,12.0,20.0,16.0,16.0,11.0,11.0,3.0,12.0,13.0,4.0,5.0,12.0,2.0,1.0,17.0,5.0,3.0,7.0,1.0,15.0,15.0,16.0,3.0,8.0,8.0,11.0,3.0,16.0,10.0,17.0,22.0,24.0,4.0,3.0,26.0,14.0,24.0,24.0,7.0,14.0,16.0,11.0,17.0,11.0,22.0,14.0,14.0,16.0,5.0,12.0,13.0,12.0,2.0,2.0,33.0,30.0,6.0,16.0,16.0,16.0,23.0,10.0,5.0,25.0,3.0,5.0,21.0,24.0,12.0,20.0,14.0,7.0,13.0,16.0,2.0,17.0,20.0,1.0,21.0,32.0,4.0,0.0,13.0,27.0,16.0,15.0,18.0,4.0,4.0,10.0,5.0,13.0,2.0,12.0,7.0,12.0,8.0,9.0,12.0,10.0,10.0,9.0,2.0,15.0,6.0,20.0,6.0,6.0,17.0,0.0,21.0,12.0,22.0,12.0,11.0,0.0,6.0,2.0,25.0,17.0,16.0,7.0,9.0,14.0,16.0,8.0,14.0,30.0,22.0,8.0,4.0,12.0,7.0,8.0,14.0,3.0,20.0,9.0,12.0,14.0,0.0,12.0,10.0,9.0,0.0,15.0,11.0,7.0,4.0,1.0,11.0,6.0,7.0,14.0,16.0,12.0,3.0,12.0,2.0,5.0,9.0,21.0,15.0,12.0,6.0,6.0,4.0,6.0,16.0,26.0,32.0,6.0,17.0,14.0,14.0,2.0,23.0,4.0,8.0,16.0,7.0,6.0,19.0,26.0,12.0,9.0,0.0,22.0,12.0,17.0,15.0,24.0,21.0,15.0,4.0,10.0,5.0,3.0,29.0,15.0,16.0,17.0,11.0,24.0,5.0,10.0,9.0,6.0,18.0,2.0,11.0,7.0,6.0,6.0,12.0,20.0,27.0,9.0,7.0,10.0,14.0,3.0,7.0,12.0,11.0,5.0,12.0,10.0,16.0,5.0,3.0,0.0,8.0,4.0,4.0,16.0,5.0,22.0,10.0,16.0,2.0,10.0,21.0,3.0,6.0,9.0,4.0,13.0,15.0,5.0,13.0,8.0,11.0,15.0,13.0,9.0,25.0,22.0,23.0,7.0,22.0,4.0,12.0,16.0,3.0,12.0,6.0,14.0,11.0,15.0,12.0,12.0,3.0,9.0,9.0,16.0,1.0,11.0,25.0,12.0,12.0,7.0,24.0,7.0,3.0,1.0,1.0,3.0,2.0,1.0,5.0,1.0,0.0,0.0,0.0,0.0,1.0,4.0,1.0,2.0,4.0,0.0,1.0,0.0,1.0,0.0,1.0,1.0,0.0,0.0,5.0,1.0,0.0,1.0,5.0,2.0,,3.0,5.0,5.0,1.0,0.0,0.0,0.0,0.0,3.0,0.0,4.0,3.0,0.0,2.0,0.0,1.0,1.0,0.0,1.0,0.0,1.0,1.0,0.0,1.0,0.0,3.0,1.0,2.0,1.0,1.0,5.0,2.0,1.0,0.0,0.0,1.0,5.0,1.0,0.0,0.0,2.0,0.0,2.0,0.0,1.0,1.0,1.0,3.0,1.0,4.0,0.0,0.0,0.0,0.0,0.0,0.0,5.0,3.0,0.0,0.0,0.0,1.0,2.0,2.0,1.0,0.0,3.0,1.0,3.0,2.0,1.0,0.0,0.0,0.0,0.0,5.0,0.0,3.0,2.0,0.0,1.0,4.0,11.0,1.0,4.0,1.0,2.0,3.0,2.0,2.0,3.0,5.0,11.0,1.0,1.0,0.0,5.0,4.0,4.0,5.6,1.0,0.0,0.0,2.0,7.0,1.0,2.0,1.0,4.0,5.0,3.0,6.0,1.0,5.0,14.0,0.0,5.0,1.0,6.0,0.0,0.0,0.0,0.0,3.0,2.0,4.0,10.0,2.0,6.0,8.0,1.0,5.0,2.0,3.0,4.0,3.0,2.0,6.0,0.0,7.0,6.0,10.0,1.0,4.666666666666667,1.0,3.0,8.0,3.0,0.0,8.0,4.0,0.0,2.0,2.0,6.0,6.0,3.0,2.0,6.0,4.0,5.0,5.0,3.0,2.0,0.0,8.0,1.0,0.0,4.0,6.0,10.0,1.0,2.0,1.0,6.0,6.0,0.0,1.0,2.0,6.0,3.0,0.0,2.0,0.0,1.0,2.0,1.0,2.0,8.0,3.0,3.0,2.0,5.0,5.0,1.0,5.0,14.0,4.0,1.0,2.0,3.0,4.0,3.0,6.0,1.0,12.0,7.0,6.0,8.0,4.0,0.0,1.0,4.0,5.0,9.0,4.0,2.0,2.0,1.0,2.0,4.0,4.0,1.0,6.0,4.0,1.0,6.0,6.0,1.0,2.0,3.0,3.0,4.0,1.0,2.0,6.0,7.0,8.0,1.0,8.0,3.0,9.0,2.0,4.0,7.0,3.0,3.0,13.0,13.0,0.0,0.0,5.0,4.0,3.0,5.0,3.0,5.0,1.0,8.0,6.0,5.0,6.0,1.0,1.0,2.0,0.0,9.0,3.0,7.0,5.0,4.0,2.0,2.0,1.0,4.0,5.0,3.0,9.0,0.0,3.0,18.0,2.0,7.0,8.0,3.0,21.0,8.0,19.0,17.0,20.0,13.0,18.0,17.0,17.0,22.0,4.0,9.0,0.0,2.0,15.0,0.0,4.0,6.0,14.0,22.0,15.0,9.0,9.0,7.0,2.0,4.0,1.0,12.0,3.0,2.0,4.0,3.0,13.0,6.0,4.0,4.0,8.0,5.0,14.0,17.0,0.0,10.0,4.0,12.0,14.0,9.0,10.0,14.0,4.0,4.0,13.0,20.0,12.0,3.0,3.0,1.0,9.0,2.0,5.0,15.0,20.0,8.0,1.0,8.0,29.0,4.0,7.0,9.0,18.0,29.0,27.0,22.0,8.0,4.0,9.0,4.0,9.0,15.0,13.0,8.0,4.0,4.0,20.0,5.0,2.0,8.0,13.0,3.0,0.0,11.0,5.0,0.0,3.0,6.0,3.0,0.0,1.0,10.0,8.0,8.0,6.0,24.0,4.0,2.0,15.0,11.0,10.0,17.0,0.0,13.0,2.0,3.0,5.0,11.0,13.0,3.0,16.0,14.0,17.0,4.0,14.0,19.0,19.0,17.0,19.0,5.0,20.0,11.0,20.0,19.0,10.0,12.0,4.0,4.0,8.0,1.0,3.0,7.0,2.0,1.0,6.0,7.0,5.0,10.0,4.0,9.0,4.0,22.0,15.0,15.0,1.0,15.0,10.0,13.0,5.0,4.0,4.0,17.0,9.0,6.0,2.0,3.0,9.0,10.0,7.0,1.0,2.0,3.0,12.0,14.0,11.0,9.0,15.0,1.0,11.0,13.0,0.0,4.0,3.0,3.0,16.0,10.0,16.0,12.0,1.0,2.0,20.0,11.0,9.0,10.0,10.0,0.0,5.0,2.0,7.0,6.0,4.0,2.0,12.0,15.0,2.0,7.0,14.0,15.0,0.0,18.0,2.0,7.0,15.0,12.0,10.0,15.0,14.0,7.0,5.0,6.0,13.0,9.0,12.0,17.0,4.0,20.0,7.0,18.0,2.0,4.0,5.0,4.0,1.0,0.0,1.0,13.0,7.0,2.0,4.0,20.0,4.0,10.0,0.0,0.0,2.0,12.0,3.0,8.0,0.0,5.0,8.0,6.0,9.0,6.0,9.0,17.0,9.0,3.0,11.0,1.0,10.0,2.0,17.0,2.0,13.0,15.0,20.0,18.0,8.0,7.0,6.0,12.0,8.0,11.0,6.0,10.0,14.0,24.0,9.0,6.0,12.0,7.0,7.0,10.0,6.0,11.0,8.0,10.0,9.0,15.0,9.0,12.0,11.0,11.0,8.0,10.0,5.0,9.0,0.0,0.0,0.0,0.0,0.0,0.0,16.0,0.0,0.0,1.0,4.0,0.0,10.0,23.0,6.0,1.0,3.0,2.0,12.0,5.0,21.0,20.0,3.0,9.0,3.0,0.0,2.0,8.0,8.0,7.0,15.0,13.0,11.0,5.0,2.0,9.0,2.0,0.0,2.0,3.0,12.0,18.0,9.0,16.0,3.0,24.0,1.0,8.0,6.0,6.0,0.0,0.0,9.0,21.0,13.0,7.0,2.0,4.0,3.0,4.0,1.0,2.0,1.0,2.0,16.0,10.0,9.0,25.0,0.0,3.0,5.0,15.0,0.0,5.0,7.0,2.0,4.0,7.0,1.0,15.0,7.0,21.0,2.0,0.0,3.0,25.0,7.0,4.0,4.0,4.0,2.0,1.0,6.0,9.0,3.0,2.0,1.0,2.0,6.0,13.0,46.0,19.0,25.0,7.0,22.0,2.0,0.0,18.0,8.0,6.0,14.0,0.0,25.0,15.0,12.0,13.0,8.0,23.0,7.0,0.0,1.0,1.0,3.0,9.0,5.0,9.0,3.0,2.0,6.0,5.0,2.0,8.0,14.0,11.0,4.0,2.0,11.0,35.0,10.0,7.0,3.0,18.0,9.0,3.0,21.0,1.0,3.0,12.0,3.0,2.0,15.0,39.0,7.0,7.0,3.0,1.0,2.0,4.0,1.0,11.0,11.0,3.0,10.0,3.0,31.0,21.0,4.0,6.0,4.0,10.0,3.0,9.0,2.0,2.0,7.0,3.0,0.0,4.0,18.0,3.0,17.0,7.0,2.0,2.0,6.0,10.0,4.0,18.0,3.0,8.0,4.0,21.0,10.0,2.0,0.0,15.0,1.0,3.0,12.0,2.0,8.0,4.0,1.0,5.0,11.0,9.0,0.0,6.0,6.0,1.0,2.0,5.0,17.0,8.0,8.0,5.0,3.0,6.0,3.0,5.0,5.0,7.0,11.0,2.0,4.0,0.0,22.0,7.0,3.0,3.0,11.0,4.0,1.0,30.0,20.0,5.0,31.0,1.0,6.0,3.0,12.0,4.0,7.5,20.0,7.0,3.0,23.0,2.0,1.0,8.0,8.0,0.0,6.0,7.0,7.0,18.0,2.0,3.0,6.0,1.0,14.0,1.0,21.0,28.0,6.0,14.0,4.0,6.0,11.0,27.0,3.0,7.0,2.0,8.0,7.0,32.0,0.0,5.0,2.0,16.0,4.0,7.0,16.0,2.0,0.0,0.0,25.0,4.0,17.0,14.0,0.0,9.0,16.0,0.0,1.0,1.0,8.0,6.0,31.0,2.0,7.0,1.0,6.0,2.0,4.0,10.0,2.0,11.0,4.0,5.0,3.0,0.0,2.0,5.0,5.0,10.0,0.0,3.0,12.0,8.0,5.0,1.0,5.0,4.0,1.0,2.0,0.0,7.0,11.0,3.0,2.0,4.0,6.0,9.0,4.0,10.0,2.0,3.0,10.0,4.0,5.0,4.0,1.0,13.0,12.0,1.0,14.0,13.0,4.0,1.0,2.0,35.0,0.0,4.0,3.0,17.0,4.0,12.0,1.0,1.0,12.0,8.0,2.0,1.0,3.0,2.0,7.0,8.0,6.0,4.0,5.0,12.0,8.0,4.0,4.0,8.0,5.0,5.0,4.0,25.0,6.0,16.0,20.0,9.0,47.0,6.0,4.0,3.0,5.0,5.0,1.0,3.0,0.0,15.0,7.0,0.0,4.0,3.0,9.0,17.0,26.0,7.0,2.0,18.0,1.0,11.0,4.0,6.0,17.0,11.0,7.0,1.0,16.0,8.0,1.0,5.0,25.0,11.0,3.0,5.0,6.0,0.0,5.0,9.0,10.0,11.0,4.0,2.0,3.0,10.0,0.0,13.0,20.0,4.0,15.0,0.0,8.0,13.0,6.0,17.0,5.0,17.0,6.0,18.0,3.0,23.0,8.0,11.0,22.0,8.0,0.0,5.0,13.0,2.0,15.0,10.0,5.0,14.0,17.0,26.0,32.0,8.0,26.0,5.0,9.0,16.0,5.0,2.0,6.0,5.0,1.0,2.0,6.0,3.0,1.0,3.0,7.0,5.0,1.0,6.0,13.0,8.0,7.0,4.0,2.0,13.0,0.0,3.0,20.0,8.0,7.0,1.0,3.0,13.0,15.0,17.0,8.0,2.0,2.0,6.0,8.0,3.0,16.0,2.0,2.0,4.0,17.0,9.0,22.0,6.0,5.0,1.0,3.0,10.0,0.0,7.0,0.0,3.0,5.0,13.0,6.0,5.0,4.0,14.0,8.0,8.0,3.0,4.0,18.0,4.0,18.0,2.0,9.0,9.0,2.0,2.0,7.0,11.0,2.0,4.0,1.0,12.0,4.0,0.0,11.0,8.0,2.0,5.0,15.0,46.0,8.0,11.0,11.0,7.375,14.0,8.0,8.0,4.0,7.0,3.0,2.0,12.0,16.0,6.0,5.0,3.0,3.0,3.0,14.0,17.0,1.0,6.0,9.0,2.0,2.0,13.0,4.0,3.0,13.0,1.0,6.0,6.0,2.0,4.0,8.0,3.0,8.0,8.0,3.0,22.0,8.0,2.0,9.0,0.0,8.0,3.0,4.0,3.0,19.0,6.0,2.0,4.0,8.0,0.0,7.0,5.0,6.0,0.0,1.0,4.0,10.0,4.0,7.0,9.0,1.0,4.0,3.0,11.0,4.0,15.0,2.0,8.0,5.0,1.0,6.0,9.0,14.0,0.0,3.0,3.0,0.0,2.0,1.0,0.0,7.0,6.0,9.0,5.0,7.0,21.0,24.0,23.0,23.0,2.0,1.0,0.0,9.0,9.0,7.0,9.0,1.0,14.0,2.0,5.0,2.0,6.0,9.0,2.0,8.0,29.0,3.0,8.0,4.0,5.0,6.0,9.0,3.0,2.0,3.0,3.0,2.0,8.0,1.0,12.0,14.0,7.0,17.0,8.0,12.0,5.0,7.0,28.0,3.0,8.0,6.0,14.0,21.0,2.0,4.0,2.0,1.0,2.0,9.0,11.0,3.0,8.0,8.0,4.0,30.0,3.0,12.0,4.0,11.0,15.0,8.0,1.0,4.0,0.0,39.0,6.0,0.0,7.0,17.0,7.0,0.0,4.0,8.0,1.0,2.0,10.0,1.0,19.0,4.0,2.0,8.0,9.0,15.0,4.0,19.0,8.0,2.0,5.0,3.0,6.0,3.0,1.0,9.0,1.0,1.0,1.0,2.0,19.0,5.0,13.0,18.0,7.0,16.0,4.0,21.0,20.0,47.0,5.0,2.0,4.0,4.0,12.0,11.0,6.0,4.0,2.0,16.0,25.0,7.0,7.0,9.0,2.0,10.0,9.0,3.0,13.0,3.0,3.0,25.0,6.0,12.0,7.0,4.0,10.0,31.0,25.0,2.0,9.0,8.0,12.0,5.0,8.0,1.0,8.0,21.0,7.0,8.0,2.0,1.0,31.0,3.0,6.0,3.0,4.0,9.0,5.0,2.0,5.0,9.0,9.0,5.0,4.0,10.0,12.0,21.0,5.0,4.0,3.0,2.0,9.0,18.0,5.0,7.0,6.0,1.0,7.0,8.0,2.0,2.0,21.0,7.0,3.0,11.0,8.0,7.0,6.0,7.0,9.0,1.0,10.0,10.0,16.0,20.0,5.0,6.0,5.0,7.0,7.0,2.0,3.0,3.0,6.0,3.0,5.0,16.0,15.0,12.0,6.0,8.0,0.0,2.0,12.0,6.0,2.0,14.0,5.0,4.0,22.0,6.0,8.0,7.0,4.0,2.0,1.0,1.0,2.0,3.0,0.0,4.0,9.0,8.0,44.0,6.0,5.0,3.0,24.0,35.0,3.0,30.0,15.0,13.0,3.0,3.0,5.0,1.0,5.0,2.0,5.0,12.0,7.0,14.0,2.0,4.0,8.0,13.0,10.0,3.0,12.0,1.0,3.0,11.0,8.0,23.0,11.0,5.0,3.0,16.0,9.0,1.0,3.0,2.0,2.0,9.0,16.0,20.0,6.0,3.0,9.0,12.0,16.0,3.0,6.0,2.0,3.0,10.0,9.0,3.0,10.0,16.0,3.0,9.0,20.0,10.0,0.0,9.0,1.0,12.0,10.0,3.0,12.0,23.0,3.0,10.0,5.0,9.0,7.0,6.0,11.0,37.0,15.0,10.0,11.0,20.0,5.0,3.0,22.0,3.0,5.5,6.0,0.0,4.0,4.0,12.0,9.0,5.0,12.0,5.0,4.0,10.0,11.0,17.0,3.0,1.0,24.0,9.0,2.0,11.0,3.0,4.0,0.0,5.5,6.5,2.0,13.0,2.0,6.0,6.0,28.0,15.0,13.0,0.0,2.0,11.0,0.0,4.0,0.0,12.0,32.0,23.0,3.0,4.0,15.0,6.0,6.0,14.0,10.0,9.0,14.0,5.0,0.0,19.0,0.0,16.0,11.0,10.0,9.5,22.0,10.0,6.0,2.0,34.0,57.0,8.0,6.0,3.0,13.0,5.0,4.0,1.0,9.0,22.0,19.0,2.0,23.0,16.0,6.0,3.0,3.0,9.0,18.0,18.0,20.0,5.0,17.0,20.0,8.0,1.0,3.0,2.0,7.0,5.0,4.0,15.0,1.0,9.0,0.0,18.0,16.0,9.0,2.0,17.0,4.0,0.0,28.0,2.0,,10.0,1.0,11.0,0.0,30.0,19.0,4.0,11.0,9.0,14.0,6.0,20.0,17.0,4.0,3.0,6.0,3.0,2.0,1.0,1.0,5.0,0.0,0.0,18.0,40.0,18.0,3.0,6.0,0.0,2.0,7.0,11.0,3.0,6.0,4.0,5.0,9.0,3.0,7.0,4.0,5.0,13.0,5.0,5.0,18.0,28.0,10.0,6.0,11.0,5.0,5.0,11.0,7.0,9.0,17.0,8.0,11.0,14.0,3.0,6.0,1.0,4.0,6.0,22.0,4.0,7.0,24.0,1.0,17.0,16.0,5.0,5.0,7.0,1.0,3.0,26.0,34.0,7.0,14.0,4.0,7.0,5.0,30.0,24.0,3.0,5.0,0.0,13.0,5.0,6.0,0.0,3.0,5.0,7.0,0.0,3.0,8.0,3.0,3.0,8.0,3.0,3.0,1.0,2.0,1.0,8.0,14.0,10.0,3.0,6.0,25.0,14.0,7.0,2.0,23.0,23.0,7.0,6.0,18.0,7.0,9.0,18.0,4.0,5.0,1.0,15.0,1.0,2.0,7.0,10.0,4.0,2.0,0.0,15.0,12.0,5.0,2.0,6.0,8.0,3.0,6.0,2.0,1.0,10.0,3.0,8.0,4.0,5.0,2.0,7.0,20.0,3.0,5.0,15.0,7.0,6.0,8.0,3.0,7.0,37.0,0.0,16.0,11.0,6.0,2.0,14.0,1.0,7.0,0.0,8.0,10.0,1.0,3.0,13.0,0.0,15.0,7.0,2.0,0.0,3.0,1.0,3.0,2.0,1.0,3.0,2.0,1.0,0.0,7.0,5.0,0.0,17.0,2.0,0.0,3.0,2.0,6.0,3.0,10.0,15.0,0.0,0.0,0.0,12.0,11.0,16.0,17.0,2.0,1.0,4.0,8.0,2.0,26.0,2.0,2.0,12.0,10.0,19.0,0.0,5.0,9.0,4.0,1.0,2.0,2.0,2.0,2.0,7.0,16.0,11.0,27.0,4.0,18.0,0.0,23.0,25.0,22.0,11.0,6.0,18.0,15.0,3.0,7.0,16.0,1.0,9.0,15.0,10.0,14.0,10.0,7.0,15.0,9.0,0.0,3.0,0.0,15.0,0.0,0.0,15.0,19.0,12.0,3.0,6.0,1.0,9.0,3.0,1.0,5.0,4.0,19.0,1.0,2.0,3.0,32.0,0.0,4.0,4.0,9.0,6.0,22.0,5.0,9.0,8.0,0.0,7.0,1.0,22.0,18.0,4.0,7.0,2.0,14.0,8.0,34.0,14.0,1.0,6.0,20.0,12.0,16.0,12.0,1.0,10.0,25.0,27.0,10.0,9.0,17.0,29.0,30.0,17.0,28.0,7.0,18.0,11.0,1.0,17.0,11.0,13.0,12.0,25.0,10.0,11.0,20.0,22.0,8.0,0.0,6.0,2.0,33.0,27.0,17.0,23.0,20.0,13.0,22.0,26.0,7.0,14.0,13.0,13.0,5.0,6.0,23.0,23.0,2.0,5.0,15.0,8.0,8.0,15.0,21.0,4.0,9.0,4.0,7.0,20.0,17.0,9.0,11.0,13.0,20.0,1.0,7.0,13.0,8.0,13.0,13.0,27.0,30.0,7.0,7.0,0.0,14.0,7.0,1.0,3.0,19.0,9.0,14.0,10.0,9.0,13.0,12.0,17.0,4.0,21.0,9.0,0.0,2.0,13.0,17.0,11.0,13.0,24.0,3.0,17.0,4.0,4.0,6.0,9.0,13.0,14.0,4.0,6.0,0.0,6.0,2.0,8.0,10.0,31.0,12.0,14.0,3.0,16.0,29.0,34.0,5.0,31.0,3.0,15.0,16.0,9.0,13.0,10.0,16.0,8.0,7.0,7.0,29.0,13.0,20.0,3.0,22.0,25.0,5.0,15.0,6.0,28.0,10.0,11.0,21.0,6.0,8.0,11.0,27.0,1.0,11.0,12.0,21.0,15.0,11.0,4.0,3.0,23.0,14.0,2.0,19.0,8.0,13.0,21.0,12.0,12.0,6.0,16.0,33.0,9.0,14.0,22.0,19.0,11.0,2.0,8.0,18.0,23.0,20.0,17.0,2.0,8.0,1.0,23.0,17.0,11.0,13.0,9.0,6.0,23.0,21.0,22.0,24.0,11.0,12.0,6.0,10.0,12.0,0.0,0.0,12.0,11.0,13.0,11.0,9.0,21.0,23.0,10.0,8.0,17.0,9.0,26.0,2.0,5.0,1.0,20.0,6.0,10.0,9.0,16.0,12.0,18.0,9.0,7.0,4.0,15.0,4.0,6.0,10.0,12.0,7.0,11.0,8.0,13.0,17.0,11.0,17.0,8.0,20.0,17.0,10.0,21.0,11.0,8.0,11.0,2.0,10.0,7.0,18.0,5.0,13.0,24.0,7.0,9.0,13.0,6.0,7.0,4.0,15.0,6.0,12.0,19.0,13.0,22.0,10.0,11.0,10.0,7.0,7.0,6.0,1.0,24.0,8.0,19.0,22.0,13.0,16.0,25.0,19.0,22.0,20.0,8.0,12.0,4.0,6.0,21.0,20.0,20.0,7.0,3.0,7.0,2.0,8.0,4.0,5.0,9.0,2.0,6.0,6.0,7.0,9.0,11.0,8.0,6.0,7.0,8.0,16.0,22.0,4.0,7.0,8.0,15.0,13.0,8.0,3.0,8.0,6.0,9.0,7.0,6.0,5.0,5.0,11.0,7.0,5.0,1.0,6.0,6.0,2.0,5.0,0.0,1.0,7.0,0.0,6.0,1.0,1.0,3.0,0.0,1.0,1.0,20.0,21.0,1.0,14.0,11.0,11.0,16.0,8.0,6.0,15.0,7.0,2.0,13.0,8.0,4.0,0.0,9.0,12.0,3.0,1.0,2.0,0.0,5.0,6.0,12.0,4.0,8.0,2.0,17.0,4.0,2.0,4.0,10.0,7.0,13.0,0.0,0.0,8.0,9.0,8.0,5.0,3.0,4.0,5.0,7.0,12.0,11.0,18.0,0.0,5.0,6.0,4.0,4.0,5.0,7.0,4.0,6.0,3.0,2.0,4.0,3.0,2.0,4.0,8.0,2.0,10.0,9.0,6.0,13.0,0.0,3.0,3.0,1.0,7.0,7.0,0.0,,6.0,9.0,10.0,1.0,2.0,4.0,2.0,3.0,3.0,2.0,2.0,1.0,1.0,3.0,7.0,5.0,4.0,7.0,9.0,7.0,3.0,2.0,2.0,3.0,5.0,9.0,28.0,14.0,0.0,6.0,2.0,5.0,13.0,18.0,7.0,2.0,,6.0,7.0,12.0,12.0,12.0,8.0,8.0,,0.0,16.0,0.0,3.0,8.0,6.0,8.0,17.0,10.0,17.0,18.0,9.0,13.0,6.0,2.0,5.0,4.0,6.0,20.0,12.0,8.0,2.0,12.0,5.0,4.0,3.0,8.0,10.0,24.0,4.0,7.0,1.0,3.0,18.0,2.0,3.0,2.0,8.0,14.0,6.0,5.0,3.0,10.0,4.0,7.0,15.0,8.0,18.0,4.0,7.0,4.0,16.0,11.0,10.0,11.0,10.0,7.0,6.0,19.0,14.0,9.0,0.0,8.0,11.0,8.0,11.0,9.0,14.0,4.0,13.0,2.0,10.0,3.0,13.0,7.0,14.0,18.0,10.0,14.0,10.0,2.0,19.0,4.0,6.0,10.0,16.0,,2.0,3.0,10.0,5.0,,5.0,10.0,12.0,6.0,14.0,3.0,14.0,8.0,15.0,17.0,13.0,7.0,9.0,2.0,11.0,10.0,3.0,2.0,9.0,2.0,3.0,15.0,19.0,3.0,4.0,1.0,16.0,9.0,5.0,3.0,23.0,12.0,19.0,8.0,7.0,1.0,0.0,2.0,15.0,7.0,10.0,10.0,12.0,6.0,7.0,0.0,9.0,11.0,6.0,10.0,1.0,10.0,4.0,10.0,12.0,7.0,2.0,6.0,5.0,1.0,1.0,9.0,8.0,4.0,5.0,4.0,5.0,4.0,4.0,6.0,4.0,3.0,7.0,0.0,6.0,9.0,9.0,0.0,5.0,4.0,4.0,5.0,4.0,1.0,0.0,3.0,4.0,8.0,5.0,5.0,3.0,6.0,2.0,4.0,4.0,6.0,10.0,0.0,2.0,14.0,6.0,7.0,17.0,7.0,1.0,0.0,7.0,5.0,2.0,9.0,18.0,5.0,5.0,13.0,2.0,7.0,18.0,11.0,8.0,7.0,17.0,4.0,11.0,0.0,6.0,20.0,24.0,18.0,1.0,3.0,1.0,11.0,0.0,0.0,9.0,4.0,0.0,0.0,6.0,6.0,9.0,1.0,9.0,13.0,6.0,6.0,5.0,3.0,2.0,5.0,5.0,0.0,15.0,3.0,9.0,3.0,1.0,4.0,0.0,6.0,5.0,12.0,5.0,11.0,2.0,0.0,7.0,9.0,8.0,11.0,0.0,1.0,7.0,3.0,8.0,15.0,6.0,0.0,18.0,9.0,11.0,1.0,2.0,6.0,8.0,9.0,6.0,10.0,9.0,7.0,2.0,8.0,8.0,5.0,3.0,7.0,14.0,5.0,9.0,15.0,18.0,9.0,8.0,11.0,9.0,21.0,1.0,7.0,13.0,5.0,1.0,6.0,0.0,4.0,8.0,6.0,9.0,4.0,9.0,19.0,4.0,12.0,4.0,4.0,2.0,1.0,8.0,8.0,6.0,11.0,5.0,13.0,10.0,12.0,11.0,17.0,2.0,4.0,12.0,4.0,9.0,2.0,6.0,6.0,1.0,6.0,15.0,9.0,10.0,6.0,6.0,8.0,4.0,7.0,2.0,6.0,9.0,2.0,2.0,1.0,6.0,7.0,5.0,1.0,9.0,11.0,9.0,8.0,0.0,6.0,2.0,0.0,0.0,5.0,5.0,8.0,0.0,12.0,21.0,1.0,4.0,3.0,1.0,2.0,1.0,18.0,1.0,1.0,0.0,3.0,0.0,4.0,24.0,4.0,3.0,0.0,11.0,7.0,4.0,0.0,15.0,2.0,0.0,0.0,5.0,11.0,0.0,11.0,1.0,2.0,15.0,7.0,13.0,14.0,2.0,1.0,0.0,1.0,0.0,0.0,0.0,7.0,0.0,3.0,4.0,3.0,3.0,10.0,2.0,4.0,0.0,3.0,1.0,1.0,3.0,0.0,9.0,1.0,15.0,1.0,3.0,5.0,3.0,5.0,8.0,0.0,0.0,18.0,1.0,2.0,2.0,1.0,6.0,1.0,4.0,2.0,2.0,0.0,3.0,8.0,1.0,2.0,8.0,10.0,8.0,3.0,0.0,6.0,3.0,0.0,12.0,6.0,8.0,2.0,27.0,6.0,19.0,40.0,16.0,14.0,12.0,10.0,13.0,14.0,22.0,12.0,14.0,19.0,14.0,11.0,7.0,25.0,8.0,14.0,16.0,10.0,0.0,8.0,4.0,10.0,20.0,10.0,9.0,2.0,23.0,0.0,3.0,33.0,3.0,4.0,9.0,4.0,8.0,4.0,2.0,2.0,8.0,18.0,15.0,34.0,8.0,6.0,15.0,0.0,1.0,2.0,19.0,0.0,0.0,3.0,1.0,15.0,20.0,1.0,16.0,25.0,2.0,3.0,17.0,13.0,3.0,0.0,10.0,10.0,5.0,1.0,1.0,3.0,3.0,4.0,3.0,10.0,4.0,8.0,3.0,6.0,0.0,9.0,1.0,3.0,4.0,5.0,15.0,0.0,8.0,12.0,9.0,2.0,13.0,17.0,16.0,27.0,0.0,13.0,6.0,5.0,5.0,15.0,8.0,13.0,8.0,6.0,9.0,0.0,9.0,7.0,3.0,7.0,9.0,11.0,7.0,1.0,4.0,0.0,9.0,2.0,12.0,15.0,7.0,6.0,6.0,20.0,22.0,4.0,5.0,3.0,4.0,7.0,3.0,1.0,2.0,4.0,4.0,8.0,14.0,22.0,15.0,10.0,9.0,20.0,29.0,9.0,9.0,3.0,7.0,5.0,6.0,7.0,19.0,10.0,6.0,9.0,7.0,1.0,13.0,16.0,4.0,11.0,0.0,17.0,2.0,4.0,10.0,0.0,1.0,9.0,14.0,5.0,11.0,2.0,0.0,6.0,1.0,3.0,12.0,11.0,24.0,1.0,8.0,0.0,4.0,7.0,9.0,3.0,1.0,3.0,0.0,0.0,4.0,4.0,7.0,0.0,8.0,4.0,0.0,1.0,1.0,2.0,0.0,0.0,5.0,14.0,15.0,0.0,4.0,8.0,1.0,11.0,0.0,4.0,0.0,5.0,0.0,8.0,1.0,8.0,2.0,1.0,4.0,0.0,6.0,7.0,14.0,9.0,4.0,8.0,5.0,14.0,4.0,14.0,12.0,3.0,8.0,5.0,7.0,7.0,0.0,13.0,15.0,13.0,5.0,8.0,0.0,0.0,0.0,16.0,8.0,8.0,7.0,6.0,8.0,5.0,7.0,4.0,9.0,7.0,9.0,5.0,5.0,4.0,5.0,8.0,6.0,3.0,7.0,4.0,6.0,3.0,5.0,6.0,6.0,10.0,12.0,8.0,3.0,10.0,5.0,7.0,6.0,2.0,8.0,5.0,4.0,5.0,6.0,6.0,3.0,6.0,4.0,8.0,5.0,3.0,2.0,6.0,5.0,3.0,2.0,2.0,11.0,6.0,5.0,9.0,4.0,4.0,6.0,6.0,5.0,3.0,5.0,8.0,6.0,5.0,6.0,5.0,6.0,13.0,10.0,3.0,7.0,12.0,14.0,8.0,8.0,0.0,9.0,5.0,5.0,12.0,4.0,4.0,5.0,4.0,0.0,18.0,20.0,3.0,5.0,14.0,3.0,12.0,2.0,12.0,22.0,13.0,6.0,2.0,17.0,4.0,13.0,15.0,10.0,11.0,8.0,15.0,0.0,0.0,15.0,18.0,8.0,11.0,0.0,5.0,7.0,3.0,8.0,6.0,13.0,6.0,6.0,9.0,7.0,6.0,4.0,6.0,14.0,5.0,9.0,16.0,16.0,20.0,7.0,18.0,16.0,9.0,7.0,8.0,7.0,7.0,9.0,10.0,14.0,0.0,13.0,8.0,14.0,5.0,8.0,13.0,6.0,3.0,3.0,14.0,8.0,5.0,10.0,9.0,8.0,16.0,9.0,9.0,7.0,16.0,22.0,22.0,4.0,9.0,16.0,9.0,11.0,9.0,5.0,13.0,14.0,9.0,12.0,5.0,19.0,12.0,15.0,5.0,10.0,8.0,11.0,7.0,5.0,6.0,11.0,11.0,12.0,5.0,11.0,15.0,7.0,14.0,15.0,17.0,14.0,3.0,4.0,10.0,1.0,3.0,11.0,11.0,2.0,17.0,13.0,20.0,1.0,14.0,10.0,9.0,3.0,0.0,8.0,8.0,2.0,10.0,7.0,0.0,6.0,8.0,18.0,17.0,8.0,13.0,2.0,10.0,10.0,7.0,16.0,9.0,9.0,6.0,5.0,5.0,9.0,4.0,18.0,4.0,11.0,3.0,10.0,7.0,14.0,11.0,5.0,1.0,10.0,3.0,5.0,2.0,8.0,9.0,16.0,9.0,11.0,4.0,10.0,8.0,5.0,3.0,5.0,5.0,5.0,5.0,3.0,17.0,9.0,14.0,9.0,9.0,10.0,3.0,8.0,4.0,1.0,3.0,8.0,6.0,14.0,0.0,8.0,14.0,13.0,2.0,4.0,2.0,2.0,1.0,7.0,4.0,14.0,14.0,6.0,9.0,6.0,6.0,7.0,7.0,2.0,10.0,16.0,16.0,6.0,1.0,7.0,12.0,4.0,0.0,5.0,1.0,8.0,8.0,7.0,12.0,13.0,11.0,12.0,13.0,7.0,3.0,6.0,9.0,8.0,9.0,8.0,6.0,4.0,4.0,6.0,9.0,12.0,2.0,6.0,12.0,3.0,7.0,7.0,4.0,10.0,9.0,10.0,6.0,10.0,10.0,2.0,5.0,0.0,11.0,1.0,12.0,4.0,6.0,12.0,15.0,5.0,8.0,5.0,3.0,11.0,9.0,7.0,10.0,2.0,7.0,16.0,3.0,0.0,2.0,0.0,1.0,0.0,0.0,0.0,1.0,0.0,3.0,0.0,0.0,0.0,1.0,2.0,5.0,1.0,0.0,0.0,2.0,0.0,0.0,5.0,0.0,2.0,1.0,0.0,5.0,0.0,1.0,0.0,3.0,0.0,5.0,4.0,1.0,1.0,0.0,0.0,0.0,0.0,3.0,3.0,2.0,0.0,1.0,0.0,0.0,5.0,3.0,2.0,0.0,2.0,0.0,0.0,1.0,3.0,5.0,2.0,0.0,4.0,0.0,0.0,1.0,2.0,2.0,3.0,0.0,0.0,1.0,0.0,4.0,1.0,2.0,3.0,3.0,0.0,1.0,0.0,2.0,4.0,4.0,17.0,4.0,4.0,3.0,2.0,1.0,4.0,3.0,17.0,1.0,4.0,2.0,1.0,13.0,1.0,0.0,4.0,0.0,7.0,9.0,4.0,24.0,4.0,16.0,1.0,5.0,11.0,3.0,6.0,3.0,1.0,6.0,2.0,3.0,1.0,0.0,0.0,6.0,1.0,5.0,6.0,6.0,0.0,9.0,2.0,5.0,56.0,7.0,16.0,0.0,0.0,9.0,13.0,2.0,13.0,7.0,4.0,1.0,6.0,7.0,2.0,0.0,2.0,13.0,5.0,11.0,1.0,10.0,1.0,4.0,3.0,7.0,1.0,3.0,14.0,12.0,7.0,7.0,7.0,6.0,26.0,2.0,0.0,1.0,0.0,1.0,4.0,1.0,0.0,1.0,2.0,0.0,1.0,9.0,19.0,1.0,1.0,18.0,7.0,5.0,17.0,12.0,8.0,0.0,5.0,2.0,14.0,15.0,14.0,24.0,2.0,6.0,8.0,5.0,4.0,10.0,1.0,1.0,2.0,15.0,3.0,14.0,4.0,5.0,0.0,11.0,20.0,0.0,5.0,0.0,10.0,2.0,6.0,4.0,15.0,4.0,15.0,30.0,2.0,1.0,0.0,1.0,8.0,3.0,7.0,12.0,1.0,4.0,9.0,12.0,3.0,4.0,13.0,0.0,10.0,2.0,1.0,4.0,0.0,25.0,2.0,11.0,33.0,1.0,10.0,2.0,20.0,14.0,12.0,1.0,0.0,1.0,1.0,9.0,5.0,3.0,3.0,2.0,4.0,6.0,16.0,1.0,3.0,8.0,5.0,16.0,3.0,7.0,2.0,4.0,1.0,6.0,6.0,28.0,1.0,3.0,1.0,3.0,4.0,5.0,0.0,1.0,6.0,24.0,14.0,13.0,5.0,5.0,8.0,16.0,2.0,10.0,9.0,7.0,9.0,3.0,4.0,5.0,5.0,1.0,11.0,6.0,4.0,0.0,3.0,2.0,0.0,15.0,5.0,5.0,0.0,5.0,2.0,3.0,4.0,4.0,0.0,5.0,1.0,3.0,10.0,4.0,6.0,6.0,1.0,0.0,3.0,11.0,1.0,0.0,1.0,12.0,3.0,0.0,12.0,11.0,2.0,0.0,1.0,8.0,18.0,10.0,1.0,11.0,1.0,7.0,0.0,6.0,3.0,7.0,3.0,10.0,10.0,7.0,0.0,10.0,7.0,11.0,1.0,4.0,3.0,6.0,6.0,0.0,0.0,13.0,7.0,1.0,8.0,6.0,1.0,1.0,6.0,1.0,13.0,7.0,2.0,2.0,7.0,2.0,4.0,3.0,3.0,0.0,3.0,1.0,0.0,16.0,4.0,8.0,4.0,6.0,0.0,2.0,5.0,0.0,10.0,1.0,6.0,0.0,1.0,1.0,15.0,0.0,3.0,11.0,7.0,4.0,5.0,1.0,0.0,0.0,3.0,5.0,5.0,13.0,10.0,3.0,3.0,13.0,2.0,7.0,3.0,4.0,10.0,3.0,0.0,3.0,0.0,2.0,3.0,2.0,2.0,6.0,2.0,3.0,2.0,8.0,26.0,7.0,12.0,15.0,9.0,3.0,0.0,8.0,17.0,10.0,16.0,18.0,1.0,2.0,0.0,1.0,11.0,0.0,1.0,0.0,0.0,1.0,3.0,0.0,0.0,2.0,0.0,2.0,9.0,5.0,0.0,1.0,1.0,1.0,2.0,0.0,1.0,0.0,0.0,1.0,2.0,0.0,3.0,1.0,0.0,2.0,0.0,0.0,0.0,1.0,4.0,0.0,0.0,3.0,0.0,0.0,0.0,1.0,1.0,0.0,3.0,2.0,1.0,1.0,0.0,1.0,0.0,0.0,1.0,1.0,0.0,0.0,1.0,3.0,1.0,3.0,4.0,2.0,0.0,0.0,2.0,1.0,3.0,0.0,2.0,0.0,1.0,0.0,0.0,0.0,1.0,4.0,0.0,1.0,0.0,1.0,2.0,7.0,10.0,4.0,12.0,7.0,6.0,10.0,5.0,5.0,5.0,5.0,5.0,5.0,5.0,5.0,2.0,5.0,5.0,3.0,2.0,5.0,5.0,2.0,5.0,5.0,5.0,5.0,5.0,5.0,5.0,5.0,1.0,5.0,5.0,5.0,5.0,5.0,5.0,5.0,5.0,5.0,3.0,4.0,5.0,5.0,5.0,5.0,1.0,0.0,0.0,0.0,0.0,2.0,0.0,1.0,0.0,2.0,0.0,2.0,0.0,3.0,3.0,0.0,4.0,0.0,1.0,1.0,1.0,3.0,4.0,0.0,0.0,0.0,0.0,3.0,0.0,1.0,3.0,2.0,2.0,1.0,0.0,3.0,2.0,5.0,1.0,1.0,3.0,0.0,2.0,1.0,0.0,1.0,2.0,1.0,4.0,7.0,2.0,6.0,5.0,3.0,0.0,4.0,1.0,0.0,6.0,4.0,1.0,1.0,0.0,1.0,0.0,0.0,0.0,1.0,0.0,2.0,1.0,0.0,2.0,0.0,4.0,2.0,0.0,0.0,1.0,1.0,0.0,0.0,0.0,0.0,1.0,4.0,5.0,1.0,3.0,1.0,1.0,1.0,2.0,2.0,3.0,0.0,1.0,2.0,1.0,0.0,0.0,1.0,0.0,1.0,0.0,0.0,2.0,6.0,4.0,0.0,1.0,0.0,1.0,1.0,9.0,0.0,1.0,3.0,0.0,0.0,0.0,1.0,2.0,1.0,8.0,0.0,0.0,0.0,6.0,3.0,0.0,0.0,5.0,1.0,2.0,1.0,3.0,5.0,3.0,3.0,1.0,0.0,1.0,0.0,0.0,7.0,0.0,0.0,3.0,0.0,2.0,4.0,3.0,1.0,0.0,2.0,2.0,0.0,4.0,0.0,0.0,0.0,2.0,5.0,3.0,2.0,4.0,2.0,3.0,0.0,1.0,1.0,2.0,0.0,0.0,1.0,4.0,2.0,1.0,0.0,1.0,1.0,3.0,1.0,2.0,4.0,1.0,4.0,0.0,2.0,0.0,2.0,0.0,4.0,1.0,1.0,3.0,2.0,1.0,4.0,0.0,5.0,5.0,0.0,5.0,12.0,8.0,7.0,4.0,3.0,4.0,9.0,10.0,13.0,6.0,8.0,8.0,8.0,10.0,13.0,10.0,4.0,19.0,7.0,5.0,5.0,13.0,6.0,28.0,4.0,6.0,9.0,13.0,9.0,8.0,16.0,14.0,15.0,11.0,13.0,12.0,10.0,0.0,14.0,7.0,9.0,9.0,7.0,5.0,3.0,2.0,5.0,7.0,0.0,29.0,3.0,1.0,4.0,0.0,1.0,0.0,9.0,0.0,0.0,21.0,18.0,4.0,32.0,0.0,11.0,9.0,1.0,1.0,22.0,1.0,4.0,0.0,13.0,32.0,30.0,26.0,23.0,30.0,0.0,33.0,2.0,2.0,6.0,38.0,0.0,0.0,2.0,0.0,20.0,2.0,31.0,39.0,12.0,0.0,0.0,17.0,26.0,38.0,3.0,4.0,0.0,0.0,0.0,0.0,0.0,2.0,2.0,2.0,1.0,0.0,3.0,21.0,30.0,2.0,0.0,29.0,39.0,15.0,19.0,0.0,20.0,0.0,0.0,15.0,31.0,0.0,3.0,0.0,15.0,0.0,0.0,0.0,20.0,13.0,12.0,0.0,11.0,1.0,0.0,4.0,18.0,36.0,0.0,0.0,19.0,0.0,0.0,21.0,3.0,5.0,26.0,1.0,3.0,5.0,5.0,33.0,0.0,32.0,10.0,0.0,3.0,3.0,1.0,3.0,6.0,3.0,3.0,0.0,2.0,2.0,4.0,3.0,1.0,0.0,3.0,4.0,1.0,0.0,3.0,0.0,1.0,3.0,1.0,2.0,2.0,3.0,1.0,9.0,1.0,3.0,3.0,0.0,0.0,2.0,1.0,2.0,4.0,1.0,3.0,2.0,3.0,1.0,5.0,2.0,4.0,3.0,0.0,1.0,3.0,0.0,5.0,0.0,0.0,0.0,0.0,0.0,0.0,,,,,,,,,,,,5.0,1.0,0.0,3.0,4.0,,2.0,1.0,0.0,2.0,0.0,3.0,2.0,,4.0,1.0,5.0,,5.0,1.0,4.0,4.0,2.0,1.0,,1.0,3.0,,2.0,0.0,3.0,2.0,2.0,,1.0,1.0,2.0,,5.0,4.0,3.0,,1.0,4.0,5.0,4.5,0.0,3.0,2.0,,2.0,0.0,1.0,4.0,3.0,0.0,,1.0,5.0,5.0,0.0,2.0,3.0,,0.0,,2.0,0.0,,5.0,0.0,4.0,1.0,0.0,2.0,,2.0,1.0,2.0,1.0,2.0,1.0,1.0,1.0,4.0,5.0,3.0,4.0,2.0,2.0,0.0,4.0,3.0,0.0,5.0,3.0,5.0,2.0,5.0,3.0,5.0,5.0,1.0,4.0,1.0,0.0,0.0,0.0,2.0,0.0,5.0,0.0,0.0,3.0,,,,,1.0,1.0,,,,0.0,,3.0,3.0,5.0,2.0,5.0,1.0,1.0,2.0,2.0,1.0,3.0,0.0,2.0,2.0,0.0,2.0,0.0,1.0,1.0,0.0,0.0,3.0,0.0,0.0,0.0,1.0,1.0,1.0,3.0,,,,,2.0,,2.0,,0.0,1.0,4.0,3.0,2.0,0.0,,4.0,2.0,1.0,1.0,0.0,1.0,4.0,5.0,1.0,0.0,,5.0,2.0,0.0,0.0,0.0,2.0,0.0,1.0,0.0,1.0,2.0,0.0,2.0,0.0,0.0,,1.0,5.0,4.0,2.0,1.0,0.0,2.0,5.0,5.0,0.0,0.0,0.0,4.0,2.0,,,,,,,,,,,,,,,,0.0,1.0,3.0,1.5,1.0,,3.0,,4.0,2.0,1.0,2.0,0.0,1.0,,0.0,,,2.0,3.0,5.0,1.0,2.0,0.0,1.0,0.0,3.0,,0.0,3.0,0.0,2.0,2.0,1.0,4.0,1.0,2.0,2.0,0.0,,0.0,0.0,1.0,2.0,0.0,0.0,5.0,1.0,5.0,1.0,,3.0,3.0,4.0,1.0,1.0,3.0,,2.0,5.0,,,5.0,5.0,5.0,,,1.0,3.0,2.0,4.0,5.0,0.0,5.0,2.0,0.0,0.0,5.0,1.0,1.0,1.0,5.0,3.0,3.0,2.0,1.0,,5.0,5.0,,2.0,5.0,4.0,,2.0,3.0,3.0,0.0,0.0,0.0,5.0,3.0,3.0,0.0,1.0,3.0,5.0,1.0,1.0,0.0,0.0,0.0,0.0,0.0,1.0,3.0,0.0,3.0,1.0,0.0,3.0,3.0,3.0,2.0,3.0,0.0,5.0,0.0,0.0,0.0,2.0,0.0,0.0,5.0,4.0,3.0,2.0,1.0,0.0,2.0,0.0,0.0,2.0,0.0,1.0,1.0,2.0,0.0,3.0,1.0,0.0,1.0,0.0,5.0,4.0,2.0,5.0,0.0,0.0,0.0,0.0,0.0,0.0,0.0,1.0,4.0,2.0,1.0,4.0,2.0,0.0,0.0,5.0,4.0,0.0,3.0,1.0,0.0,5.0,1.0,0.0,1.0,5.0,4.0,1.0,2.0,0.0,1.0,0.0,1.0,0.0,2.0,1.0,3.0,0.0,0.0,4.0,1.0,0.0,1.0,3.0,3.0,4.0,1.0,0.0,1.0,1.0,0.0,2.0,2.0,0.0,0.0,2.0,4.0,4.0,0.0,1.0,2.0,4.0,0.0,1.0,5.0,0.0,5.0,0.0,0.0,5.0,0.0,1.0,1.0,3.0,0.0,1.0,3.0,3.0,1.0,0.0,1.0,2.0,1.0,4.0,4.0,1.0,4.0,0.0,3.0,2.0,5.0,4.0,0.0,0.0,4.0,0.0,1.0,2.0,1.0,2.0,5.0,3.0,1.0,1.0,2.0,0.0,1.0,0.0,2.0,0.0,1.0,2.0,5.0,8.0,13.0,13.0,3.0,0.0,14.0,1.0,0.0,11.0,10.0,3.0,22.0,18.0,20.0,13.0,19.0,19.0,4.0,1.0,27.0,23.0,7.0,33.0,0.0,17.0,19.0,8.0,19.0,10.0,16.0,16.0,24.0,7.0,24.0,1.0,11.0,4.0,0.0,8.0,0.0,9.0,16.0,6.0,11.0,2.0,8.0,18.0,14.0,18.0,8.0,32.0,16.0,11.0,3.0,18.0,27.0,14.0,4.0,17.0,18.0,0.0,10.0,15.0,11.0,5.0,22.0,19.0,7.0,8.0,12.0,16.0,11.0,3.0,17.0,15.0,7.0,10.0,3.0,10.0,5.0,6.0,11.0,18.0,9.0,7.0,22.0,5.0,9.0,11.0,15.0,6.0,3.0,9.0,8.0,2.0,5.0,8.0,5.0,11.0,11.0,12.0,16.0,10.0,13.0,4.0,3.0,14.0,2.0,7.0,18.0,10.0,4.0,10.0,13.0,16.0,8.0,17.0,0.0,16.0,11.0,18.0,13.0,0.0,4.0,2.0,0.0,4.0,22.0,17.0,17.0,16.0,6.0,7.0,13.0,6.0,41.0,21.0,13.0,13.0,11.0,10.0,15.0,16.0,16.0,15.0,6.0,17.0,8.0,8.0,0.0,3.0,1.0,7.0,14.0,13.0,20.0,16.0,16.0,9.0,19.0,7.0,6.0,17.0,2.0,8.0,20.0,4.0,7.0,12.0,15.0,7.0,11.0,21.0,10.0,5.0,1.0,0.0,8.0,12.0,14.0,0.0,14.0,2.0,13.0,12.0,22.0,3.0,12.0,15.0,17.0,10.0,8.0,3.0,9.0,20.0,5.0,7.0,18.0,4.0,13.0,9.0,7.0,22.0,8.0,0.0,9.0,8.0,18.0,13.0,14.0,8.0,12.0,8.0,13.0,13.0,17.0,5.0,10.0,10.0,13.0,15.0,13.0,10.0,9.0,8.0,13.0,7.0,7.0,4.0,15.0,14.0,5.0,21.0,6.0,17.0,14.0,8.0,6.0,13.0,9.0,3.0,12.0,6.0,19.0,9.0,9.0,13.0,16.0,0.0,14.0,18.0,6.0,10.0,10.0,8.0,12.0,6.0,9.0,13.0,4.0,18.0,11.0,10.0,10.0,24.0,14.0,11.0,8.0,13.0,15.0,17.0,14.0,9.0,7.0,18.0,2.0,9.0,9.0,10.0,3.0,1.0,14.0,12.0,12.0,8.0,11.0,15.0,1.0,11.0,20.0,10.0,5.0,8.0,5.0,14.0,14.0,11.0,15.0,23.0,6.0,1.0,16.0,17.0,6.0,10.0,12.0,14.0,16.0,10.0,14.0,4.0,11.0,8.0,12.0,3.0,20.0,11.0,12.0,5.0,4.0,7.0,9.0,3.0,19.0,7.0,1.0,7.0,13.0,14.0,9.0,6.0,13.0,4.0,4.0,4.0,3.0,19.0,16.0,13.0,12.0,18.0,9.0,11.0,13.0,14.0,8.0,7.0,6.0,9.0,6.0,13.0,9.0,,,,,,,,,,,,,,,,,,,,,,,,,,,5.0,5.0,5.0,1.0,5.0,5.0,5.0,5.0,5.0,4.0,2.0,3.0,5.0,5.0,5.0,0.0,5.0,5.0,5.0,5.0,1.0,5.0,0.0,1.0,5.0,5.0,4.0,5.0,3.0,5.0,5.0,5.0,5.0,5.0,1.0,5.0,2.0,5.0,5.0,5.0,5.0,5.0,5.0,5.0,5.0,5.0,5.0,5.0,5.0,5.0,5.0,5.0,5.0,5.0,5.0,5.0,5.0,0.0,5.0,5.0,5.0,5.0,4.0,3.0,3.0,4.0,2.0,1.0,5.0,5.0,5.0,5.0,5.0,1.0,5.0,,3.0,5.0,4.0,3.0,5.0,0.0,2.0,5.0,5.0,3.0,5.0,1.0,4.0,0.0,5.0,3.0,5.0,5.0,3.0,1.0,5.0,1.0,5.0,5.0,5.0,5.0,2.0,3.0,1.0,5.0,5.0,5.0,5.0,3.0,3.0,2.0,5.0,5.0,1.0,1.0,5.0,3.0,0.0,5.0,5.0,5.0,3.0,5.0,5.0,5.0,5.0,1.0,2.0,5.0,0.0,5.0,4.0,5.0,5.0,2.0,5.0,0.0,5.0,5.0,1.0,5.0,5.0,5.0,5.0,5.0,5.0,3.0,3.0,3.0,5.0,4.0,5.0,4.0,4.0,5.0,17.0,16.0,11.0,2.0,3.0,4.0
12,3.0,5.0,5.0,5.0,4.0,7.0,3.0,5.0,5.0,4.0,4.0,2.0,2.0,5.0,5.0,22.0,6.0,5.0,5.0,5.0,7.0,2.0,7.0,0.0,2.0,7.0,5.0,4.0,6.0,1.0,4.0,4.0,5.0,11.0,5.0,5.0,5.0,2.0,6.0,6.0,4.0,5.0,4.0,4.0,3.0,4.0,10.0,6.0,2.0,2.0,0.0,2.0,3.0,0.0,3.0,5.0,0.0,0.0,0.0,0.0,0.0,0.0,0.0,0.0,0.0,0.0,0.0,0.0,0.0,0.0,0.0,0.0,0.0,0.0,0.0,0.0,0.0,0.0,0.0,6.0,5.0,3.0,5.0,5.0,5.0,5.0,5.0,0.0,0.0,0.0,0.0,0.0,10.0,0.0,0.0,0.0,0.0,0.0,0.0,0.0,0.0,0.0,0.0,0.0,0.0,0.0,0.0,0.0,0.0,0.0,0.0,0.0,0.0,1.0,5.0,6.0,4.0,5.0,2.0,5.0,3.0,17.0,4.0,5.0,4.0,15.0,2.0,2.0,8.0,5.0,9.0,3.0,10.0,4.0,10.0,2.0,9.0,4.0,7.0,3.0,2.0,2.0,0.0,5.0,4.0,7.0,11.0,8.0,10.0,5.0,5.0,8.0,0.0,4.0,3.0,7.0,3.0,5.0,7.0,1.0,4.0,3.0,15.0,0.0,5.0,5.0,5.0,5.0,4.0,3.0,7.0,11.0,11.0,2.0,7.0,7.0,4.0,7.0,5.0,2.0,5.0,3.0,0.0,11.0,5.0,6.0,4.0,4.0,2.0,4.0,4.0,4.0,7.0,7.0,3.0,4.0,1.0,7.0,12.0,5.0,5.0,1.0,7.0,3.0,5.0,2.0,4.0,2.0,3.0,4.0,3.0,4.0,6.0,5.0,2.0,10.0,11.0,8.0,0.0,1.0,5.0,11.0,4.0,6.0,0.0,0.0,8.0,7.0,6.0,5.0,7.0,3.0,1.0,1.0,0.0,9.0,6.0,1.0,10.0,10.0,3.0,10.0,0.0,3.0,2.0,2.0,2.0,14.0,0.0,5.0,2.0,9.0,12.0,8.0,4.0,4.0,13.0,3.0,11.0,0.0,0.0,12.0,4.0,4.0,8.0,2.0,5.0,11.0,0.0,4.0,10.0,3.0,7.0,12.0,8.0,6.0,6.0,2.0,6.0,7.0,4.0,10.0,4.0,8.0,4.0,5.0,10.0,5.0,9.0,11.0,8.0,5.0,11.0,3.0,1.0,2.0,5.0,5.0,4.0,3.0,2.0,3.0,0.0,1.0,3.0,0.0,4.0,4.0,2.0,8.0,14.0,14.0,7.0,7.0,5.0,6.0,3.0,13.0,10.0,7.0,12.0,13.0,3.0,8.0,15.0,6.0,8.0,5.0,11.0,5.0,5.0,11.0,0.0,7.0,14.0,10.0,10.0,11.0,6.0,18.0,18.0,9.0,9.0,10.0,9.0,5.0,11.0,7.0,13.0,8.0,5.0,13.0,11.0,9.0,6.0,23.0,0.0,12.0,8.0,14.0,3.0,6.0,1.0,12.0,8.0,0.0,6.0,4.0,2.0,17.0,2.0,19.0,1.0,12.0,1.0,1.0,2.0,4.0,1.0,3.0,0.0,1.0,2.0,0.0,3.0,2.0,8.0,0.0,5.0,2.0,1.0,7.0,0.0,3.0,2.0,3.0,1.0,0.0,0.0,2.0,0.0,0.0,1.0,3.0,0.0,3.0,0.0,0.0,0.0,0.0,1.0,0.0,0.0,1.0,1.0,2.0,4.0,3.0,4.0,0.0,2.0,1.0,8.0,3.0,6.0,0.0,0.0,1.0,5.0,6.0,7.0,1.0,7.0,9.0,14.0,1.0,9.0,6.0,7.0,2.0,3.0,5.0,4.0,10.0,10.0,18.0,10.0,3.0,5.0,2.0,15.0,1.0,9.0,9.0,1.0,8.0,3.0,3.0,4.0,5.0,1.0,1.0,2.0,0.0,4.0,2.0,4.0,0.0,3.0,1.0,1.0,1.0,2.0,1.0,0.0,0.0,2.0,4.0,1.0,4.0,4.0,3.0,3.0,0.0,5.0,7.0,5.0,3.0,4.0,5.0,7.0,1.0,2.0,5.0,0.0,1.0,6.0,4.0,5.0,9.0,12.0,1.0,0.0,1.0,13.0,20.0,1.0,2.0,3.0,1.0,3.0,6.0,1.0,8.0,4.0,3.0,7.0,2.0,2.0,8.0,8.0,5.0,8.0,1.0,5.0,5.0,5.0,5.0,5.0,2.0,0.0,2.0,6.0,5.0,1.0,4.0,1.0,6.0,1.0,6.0,3.0,4.0,1.0,2.0,2.0,2.0,,,,,,,,,,,,,,,,,,,,,,,,,,,,,,,,,,8.0,12.0,10.0,8.0,6.0,,,8.0,10.0,15.0,20.0,4.0,9.0,,,,19.0,,,,,,,,,10.0,,,,,,,,2.0,8.0,,,12.0,10.0,17.0,15.0,,16.0,12.0,,6.0,12.0,4.0,,12.0,,,15.0,24.0,24.0,,,9.0,,10.0,7.0,13.0,23.0,17.0,6.0,,1.0,0.0,0.0,20.0,0.0,0.0,0.0,0.0,0.0,1.0,0.0,2.0,7.0,0.0,3.0,0.0,2.0,1.0,0.0,0.0,2.0,4.0,5.0,3.0,1.0,5.0,0.0,0.0,0.0,0.0,5.0,0.0,0.0,4.0,1.0,5.0,5.0,3.0,0.0,5.0,5.0,5.0,2.0,1.0,5.0,3.0,0.0,5.0,1.0,4.0,0.0,0.0,5.0,5.0,3.0,1.0,2.0,1.0,0.0,1.0,2.0,5.0,0.0,5.0,3.0,5.0,5.0,5.0,5.0,5.0,5.0,5.0,0.0,7.0,1.0,0.0,2.0,0.0,11.0,2.0,1.0,0.0,5.0,0.0,0.0,0.0,4.0,1.0,3.0,1.0,1.0,4.0,0.0,8.0,4.0,3.0,6.0,4.0,4.0,4.0,3.0,5.0,2.0,0.0,0.0,4.0,4.0,3.0,1.0,4.0,7.0,2.0,2.0,14.0,6.0,5.0,9.0,16.0,9.0,7.0,8.0,9.0,9.0,10.0,10.0,11.0,6.0,7.0,8.0,9.0,2.0,7.0,6.0,10.0,11.0,7.0,13.0,6.0,5.0,3.0,5.0,3.0,3.0,7.0,5.0,3.0,9.0,0.0,5.0,5.0,6.0,5.0,7.0,6.0,6.0,4.0,3.0,5.0,10.0,6.0,7.0,6.0,6.0,6.0,9.0,7.0,5.0,7.0,13.0,3.0,7.0,6.0,5.0,0.0,3.0,4.0,6.0,7.0,4.0,4.0,5.0,5.0,5.0,4.0,5.0,7.0,4.0,5.0,8.0,5.0,16.0,5.0,5.0,10.0,4.0,5.0,8.0,6.0,6.0,6.0,6.0,6.0,5.0,4.0,3.0,10.0,6.0,4.0,5.0,2.0,5.0,0.0,15.0,2.0,8.0,2.0,4.0,12.0,9.0,9.0,6.0,10.0,7.0,3.0,1.0,17.0,2.0,15.0,24.0,1.0,9.0,14.0,1.0,1.0,4.0,0.0,9.0,16.0,12.0,18.0,9.0,14.0,11.0,15.0,16.0,22.0,7.0,3.0,19.0,10.0,16.0,7.0,0.0,8.0,0.0,1.0,4.0,14.0,3.0,1.0,15.0,6.0,11.0,6.0,1.0,4.0,16.0,12.0,1.0,9.5,18.0,2.0,12.0,15.0,8.0,7.0,6.0,8.0,5.0,6.0,3.0,9.0,0.0,4.0,3.0,0.0,1.0,16.0,16.0,8.0,10.0,17.0,2.0,10.0,17.0,9.0,2.0,10.0,8.0,5.0,10.0,4.0,10.0,4.0,12.0,18.0,9.0,5.0,5.0,16.0,10.0,21.0,6.0,2.0,3.0,8.0,1.0,7.0,14.0,11.0,13.0,3.0,13.0,7.0,10.0,0.0,6.0,10.0,5.0,10.0,8.0,13.0,4.0,5.0,5.0,7.0,2.0,3.0,10.0,4.0,4.0,0.0,2.0,2.0,10.0,8.0,1.0,5.0,10.0,4.0,6.0,6.0,1.0,5.0,11.0,4.0,7.0,1.0,4.0,1.0,8.0,7.0,21.0,7.0,2.0,5.0,6.0,10.0,0.0,0.0,5.0,9.0,9.0,6.0,1.0,3.0,5.0,22.0,6.0,13.0,5.0,3.0,4.0,5.0,11.0,4.0,11.0,9.0,1.0,8.0,17.0,12.0,0.0,11.0,10.0,2.0,13.0,21.0,12.0,4.0,13.0,15.0,1.0,4.0,2.0,0.0,3.0,0.0,0.0,5.0,3.0,0.0,1.0,6.0,2.0,1.0,3.0,5.0,4.0,0.0,0.0,1.0,6.0,7.0,2.0,6.0,3.0,1.0,2.0,0.0,2.0,4.0,0.0,1.0,4.0,2.0,4.0,1.0,0.0,7.0,0.0,1.0,0.0,1.0,1.0,1.0,5.0,1.0,0.0,3.0,2.0,1.0,0.0,1.0,0.0,0.0,3.0,4.0,1.0,6.0,0.0,7.0,2.0,1.0,3.0,2.0,2.0,3.0,2.0,3.0,2.0,0.0,12.0,3.0,1.0,3.0,2.0,0.0,2.0,2.0,6.0,2.0,2.0,7.0,3.0,0.0,0.0,0.0,2.0,6.0,8.0,9.0,7.0,9.0,2.0,3.0,5.0,3.0,1.0,6.0,4.0,1.0,3.0,12.0,0.0,3.0,2.0,3.0,0.0,14.0,3.0,6.0,10.0,2.0,0.0,0.0,5.0,1.0,2.0,0.0,4.0,1.0,6.0,4.0,1.0,7.0,9.0,2.0,1.0,6.0,2.0,2.0,5.0,8.0,2.0,3.0,5.0,12.0,0.0,5.0,3.0,7.0,4.0,0.0,10.0,11.0,0.0,1.0,1.0,1.0,1.0,7.0,1.0,4.0,9.0,3.0,7.0,1.0,0.0,3.0,3.0,1.0,4.0,3.0,5.0,4.0,14.0,4.0,1.0,2.0,9.0,2.0,3.0,0.0,4.5,17.5,2.0,11.5,1.5,5.5,12.0,7.0,14.0,19.0,5.5,12.0,3.0,15.0,12.0,2.5,1.5,3.5,4.5,15.5,2.5,2.0,9.5,4.0,5.0,1.0,10.5,0.0,6.0,1.0,8.0,6.5,6.0,3.5,1.5,4.5,8.5,9.5,9.5,2.5,6.0,6.0,7.0,6.0,4.0,13.5,8.0,4.5,5.5,2.0,4.5,0.5,5.5,2.5,11.0,3.0,1.5,5.0,4.0,1.0,0.0,1.0,0.0,0.0,0.0,0.0,0.0,0.0,0.0,0.0,0.0,0.0,0.0,0.0,0.0,0.0,0.0,0.0,2.0,0.0,0.0,0.0,0.0,0.0,0.0,0.0,0.0,0.0,0.0,4.0,0.0,4.0,0.0,3.0,0.0,2.0,1.0,4.0,2.0,0.0,2.0,3.0,0.0,0.0,2.0,,0.0,0.0,0.0,0.0,3.0,0.0,0.0,0.0,0.0,0.0,2.0,0.0,0.0,0.0,0.0,0.0,4.0,2.0,0.0,0.0,0.0,0.0,0.0,0.0,5.0,3.0,0.0,0.0,0.0,0.0,0.0,2.0,7.0,6.0,0.0,3.0,2.0,0.0,0.0,0.0,0.0,0.0,,0.0,0.0,0.0,0.0,0.0,0.0,0.0,0.0,,0.0,0.0,0.0,0.0,0.0,0.0,0.0,0.0,,0.0,0.0,0.0,0.0,0.0,0.0,0.0,0.0,0.0,0.0,6.0,0.0,0.0,0.0,0.0,0.0,0.0,0.0,0.0,0.0,5.0,0.0,5.0,0.0,2.0,0.0,0.0,5.0,0.0,0.0,0.0,0.0,0.0,0.0,0.0,0.0,1.0,2.0,0.0,0.0,0.0,0.0,,0.0,0.0,1.0,1.0,0.0,0.0,2.0,0.0,0.0,3.0,0.0,0.0,1.0,3.0,4.0,0.0,1.0,0.0,3.0,0.0,,0.0,2.1666666666666665,4.0,0.0,0.0,0.0,0.0,0.0,3.0,3.0,0.0,2.0,0.0,1.0,0.0,2.0,3.0,0.0,1.0,0.0,0.0,0.0,0.0,0.0,0.0,0.0,0.0,0.0,0.0,0.0,0.0,0.0,0.0,0.0,0.0,3.0,0.0,,0.0,0.0,1.0,0.0,0.0,0.0,0.0,0.0,0.0,0.0,0.0,0.0,,2.0,2.0,0.0,0.0,0.0,2.0,0.0,0.0,0.0,0.0,0.0,0.0,0.0,0.0,0.0,0.0,,0.0,0.0,0.0,0.0,0.0,0.0,0.0,0.0,1.0,0.0,3.5,0.0,0.0,0.0,3.0,0.0,2.0,1.5,,0.0,0.0,0.0,0.0,0.0,7.0,0.0,0.0,,2.0,0.0,0.0,0.0,0.0,0.0,0.0,0.0,0.0,0.0,0.0,4.0,0.0,0.0,8.0,22.0,13.0,10.0,20.0,20.0,6.0,1.0,23.0,0.0,0.0,0.0,4.0,22.0,16.0,1.0,2.0,2.0,1.0,10.0,3.0,1.0,5.0,5.0,3.0,10.0,25.0,19.0,5.0,25.0,16.0,2.0,1.0,0.0,4.0,27.0,11.0,18.0,12.0,14.0,26.0,42.0,23.0,20.0,12.0,15.0,17.0,15.0,19.0,8.0,8.0,23.0,13.0,6.0,29.0,8.0,23.0,16.0,16.0,7.0,8.0,13.0,16.0,10.0,9.0,15.0,22.0,29.0,12.0,10.0,5.0,7.0,27.0,24.0,18.0,16.0,19.0,6.0,23.0,9.0,10.0,16.0,16.0,29.0,34.0,4.0,15.0,21.0,13.0,12.0,21.0,8.0,7.0,48.0,6.0,7.0,24.0,5.0,5.0,1.0,4.0,0.0,6.0,14.0,1.0,7.0,3.0,2.0,0.0,22.0,1.0,2.0,3.0,1.0,2.0,10.0,3.0,3.0,4.0,22.0,16.0,8.0,2.0,0.0,0.0,2.0,3.0,5.0,16.0,5.0,6.0,0.0,3.0,8.0,2.0,5.0,2.0,0.0,0.0,0.0,3.0,1.0,0.0,0.0,0.0,0.0,18.0,0.0,0.0,2.0,0.0,1.0,4.0,5.0,3.0,13.0,11.0,17.0,19.0,7.0,11.0,4.0,8.0,5.0,0.0,13.0,4.0,5.0,6.0,5.0,6.0,0.0,1.0,2.0,8.0,0.0,14.0,6.0,2.0,8.0,10.0,7.0,5.0,15.0,4.0,7.0,8.0,12.0,1.0,2.0,1.0,9.0,13.0,7.0,2.0,16.0,1.0,1.0,1.0,6.0,2.0,13.0,1.0,0.0,1.0,20.0,0.0,15.0,15.0,5.0,7.0,0.0,1.0,0.0,0.0,0.0,1.0,0.0,2.0,0.0,18.0,8.0,7.0,2.0,0.0,5.0,1.0,9.0,2.0,1.0,2.0,3.0,2.0,15.0,20.0,13.0,3.0,4.0,2.0,3.0,11.0,24.0,1.0,0.0,23.0,1.0,0.0,1.0,5.0,2.0,13.0,0.0,11.0,17.0,8.0,21.0,0.0,15.0,1.0,19.0,9.0,12.0,10.0,21.0,22.0,16.0,13.0,15.0,4.0,25.0,21.0,32.0,34.0,19.0,19.0,25.0,10.0,1.0,27.0,19.0,2.0,3.0,1.0,0.0,19.0,19.0,16.0,16.0,25.0,5.0,21.0,16.0,4.0,0.0,9.0,13.0,20.0,7.0,13.0,22.0,22.0,0.0,27.0,21.0,25.0,9.0,20.0,17.0,11.0,0.0,8.0,10.0,11.0,11.0,11.0,40.0,22.0,7.0,11.0,18.0,10.0,27.0,23.0,24.0,2.0,5.0,28.0,15.0,23.0,16.0,3.0,26.0,13.0,15.0,10.0,16.0,22.0,18.0,17.0,4.0,1.0,8.0,27.0,19.0,1.0,6.0,11.0,2.0,9.0,11.0,3.0,24.0,18.0,8.0,38.0,21.0,11.0,7.0,17.0,21.0,0.0,2.0,2.0,15.0,18.0,0.0,18.0,17.0,13.0,18.0,16.0,17.0,20.0,20.0,23.0,19.0,18.0,13.0,2.0,1.0,18.0,6.0,2.0,6.0,6.0,0.0,1.0,1.0,7.0,4.0,12.0,2.0,5.0,2.0,5.0,15.0,8.0,0.0,0.0,1.0,0.0,2.0,1.0,0.0,0.0,1.0,0.0,6.0,4.0,0.0,,0.0,0.0,0.0,0.0,0.0,,0.0,,,0.0,0.0,0.0,0.0,0.0,12.0,1.0,11.0,6.0,6.0,4.0,1.0,8.0,4.0,4.0,1.0,8.0,7.0,5.0,5.0,2.0,9.0,9.0,8.0,9.0,6.0,6.0,11.0,16.0,2.0,11.0,3.0,10.0,6.0,3.0,1.0,10.0,5.0,4.0,10.0,5.0,17.0,8.0,9.0,12.0,8.0,9.0,6.0,10.0,10.0,3.0,21.0,12.0,13.0,1.0,4.0,10.0,8.0,7.0,9.0,8.0,4.0,8.0,4.0,0.0,7.0,8.0,10.0,12.0,6.0,16.0,4.0,9.0,5.0,6.0,4.0,10.0,23.0,8.0,14.0,2.0,5.0,22.0,19.0,0.0,5.0,11.0,7.0,3.0,4.0,13.0,9.0,7.0,21.0,7.0,9.0,14.0,7.0,13.0,5.0,4.0,3.0,5.0,3.0,5.0,11.0,13.0,6.0,0.0,1.0,12.0,8.0,3.0,3.0,9.0,18.0,9.0,0.0,11.0,3.0,12.0,7.0,14.0,3.0,8.0,6.0,5.0,1.0,8.0,6.0,12.0,20.0,9.0,18.0,5.0,0.0,5.0,6.0,6.0,11.0,8.0,11.0,20.0,0.0,3.0,6.0,4.0,5.0,11.0,5.0,10.0,8.0,1.0,8.0,2.0,4.0,8.0,3.0,4.0,10.0,0.0,5.0,0.0,3.0,2.0,2.0,3.0,2.0,2.0,3.0,0.0,0.0,4.0,2.0,2.0,4.0,8.0,1.0,1.0,3.0,1.0,2.0,5.0,7.0,7.0,7.0,2.0,3.0,8.0,6.0,6.0,0.0,11.0,,5.0,8.0,11.0,16.0,14.0,0.0,5.0,13.0,13.0,9.0,5.0,13.0,0.0,12.0,3.0,2.0,2.0,10.0,1.0,1.0,16.0,7.0,0.0,0.0,19.0,5.0,22.0,0.0,1.0,2.0,9.0,22.0,1.0,40.0,2.0,1.0,10.0,10.0,0.0,4.0,6.0,0.0,3.0,11.0,0.0,3.0,3.0,11.0,0.0,1.0,2.0,1.0,,13.0,4.0,12.0,0.0,12.0,12.0,2.0,13.0,4.0,1.0,5.0,13.0,6.0,1.0,4.0,5.0,5.0,0.0,0.0,4.0,12.0,2.0,8.0,0.0,0.0,0.0,1.0,0.0,0.0,4.0,1.0,4.0,0.0,19.0,12.0,4.0,,1.0,0.0,0.0,12.0,10.0,0.0,16.0,9.0,8.0,4.0,10.0,13.0,8.0,17.0,3.0,17.0,8.0,15.0,6.0,3.0,4.0,0.0,8.0,10.0,1.0,6.0,4.0,2.0,6.0,2.0,7.0,3.0,5.0,,19.0,7.0,3.0,7.0,8.0,12.0,8.0,4.0,13.0,2.0,8.0,1.0,23.0,11.0,2.0,7.0,7.0,11.0,0.0,2.0,5.0,12.0,15.0,17.0,7.0,6.0,3.0,5.0,12.0,1.0,12.0,3.0,15.0,6.0,41.0,0.0,19.0,0.0,13.0,8.0,3.0,3.0,12.0,8.0,7.0,0.0,8.0,3.0,0.0,20.0,6.0,10.0,17.0,0.0,12.0,14.0,8.0,22.0,6.0,3.0,9.0,9.0,6.0,15.0,10.0,1.0,8.0,1.0,1.0,12.0,0.0,11.0,0.0,5.0,18.0,8.0,4.0,14.0,6.0,0.0,0.0,0.0,1.0,17.0,8.0,13.0,16.0,10.0,4.0,6.0,5.0,0.0,0.0,0.0,0.0,9.0,8.0,4.0,,21.0,7.0,2.0,18.0,10.0,8.0,3.0,13.0,1.0,16.0,13.0,8.0,5.0,0.0,2.0,10.0,4.0,,14.0,13.0,13.0,0.0,0.0,10.0,12.0,6.0,13.0,13.0,15.0,6.0,1.0,13.0,7.0,5.0,5.0,0.0,0.0,6.0,16.0,3.0,9.0,1.0,0.0,0.0,12.0,,15.0,11.0,10.0,15.0,5.0,3.0,9.0,11.0,8.0,1.0,14.0,0.0,11.0,0.0,1.0,8.0,15.0,4.0,10.0,5.0,5.0,5.0,0.0,4.0,16.0,6.0,2.0,17.0,1.0,13.0,14.0,16.0,6.0,0.0,9.0,8.0,9.0,7.0,2.0,7.0,5.0,4.0,18.0,2.0,13.0,13.0,0.0,1.0,8.0,6.0,12.0,11.0,12.0,3.0,18.0,15.0,0.0,8.0,7.0,12.0,23.0,17.0,0.0,0.0,10.0,16.0,5.0,15.0,11.0,7.0,21.0,7.0,15.0,9.0,13.0,6.0,2.0,3.0,9.0,0.0,,14.0,0.0,4.0,2.0,16.0,1.0,0.0,2.0,0.0,2.0,5.0,,3.0,1.0,3.0,1.0,7.0,0.0,1.0,10.0,4.0,10.0,3.0,9.0,0.0,0.0,13.0,18.0,6.0,16.0,13.0,25.0,10.0,6.0,6.0,12.0,0.0,0.0,14.0,0.0,0.0,1.0,0.0,7.0,5.0,4.0,7.0,8.0,4.0,9.0,13.0,7.0,7.0,,2.0,8.0,17.0,2.0,9.0,5.0,5.0,19.0,16.0,5.0,7.0,11.0,7.0,8.0,5.0,14.0,0.0,1.0,6.0,4.0,11.0,1.0,7.0,7.0,1.0,9.0,13.0,,7.0,17.0,8.0,5.0,3.0,25.0,8.0,20.0,5.0,19.0,0.0,8.0,4.0,5.0,3.0,21.0,3.0,5.0,1.0,1.0,0.0,1.0,2.0,1.0,12.0,3.0,10.0,1.0,0.0,21.0,5.0,3.0,16.0,1.5,1.0,5.5,0.0,2.5,1.0,6.5,0.0,5.5,0.0,5.5,0.0,2.0,8.5,0.5,0.0,1.0,0.0,2.0,0.0,1.0,9.0,0.5,2.5,1.0,0.0,1.0,13.5,4.0,2.5,7.5,4.0,10.5,8.0,1.5,0.0,1.0,0.5,1.0,0.5,1.0,3.0,2.0,11.0,0.5,0.0,0.0,10.0,0.0,0.0,4.0,0.0,4.0,1.0,5.0,1.0,5.0,3.0,0.0,4.0,5.0,3.0,1.0,3.0,5.0,0.0,0.0,2.0,3.0,3.0,2.0,15.0,0.0,12.0,15.0,8.0,6.0,25.0,2.0,1.0,8.0,1.0,24.0,14.0,15.0,9.0,7.0,3.0,6.0,9.0,25.0,8.0,8.0,13.0,9.0,7.0,14.0,7.0,19.0,5.0,9.0,9.0,15.0,19.0,19.0,13.0,17.0,1.0,10.0,20.0,9.0,2.0,12.0,12.0,7.0,14.0,12.0,11.0,1.0,11.0,8.0,27.0,5.0,26.0,13.0,15.0,4.0,7.0,14.0,12.0,15.0,18.0,14.0,10.0,4.0,9.0,13.0,9.0,10.0,5.0,11.0,21.0,20.0,24.0,11.0,18.0,14.0,14.0,5.0,21.0,23.0,6.0,13.0,12.0,8.0,0.0,26.0,5.0,10.0,5.0,10.0,2.0,21.0,11.0,17.0,28.0,9.0,14.0,15.0,18.0,13.0,19.0,4.0,11.0,16.0,9.0,11.0,10.0,5.0,13.0,21.0,19.0,8.0,11.0,9.0,8.0,3.0,9.0,11.0,10.0,9.0,11.0,25.0,8.0,6.0,8.0,20.0,4.0,8.0,10.0,7.0,19.0,1.0,1.0,15.0,16.0,7.0,1.0,18.0,26.0,29.0,12.0,8.0,10.0,9.0,11.0,9.0,13.0,13.0,11.0,9.0,9.0,22.0,13.0,17.0,3.0,4.0,3.0,9.0,10.0,13.0,14.0,9.0,17.0,9.0,5.0,19.0,2.0,4.0,23.0,14.0,14.0,15.0,18.0,7.0,3.0,21.0,18.0,20.0,8.0,6.0,27.0,10.0,13.0,15.0,5.0,19.0,13.0,11.0,1.0,13.0,5.0,35.0,14.0,16.0,12.0,10.0,7.0,16.0,6.0,10.0,8.0,13.0,5.0,9.0,16.0,12.0,3.0,20.0,25.0,17.0,17.0,18.0,9.0,13.0,8.0,20.0,12.0,16.0,8.0,18.0,8.0,4.0,4.0,9.0,3.0,12.0,24.0,14.0,20.0,4.0,9.0,8.0,14.0,5.0,10.0,8.0,5.0,5.0,8.0,19.0,18.0,11.0,14.0,15.0,7.0,10.0,11.0,10.0,8.0,12.0,14.0,15.0,12.0,12.0,19.0,12.0,13.0,12.0,10.0,15.0,8.0,2.0,8.0,6.0,5.0,8.0,11.0,6.0,7.0,9.0,11.0,20.0,23.0,11.0,14.0,9.0,12.0,8.0,11.0,11.0,12.0,8.0,6.0,16.0,8.0,19.0,12.0,10.0,10.0,9.0,2.0,17.0,2.0,9.0,0.0,0.0,13.0,14.0,9.0,6.0,9.0,5.0,4.0,4.0,15.0,7.0,11.0,6.0,2.0,5.0,7.0,13.0,20.0,11.0,19.0,6.0,0.0,13.0,13.0,9.0,17.0,3.0,18.0,23.0,2.0,9.0,6.0,7.0,15.0,2.0,0.0,3.0,0.0,0.0,0.0,3.0,14.0,16.0,15.0,17.0,7.0,4.0,7.0,9.0,14.0,5.0,1.0,15.0,1.0,1.0,11.0,11.0,10.0,11.0,6.0,7.0,4.0,14.0,22.0,7.0,10.0,14.0,3.0,12.0,7.0,20.0,6.0,4.0,9.0,9.0,0.0,15.0,14.0,1.0,9.0,13.0,2.0,18.0,1.0,10.0,18.0,1.0,3.0,9.0,5.0,10.0,13.0,10.0,6.0,0.0,0.0,2.0,27.0,5.0,6.0,9.0,10.0,16.0,1.0,0.0,7.0,1.0,17.0,6.0,3.0,10.0,4.0,11.0,4.0,10.0,14.0,1.0,21.0,17.0,13.0,5.0,0.0,0.0,0.0,1.0,2.0,1.0,0.0,3.0,14.0,0.0,4.0,2.0,1.0,1.0,0.0,1.0,8.0,0.0,3.0,4.0,0.0,0.0,2.0,1.0,2.0,2.0,6.0,0.0,0.0,1.0,0.0,0.0,5.0,13.0,16.0,0.0,1.0,0.0,0.0,2.0,0.0,0.0,0.0,2.0,0.0,9.0,7.0,2.0,9.0,0.0,1.0,0.0,0.0,4.0,2.0,0.0,3.0,0.0,2.0,4.0,10.0,0.0,0.0,3.0,10.0,26.0,17.0,2.0,1.0,8.0,1.0,0.0,0.0,1.0,3.0,1.0,3.0,8.0,3.0,0.0,14.0,15.0,14.0,4.0,3.0,6.0,11.0,0.0,1.0,10.0,5.0,10.0,1.0,0.0,1.0,0.0,2.0,4.0,7.0,0.0,1.0,7.0,13.0,8.0,13.0,15.0,4.0,10.0,13.0,10.0,11.0,0.0,2.0,0.0,6.0,22.0,10.0,0.0,0.0,3.0,0.0,5.0,0.0,2.0,10.0,5.0,0.0,10.0,11.0,0.0,1.0,9.0,8.0,14.0,8.0,0.0,15.0,8.0,7.0,0.0,13.0,2.0,2.0,4.0,0.0,5.0,2.0,12.0,6.0,6.0,4.0,9.0,2.0,11.0,1.0,6.0,7.0,3.0,4.0,9.0,1.0,4.0,23.0,12.0,3.0,4.0,1.0,2.0,0.0,2.0,0.0,3.0,0.0,9.0,7.0,9.0,0.0,4.0,2.0,2.0,5.0,5.0,13.0,1.0,5.0,10.0,1.0,0.0,2.0,17.0,1.0,0.0,7.0,4.0,11.0,10.0,3.0,0.0,0.0,3.0,0.0,11.0,7.0,4.0,4.0,2.0,10.0,2.0,3.0,0.0,8.0,1.0,16.0,3.0,1.0,2.0,2.0,8.0,0.0,0.0,0.0,5.0,13.0,7.0,5.0,0.0,2.0,17.0,1.0,5.0,0.0,0.0,3.0,0.0,5.0,5.0,8.0,2.0,22.0,5.0,5.0,0.0,7.0,3.0,11.0,11.0,5.0,3.0,6.0,0.0,8.0,0.0,2.0,2.0,0.0,1.0,8.0,0.0,1.0,1.0,24.0,15.0,8.0,8.0,15.0,20.0,5.0,4.0,1.0,0.0,16.0,0.0,13.0,9.0,10.0,0.0,2.0,13.0,3.0,21.0,17.0,5.0,47.0,2.0,7.0,0.0,1.0,1.0,0.0,3.0,0.0,0.0,3.0,5.0,4.0,2.0,0.0,12.0,15.0,5.0,18.0,6.0,13.0,22.0,10.0,35.0,1.0,5.0,9.0,0.0,12.0,9.0,23.0,2.0,14.0,15.0,0.0,0.0,0.0,0.0,3.0,1.0,1.0,3.0,16.0,0.0,2.0,0.0,6.0,0.0,0.0,0.0,2.0,4.0,1.0,11.0,0.0,3.0,1.0,1.0,0.0,1.0,0.0,1.0,3.0,1.0,1.0,5.0,0.0,0.0,0.0,7.0,1.0,7.0,3.0,14.0,9.0,6.0,12.0,15.0,3.0,6.0,7.0,5.0,5.0,5.0,3.0,28.0,6.0,9.0,0.0,4.0,3.0,7.0,2.0,2.0,3.0,5.0,9.0,5.0,6.0,6.0,6.0,7.0,5.0,6.0,5.0,11.0,1.0,3.0,5.0,17.0,2.0,11.0,0.0,10.0,9.0,7.0,0.0,7.0,3.0,9.0,2.0,0.0,0.0,2.0,0.0,3.0,0.0,0.0,0.0,10.0,7.0,0.0,0.0,3.0,0.0,0.0,0.0,0.0,0.0,0.0,1.0,3.0,1.0,5.0,5.0,9.0,0.0,5.0,7.0,5.0,13.0,10.0,0.0,12.0,10.0,3.0,10.0,9.0,7.0,14.0,4.0,11.0,2.0,12.0,7.0,5.0,4.0,1.0,2.0,12.0,12.0,8.0,6.0,8.0,7.0,4.0,1.0,3.0,6.0,0.0,10.0,2.0,4.0,3.0,6.0,0.0,4.0,4.0,7.0,6.0,5.0,3.0,2.0,2.0,1.0,8.0,10.0,6.0,5.0,7.0,1.0,5.0,1.0,1.0,16.0,1.0,8.0,4.0,6.0,8.0,10.0,6.0,14.0,13.0,2.0,3.0,9.0,16.0,1.0,3.0,2.0,1.0,7.0,7.0,1.0,7.0,3.0,4.0,4.0,4.0,5.0,5.0,6.0,6.0,8.0,7.0,8.0,6.0,7.0,5.0,3.0,12.0,13.0,6.0,16.0,8.0,4.0,8.0,9.0,11.0,6.0,4.0,13.0,6.0,12.0,9.0,10.0,12.0,12.0,4.0,5.0,4.0,8.0,6.0,7.0,14.0,5.0,7.0,10.0,7.0,4.0,5.0,9.0,8.0,6.0,9.0,10.0,12.0,9.0,8.0,4.0,12.0,4.0,3.0,9.0,23.0,8.0,9.0,5.0,14.0,3.0,11.0,17.0,10.0,10.0,10.0,6.0,12.0,16.0,9.0,5.0,10.0,10.0,6.0,8.0,7.0,6.0,7.0,12.0,11.0,7.0,4.0,7.0,9.0,11.0,10.0,7.0,12.0,1.0,8.0,6.0,1.0,13.0,10.0,9.0,5.0,7.0,9.0,7.0,11.0,8.0,13.0,3.0,11.0,1.0,5.0,11.0,3.0,9.0,13.0,9.0,2.0,3.0,9.0,15.0,3.0,3.0,4.0,6.0,4.0,12.0,5.0,9.0,6.0,2.0,5.0,5.0,7.0,8.0,9.0,6.0,1.0,10.0,12.0,13.0,5.0,6.0,14.0,18.0,10.0,4.0,12.0,9.0,14.0,10.0,12.0,4.0,7.0,4.0,19.0,15.0,6.0,2.0,5.0,7.0,6.0,10.0,5.0,8.0,11.0,9.0,11.0,7.0,10.0,5.0,5.0,8.0,8.0,1.0,5.0,9.0,5.0,6.0,5.0,9.0,6.0,3.0,2.0,6.0,6.0,7.0,6.0,13.0,3.0,3.0,8.0,10.0,11.0,11.0,6.0,20.0,9.0,8.0,10.0,8.0,3.0,8.0,5.0,5.0,8.0,8.0,6.0,8.0,6.0,4.0,3.0,7.0,7.0,4.0,10.0,0.0,2.0,3.0,10.0,9.0,2.0,1.0,3.0,0.0,0.0,1.0,0.0,9.0,11.0,1.0,3.0,8.0,0.0,2.0,2.0,10.0,2.0,1.0,1.0,3.0,7.0,1.0,1.0,2.0,12.0,3.0,1.0,5.0,5.0,5.0,3.0,1.0,0.0,4.0,3.0,5.0,0.0,5.0,5.0,5.0,3.0,2.0,5.0,3.0,5.0,3.0,0.0,5.0,5.0,2.0,5.0,2.0,4.0,2.0,5.0,1.0,4.0,3.0,0.0,1.0,3.0,5.0,5.0,5.0,3.0,1.0,5.0,5.0,5.0,5.0,3.0,5.0,3.0,0.0,5.0,4.0,0.0,0.0,5.0,5.0,5.0,2.0,5.0,5.0,2.0,4.0,5.0,2.0,5.0,5.0,5.0,5.0,5.0,5.0,2.0,5.0,5.0,5.0,5.0,5.0,5.0,5.0,5.0,1.0,1.0,4.0,5.0,1.0,5.0,3.0,5.0,5.0,5.0,5.0,2.0,0.0,1.0,1.0,1.0,1.0,0.0,2.0,1.0,0.0,0.0,0.0,2.0,9.0,2.0,0.0,2.0,3.0,5.0,3.0,0.0,2.0,0.0,0.0,3.0,0.0,2.0,1.0,0.0,3.0,2.0,2.0,0.0,0.0,2.0,7.0,0.0,2.0,0.0,2.0,0.0,15.0,5.0,2.0,5.0,18.0,14.0,14.0,1.0,2.0,0.0,1.0,13.0,8.0,10.0,0.0,8.0,6.0,0.0,8.0,2.0,11.0,11.0,5.0,11.0,6.0,3.0,2.0,1.0,0.0,6.0,10.0,5.0,1.0,9.0,0.0,3.0,14.0,11.0,5.0,0.0,13.0,5.0,1.0,1.0,0.0,0.0,5.0,0.0,14.0,0.0,3.0,4.0,23.0,3.0,5.0,2.0,5.0,10.0,1.0,11.0,2.0,1.0,25.0,6.0,2.0,6.0,9.0,0.0,4.0,9.0,3.0,0.0,0.0,1.0,14.0,16.0,8.0,5.0,23.0,11.0,33.0,2.0,12.0,0.0,0.0,0.0,6.0,0.0,12.0,14.0,8.0,4.0,6.0,4.0,6.0,9.0,22.0,3.0,0.0,14.0,0.0,7.0,2.0,2.0,0.0,20.0,15.0,4.0,10.0,17.0,15.0,21.0,13.0,0.0,17.0,5.0,15.0,2.0,18.0,9.0,2.0,14.0,4.0,11.0,0.0,2.0,13.0,12.0,1.0,17.0,10.0,0.0,2.0,11.0,6.0,8.0,10.0,21.0,0.0,1.0,9.0,14.0,0.0,7.0,0.0,1.0,6.0,12.0,6.0,7.0,0.0,2.0,21.0,13.0,19.0,6.0,16.0,6.0,10.0,2.0,20.0,3.0,2.0,0.0,12.0,0.0,10.0,0.0,0.0,10.0,1.0,0.0,0.0,12.0,1.0,7.0,3.0,19.0,2.0,0.0,6.0,1.0,2.0,18.0,3.0,0.0,0.0,2.0,21.0,7.0,16.0,7.0,0.0,4.0,15.0,9.0,6.0,4.0,11.0,23.0,9.0,14.0,11.0,0.0,13.0,2.0,8.0,17.0,14.0,25.0,4.0,4.0,14.0,0.0,11.0,7.0,14.0,5.0,4.0,5.0,0.0,14.0,5.0,2.0,3.0,1.0,1.0,0.0,0.0,10.0,10.0,7.0,0.0,16.0,17.0,10.0,6.0,0.0,0.0,8.0,2.0,2.0,20.0,9.0,11.0,13.0,2.0,6.0,18.0,15.0,,17.0,8.0,5.0,7.0,5.0,13.0,15.0,1.0,8.0,5.0,10.0,0.0,0.0,0.0,1.0,0.0,23.0,19.0,13.0,17.0,1.0,10.0,22.0,20.0,0.0,15.0,0.0,8.0,26.0,7.0,0.0,2.0,8.0,3.0,7.0,5.0,18.0,5.0,19.0,14.0,11.0,32.0,3.0,15.0,1.0,2.0,17.0,7.0,14.0,12.0,16.0,24.0,13.0,18.0,3.0,8.0,0.0,17.0,14.0,1.0,9.0,29.0,12.0,15.0,7.0,26.0,15.0,23.0,15.0,12.0,28.0,1.0,0.0,14.0,13.0,5.0,18.0,9.0,5.0,35.0,25.0,44.0,1.0,5.0,11.0,7.0,2.0,0.0,12.0,5.0,18.0,24.0,32.0,10.0,1.0,7.0,4.0,9.0,5.0,6.0,2.0,14.0,4.0,5.0,4.0,3.0,21.0,8.0,6.0,16.0,20.0,0.0,7.0,24.0,16.0,0.0,17.0,4.0,15.0,8.0,8.0,1.0,7.0,1.0,0.0,10.0,9.0,3.0,15.0,9.0,16.0,14.0,0.0,9.0,11.0,21.0,14.0,4.0,5.0,17.0,2.0,19.0,8.0,44.0,0.0,4.0,3.0,1.0,12.0,13.0,20.0,11.0,1.0,1.0,8.0,16.0,12.0,1.0,0.0,3.0,7.0,1.0,15.0,2.0,15.0,7.0,9.0,10.0,7.0,11.0,9.0,14.0,0.0,5.0,10.0,8.0,12.0,7.0,6.0,5.0,10.0,14.0,9.0,20.0,6.0,6.0,1.0,4.0,14.0,4.0,11.0,31.0,4.0,4.0,0.0,3.0,30.0,10.0,19.0,20.0,7.0,4.0,13.0,9.0,1.0,0.0,1.0,3.0,14.0,16.0,19.0,41.0,13.0,13.0,10.0,5.0,2.0,16.0,7.0,0.0,2.0,2.0,9.0,7.0,0.0,7.0,21.0,12.0,11.0,29.0,0.0,6.0,15.0,3.0,30.0,0.0,3.0,6.0,5.0,0.0,4.0,12.0,9.0,1.0,4.0,2.0,2.0,4.0,6.0,4.0,13.0,0.0,8.0,1.0,11.0,3.0,1.0,7.0,14.0,10.0,5.0,3.0,3.0,0.0,4.0,0.0,1.0,7.0,2.0,1.0,0.0,9.0,2.0,10.0,0.0,1.0,3.0,10.0,1.0,18.0,9.0,3.0,7.0,26.0,0.0,6.0,4.0,23.0,23.0,4.0,12.0,17.0,9.0,0.0,0.0,13.0,15.0,13.0,22.0,2.0,19.0,23.0,3.0,,2.0,0.0,0.0,15.0,0.0,0.0,9.0,11.0,15.0,0.0,1.0,8.0,1.0,2.0,0.0,2.0,0.0,2.0,0.0,1.0,5.0,31.0,10.0,48.0,15.0,28.0,5.0,3.0,24.0,0.0,14.0,1.0,9.0,0.0,0.0,15.0,10.0,1.0,8.0,2.0,13.0,15.0,5.0,25.0,0.0,8.0,4.0,0.0,0.0,21.0,23.0,5.0,11.0,11.0,9.0,8.0,9.0,14.0,9.0,9.0,3.0,0.0,8.0,3.0,21.0,12.0,15.0,12.0,9.0,7.0,2.0,4.0,12.0,8.0,13.0,8.0,13.0,6.0,14.0,20.0,11.0,1.0,4.0,7.0,9.0,15.0,15.0,6.0,10.0,13.0,9.0,16.0,13.0,12.0,11.0,8.0,0.0,17.0,11.0,5.0,6.0,8.0,7.0,13.0,11.0,14.0,8.0,16.0,13.0,7.0,11.0,0.0,1.0,3.0,8.0,7.0,11.0,14.0,14.0,0.0,3.0,13.0,8.0,9.0,7.0,3.0,6.0,12.0,8.0,10.0,6.0,7.0,3.0,12.0,14.0,7.0,6.0,15.0,5.0,9.0,10.0,6.0,19.0,2.0,17.0,15.0,20.0,11.0,15.0,14.0,16.0,18.0,6.0,4.0,9.0,4.0,11.0,13.0,6.0,10.0,11.0,13.0,10.0,7.0,8.0,15.0,9.0,14.0,3.0,11.0,0.0,9.0,10.0,15.0,17.0,16.0,12.0,8.0,12.0,7.0,4.0,7.0,7.0,6.0,13.0,14.0,7.0,12.0,12.0,8.0,10.0,0.0,18.0,8.0,18.0,7.0,10.0,5.0,12.0,1.0,14.0,0.0,15.0,3.0,1.0,3.0,17.0,7.0,4.0,10.0,8.0,7.0,0.0,2.0,0.0,0.0,6.0,2.0,6.0,4.0,11.0,0.0,18.0,15.0,11.0,16.0,1.0,0.0,18.0,4.0,8.0,11.0,12.0,10.0,9.0,10.0,3.0,0.0,8.0,0.0,2.0,4.0,1.0,12.0,1.0,8.0,0.0,10.0,8.0,9.0,2.0,13.0,7.0,1.0,8.0,11.0,8.0,7.0,10.0,2.0,8.0,4.0,4.0,0.0,4.0,5.0,3.0,3.0,13.0,3.0,6.0,1.0,6.0,3.0,0.0,0.0,3.0,10.0,0.0,0.0,2.0,17.0,9.0,8.0,17.0,2.0,13.0,6.0,0.0,4.0,6.0,20.0,0.0,5.0,9.0,9.0,0.0,13.0,9.0,7.0,10.0,8.0,5.0,7.0,1.0,2.0,3.0,11.0,6.0,16.0,12.0,4.0,25.0,6.0,1.0,3.0,0.0,9.0,11.0,3.0,17.0,14.0,10.0,2.0,3.0,6.0,2.0,0.0,2.0,13.0,5.0,11.0,19.0,6.0,10.0,7.0,0.0,0.0,3.0,2.0,8.0,1.0,9.0,2.0,0.0,9.0,5.0,0.0,3.0,6.0,4.0,6.0,7.0,8.0,17.0,0.0,0.0,10.0,0.0,2.0,3.0,4.0,4.0,6.0,24.0,22.0,25.0,0.0,2.0,3.0,9.0,9.0,3.0,3.0,4.0,0.0,15.0,0.0,12.0,11.0,5.0,5.0,9.0,6.0,1.0,4.0,3.0,3.0,5.0,6.0,0.0,1.0,5.0,0.0,8.0,0.0,5.0,15.0,17.0,6.0,0.0,4.0,1.0,16.0,7.0,15.0,11.0,2.0,5.0,8.0,6.0,16.0,6.0,1.0,12.0,7.0,6.0,8.0,1.0,9.0,0.0,0.0,8.0,12.0,13.0,7.0,13.0,0.0,5.0,0.0,12.0,10.0,1.0,3.0,1.0,3.0,0.0,1.0,0.0,11.0,0.0,8.0,10.0,7.0,4.0,12.0,12.0,10.0,1.0,4.0,1.0,8.0,3.0,1.0,13.0,1.0,0.0,4.0,1.0,3.0,1.0,14.0,12.0,11.0,9.0,5.0,3.0,0.0,0.0,10.0,3.0,0.0,9.0,7.0,8.0,6.0,14.0,6.0,0.0,3.0,0.0,1.0,13.0,4.0,15.0,13.0,10.0,1.0,0.0,0.0,0.0,0.0,0.0,2.0,5.0,3.0,3.0,1.0,0.0,3.0,1.0,0.0,1.0,10.0,0.0,4.0,0.0,1.0,6.0,0.0,5.0,0.0,0.0,0.0,0.0,0.0,0.0,5.0,1.0,0.0,0.0,0.0,0.0,0.0,4.0,1.0,1.0,1.0,0.0,0.0,2.0,0.0,0.0,0.0,1.0,2.0,3.0,2.0,4.0,3.0,0.0,1.0,0.0,3.0,2.0,0.0,0.0,0.0,0.0,1.0,0.0,0.0,2.0,2.0,0.0,2.0,0.0,0.0,2.0,0.0,2.0,2.0,0.0,0.0,0.0,0.0,0.0,1.0,0.0,2.0,0.0,1.0,4.0,2.0,0.0,0.0,0.0,0.0,0.0,0.0,3.0,1.0,1.0,1.0,0.0,0.0,3.0,8.0,11.0,0.0,2.0,0.0,0.0,3.0,6.0,8.0,2.0,3.0,10.0,12.0,9.0,10.0,6.0,2.0,5.0,4.0,11.0,10.0,8.0,6.0,8.0,8.0,1.0,0.0,3.0,2.0,4.0,4.0,8.0,4.0,10.0,0.0,9.0,13.0,9.0,6.0,7.0,7.0,2.0,9.0,0.0,1.0,4.0,3.0,2.0,2.0,4.0,3.0,4.0,7.0,5.0,2.0,2.0,8.0,3.0,5.0,3.0,5.0,2.0,1.0,5.0,1.0,2.0,6.0,3.0,3.0,5.0,4.0,2.0,2.0,8.0,6.0,3.0,5.0,6.0,1.0,3.0,10.0,3.0,4.0,5.0,4.0,0.0,3.0,5.0,5.0,4.0,0.0,1.0,8.0,0.0,0.0,4.0,2.0,4.0,5.0,2.0,0.0,3.0,2.0,3.0,6.0,7.0,1.0,2.0,4.0,4.0,0.0,2.0,2.0,4.0,0.0,0.0,2.0,8.0,6.0,7.0,5.0,2.0,2.0,4.0,9.0,3.0,3.0,3.0,2.0,2.0,5.0,6.0,6.0,6.0,4.0,0.0,5.0,3.0,5.0,4.0,4.0,4.0,0.0,3.0,2.0,11.0,3.0,7.0,14.0,5.0,11.0,7.0,6.0,3.0,3.0,3.0,4.0,4.0,2.0,12.0,7.0,3.0,6.0,0.0,1.0,8.0,3.0,3.0,0.0,2.0,7.0,0.0,1.0,1.0,1.0,3.0,2.0,0.0,0.0,2.0,0.0,2.0,6.0,1.0,1.0,6.0,0.0,0.0,0.0,0.0,0.0,4.0,8.0,11.0,6.0,5.0,4.0,5.0,4.0,6.0,8.0,4.0,5.0,5.0,6.0,3.0,4.0,9.0,7.0,4.0,6.0,7.0,6.0,5.0,7.0,8.0,5.0,8.0,3.0,12.0,2.0,11.0,5.0,8.0,6.0,5.0,5.0,5.0,2.0,9.0,3.0,7.0,4.0,5.0,9.0,6.0,2.0,2.0,9.0,6.0,5.0,10.0,4.0,2.0,4.0,7.0,4.0,6.0,8.0,8.0,5.0,5.0,6.0,2.0,6.0,7.0,3.0,6.0,5.0,2.0,3.0,10.0,4.0,2.0,7.0,14.0,6.0,8.0,2.0,11.0,2.0,3.0,6.0,8.0,2.0,6.0,3.0,4.0,7.0,5.0,2.0,3.0,5.0,10.0,8.0,5.0,6.0,6.0,8.0,5.0,3.0,3.0,2.0,4.0,2.0,6.0,6.0,5.0,5.0,7.0,7.0,4.0,3.0,4.0,5.0,4.0,4.0,0.0,0.0,4.0,4.0,5.0,5.0,5.0,5.0,5.0,5.0,4.0,4.0,5.0,5.0,5.0,4.0,4.0,3.0,3.0,5.0,5.0,5.0,5.0,0.0,2.0,4.0,5.0,3.0,4.0,3.0,4.0,5.0,0.0,5.0,0.0,1.0,1.0,0.0,1.0,3.0,6.0,0.0,12.0,0.0,3.0,0.0,15.0,3.0,1.0,1.0,1.0,0.0,0.0,7.0,2.0,1.0,6.0,0.0,2.0,0.0,9.0,3.0,9.0,7.0,0.0,1.0,11.0,5.0,5.0,0.0,0.0,12.0,2.0,0.0,17.0,2.0,4.0,16.0,0.0,1.0,5.0,0.0,0.0,1.0,12.0,0.0,2.0,1.0,5.0,0.0,15.0,0.0,9.0,0.0,12.0,0.0,3.0,7.0,0.0,0.0,0.0,3.0,1.0,2.0,5.0,0.0,0.0,4.0,2.0,0.0,0.0,0.0,5.0,17.0,1.0,12.0,0.0,12.0,1.0,1.0,1.0,2.0,0.0,0.0,0.0,0.0,0.0,4.0,8.0,3.0,4.0,0.0,2.0,9.0,9.0,8.0,7.0,4.0,9.0,6.0,3.0,5.0,4.0,10.0,21.0,6.0,7.0,4.0,8.0,2.0,3.0,3.0,3.0,4.0,3.0,0.0,2.0,7.0,12.0,5.0,0.0,0.0,0.0,4.0,11.0,1.0,0.0,8.0,2.0,4.0,7.0,0.0,12.0,1.0,2.0,5.0,5.0,7.0,4.0,6.0,3.0,6.0,6.0,9.0,9.0,0.0,0.0,8.0,7.0,4.0,5.0,5.0,0.0,12.0,0.0,6.0,17.0,2.0,10.0,3.0,4.0,3.0,0.0,9.0,3.0,11.0,15.0,4.0,2.0,14.0,8.0,11.0,8.0,13.0,11.0,11.0,1.0,15.0,11.0,10.0,5.0,3.0,5.0,9.0,10.0,2.0,8.0,9.0,4.0,1.0,15.0,2.0,3.0,8.0,3.0,6.0,13.0,10.0,9.0,13.0,8.0,2.0,5.0,11.0,14.0,7.0,13.0,0.0,11.0,11.0,5.0,13.0,9.0,10.0,18.0,19.0,4.0,3.0,0.0,21.0,0.0,7.0,6.0,5.0,2.0,10.0,11.0,1.0,38.0,12.0,0.0,0.0,13.0,4.0,3.0,18.0,31.0,15.0,0.0,0.0,11.0,24.0,4.0,11.0,4.0,2.0,3.0,0.0,0.0,0.0,1.0,1.0,26.0,25.0,0.0,0.0,5.0,2.0,7.0,23.0,14.0,8.0,16.0,11.0,8.0,10.0,7.0,13.0,3.0,0.0,3.0,0.0,0.0,8.0,4.0,6.0,5.0,14.0,0.0,4.0,2.0,3.0,1.0,13.0,2.0,12.0,15.0,10.0,0.0,14.0,3.0,5.0,17.0,0.0,1.0,20.0,2.0,6.0,0.0,16.0,2.0,23.0,5.0,0.0,1.0,9.0,23.0,0.0,0.0,17.0,0.0,6.0,9.0,6.0,0.0,7.0,27.0,4.0,16.0,21.0,0.0,9.0,6.0,3.0,0.0,3.0,1.0,0.0,5.0,3.0,0.0,0.0,28.0,9.0,0.0,0.0,13.0,0.0,15.0,3.0,10.0,5.0,13.0,0.0,0.0,16.0,1.0,0.0,4.0,5.0,1.0,11.0,11.0,18.0,18.0,24.0,20.0,2.0,0.0,9.0,14.0,16.0,10.0,1.0,12.0,6.0,16.0,9.0,1.0,16.0,5.0,17.0,7.0,7.0,2.0,0.0,0.0,9.0,1.0,0.0,5.0,15.0,2.0,9.0,0.0,4.0,29.0,5.0,1.0,11.0,18.0,0.0,20.0,7.0,21.0,0.0,11.0,0.0,5.0,9.0,16.0,1.0,2.0,16.0,11.0,1.0,9.0,1.0,12.0,3.0,0.0,3.0,20.0,0.0,6.0,6.0,7.0,11.0,10.0,1.0,25.0,12.0,3.0,10.0,20.0,1.0,5.0,7.0,2.0,1.0,3.0,12.0,1.0,0.0,2.0,27.0,10.0,4.0,2.0,10.0,0.0,2.0,0.0,14.0,5.0,0.0,18.0,22.0,0.0,0.0,9.0,4.0,23.0,13.0,15.0,2.0,13.0,18.0,18.0,12.0,4.0,0.0,0.0,24.0,12.0,2.0,3.0,39.0,0.0,26.0,2.0,8.0,20.0,44.0,1.0,0.0,0.0,8.0,20.0,28.0,0.0,3.0,3.0,6.0,4.0,18.0,19.0,16.0,41.0,10.0,2.0,14.0,14.0,0.0,11.0,5.0,1.0,10.0,2.0,5.5,11.0,24.0,9.0,0.0,0.0,5.0,49.0,30.0,17.0,19.0,6.0,29.0,4.0,22.0,2.0,1.0,26.0,9.0,17.0,39.0,17.0,2.0,8.0,10.0,3.0,0.0,0.0,0.0,2.0,3.0,,31.0,19.0,6.0,0.0,0.0,1.0,8.0,6.0,17.0,11.0,0.0,0.0,1.0,11.0,1.0,10.0,11.0,1.0,17.0,13.0,7.0,0.0,20.0,0.0,34.0,9.0,3.0,11.0,26.0,4.0,3.0,10.0,1.0,0.0,2.0,3.0,14.0,29.0,17.0,23.0,22.0,30.0,0.0,12.0,12.0,15.0,8.0,24.0,0.0,6.0,17.0,3.0,4.0,1.0,8.0,13.0,17.0,23.0,0.0,1.0,7.0,1.0,8.0,1.0,27.0,8.0,9.0,4.0,18.0,12.0,9.0,8.0,9.0,11.0,0.0,2.0,8.0,14.0,5.0,9.0,13.0,1.0,1.0,0.0,0.0,1.0,0.0,2.0,0.0,0.0,2.0,1.0,0.0,0.0,0.0,0.0,0.0,2.0,0.0,0.0,5.0,1.0,0.0,0.0,0.0,0.0,5.0,0.0,0.0,0.0,1.0,1.0,1.0,0.0,0.0,0.0,0.0,1.0,0.0,0.0,2.0,1.0,1.0,0.0,0.0,0.0,1.0,2.0,1.0,0.0,0.0,0.0,0.0,2.0,0.0,1.0,2.0,1.0,0.0,0.0,0.0,0.0,2.0,1.0,1.0,1.0,2.0,1.0,6.0,12.0,15.0,8.0,8.0,16.0,8.0,6.0,11.0,12.0,13.0,11.0,7.0,5.0,11.0,9.0,15.0,13.0,5.0,6.0,1.0,5.0,11.0,10.0,6.0,4.0,4.0,8.0,13.0,6.0,6.0,7.0,13.0,14.0,7.0,12.0,7.0,10.0,11.0,6.0,3.0,14.0,23.0,11.0,10.0,4.0,6.0,6.0,10.0,9.0,8.0,0.0,0.0,0.0,3.0,3.0,3.0,4.0,2.0,4.0,4.0,15.0,0.0,18.0,11.0,11.0,0.0,16.0,8.0,0.0,14.0,0.0,6.0,2.0,1.0,0.0,5.0,1.0,2.0,2.0,6.0,10.0,0.0,5.0,7.0,2.0,3.0,8.0,9.0,0.0,13.0,11.0,2.0,12.0,11.0,15.0,12.0,0.0,0.0,2.0,9.0,0.0,9.0,3.0,0.0,4.0,1.0,0.0,4.0,12.0,10.0,4.0,5.0,1.0,7.0,0.0,9.0,9.0,0.0,1.0,8.0,0.0,0.0,7.0,15.0,25.0,12.0,5.0,7.0,8.0,10.0,25.0,12.0,7.0,1.0,20.0,6.0,0.0,4.0,6.0,11.0,20.0,8.0,6.0,5.0,6.0,8.0,10.0,0.0,13.0,4.0,2.0,0.0,0.0,8.0,13.0,6.0,8.0,10.0,0.0,11.0,7.0,2.0,11.0,3.0,4.0,7.0,6.0,8.0,8.0,10.0,10.0,8.0,14.0,5.0,3.0,10.0,5.0,2.0,3.0,13.0,5.0,6.0,3.0,12.0,9.0,12.0,0.0,10.0,0.0,3.0,1.0,0.0,7.0,20.0,6.0,9.0,7.0,7.0,10.0,11.0,20.0,10.0,3.0,0.0,11.0,7.0,0.0,6.0,15.0,11.0,2.0,10.0,1.0,6.0,1.0,0.0,9.0,2.0,9.0,14.0,0.0,,0.0,0.0,4.0,5.0,0.0,0.0,10.0,0.0,3.0,5.0,5.0,3.0,2.0,11.0,9.0,6.0,6.0,7.0,10.0,4.0,5.0,12.0,10.0,3.0,5.0,7.0,10.0,19.0,13.0,14.0,9.0,3.0,5.0,5.0,6.0,10.0,11.0,2.0,5.0,5.0,4.0,6.0,4.0,0.0,7.0,17.0,7.0,8.0,0.0,8.0,5.0,10.0,6.0,0.0,1.0,1.0,8.0,0.0,7.0,3.0,7.0,2.0,1.0,0.0,3.0,4.0,4.0,14.0,5.0,0.0,1.0,2.0,5.0,19.0,10.0,8.0,3.0,11.0,5.0,14.0,15.0,1.0,6.0,3.0,11.0,9.0,3.0,5.0,4.0,14.0,17.0,10.0,4.0,1.0,2.0,6.0,6.0,13.0,10.0,5.0,8.0,14.0,5.0,0.0,3.0,10.0,1.0,4.0,4.0,11.0,7.0,9.0,3.0,2.0,3.0,6.0,8.0,2.0,3.0,6.0,8.0,13.0,12.0,6.0,10.0,0.0,11.0,1.0,0.0,10.0,5.0,5.0,11.0,5.0,7.0,6.0,12.0,5.0,8.0,12.0,2.0,5.0,10.0,9.0,8.0,3.0,4.0,4.0,3.0,4.0,4.0,6.0,1.0,4.0,6.0,0.0,7.0,8.0,1.0,4.0,14.0,10.0,5.0,8.0,2.0,6.0,6.0,6.0,5.0,10.0,5.0,10.0,5.0,11.0,7.0,5.0,4.0,11.0,10.0,4.0,13.0,9.0,15.0,10.0,6.0,0.0,11.0,3.0,9.0,6.0,0.0,7.0,8.0,4.0,6.0,3.0,1.0,0.0,8.0,11.0,2.0,17.0,10.0,11.0,3.0,10.0,0.0,15.0,9.0,5.0,8.0,16.0,0.0,0.0,23.0,9.0,7.0,1.0,8.0,4.0,25.0,7.0,12.0,7.0,8.0,0.0,5.0,8.0,9.0,11.0,4.0,0.0,8.0,14.0,15.0,7.0,1.0,3.0,3.0,2.0,6.0,10.0,2.0,4.0,4.0,15.0,7.0,17.0,13.0,0.0,12.0,4.0,0.0,0.0,15.0,17.0,5.0,4.0,3.0,12.0,19.0,9.0,6.0,9.0,7.0,10.0,6.0,7.0,6.0,6.0,4.0,6.0,6.0,7.0,8.0,12.0,0.0,4.0,13.0,6.0,8.0,9.0,17.0,8.0,12.0,8.0,9.0,9.0,9.0,9.0,5.0,4.0,6.0,8.0,6.0,7.0,6.0,2.0,7.0,18.0,7.0,17.0,5.0,9.0,6.0,12.0,10.0,7.0,4.0,3.0,3.0,11.0,9.0,6.0,6.0,8.0,6.0,14.0,5.0,6.0,6.0,6.0,4.0,4.0,18.0,11.0,6.0,13.0,6.0,2.0,7.0,8.0,9.0,4.0,5.0,8.0,0.0,13.0,7.0,2.0,8.0,18.0,11.0,1.0,5.0,11.0,1.0,5.0,9.0,10.0,5.0,1.0,6.0,3.0,5.0,6.0,5.0,14.0,5.0,2.0,5.0,2.0,13.0,25.0,7.0,10.0,0.0,7.0,6.0,6.0,2.0,10.0,11.0,25.0,13.0,2.0,3.0,12.0,7.0,7.0,6.0,3.0,8.0,6.0,3.0,4.0,6.0,0.0,3.0,10.0,2.0,1.0,10.0,12.0,13.0,14.0,8.0,3.0,9.0,1.0,2.0,5.0,0.0,0.0,0.0,0.0,0.0,0.0,0.0,0.0,1.0,0.0,3.0,4.0,0.0,4.0,2.0,2.0,3.0,8.0,5.0,9.0,3.0,2.0,7.0,4.0,16.0,8.0,6.0,3.0,3.0,4.0,2.0,5.0,2.0,4.0,7.0,2.0,3.0,3.0,5.0,3.0,4.0,8.0,2.0,2.0,2.0,2.0,2.0,0.0,1.0,2.0,2.0,3.0,2.0,1.0,3.0,2.0,2.0,2.0,2.0,2.0,3.0,3.0,2.0,3.0,5.0,4.0,2.0,4.0,2.0,2.0,2.0,2.0,4.0,3.0,0.0,0.0,4.0,3.0,3.0,4.0,4.0,4.0,5.0,3.0,2.0,1.0,0.0,2.0,0.0,2.0,4.0,4.0,2.0,2.0,3.0,2.0,4.0,2.0,3.0,0.0,4.0,3.0,3.0,2.0,0.0,2.0,3.0,2.0,1.0,2.0,2.0,1.0,2.0,3.0,3.0,2.0,2.0,2.0,2.0,2.0,3.0,2.0,3.0,4.0,2.0,3.0,5.0,5.0,3.0,1.0,3.0,0.0,2.0,0.0,1.0,3.0,5.0,2.0,6.0,4.0,2.0,1.0,9.0,4.0,7.0,6.0,3.0,3.0,4.0,5.0,4.0,3.0,5.0,7.0,11.0,6.0,6.0,5.0,4.0,4.0,7.0,5.0,6.0,0.0,0.0,0.0,10.0,0.0,0.0,6.0,6.0,0.0,0.0,3.0,0.0,0.0,0.0,0.0,0.0,3.0,5.0,0.0,4.0,0.0,7.0,4.0,0.0,3.0,0.0,0.0,0.0,0.0,0.0,0.0,0.0,0.0,13.0,7.0,0.0,0.0,0.0,5.0,5.0,5.0,5.0,5.0,4.0,5.0,5.0,5.0,4.0,9.0,8.0,4.0,10.0,8.0,2.0,5.0,3.0,6.0,4.0,8.0,5.0,7.0,6.0,8.0,7.0,6.0,5.0,6.0,9.0,3.0,3.0,9.0,13.0,5.0,7.0,6.0,7.0,2.0,7.0,2.0,4.0,6.0,8.0,7.0,5.0,9.0,4.0,8.0,6.0,9.0,7.0,5.0,8.0,4.0,8.0,4.0,5.0,5.0,10.0,4.0,6.0,12.0,11.0,6.0,3.0,6.0,13.0,8.0,8.0,12.0,4.0,6.0,2.0,8.0,10.0,6.0,8.0,17.0,3.0,13.0,10.0,8.0,6.0,10.0,13.0,10.0,4.0,15.0,7.0,14.0,8.0,1.0,5.0,8.0,11.0,8.0,5.0,6.0,0.0,1.0,9.0,5.0,13.0,7.0,16.0,10.0,9.0,4.0,8.0,15.0,9.0,7.0,11.0,6.0,8.0,2.0,7.0,12.0,5.0,6.0,9.0,7.0,4.0,10.0,13.0,8.0,6.0,15.0,0.0,11.0,3.0,2.0,6.0,10.0,3.0,3.0,5.0,4.0,6.0,15.0,10.0,7.0,8.0,5.0,5.0,0.0,9.0,4.0,7.0,9.0,10.0,6.0,4.0,3.0,3.0,4.0,3.0,8.0,13.0,9.0,9.0,,8.0,7.0,8.0,8.0,5.0,6.0,3.0,8.0,7.0,6.0,8.0,5.0,3.0,5.0,5.0,2.0,3.0,7.0,8.0,7.0,4.0,6.0,6.0,6.0,6.0,2.0,5.0,6.0,4.0,7.0,4.0,4.0,7.0,5.0,6.0,6.0,6.0,5.0,3.0,7.0,6.0,11.0,8.0,8.0,4.0,3.0,7.0,5.0,5.0,6.0,13.0,0.0,0.0,29.0,24.0,3.0,41.0,0.0,16.0,6.0,12.0,17.0,15.0,0.0,29.0,1.0,4.0,17.0,14.0,33.0,21.0,7.0,1.0,11.0,37.0,30.0,17.0,2.0,3.0,37.0,19.0,17.0,17.0,7.0,9.0,14.0,14.0,20.0,16.0,17.0,4.0,17.0,16.0,24.0,10.0,0.0,2.0,1.0,14.0,24.0,25.0,21.0,16.0,7.0,2.0,0.0,2.0,13.0,27.0,2.0,14.0,0.0,10.0,19.0,17.0,10.0,15.0,10.0,27.0,14.0,23.0,32.0,33.0,10.0,9.0,15.0,16.0,32.0,10.0,15.0,12.0,5.0,4.0,14.0,1.0,19.0,6.0,32.0,27.0,13.0,2.0,12.0,25.0,5.0,0.0,14.0,16.0,20.0,21.0,4.0,8.0,22.0,20.0,28.0,5.0,4.0,4.0,2.0,2.0,1.0,15.0,0.0,15.0,0.0,1.0,28.0,7.0,0.0,0.0,2.0,3.0,5.0,21.0,20.0,0.0,2.0,0.0,3.0,0.0,0.0,24.0,16.0,22.0,30.0,9.0,0.0,9.0,0.0,0.0,0.0,3.0,39.0,1.0,1.0,0.0,0.0,6.0,20.0,11.0,30.0,3.0,13.0,8.0,0.0,4.0,18.0,0.0,0.0,23.0,17.0,3.0,0.0,0.0,5.0,37.0,1.0,4.0,7.0,35.0,0.0,9.0,0.0,1.0,0.0,12.0,20.0,28.0,25.0,18.0,7.0,0.0,29.0,11.0,10.0,1.0,7.0,16.0,3.0,5.0,10.0,16.0,9.0,47.0,45.0,16.0,15.0,5.0,13.0,25.0,1.0,0.0,14.0,11.0,9.0,4.0,18.0,8.0,3.0,19.0,2.0,0.0,0.0,22.0,10.0,1.0,15.0,6.0,13.0,17.0,5.0,26.0,0.0,9.0,7.0,20.0,0.0,13.0,18.0,14.0,18.0,38.0,11.0,18.0,16.0,10.0,9.0,24.0,1.0,21.0,20.0,6.0,2.0,10.0,4.0,2.0,1.0,0.0,11.0,16.0,8.0,20.0,17.0,20.0,2.0,24.0,0.0,19.0,6.0,12.0,19.0,20.0,2.0,20.0,1.0,4.0,1.0,12.0,3.0,19.0,12.0,1.0,18.0,52.0,20.0,11.0,11.0,5.0,5.0,9.0,14.0,4.0,9.0,51.0,8.0,0.0,14.0,4.0,30.0,11.0,11.0,18.0,1.0,14.0,19.0,2.0,4.0,1.0,0.0,22.0,14.0,20.0,3.0,29.0,0.0,3.0,31.0,23.0,0.0,43.0,7.0,8.0,34.0,22.0,27.0,21.0,19.0,0.0,0.0,8.0,7.0,25.0,22.0,27.0,29.0,15.0,29.0,19.0,26.0,1.0,3.0,27.0,12.0,0.0,1.0,27.0,15.0,57.0,0.0,2.0,0.0,11.0,16.0,8.0,18.0,25.0,1.0,5.0,2.0,0.0,32.0,10.0,2.0,19.0,41.0,17.0,2.0,16.0,1.0,8.0,14.0,22.0,32.0,21.0,16.0,22.0,50.0,3.0,5.0,4.0,50.0,9.0,35.0,,4.0,0.0,32.0,34.0,0.0,0.0,6.0,0.0,6.0,1.0,0.0,8.0,0.0,1.0,2.0,0.0,0.0,13.0,0.0,0.0,0.0,2.0,0.0,0.0,1.0,0.0,0.0,0.0,15.0,0.0,1.0,1.0,2.0,21.0,0.0,34.0,5.0,3.0,5.0,16.0,9.0,1.0,2.0,5.0,7.0,1.0,0.0,25.0,2.0,2.0,22.0,23.0,1.0,19.0,21.0,28.0,27.0,27.0,15.0,4.0,31.0,29.0,1.0,19.0,13.0,0.0,8.0,19.0,8.0,1.0,16.0,15.0,1.0,16.0,0.0,21.0,8.0,0.0,4.0,16.0,0.0,0.0,6.0,2.0,0.0,20.0,27.0,4.0,0.0,9.0,1.0,2.0,5.0,21.0,1.0,10.0,1.0,2.0,4.0,7.0,11.0,4.0,7.0,12.0,7.0,2.0,9.0,18.0,0.0,3.0,20.0,1.0,22.0,16.0,37.0,19.0,43.0,20.0,20.0,19.0,1.0,2.0,2.0,0.0,26.0,6.0,0.0,5.0,28.0,1.0,17.0,17.0,41.0,10.0,20.0,22.0,2.0,18.0,1.0,3.0,5.0,9.0,0.0,5.0,35.0,33.0,9.0,26.0,8.0,21.0,14.0,22.0,32.0,8.0,2.0,18.0,10.0,0.0,25.0,8.0,11.0,1.0,0.0,29.0,24.0,21.0,13.0,6.0,0.0,11.0,2.0,18.0,11.0,1.0,18.0,4.0,27.0,22.0,0.0,18.0,29.0,0.0,33.0,10.0,0.0,23.0,2.0,12.0,11.0,10.0,0.0,8.0,12.0,20.0,9.0,25.0,24.0,0.0,5.0,6.0,31.0,4.0,0.0,0.0,1.0,2.0,12.0,0.0,11.0,3.0,1.0,1.0,21.0,16.0,21.0,15.0,22.0,5.0,15.0,11.0,17.0,23.0,13.0,18.0,2.0,0.0,7.0,4.0,13.0,3.0,9.0,1.0,19.0,0.0,26.0,13.0,1.0,8.0,6.0,11.0,12.0,10.0,1.0,1.0,14.0,13.0,17.0,0.0,5.0,7.0,19.0,19.0,15.0,2.0,2.0,4.0,21.0,17.0,4.0,0.0,19.0,12.0,7.0,16.0,0.0,3.0,0.0,4.0,3.0,4.0,10.0,10.0,16.0,17.0,2.0,0.0,5.0,3.0,0.0,0.0,6.0,4.0,1.0,2.0,0.0,7.0,0.0,1.0,0.0,0.0,3.0,23.0,12.0,10.0,3.0,21.0,31.0,10.0,10.0,22.0,24.0,8.0,29.0,14.0,0.0,0.0,2.0,13.0,0.0,7.0,28.0,2.0,1.0,3.0,4.0,0.0,30.0,16.0,4.0,0.0,17.0,18.0,6.0,15.0,16.0,21.0,7.0,10.0,0.0,0.0,1.0,12.0,8.0,15.0,25.0,2.0,23.0,21.0,11.0,23.0,18.0,4.0,18.0,26.0,16.0,24.0,17.0,37.0,1.0,35.0,0.0,11.0,1.0,7.0,42.0,3.0,3.0,6.0,4.0,0.0,1.0,4.0,6.0,18.0,4.0,38.0,5.0,37.0,4.0,30.0,38.0,1.0,3.0,29.0,4.0,0.0,4.0,4.0,17.0,0.0,6.0,0.0,5.0,40.0,4.0,1.0,17.0,1.0,0.0,27.0,0.0,2.0,0.0,1.0,13.0,33.0,0.0,0.0,0.0,0.0,0.0,1.0,7.0,5.0,0.0,1.0,0.0,39.0,15.0,5.0,0.0,0.0,0.0,0.0,0.0,8.0,0.0,1.0,0.0,0.0,0.0,0.0,0.0,0.0,15.0,3.0,16.0,0.0,17.0,0.0,2.0,13.0,1.0,4.0,25.0,5.0,20.0,5.0,0.0,2.0,20.0,26.0,8.0,17.0,22.0,2.0,7.0,10.0,17.0,28.0,18.0,9.0,7.0,17.0,1.0,33.0,4.0,3.0,24.0,18.0,5.0,1.0,6.0,15.0,0.0,8.0,4.0,12.0,0.0,7.0,7.0,3.0,8.0,10.0,6.0,0.0,9.0,7.0,10.0,7.0,2.0,4.0,6.0,36.0,13.0,1.0,1.0,2.0,1.0,0.0,5.0,11.0,4.0,2.0,7.0,13.0,0.0,5.0,1.0,25.0,2.0,2.0,2.0,9.0,17.0,0.0,6.0,1.0,13.0,19.0,11.0,12.0,3.0,1.0,13.0,12.0,3.0,2.0,1.0,1.0,0.0,18.0,5.5,13.0,7.0,8.0,6.0,6.0,1.0,7.0,1.0,15.0,12.0,9.0,14.0,7.0,22.0,1.0,20.0,2.0,1.0,5.0,2.0,21.0,2.0,1.0,0.0,14.0,6.0,1.0,5.0,16.0,0.0,28.0,0.0,0.0,8.0,0.0,5.0,12.0,1.0,2.0,13.0,0.0,5.0,29.0,14.0,12.0,42.0,11.0,3.0,1.0,4.0,3.0,31.0,0.0,4.0,2.0,13.0,0.0,10.0,4.0,6.0,2.0,1.0,9.0,13.0,3.0,19.0,6.0,6.0,29.0,7.0,24.0,1.0,8.0,12.0,16.0,6.0,15.0,7.0,5.0,11.0,3.0,14.0,9.0,13.0,5.0,4.0,5.0,13.0,6.0,3.0,13.0,3.0,0.0,11.0,9.0,2.0,15.0,7.0,2.0,5.0,1.0,30.0,12.0,7.0,2.0,7.0,2.0,12.0,6.0,2.0,1.0,1.0,5.0,0.0,8.0,8.0,12.0,3.0,10.0,5.0,26.0,41.0,15.0,10.0,12.0,9.0,7.0,6.0,6.0,2.0,23.0,3.0,2.0,11.0,6.0,7.0,5.0,10.0,0.0,5.0,32.0,20.0,11.0,11.0,0.0,10.0,25.0,15.0,8.0,1.0,10.0,9.0,44.0,0.0,2.0,7.0,1.0,7.0,17.0,13.0,6.0,9.0,36.0,10.0,2.0,51.0,0.0,0.0,3.0,10.0,9.0,4.0,6.0,4.0,6.0,10.0,8.0,9.0,29.0,12.0,1.0,19.0,4.0,9.0,24.0,13.0,0.0,2.0,3.0,17.0,10.0,12.0,3.0,23.0,22.0,6.0,5.0,10.0,29.0,15.0,3.0,7.0,13.0,8.0,14.0,6.0,14.0,15.0,2.0,14.0,1.0,3.0,35.0,0.0,2.0,10.0,4.0,1.0,1.0,15.0,2.0,17.0,10.0,4.0,13.0,9.0,12.0,1.0,2.0,2.0,11.0,12.0,1.0,0.0,8.0,7.0,2.0,31.0,6.0,20.0,1.0,12.0,0.0,14.0,3.0,2.0,5.0,4.0,13.0,9.0,11.0,1.0,1.0,2.0,2.0,6.0,15.0,27.0,43.0,3.0,18.0,2.0,14.0,5.0,7.0,3.0,13.0,14.0,7.0,4.0,1.0,8.0,6.0,11.0,2.0,62.0,0.0,14.0,0.0,11.0,3.0,9.0,20.0,6.0,1.0,13.0,11.0,0.0,10.0,1.0,7.0,1.0,5.0,0.0,11.0,46.0,13.0,21.0,0.0,5.0,2.0,6.0,3.0,9.0,2.0,9.0,8.0,10.0,15.0,6.0,7.0,13.0,5.0,12.0,16.0,11.0,3.0,8.0,1.0,3.0,0.0,10.0,1.0,1.0,2.0,4.0,20.0,17.0,12.0,11.0,1.0,1.0,3.0,2.0,0.0,19.0,10.0,3.0,4.0,6.0,9.0,4.0,5.0,6.0,13.0,45.0,4.0,1.0,6.0,0.0,69.0,17.0,9.0,8.0,15.0,7.0,4.0,1.0,45.0,3.0,23.0,6.0,12.0,9.0,22.0,14.0,2.0,2.0,1.0,2.0,3.0,1.0,2.0,12.0,11.0,2.0,5.0,12.0,0.0,5.0,4.0,7.0,12.0,7.0,14.0,1.0,1.0,4.0,1.0,3.0,4.0,5.0,8.0,15.0,11.0,18.0,20.0,5.0,10.0,3.0,9.0,14.0,13.0,12.0,14.0,9.0,7.0,12.0,16.0,2.0,3.0,5.0,13.0,11.0,1.0,9.0,5.0,10.0,4.0,14.0,18.0,6.0,18.0,16.0,17.0,31.0,11.0,10.0,29.0,0.0,13.0,17.0,19.0,23.0,17.0,25.0,18.0,17.0,7.0,32.0,9.0,16.0,8.0,21.0,20.0,23.0,17.0,12.0,13.0,13.0,5.0,2.0,3.0,0.0,15.0,0.0,0.0,11.0,11.0,0.0,11.0,20.0,0.0,1.0,0.0,3.0,6.0,1.0,5.0,16.0,16.0,12.0,23.0,1.0,12.0,0.0,12.0,1.0,2.0,1.0,1.0,18.0,1.0,5.0,0.0,8.0,10.0,18.0,6.0,1.0,6.0,2.0,5.0,8.0,14.0,12.0,6.0,5.0,6.0,13.0,15.0,20.0,1.0,18.0,0.0,1.0,8.0,2.0,11.0,13.0,16.0,5.0,3.0,19.0,9.0,0.0,9.0,9.0,17.0,25.0,0.0,15.0,23.0,12.0,13.0,13.0,15.0,15.0,9.0,12.0,17.0,26.0,16.0,16.0,4.0,19.0,10.0,4.0,16.0,5.0,4.0,12.0,0.0,0.5,11.5,12.0,22.0,19.0,14.0,12.0,21.5,0.0,7.0,19.0,0.0,20.0,2.0,3.0,8.0,6.0,7.0,17.0,0.0,7.5,12.0,0.5,2.5,11.5,1.0,3.0,21.0,25.5,16.0,11.5,12.0,4.0,4.0,17.0,20.5,23.0,17.0,15.0,19.0,2.0,11.5,11.5,4.0,14.5,8.5,6.5,1.0,19.0,10.5,5.0,1.0,23.5,4.5,22.0,12.0,0.5,30.0,9.0,19.5,12.0,10.0,22.0,10.0,1.5,14.0,19.0,18.5,19.0,19.5,2.0,10.0,1.0,0.0,1.0,2.5,17.0,3.5,16.0,3.0,16.5,3.0,16.5,6.5,19.0,6.5,36.0,8.0,5.0,11.0,3.0,2.5,9.0,15.0,16.0,6.5,17.0,9.5,26.0,1.0,16.0,19.5,0.0,11.0,5.5,7.0,13.5,0.5,26.5,2.0,1.0,4.5,3.5,30.5,26.5,19.5,17.0,8.0,0.0,0.0,0.0,0.0,13.0,9.0,14.0,7.0,11.0,9.0,0.0,10.0,10.0,17.0,3.0,7.0,6.0,8.0,16.0,4.0,3.0,4.0,3.0,13.0,0.0,6.0,9.0,9.0,6.0,3.0,3.0,5.0,11.0,13.0,5.0,1.0,16.0,6.0,17.0,3.0,9.0,12.0,15.0,13.0,6.0,11.0,2.0,11.0,8.0,12.0,7.0,10.0,5.0,7.0,0.0,0.0,0.0,0.0,0.0,0.0,0.0,7.0,8.0,9.0,5.0,6.0,9.0,13.0,7.0,4.0,5.0,6.0,4.0,5.0,5.0,12.0,7.0,6.0,7.0,12.0,5.0,5.0,4.0,4.0,4.0,10.0,9.0,12.0,9.0,3.0,4.0,8.0,6.0,8.0,6.0,3.0,9.0,5.0,4.0,6.0,7.0,7.0,3.0,6.0,7.0,5.0,5.0,6.0,8.0,7.0,9.0,8.0,8.0,5.0,6.0,6.0,5.0,4.0,4.0,5.0,10.0,10.0,5.0,7.0,4.0,4.0,7.0,6.0,7.0,8.0,4.0,6.0,8.0,11.0,8.0,4.0,9.0,2.0,10.0,13.0,3.0,11.0,7.0,7.0,13.0,4.0,8.0,5.0,4.0,8.0,6.0,12.0,9.0,5.0,5.0,3.0,7.0,8.0,5.0,9.0,7.0,4.0,0.0,0.0,1.0,1.0,2.0,2.0,2.0,0.0,1.0,0.0,0.0,0.0,3.0,0.0,0.0,2.0,0.0,0.0,4.0,6.0,8.0,8.0,4.0,15.0,3.0,7.0,6.0,4.0,0.0,14.0,4.0,0.0,14.0,7.0,4.0,16.0,0.0,14.0,9.0,6.0,16.0,1.0,9.0,11.0,2.0,4.0,16.0,8.0,7.0,0.0,6.0,8.0,4.0,0.0,3.0,10.0,8.0,7.0,11.0,5.0,0.0,16.0,13.0,8.0,7.0,10.0,10.0,7.0,6.0,6.0,8.0,18.0,11.0,11.0,7.0,5.0,7.0,5.0,5.0,2.0,12.0,8.0,8.0,9.0,8.0,1.0,3.0,10.0,7.0,6.0,17.0,4.0,7.0,9.0,10.0,0.0,9.0,13.0,,1.0,7.0,3.0,0.0,0.0,5.0,13.0,2.0,3.0,10.0,8.0,9.0,4.0,12.0,3.0,11.0,0.0,0.0,0.0,0.0,0.0,0.0,0.0,0.0,0.0,6.0,4.0,10.0,8.0,7.0,18.0,14.0,9.0,9.0,15.0,5.0,15.0,3.0,12.0,6.0,8.0,8.0,11.0,13.0,3.0,4.0,11.0,12.0,7.0,9.0,7.0,11.0,4.0,0.0,3.0,11.0,5.0,9.0,1.0,2.0,7.0,12.0,0.0,0.0,0.0,0.0,0.0,0.0,0.0,0.0,0.0,0.0,0.0,0.0,0.0,0.0,0.0,0.0,0.0,0.0,0.0,0.0,0.0,20.0,16.0,1.0,2.0,0.0,0.0,0.0,1.0,4.0,0.0,0.0,0.0,0.0,0.0,1.0,0.0,4.0,0.0,0.0,1.0,2.0,0.0,2.0,2.0,0.0,0.0,0.0,0.0,0.0,12.0,7.0,4.0,6.0,9.0,9.0,9.0,7.0,7.0,9.0,12.0,13.0,8.0,9.0,6.0,10.0,4.0,5.0,9.0,4.0,7.0,7.0,6.0,3.0,3.0,7.0,7.0,6.0,8.0,5.0,6.0,6.0,9.0,6.0,7.0,4.0,7.0,11.0,6.0,3.0,6.0,6.0,5.0,6.0,1.0,5.0,7.0,6.0,3.0,8.0,7.0,8.0,7.0,4.0,7.0,5.0,6.0,0.0,10.0,2.0,7.0,5.0,8.0,5.0,6.0,10.0,6.0,5.0,9.0,4.0,4.0,4.0,8.0,10.0,3.0,4.0,8.0,5.0,12.0,10.0,6.0,7.0,3.0,3.0,8.0,8.0,9.0,3.0,9.0,9.0,7.0,0.0,13.0,12.0,4.0,6.0,6.0,4.0,6.0,5.0,19.0,3.0,5.0,1.0,8.0,9.0,10.0,8.0,15.0,7.0,2.0,5.0,9.0,11.0,7.0,4.0,9.0,6.0,4.0,9.0,6.0,7.0,2.0,4.0,11.0,2.0,10.0,6.0,9.0,1.0,8.0,10.0,11.0,11.0,4.0,5.0,5.0,4.0,6.0,6.0,9.0,10.0,2.0,6.0,2.0,4.0,3.0,6.0,7.0,10.0,18.0,1.0,5.0,3.0,5.0,6.0,6.0,3.0,4.0,5.0,5.0,3.0,2.0,5.0,8.0,8.0,4.0,6.0,5.0,2.0,6.0,7.0,7.0,4.0,6.0,9.0,4.0,0.0,0.0,1.0,11.0,0.0,8.0,7.0,6.0,6.0,15.0,0.0,6.0,6.0,6.0,1.0,4.0,5.0,5.0,8.0,6.0,6.0,13.0,4.0,6.0,6.0,2.0,9.0,5.0,14.0,6.0,5.0,2.0,3.0,11.0,6.0,6.0,3.0,6.0,4.0,3.0,7.0,3.0,2.0,6.0,10.0,3.0,15.0,10.0,2.0,11.0,16.0,9.0,21.0,18.0,7.0,14.0,18.0,5.0,3.0,9.0,9.0,5.0,6.0,13.0,14.0,11.0,1.0,8.0,9.0,10.0,3.0,9.0,8.0,7.0,4.0,8.0,8.0,6.0,12.0,15.0,1.0,0.0,8.0,9.0,2.0,15.0,1.0,0.0,3.0,2.0,0.0,2.0,11.0,1.0,11.0,6.0,2.0,3.0,1.0,0.0,1.0,5.0,11.0,3.0,4.0,6.0,4.0,3.0,4.0,7.0,20.0,14.0,4.0,9.0,10.0,6.0,0.0,7.0,19.0,11.0,5.0,14.0,4.0,10.0,15.0,14.0,5.0,14.0,15.0,5.0,8.0,22.0,0.0,13.0,6.0,6.0,9.0,10.0,6.0,6.0,11.0,4.0,19.0,1.0,3.0,1.0,2.0,3.0,14.0,9.0,5.0,6.0,0.0,4.0,8.0,10.0,8.0,2.0,4.0,4.0,0.0,12.0,9.0,5.0,7.0,2.0,11.0,6.0,2.0,5.0,7.0,7.0,9.0,16.0,11.0,7.0,13.0,6.0,9.0,14.0,16.0,5.0,12.0,2.0,0.0,8.0,0.0,38.0,0.0,0.0,4.0,0.0,1.0,4.0,3.0,4.0,3.0,1.0,7.0,12.0,4.0,4.0,1.0,3.0,0.0,3.0,10.0,4.0,4.0,6.0,9.0,5.0,10.0,6.0,13.0,13.0,5.0,0.0,4.0,14.0,8.0,4.0,9.0,5.0,10.0,11.0,4.0,0.0,23.0,0.0,4.0,14.0,20.0,1.0,22.0,7.0,3.0,2.0,8.0,10.0,10.0,7.0,1.0,3.0,7.0,3.0,3.0,2.0,7.0,5.0,4.0,5.0,9.0,1.0,0.0,2.0,13.0,0.0,2.0,1.0,4.0,3.0,4.0,4.0,4.0,5.0,11.0,6.0,0.0,12.0,11.0,5.0,4.0,0.0,0.0,0.0,4.0,8.0,6.0,4.0,1.0,3.0,8.0,5.0,6.0,4.0,11.0,15.0,5.0,4.0,4.0,8.0,4.0,7.0,9.0,4.0,7.0,17.0,0.0,2.0,4.0,2.0,2.0,2.0,1.0,10.0,12.0,33.0,14.0,12.0,5.0,1.0,12.0,12.0,18.0,1.0,7.0,15.0,8.0,12.0,15.0,12.0,4.0,2.0,3.0,8.0,3.0,15.0,6.0,3.0,5.0,13.0,2.0,5.0,14.0,1.0,14.0,4.0,6.0,3.0,11.0,18.0,9.0,3.0,13.0,9.0,9.0,12.0,12.0,6.0,5.0,18.0,7.0,3.0,4.0,14.0,8.0,0.0,5.0,5.0,10.0,0.0,6.0,7.0,18.0,6.0,5.0,18.0,3.0,0.0,3.0,29.0,10.0,6.0,9.0,13.0,1.0,3.0,0.0,5.0,32.0,6.0,14.0,7.0,32.0,3.0,9.0,6.0,7.0,8.0,2.0,17.0,9.0,10.0,14.0,7.0,10.0,11.0,10.0,2.0,3.0,1.0,3.0,2.0,11.0,3.0,0.0,4.0,5.0,7.0,1.0,0.0,2.0,9.0,9.0,8.0,13.0,3.0,3.0,4.0,1.0,4.0,5.0,4.0,18.0,3.0,9.0,2.0,6.0,5.0,8.0,7.0,0.0,4.0,1.0,7.0,3.0,3.0,8.0,1.0,13.0,3.0,4.0,3.0,3.0,7.0,1.0,18.0,29.0,8.0,1.0,6.0,1.0,6.0,0.0,6.0,0.0,10.0,4.0,6.0,0.0,8.0,0.0,6.0,10.0,7.0,4.0,5.0,3.0,6.0,4.0,23.0,14.0,22.0,4.0,21.0,14.0,5.0,4.0,20.0,4.0,14.0,17.0,10.0,2.0,1.0,5.0,15.0,11.0,2.0,6.0,12.0,6.0,2.0,12.0,10.0,4.0,7.0,18.0,17.0,14.0,10.0,10.0,6.0,5.0,11.0,7.0,2.0,7.0,5.0,0.0,3.0,3.0,0.0,19.0,1.0,1.0,8.0,8.0,4.0,3.0,1.0,9.0,2.0,9.0,5.0,3.0,5.0,1.0,7.0,7.0,27.0,0.0,4.0,12.0,10.0,6.0,3.0,1.0,10.0,8.0,2.0,2.0,26.0,3.0,4.0,8.0,13.0,10.0,5.0,8.0,9.0,17.0,10.0,5.0,1.0,7.0,2.0,6.0,6.0,2.0,7.0,5.0,11.0,0.0,0.0,1.0,6.0,3.0,0.0,4.0,11.0,10.0,6.0,3.0,10.0,11.0,9.0,1.0,5.0,17.0,14.0,13.0,8.0,14.0,7.0,0.0,23.0,22.0,6.0,4.0,6.0,15.0,7.0,11.0,10.0,0.0,15.0,14.0,10.0,13.0,5.0,6.0,6.0,1.0,0.0,3.0,0.0,4.0,3.0,0.0,0.0,0.0,0.0,0.0,2.0,1.0,0.0,4.25,9.0,1.0,7.0,0.0,0.0,2.0,2.0,1.0,1.0,3.0,1.0,1.0,1.0,2.0,4.0,6.0,2.0,0.0,2.0,0.0,0.0,2.0,0.0,0.0,3.0,0.0,1.0,4.0,1.0,0.0,3.0,4.0,5.0,50.0,50.0,30.0,30.0,40.0,3.0,13.0,8.0,5.0,11.0,0.0,5.0,15.0,20.0,32.0,10.0,4.0,13.0,12.0,7.0,8.0,13.0,13.0,8.0,10.0,14.0,21.0,13.0,4.0,11.0,8.0,15.0,11.0,13.0,5.0,8.0,7.0,5.0,28.0,16.0,6.0,14.0,13.0,8.0,7.0,7.0,3.0,13.0,35.0,6.0,4.0,12.0,11.0,16.0,6.0,1.0,5.0,15.0,24.0,9.0,16.0,18.0,14.0,9.0,13.0,0.0,8.0,18.0,22.0,17.0,10.0,13.0,12.0,15.0,3.0,1.0,3.0,9.0,10.0,17.0,16.0,1.0,8.0,0.0,2.0,24.0,15.0,8.0,1.0,14.0,12.0,11.0,2.0,13.0,3.0,16.0,0.0,19.0,12.0,4.0,8.0,7.0,19.0,2.0,10.0,0.0,9.0,8.0,11.0,5.0,1.0,4.0,7.0,9.0,4.0,7.0,5.0,6.0,20.0,4.0,7.0,9.0,0.0,16.0,13.0,13.0,4.0,5.0,6.0,4.0,9.0,9.0,13.0,8.0,5.0,3.0,0.0,3.0,8.0,9.0,8.0,0.0,3.0,5.0,4.0,7.0,8.0,7.0,6.0,10.0,8.0,5.0,5.0,8.0,19.0,5.0,13.0,11.0,4.0,4.0,1.0,3.0,5.0,1.0,7.0,0.0,2.0,0.0,23.0,20.0,14.0,3.0,10.0,2.0,26.0,5.0,20.0,27.0,29.0,29.0,31.0,30.0,23.0,7.0,24.0,12.0,6.0,26.0,18.0,28.0,14.0,14.0,14.0,13.0,16.0,31.0,16.0,7.0,11.0,4.0,3.0,0.0,14.0,10.0,7.0,31.0,9.0,2.0,13.0,13.0,13.0,33.0,17.0,8.0,10.0,31.0,13.0,5.0,8.0,8.0,5.0,5.0,2.0,5.0,6.0,7.0,0.0,8.0,3.0,13.0,6.0,6.0,8.0,7.0,13.0,11.0,22.0,16.0,7.0,7.0,0.0,15.0,2.0,4.0,16.0,5.0,15.0,6.0,5.0,4.0,8.0,7.0,3.0,3.0,9.0,1.0,14.0,17.0,16.0,15.0,24.0,13.0,6.0,7.0,8.0,4.0,1.0,1.0,16.0,9.0,5.0,4.0,7.0,5.0,8.0,2.0,9.0,3.0,11.0,10.0,7.0,2.0,5.0,8.0,14.0,1.0,6.0,2.0,7.0,6.0,7.0,3.0,4.0,2.0,3.0,13.0,9.0,3.0,13.0,7.0,12.0,13.0,11.0,7.0,4.0,5.0,24.0,12.0,3.0,7.0,6.0,6.0,1.0,3.0,8.0,4.0,13.0,17.0,9.0,10.0,10.0,4.0,8.0,14.0,5.0,0.0,14.0,22.0,8.0,1.0,7.0,10.0,13.0,22.0,6.0,3.0,15.0,13.0,16.0,14.0,3.0,5.0,5.0,7.0,8.0,9.0,6.0,2.0,5.0,10.0,15.0,10.0,2.0,13.0,13.0,29.0,12.0,11.0,10.0,11.0,11.0,12.0,4.0,14.0,9.0,3.0,9.0,9.0,0.0,9.0,5.0,23.0,1.0,17.0,17.0,13.0,0.0,6.0,1.0,6.0,3.0,4.0,9.0,7.0,1.0,2.0,4.0,3.0,17.0,6.0,13.0,2.0,6.0,3.0,7.0,13.0,3.0,20.0,10.0,8.0,9.0,2.0,5.0,2.0,7.0,17.0,12.0,4.0,14.0,5.0,3.0,15.0,15.0,1.0,1.0,22.0,6.0,8.0,16.0,9.0,13.0,0.0,5.0,6.0,8.0,13.0,23.0,15.0,10.0,8.0,13.0,4.0,8.0,13.0,0.0,8.0,18.0,18.0,11.0,6.0,7.0,3.0,8.0,7.0,13.0,8.0,0.0,8.0,10.0,8.0,10.0,7.0,6.0,5.0,2.0,15.0,15.0,14.0,10.0,6.0,8.0,7.0,7.0,7.0,3.0,9.0,6.0,7.0,14.0,9.0,11.0,5.0,12.0,16.0,19.0,19.0,7.0,4.0,3.0,6.0,5.0,5.0,5.0,7.0,9.0,2.0,1.0,5.0,15.0,0.0,0.0,0.0,1.0,1.0,6.0,2.0,0.0,1.0,3.0,12.0,9.0,0.0,0.0,1.0,6.0,8.0,3.0,8.0,5.0,0.0,3.0,0.0,1.0,1.0,2.0,1.0,2.0,0.0,5.0,3.0,11.0,1.0,2.0,0.0,15.0,8.0,5.0,0.0,1.0,1.0,7.0,10.0,0.0,15.0,0.0,0.0,6.0,0.0,0.0,2.0,3.0,1.0,0.0,14.0,1.0,3.0,5.0,0.0,0.0,1.0,3.0,1.0,2.0,0.0,0.0,2.0,1.0,0.0,0.0,6.0,1.0,5.0,18.0,1.0,8.0,0.0,1.0,1.0,1.0,0.0,1.0,0.0,0.0,1.0,0.0,1.0,0.0,7.0,10.0,2.0,0.0,12.0,1.0,1.0,6.0,1.0,9.0,1.0,0.0,0.0,0.0,19.0,0.0,0.0,23.0,2.0,1.0,13.0,3.0,0.0,0.0,0.0,1.0,1.0,0.0,0.0,0.0,2.0,1.0,1.0,1.0,1.0,3.0,1.0,1.0,11.0,2.0,3.0,4.0,3.0,14.0,1.0,0.0,0.0,1.0,1.0,0.0,2.0,3.0,0.0,0.0,0.0,0.0,21.0,13.0,8.0,0.0,1.0,2.0,0.0,0.0,3.0,8.0,3.0,0.0,0.0,23.0,14.0,1.0,3.0,1.0,0.0,0.0,0.0,1.0,0.0,0.0,1.0,4.0,3.0,2.0,0.0,1.0,1.0,0.0,0.0,0.0,0.0,1.0,0.0,0.0,0.0,4.0,3.0,0.0,1.0,0.0,0.0,0.0,5.0,0.0,0.0,2.0,1.0,1.0,1.0,2.0,0.0,0.0,1.0,7.0,6.0,2.0,0.0,1.0,1.0,9.0,1.0,13.0,0.0,1.0,4.0,3.0,0.0,6.0,0.0,1.0,0.0,7.0,12.0,8.0,2.0,2.0,0.0,0.0,0.0,0.0,1.0,2.0,2.0,19.0,0.0,0.0,0.0,1.0,0.0,0.0,0.0,2.0,0.0,1.0,5.0,0.0,6.0,0.0,0.0,0.0,1.0,7.0,1.0,1.0,1.0,0.0,0.0,5.0,0.0,0.0,0.0,2.0,3.0,1.0,2.0,9.0,0.0,3.0,0.0,0.0,1.0,3.0,0.0,0.0,1.0,0.0,0.0,0.0,12.0,1.0,8.0,0.0,1.0,2.0,1.0,7.0,6.0,1.0,0.0,1.0,0.0,1.0,1.0,1.0,0.0,0.0,0.0,16.0,9.0,2.0,5.0,0.0,0.0,1.0,7.0,0.0,14.0,1.0,3.0,8.0,1.0,2.0,2.0,1.0,5.0,7.0,1.0,6.0,2.0,0.0,14.0,0.0,2.0,1.0,6.0,8.0,1.0,0.0,1.0,2.0,0.0,11.0,4.0,5.0,0.0,0.0,1.0,0.0,7.0,1.0,0.0,6.0,2.0,2.0,6.0,7.0,15.0,3.0,16.0,2.0,0.0,0.0,5.0,0.0,2.0,3.0,1.0,4.0,0.0,18.0,1.0,2.0,1.0,0.0,8.0,1.0,3.0,0.0,1.0,2.0,1.0,4.0,3.0,4.0,2.0,0.0,7.0,0.0,2.0,0.0,0.0,1.0,18.0,5.0,2.0,3.0,1.0,2.0,1.0,1.0,0.0,2.0,0.0,0.0,13.0,0.0,9.0,5.0,7.0,3.0,3.0,7.0,10.0,9.0,7.0,11.0,10.0,11.0,10.0,6.0,10.0,0.0,0.0,0.0,0.0,0.0,0.0,0.0,0.0,0.0,0.0,0.0,3.0,0.0,13.0,2.0,14.0,3.0,7.0,1.0,1.0,12.0,13.0,2.0,8.0,7.0,1.0,8.0,3.0,4.0,15.0,0.0,6.0,7.0,4.0,5.0,5.0,0.0,12.0,1.0,10.0,3.0,2.0,3.0,3.0,3.0,5.0,0.0,19.0,1.0,0.0,8.0,13.0,6.0,2.0,6.0,17.0,1.0,2.0,17.0,3.0,12.0,5.0,2.0,3.0,13.0,0.0,7.0,16.0,3.0,17.0,1.0,0.0,3.0,0.0,19.0,2.0,1.0,1.0,16.0,1.0,6.0,7.0,17.0,10.0,1.0,0.0,10.0,1.0,15.0,6.0,5.0,3.0,4.0,3.0,3.0,0.0,8.0,0.0,3.0,6.0,6.0,0.0,0.0,23.0,15.0,22.0,2.0,8.0,18.0,0.0,1.0,2.0,3.0,6.0,2.0,2.0,8.0,1.0,0.0,0.0,2.0,13.0,7.0,1.0,12.0,0.0,3.0,0.0,16.0,0.0,0.0,4.0,8.0,3.0,0.0,2.0,1.0,0.0,0.0,3.0,3.0,5.0,0.0,3.0,3.0,1.0,10.0,8.0,0.0,15.0,4.0,22.0,2.0,4.0,6.0,5.0,0.0,3.0,7.0,2.0,0.0,0.0,6.0,14.0,6.0,10.0,8.0,1.0,7.0,6.0,10.0,0.0,1.0,1.0,6.0,7.0,6.0,3.0,3.0,0.0,11.0,0.0,13.0,0.0,0.0,22.0,5.0,3.0,2.0,5.0,22.0,18.0,0.0,9.0,6.0,4.0,2.0,13.0,4.0,8.0,0.0,0.0,0.0,16.0,0.0,13.0,0.0,1.0,17.0,0.0,3.0,13.0,15.0,5.0,18.0,20.0,9.0,5.0,4.0,8.0,1.0,0.0,3.0,0.0,1.0,0.0,2.0,2.0,11.0,0.0,14.0,11.0,3.0,1.0,3.0,17.0,7.0,2.0,3.0,6.0,15.0,15.0,3.0,4.0,2.0,11.0,6.0,12.0,0.0,9.0,0.0,2.0,1.0,0.0,12.0,0.0,2.0,8.0,13.0,21.0,15.0,0.0,15.0,1.0,8.0,3.0,3.0,5.0,7.0,8.0,6.0,11.0,1.0,2.0,0.0,4.0,3.0,1.0,0.0,12.0,5.0,1.0,4.0,2.0,0.0,2.0,0.0,1.0,5.0,10.0,0.0,3.0,3.0,10.0,14.0,2.0,2.0,4.0,2.0,1.0,0.0,0.0,1.0,3.0,0.0,1.0,5.0,1.0,0.0,3.0,7.0,1.0,15.0,6.0,1.0,2.0,14.0,16.0,17.0,1.0,0.0,3.0,6.0,4.0,0.0,1.0,1.0,0.0,4.0,0.0,3.0,3.0,24.0,0.0,2.0,3.0,14.0,7.0,0.0,2.0,2.0,12.0,8.0,8.0,0.0,2.0,2.0,4.0,1.0,6.0,19.0,4.0,2.0,3.0,6.0,8.0,1.0,1.0,0.0,7.0,4.0,11.0,3.0,1.0,14.0,2.0,2.0,2.0,23.0,4.0,19.0,19.0,5.0,5.0,0.0,2.0,14.0,4.0,16.0,2.0,1.0,11.0,2.0,4.0,9.0,6.0,6.0,13.0,4.0,5.0,8.0,6.0,5.0,6.0,5.0,3.0,12.0,8.0,6.0,6.0,6.0,5.0,9.0,7.0,0.0,11.0,6.0,5.0,7.0,6.0,5.0,8.0,4.0,4.0,14.0,9.0,6.0,8.0,6.0,8.0,15.0,9.0,10.0,5.0,5.0,6.0,5.0,4.0,5.0,5.0,5.0,1.0,5.0,0.0,5.0,0.0,5.0,5.0,5.0,1.0,3.0,5.0,1.0,5.0,0.0,1.0,2.0,5.0,5.0,3.0,5.0,5.0,5.0,0.0,5.0,1.0,0.0,1.0,2.0,1.0,5.0,0.0,5.0,5.0,4.0,0.0,5.0,2.0,5.0,5.0,5.0,1.0,3.0,5.0,5.0,3.0,5.0,0.0,3.0,2.0,0.0,0.0,0.0,1.0,0.0,0.0,4.0,1.0,5.0,0.0,0.0,1.0,5.0,0.0,0.0,0.0,0.0,3.0,0.0,0.0,1.0,0.0,0.0,4.0,1.0,4.0,1.0,0.0,5.0,0.0,1.0,3.0,1.0,0.0,1.0,2.0,0.0,2.0,0.0,0.0,10.5,4.5,3.5,0.0,11.5,0.0,0.0,3.5,6.5,0.0,0.0,0.0,0.0,0.0,9.0,5.5,6.0,0.0,0.0,0.0,2.5,0.0,0.0,7.5,13.0,12.0,0.0,0.0,0.0,0.0,8.5,6.0,13.0,7.0,4.0,6.5,0.0,0.0,5.0,2.0,0.0,0.0,0.0,2.5,0.0,,0.0,0.0,4.5,0.0,0.0,0.0,0.0,0.0,5.5,0.0,0.0,0.0,0.0,3.0,0.0,3.0,3.0,8.0,1.5,0.0,2.5,1.0,0.0,9.5,0.0,0.0,0.0,0.0,0.0,1.5,7.0,6.0,1.5,0.0,0.0,0.0,0.0,0.0,8.5,0.0,4.0,1.0,0.0,0.0,2.5,6.5,0.0,19.0,0.0,0.0,3.0,0.0,8.0,12.0,10.0,11.0,5.0,13.0,9.0,11.0,14.0,7.0,8.0,14.0,11.0,5.0,0.0,10.0,15.0,9.0,11.0,4.0,4.0,11.0,9.0,8.0,5.0,7.0,10.0,9.0,11.0,14.0,21.0,8.0,14.0,3.0,1.0,5.0,5.0,5.0,5.0,5.0,5.0,2.0,5.0,5.0,4.0,0.0,0.0,0.0,0.0,0.0,0.0,0.0,2.0,2.0,0.0,0.0,0.0,0.0,1.0,13.0,3.0,11.0,7.0,12.0,3.0,1.0,0.0,2.0,7.0,7.0,4.0,2.0,2.0,1.0,2.0,2.0,5.0,1.0,2.0,5.0,7.0,4.0,11.0,15.0,7.0,1.0,5.0,2.0,6.0,2.0,6.0,6.0,8.0,12.0,9.0,3.0,4.0,7.0,0.0,12.0,5.0,10.0,7.0,11.0,4.0,4.0,6.0,10.0,6.0,12.0,2.0,1.0,0.0,9.0,1.0,1.0,5.0,12.0,6.0,6.0,5.0,4.0,1.0,8.0,4.0,12.0,6.0,4.0,4.0,2.0,0.0,6.0,0.0,18.0,11.0,3.0,2.0,13.0,9.0,18.0,8.0,4.0,10.0,4.0,4.0,11.0,3.0,14.0,8.0,3.0,8.0,7.0,5.0,0.0,3.0,3.0,7.0,3.0,4.0,5.0,7.0,1.0,0.0,1.0,4.0,1.0,1.0,0.0,5.0,5.0,2.0,1.0,0.0,3.0,0.0,6.0,8.0,0.0,0.0,5.0,5.0,4.0,4.0,5.0,0.0,0.0,4.0,5.0,4.0,5.0,3.0,5.0,4.0,4.0,5.0,4.0,,,,,,,2.0,4.0,4.0,1.0,4.0,5.0,1.0,0.0,11.0,5.0,7.0,4.0,8.0,13.0,14.0,7.0,6.0,8.0,1.0,1.0,0.0,0.0,0.0,0.0,3.0,1.0,4.0,2.0,0.0,2.0,3.0,4.0,1.0,4.0,4.0,2.0,5.0,7.0,3.0,2.0,0.0,1.0,0.0,0.0,0.0,2.0,0.0,1.0,2.0,2.0,3.0,1.0,1.0,2.0,5.0,2.0,4.0,0.0,1.0,4.0,5.0,0.0,0.0,1.0,4.0,0.0,1.0,7.0,0.0,6.0,5.0,6.0,1.0,2.0,8.0,4.0,0.0,1.0,0.0,6.0,1.0,2.0,3.0,5.0,6.0,2.0,10.0,9.0,3.0,0.0,1.0,5.0,0.0,2.0,0.0,0.0,4.0,1.0,2.0,1.0,5.0,5.0,0.0,0.0,7.0,3.0,5.0,10.0,6.0,2.0,3.0,6.0,5.0,3.0,11.0,3.0,3.0,7.0,7.0,5.0,11.0,6.0,5.0,5.0,6.0,5.0,4.0,5.0,11.0,8.0,7.0,3.0,5.0,6.0,0.0,6.0,3.0,11.0,10.0,3.0,13.0,6.0,8.0,0.0,7.0,4.0,9.0,8.0,7.0,4.0,0.0,6.0,8.0,2.0,0.0,8.0,9.0,4.0,3.0,4.0,6.0,8.0,4.0,7.0,4.0,8.0,5.0,1.0,0.0,0.0,3.0,2.0,1.0,3.0,7.0,0.0,7.0,3.0,2.0,0.0,1.0,4.0,3.0,4.0,0.0,5.0,2.0,9.0,1.0,5.0,1.0,0.0,10.0,1.0,1.0,6.0,1.0,2.0,5.0,2.0,2.0,4.0,2.0,1.0,4.0,5.0,3.0,2.0,7.0,0.0,7.0,4.0,2.0,0.0,14.0,7.0,5.0,3.0,4.0,1.0,2.0,3.0,4.0,4.0,1.0,0.0,0.0,3.0,0.0,4.0,3.0,1.0,3.0,0.0,10.0,4.0,8.0,5.0,9.0,1.0,1.0,0.0,1.0,2.0,2.0,2.0,0.0,1.0,1.0,0.0,2.0,1.0,5.0,1.0,4.0,3.0,4.0,0.0,3.0,3.0,3.0,4.0,2.0,3.0,3.0,6.0,2.0,6.0,9.0,6.0,5.0,10.0,5.0,3.0,5.0,3.0,7.0,6.0,5.0,2.0,5.0,5.0,6.0,5.0,6.0,4.0,3.0,3.0,5.0,2.0,4.0,4.0,4.0,2.0,5.0,3.0,4.0,6.0,1.0,3.0,0.0,6.0,2.0,3.0,3.0,3.0,5.0,4.0,3.0,1.0,2.0,5.0,6.0,3.0,3.0,4.0,0.0,7.0,5.0,3.0,2.0,10.0,2.0,8.0,3.0,6.0,5.0,6.0,3.0,4.0,4.0,1.0,4.0,7.0,4.0,5.0,7.0,4.0,4.0,4.0,7.0,6.0,5.0,2.0,7.0,3.0,9.0,5.0,3.0,3.0,8.0,2.0,4.0,4.0,6.0,3.0,4.0,10.0,7.0,6.0,4.0,7.0,10.0,5.0,5.0,6.0,5.0,1.0,7.0,13.0,8.0,0.0,9.0,1.0,3.0,4.0,3.0,5.0,7.0,8.0,3.0,3.0,6.0,6.0,10.0,4.0,6.0,4.0,3.0,0.0,3.0,7.0,5.0,8.0,6.0,3.0,11.0,9.0,0.0,6.0,6.0,6.0,6.0,7.0,9.0,7.0,0.0,5.0,5.0,8.0,4.0,5.0,5.0,4.0,7.0,2.0,10.0,4.0,5.0,8.0,6.0,1.0,5.0,2.0,6.0,15.0,10.0,11.0,4.0,5.0,9.0,5.0,8.0,7.0,5.0,17.0,10.0,8.0,5.0,4.0,7.0,1.0,8.0,9.0,3.0,3.0,7.0,15.0,9.0,19.0,12.0,7.0,8.0,17.0,10.0,11.0,7.0,11.0,23.0,13.0,10.0,14.0,10.0,15.0,5.0,16.0,9.0,22.0,17.0,3.0,4.0,1.0,6.0,14.0,12.0,1.0,4.0,12.0,0.0,2.0,16.0,5.0,17.0,10.0,13.0,7.0,20.0,0.0,4.0,4.0,4.0,12.0,6.0,1.0,9.0,2.0,1.0,7.0,1.0,15.0,3.0,0.0,3.0,0.0,11.0,8.0,3.0,13.0,4.0,6.0,7.0,17.0,3.0,2.0,2.0,0.0,5.0,6.0,7.0,14.0,2.0,12.0,9.0,3.0,12.0,13.0,9.0,10.0,13.0,24.0,20.0,13.0,5.0,12.0,0.0,8.0,10.0,15.0,16.0,15.0,12.0,12.0,7.0,5.0,8.0,25.0,14.0,8.0,9.0,4.0,8.0,4.0,8.0,9.0,2.0,5.0,14.0,1.0,5.0,13.0,18.0,3.0,9.0,22.0,3.0,2.0,7.0,3.0,2.0,4.0,12.0,10.0,6.0,3.0,0.0,6.0,5.0,7.0,2.0,2.0,6.0,3.0,6.0,5.0,8.0,1.0,4.0,4.0,0.0,6.0,11.0,4.0,8.0,16.0,2.0,0.0,2.0,8.0,0.0,2.0,0.0,0.0,3.0,2.0,1.0,2.0,2.0,3.0,1.0,5.0,4.0,0.0,0.0,4.0,2.0,0.0,0.0,0.0,0.0,3.0,9.0,7.0,3.0,6.0,0.0,4.0,0.0,0.0,0.0,7.0,1.0,3.0,0.0,1.0,1.0,0.0,0.0,0.0,4.0,2.0,0.0,0.0,1.0,20.0,0.0,8.0,3.0,3.0,1.0,1.0,0.0,2.0,1.0,2.0,0.0,1.0,3.0,4.0,9.0,0.0,1.0,3.0,0.0,0.0,1.0,1.0,9.0,1.0,0.0,1.0,0.0,1.0,0.0,0.0,3.0,1.0,3.0,0.0,1.0,1.0,0.0,0.0,0.0,0.0,0.0,7.0,0.0,0.0,0.0,0.0,1.0,0.0,0.0,1.0,5.0,5.0,5.0,5.0,5.0,5.0,1.0,5.0,5.0,1.0,0.0,1.0,0.0,1.0,0.0,1.0,2.0,0.0,0.0,0.0,5.0,1.0,1.0,1.0,1.0,3.0,15.0,4.0,8.0,8.0,37.0,10.0,23.0,6.0,12.0,5.0,11.0,15.0,7.0,4.0,8.0,4.0,1.0,16.0,3.0,7.0,15.0,10.0,12.0,4.0,5.0,10.0,7.0,9.0,4.0,8.0,4.0,2.0,4.0,5.0,5.0,9.0,2.0,13.0,8.0,5.0,15.0,0.0,6.0,2.0,5.0,5.0,4.0,5.0,5.0,5.0,4.0,5.0,2.0,3.0,4.0,5.0,5.0,5.0,5.0,5.0,5.0,1.0,5.0,5.0,5.0,3.0,5.0,5.0,2.0,4.0,5.0,5.0,5.0,5.0,5.0,0.0,5.0,2.0,5.0,4.0,2.0,0.0,3.0,3.0,3.0,0.0,5.0,4.0,2.0,0.0,2.0,5.0,5.0,1.0,5.0,5.0,4.0,1.0,5.0,5.0,5.0,5.0,5.0,5.0,5.0,5.0,0.0,5.0,2.0,0.0,1.0,3.0,5.0,5.0,1.0,3.0,1.0,5.0,2.0,2.0,5.0,2.0,4.0,0.0,2.0,5.0,5.0,5.0,0.0,5.0,2.0,3.0,5.0,2.0,5.0,5.0,2.0,5.0,4.0,3.0,3.0,5.0,5.0,5.0,5.0,2.0,1.0,0.0,5.0,0.0,5.0,5.0,3.0,2.0,5.0,1.0,5.0,5.0,2.0,5.0,2.0,10.0,18.0,9.0,7.0,16.0,11.0,4.0,4.0,11.0,5.0,16.0,17.0,15.0,17.0,10.0,3.0,2.0,5.0,5.0,0.0,5.0,5.0,5.0,2.0,1.0,5.0,5.0,5.0,4.0,5.0,5.0,3.0,5.0,5.0,5.0,5.0,5.0,5.0,5.0,5.0,5.0,3.0,5.0,3.0,5.0,5.0,0.0,0.0,2.0,1.0,5.0,3.0,5.0,5.0,5.0,2.0,5.0,5.0,5.0,4.0,5.0,5.0,0.0,3.0,2.0,0.0,2.0,3.0,4.0,5.0,5.0,5.0,5.0,5.0,5.0,0.0,2.0,4.0,3.0,5.0,5.0,2.0,0.0,0.0,5.0,2.0,3.0,5.0,5.0,5.0,5.0,5.0,5.0,5.0,5.0,5.0,3.0,5.0,5.0,1.0,5.0,0.0,5.0,5.0,5.0,5.0,5.0,5.0,1.0,5.0,1.0,5.0,5.0,5.0,5.0,5.0,5.0,1.0,5.0,4.0,5.0,4.0,5.0,2.0,5.0,5.0,8.0,10.0,6.0,6.0,9.0,3.0,8.0,4.0,3.0,2.0,9.0,8.0,0.0,1.0,11.0,5.0,2.0,12.0,9.0,13.0,15.0,6.0,7.0,13.0,5.0,9.0,6.0,6.0,2.0,4.0,7.0,6.0,7.0,12.0,2.0,3.0,3.0,6.0,6.0,2.0,8.0,8.0,9.0,8.0,10.0,6.0,4.0,8.0,9.0,2.0,9.0,1.0,5.0,10.0,8.0,1.0,2.0,7.0,4.0,8.0,9.0,8.0,9.0,6.0,9.0,3.0,3.0,8.0,9.0,8.0,0.0,1.0,10.0,4.0,9.0,8.0,4.0,4.0,2.0,0.0,7.0,10.0,7.0,1.0,2.0,6.0,1.0,3.0,3.0,11.0,5.0,6.0,5.0,5.0,5.0,11.0,8.0,7.0,9.0,8.0,13.0,7.0,4.0,0.0,6.0,8.0,6.0,3.0,7.0,7.0,13.0,0.0,5.0,1.0,5.0,13.0,2.0,9.0,10.0,1.0,5.0,11.0,6.0,6.0,6.0,3.0,15.0,10.0,8.0,6.0,6.0,12.0,6.0,9.0,13.0,10.0,2.0,7.0,9.0,6.0,9.0,6.0,6.0,7.0,12.0,5.0,9.0,10.0,11.0,7.0,11.0,2.0,3.0,6.0,15.0,9.0,0.0,10.0,4.0,4.0,2.0,3.0,12.0,6.0,4.0,7.0,3.0,3.0,6.0,0.0,3.0,5.0,16.0,4.0,12.0,10.0,1.0,11.0,11.0,7.0,9.0,8.0,4.0,6.0,7.0,6.0,4.0,6.0,5.0,6.0,11.0,5.0,9.0,9.0,13.0,7.0,9.0,2.0,6.0,8.0,7.0,4.0,4.0,7.0,4.0,0.0,0.0,0.0,0.0,0.0,13.0,17.0,8.0,2.0,4.0,6.0,10.0,35.0,24.0,13.0,3.0,7.0,11.0,20.0,10.0,5.0,8.0,3.0,3.0,5.0,8.0,6.0,2.0,6.0,2.0,5.0,3.0,1.0,8.0,7.0,5.0,10.0,2.0,4.0,3.0,2.0,6.0,4.0,0.0,9.0,1.0,6.0,2.0,5.0,2.0,4.0,5.0,8.0,9.0,1.0,5.0,1.0,6.0,6.0,2.0,0.0,5.0,5.0,12.0,13.0,3.0,5.0,11.0,5.0,10.0,6.0,5.0,10.0,10.0,9.0,2.0,3.0,6.0,5.0,4.0,14.0,12.0,14.0,1.0,6.0,6.0,5.0,4.0,1.0,1.0,9.0,7.0,4.0,4.0,4.0,10.0,10.0,3.0,6.0,8.0,4.0,1.0,7.0,3.0,6.0,7.0,12.0,6.0,9.0,12.0,15.0,8.0,8.0,8.0,12.0,7.0,10.0,2.0,6.0,6.0,6.0,5.0,6.0,8.0,8.0,13.0,5.0,3.0,8.0,4.0,8.0,0.0,1.0,5.0,9.0,9.0,,8.0,7.0,5.0,10.0,4.0,4.0,7.0,7.0,7.0,17.0,4.0,13.0,5.0,10.0,6.0,6.0,8.0,4.0,13.0,0.0,0.0,5.0,11.0,9.0,7.0,1.0,0.0,0.0,0.0,8.0,10.0,8.0,0.0,1.0,6.0,5.0,2.0,0.0,11.0,5.0,7.0,6.0,4.0,16.0,10.0,6.0,9.0,11.0,9.0,7.0,14.0,16.0,8.0,2.0,8.0,8.0,1.0,3.0,2.0,11.0,7.0,6.0,11.0,5.0,2.0,6.0,16.0,11.0,7.0,7.0,9.0,1.0,14.0,17.0,7.0,8.0,7.0,14.0,9.0,6.0,8.0,1.0,9.0,9.0,7.0,9.0,3.0,5.0,9.0,8.0,12.0,9.0,9.0,7.0,11.0,10.0,7.0,5.0,5.0,7.0,6.0,0.0,7.0,5.0,6.0,3.0,8.0,4.0,1.0,2.0,4.0,9.0,1.0,4.0,6.0,12.0,1.0,6.0,3.0,0.0,12.0,6.0,2.0,11.0,11.0,2.0,6.0,7.0,4.0,6.0,11.0,2.0,5.0,8.0,7.0,8.0,0.0,6.0,1.0,3.0,7.0,8.0,2.0,6.0,5.0,8.0,2.0,4.0,8.0,8.0,4.0,7.0,8.0,13.0,21.0,6.0,10.0,17.0,10.0,10.0,22.0,13.0,12.0,10.0,11.0,10.0,9.0,12.0,12.0,13.0,12.0,0.0,0.0,9.0,8.0,14.0,13.0,12.0,12.0,7.0,12.0,13.0,15.0,16.0,6.0,25.0,0.0,15.0,8.0,11.0,8.0,0.0,16.0,12.0,22.0,0.0,10.0,13.0,8.0,13.0,4.0,12.0,8.0,8.0,16.0,11.0,10.0,5.0,21.0,11.0,16.0,17.0,19.0,18.0,9.0,6.0,10.0,8.0,10.0,6.0,15.0,11.0,8.0,14.0,15.0,16.0,11.0,16.0,11.0,8.0,7.0,18.0,14.0,17.0,17.0,17.0,14.0,24.0,18.0,23.0,12.0,11.0,15.0,20.0,17.0,18.0,17.0,10.0,13.0,21.0,12.0,11.0,9.0,9.0,11.0,18.0,16.0,18.0,21.0,12.0,9.0,16.0,11.0,11.0,11.0,11.0,9.0,12.0,6.0,17.0,15.0,9.0,13.0,13.0,8.0,11.0,16.0,13.0,10.0,11.0,14.0,6.0,21.0,10.0,9.0,16.0,13.0,14.0,5.0,14.0,9.0,11.0,13.0,13.0,17.0,12.0,13.0,8.0,12.0,4.0,6.0,16.0,6.0,6.0,0.0,8.0,3.0,2.0,9.0,11.0,9.0,11.0,7.0,1.0,4.0,15.0,11.0,4.0,1.0,12.0,5.0,15.0,9.0,14.0,5.0,9.0,3.0,9.0,7.0,6.0,9.0,4.0,11.0,7.0,20.0,11.0,6.0,7.0,10.0,18.0,8.0,11.0,13.0,3.0,12.0,5.0,5.0,4.0,4.0,17.0,8.0,3.0,0.0,0.0,4.0,3.0,3.0,2.0,0.0,0.0,9.0,0.0,0.0,0.0,1.0,0.0,0.0,0.0,0.0,18.0,4.0,10.0,9.0,5.0,11.0,24.0,10.0,12.0,3.0,7.0,4.0,25.0,7.0,1.0,5.0,10.0,2.0,14.0,22.0,14.0,3.0,12.0,12.0,9.0,3.0,18.0,12.0,4.0,7.0,7.0,6.0,2.0,9.0,8.0,3.0,12.0,11.0,24.0,1.0,7.0,3.0,1.0,1.0,3.0,10.0,2.0,3.0,6.0,6.0,6.0,7.0,10.0,13.0,9.0,16.0,9.0,6.0,7.0,12.0,11.0,12.0,8.0,7.0,14.0,10.0,9.0,2.0,5.0,11.0,13.0,11.0,8.0,8.0,11.0,8.0,7.0,12.0,14.0,13.0,10.0,7.0,0.0,4.0,6.0,9.0,14.0,12.0,10.0,9.0,9.0,11.0,10.0,7.0,11.0,1.0,3.0,10.0,3.0,13.0,10.0,8.0,6.0,12.0,11.0,3.0,9.0,2.0,8.0,9.0,7.0,8.0,7.0,6.0,11.0,12.0,8.0,26.0,2.0,13.0,15.0,4.0,11.0,6.0,6.0,8.0,11.0,17.0,16.0,9.0,9.0,4.0,14.0,8.0,3.0,11.0,8.0,12.0,13.0,5.0,18.0,9.0,13.0,11.0,9.0,5.0,5.0,4.0,10.0,23.0,15.0,1.0,5.0,5.0,8.0,11.0,10.0,9.0,7.0,7.0,3.0,6.0,7.0,5.0,9.0,16.0,9.0,8.0,4.0,15.0,5.0,7.0,7.0,18.0,6.0,2.0,2.0,7.0,7.0,6.0,8.0,1.0,8.0,7.0,5.0,3.0,13.0,4.0,8.0,6.0,3.0,5.0,14.0,4.0,4.0,12.0,6.0,5.0,0.0,0.5,9.0,4.0,0.0,0.0,1.0,5.0,0.0,0.0,2.0,0.0,4.0,4.0,0.0,3.0,0.0,13.0,0.0,8.0,6.0,6.0,0.0,0.0,0.0,0.0,0.0,1.0,2.0,2.0,2.0,0.0,1.0,4.0,3.0,2.0,0.0,0.0,4.0,3.0,0.0,2.0,1.0,0.0,0.0,0.0,4.0,0.0,4.0,0.0,0.0,5.0,0.0,0.0,2.0,4.0,4.0,2.0,5.0,7.0,0.0,0.0,5.0,1.0,0.0,4.0,4.0,0.0,0.0,0.0,5.0,0.0,3.0,0.0,0.0,0.0,0.0,0.0,0.0,0.0,0.0,0.0,0.0,0.0,0.0,0.0,0.0,0.0,0.0,0.0,0.0,6.0,0.0,5.0,1.0,4.0,4.0,0.0,0.0,0.0,2.0,0.0,4.0,2.0,4.0,1.0,0.0,2.0,1.0,0.0,0.0,0.0,0.0,0.0,0.0,0.0,2.0,0.0,0.0,0.0,0.0,2.0,13.0,8.0,14.0,16.0,21.0,7.0,8.0,12.0,3.0,18.0,0.0,9.0,1.0,2.0,21.0,4.0,2.0,3.0,4.0,5.0,8.0,12.0,10.0,22.0,5.0,7.0,11.0,0.0,1.0,11.0,14.0,13.0,13.0,10.0,1.0,19.0,15.0,13.0,13.0,18.0,3.0,54.0,8.0,6.0,19.0,1.0,1.0,8.0,0.0,4.0,7.0,5.0,8.0,11.0,14.0,16.0,5.0,4.0,7.0,13.0,19.0,0.0,15.0,19.0,17.0,16.0,17.0,8.0,16.0,1.0,4.0,10.0,12.0,15.0,4.0,9.0,2.0,7.0,3.0,4.0,12.0,15.0,4.0,6.0,3.0,0.0,6.0,5.0,1.0,10.0,6.0,5.0,9.0,18.0,4.0,4.0,15.0,5.0,11.0,1.0,18.0,16.0,4.0,15.0,4.0,1.0,3.0,2.0,3.0,8.0,7.0,11.0,6.0,9.0,22.0,14.0,13.0,5.0,10.0,0.0,2.0,11.0,6.0,13.0,8.0,9.0,0.0,14.0,2.0,5.0,1.0,12.0,8.0,1.0,2.0,0.0,17.0,2.0,7.0,13.0,8.0,11.0,9.0,13.0,8.0,13.0,12.0,4.0,1.0,9.0,6.0,11.0,6.0,26.0,10.0,5.0,0.0,3.0,5.0,2.0,11.0,1.0,4.0,2.0,3.0,9.0,3.0,9.0,5.0,11.0,7.0,6.0,2.0,8.0,4.0,8.0,3.0,6.0,12.0,15.0,10.0,9.0,11.0,10.0,11.0,9.0,6.0,2.0,4.0,1.0,0.0,0.0,0.0,0.0,0.0,0.0,0.0,0.0,0.0,0.0,0.0,0.0,0.0,0.0,0.0,0.0,0.0,0.0,0.0,0.0,0.0,0.0,0.0,0.0,0.0,0.0,0.0,0.0,0.0,0.0,0.0,0.0,0.0,0.0,0.0,0.0,0.0,0.0,0.0,0.0,0.0,0.0,0.0,0.0,0.0,0.0,0.0,0.0,0.0,0.0,0.0,0.0,0.0,0.0,0.0,0.0,0.0,0.0,0.0,0.0,0.0,3.0,1.0,0.0,0.0,4.0,0.0,,0.0,0.0,0.0,4.0,0.0,0.0,0.0,0.0,0.0,0.0,0.0,0.0,0.0,0.0,0.0,0.0,0.0,0.0,0.0,0.0,0.0,0.0,0.0,0.0,0.0,0.0,0.0,0.0,0.0,0.0,0.0,0.0,0.0,0.0,0.0,0.0,0.0,0.0,0.0,0.0,1.0,5.0,0.0,0.0,2.0,0.0,0.0,5.0,5.0,3.0,5.0,5.0,2.0,5.0,5.0,0.0,2.0,5.0,0.0,0.0,2.0,1.0,4.0,2.0,0.0,3.0,7.0,0.0,1.0,1.0,0.0,0.0,0.0,4.0,0.0,5.0,5.0,1.0,1.0,5.0,0.0,2.0,2.0,0.0,1.0,3.0,1.0,0.0,5.0,5.0,4.0,3.0,4.0,4.0,2.0,4.0,2.0,2.0,0.0,3.0,4.0,3.0,2.0,1.0,3.0,4.0,4.0,5.0,1.0,5.0,1.0,23.0,5.0,1.0,5.0,3.0,5.0,5.0,4.0,3.0,5.0,0.0,2.0,0.0,1.0,3.0,5.0,5.0,1.0,5.0,2.0,0.0,0.0,5.0,3.0,5.0,3.0,5.0,5.0,5.0,5.0,3.0,5.0,4.0,3.0,5.0,3.0,5.0,5.0,0.0,3.0,2.0,4.0,0.0,0.0,0.0,2.0,,4.0,0.0,1.0,1.0,2.0,,,,,2.0,,4.0,5.0,1.0,,,4.0,5.0,5.0,5.0,,5.0,,0.0,5.0,5.0,3.0,0.0,3.0,5.0,5.0,0.0,1.0,2.0,4.0,2.0,3.0,4.0,0.0,5.0,,0.0,5.0,3.0,1.0,3.0,0.0,1.0,1.0,0.0,2.0,5.0,2.0,0.0,2.0,4.0,4.0,0.0,2.0,3.0,0.0,4.0,2.0,0.0,0.0,5.0,5.0,2.0,3.0,4.0,5.0,0.0,24.0,0.0,1.0,5.0,1.0,0.0,3.0,3.0,5.0,0.0,4.0,0.0,4.0,6.0,0.0,1.0,3.0,3.0,0.0,2.0,5.0,5.0,,5.0,0.0,0.0,0.0,5.0,1.0,4.0,,0.0,0.0,1.0,0.0,0.0,1.0,1.0,0.0,0.0,1.0,2.0,0.0,4.0,0.0,1.0,0.0,1.0,0.0,5.0,5.0,3.0,1.0,10.0,5.0,0.0,0.0,5.0,0.0,1.0,5.0,5.0,29.0,27.0,5.0,7.0,3.0,3.0,5.0,2.0,2.0,2.0,5.0,1.0,0.0,0.0,1.0,3.0,2.0,3.0,0.0,0.0,4.0,6.0,0.0,3.0,6.0,2.0,4.0,5.0,13.0,5.0,9.0,14.0,2.0,4.0,1.0,1.0,5.0,5.0,5.0,5.0,5.0,4.0,0.0,3.0,4.0,0.0,3.0,4.0,2.0,4.0,0.0,2.0,,5.0,2.0,15.0,1.0,0.0,5.0,3.0,2.0,0.0,5.0,1.0,1.0,3.0,5.0,3.0,0.0,1.0,2.0,1.0,1.0,0.0,0.0,5.0,1.0,1.0,10.0,2.0,3.0,4.0,1.0,0.0,3.0,5.0,1.0,5.0,5.0,3.0,5.0,2.0,0.0,5.0,4.0,5.0,4.0,6.0,2.0,5.0,5.0,0.0,,4.0,0.0,6.0,2.0,3.0,,0.0,5.0,,,9.0,7.0,5.0,4.0,0.0,5.0,3.0,4.0,5.0,3.0,1.0,3.0,0.0,2.0,2.0,2.0,1.0,0.0,0.0,2.0,1.0,1.0,0.0,,0.0,0.0,0.0,4.0,2.0,4.0,5.0,0.0,1.0,3.0,5.0,17.0,1.0,3.0,,5.0,2.0,5.0,5.0,,2.0,3.0,1.0,0.0,2.0,5.0,2.0,5.0,3.0,10.0,15.0,5.0,5.0,6.0,5.0,0.0,0.0,10.0,8.0,2.0,29.0,5.0,5.0,2.0,3.0,3.0,0.0,4.0,5.0,5.0,11.0,3.0,5.0,0.0,1.0,5.0,0.0,,1.0,2.0,5.0,5.0,3.0,1.0,5.0,5.0,5.0,5.0,3.0,0.0,1.0,4.0,0.0,4.0,4.0,4.0,7.0,1.0,5.0,5.0,0.0,4.0,5.0,0.0,0.0,0.0,5.0,3.0,0.0,2.0,2.5,5.0,0.0,5.0,,0.0,0.0,,0.0,5.0,5.0,5.0,1.0,1.0,3.0,5.0,2.0,1.0,2.0,5.0,5.0,0.0,1.0,5.0,1.0,5.0,2.0,5.0,5.0,5.0,5.0,0.0,5.0,5.0,,,1.0,4.0,5.0,5.0,5.0,5.0,5.0,4.0,0.0,5.0,,,1.0,5.0,3.0,5.0,1.0,3.0,4.0,5.0,3.0,5.0,2.0,3.0,5.0,4.0,0.0,,5.0,1.0,5.0,0.0,5.0,5.0,0.0,0.0,4.0,9.0,5.0,5.0,5.0,0.0,5.0,5.0,5.0,5.0,5.0,5.0,5.0,5.0,5.0,3.0,5.0,3.0,5.0,,0.0,2.0,5.0,0.0,1.0,0.0,3.0,2.0,,5.0,5.0,1.0,5.0,5.0,5.0,4.0,0.0,4.0,1.0,1.0,1.0,3.0,4.0,2.0,0.0,2.0,3.0,0.0,1.0,2.0,2.0,5.0,0.0,5.0,5.0,,,5.0,2.0,6.0,4.0,0.0,2.0,5.0,0.0,2.0,1.0,0.0,4.0,2.0,5.0,,2.0,5.0,1.0,1.0,5.0,4.0,5.0,3.0,0.0,0.0,1.0,0.0,2.0,0.0,5.0,0.0,5.0,5.0,1.0,,1.0,0.0,5.0,5.0,5.0,4.0,5.0,2.0,3.0,5.0,2.0,3.0,2.0,2.0,1.0,5.0,5.0,5.0,2.0,0.0,0.0,2.0,0.0,0.0,5.0,1.0,1.0,1.0,2.0,5.0,5.0,5.0,3.0,5.0,4.0,5.0,2.0,3.0,5.0,4.0,4.0,2.0,5.0,5.0,0.0,0.0,5.0,4.0,2.0,5.0,0.0,0.0,0.0,4.0,3.0,1.0,2.0,4.0,5.0,5.0,5.0,4.0,2.0,3.0,4.0,5.0,,,,4.0,2.0,2.0,3.0,1.0,2.0,12.0,4.0,4.0,1.0,3.0,0.0,3.0,0.0,0.0,5.0,0.0,1.0,1.0,1.0,4.0,3.0,0.0,,5.0,,,,3.0,3.0,5.0,2.0,5.0,5.0,5.0,0.0,3.0,5.0,5.0,2.0,0.0,4.0,5.0,5.0,5.0,5.0,0.0,6.0,2.0,5.0,0.0,1.0,0.0,5.0,0.0,0.0,4.0,5.0,5.0,2.0,0.0,5.0,4.0,1.0,0.0,5.0,3.0,5.0,4.0,1.0,2.0,0.0,1.0,2.0,4.0,3.0,3.0,5.0,5.0,0.0,5.0,5.0,0.0,5.0,1.0,0.0,1.0,0.0,0.0,0.0,1.0,1.0,5.0,5.0,4.0,0.0,3.0,0.0,5.0,0.0,4.0,5.0,5.0,2.0,4.0,4.0,0.0,2.0,5.0,0.0,0.0,5.0,5.0,0.0,1.0,0.0,1.0,2.0,0.0,8.0,5.0,5.0,0.0,0.0,2.0,0.0,0.0,1.0,5.0,5.0,3.0,4.0,5.0,1.0,0.0,3.0,3.0,4.0,5.0,3.0,0.0,2.0,5.0,0.0,4.0,2.0,2.0,2.0,1.0,4.0,3.0,2.0,1.0,5.0,1.0,5.0,2.0,4.0,0.0,4.0,5.0,0.0,2.0,4.0,5.0,0.0,5.0,,0.0,1.0,1.0,0.0,1.0,0.0,1.0,3.0,0.0,0.0,0.0,5.0,0.0,1.0,0.0,0.0,0.0,0.0,0.0,0.0,0.0,0.0,4.0,2.0,5.0,5.0,5.0,0.0,5.0,1.0,4.0,5.0,2.0,0.0,1.0,1.0,5.0,6.0,4.0,5.0,5.0,1.0,4.0,0.0,2.0,2.0,2.0,5.0,5.0,1.0,1.0,3.0,2.0,2.0,,4.0,0.0,2.0,5.0,2.0,4.0,3.0,1.0,5.0,3.0,3.0,0.0,5.0,3.0,4.0,0.0,5.0,4.0,1.0,3.0,0.0,0.0,1.0,4.0,4.0,1.0,3.0,4.0,1.0,5.0,2.0,,1.0,5.0,,5.0,0.0,5.0,0.0,0.0,5.0,5.0,9.0,2.0,2.0,0.0,4.0,5.0,5.0,5.0,5.0,2.0,3.0,5.0,1.0,4.0,5.0,2.0,0.0,5.0,3.0,5.0,5.0,5.0,3.0,4.0,5.0,2.0,0.0,5.0,3.0,5.0,0.0,5.0,1.0,5.0,,0.0,0.0,0.0,5.0,3.0,2.0,,5.0,2.0,1.0,3.0,1.0,5.0,1.0,2.0,2.0,0.0,1.0,0.0,2.0,0.0,4.0,3.0,5.0,5.0,1.0,2.0,0.0,5.0,0.0,1.0,0.0,3.0,0.0,0.0,0.0,3.0,6.0,0.0,3.0,2.0,4.0,3.0,5.0,4.0,2.0,0.0,1.0,0.0,0.0,4.0,4.0,1.0,1.0,5.0,4.0,1.0,1.0,3.0,5.0,2.0,5.0,4.0,2.0,2.0,3.0,0.0,0.0,0.0,0.0,0.0,4.0,0.0,1.0,5.0,5.0,5.0,1.0,5.0,1.0,3.0,5.0,5.0,2.0,9.0,12.0,0.0,0.0,0.0,2.0,1.0,5.0,1.0,2.0,2.0,5.0,5.0,5.0,0.0,4.0,1.0,3.0,5.0,5.0,3.0,5.0,0.0,1.0,5.0,5.0,1.0,3.0,1.0,2.0,,2.0,11.0,6.0,1.0,5.0,3.0,4.0,3.0,3.0,2.0,3.0,3.0,1.0,2.0,1.0,3.0,1.0,1.0,5.0,2.0,0.0,3.0,2.0,2.0,2.0,5.0,1.0,3.0,5.0,0.0,0.0,1.0,4.0,5.0,3.0,2.0,1.0,2.0,5.0,1.0,5.0,,2.0,5.0,2.0,13.0,4.0,0.0,4.0,5.0,5.0,3.0,4.0,5.0,1.0,6.0,3.0,5.0,0.0,0.0,4.0,5.0,6.0,5.0,5.0,3.0,3.0,2.0,2.0,2.0,4.0,5.0,1.0,5.0,0.0,0.0,5.0,2.0,5.0,6.0,4.0,4.0,4.0,4.0,4.0,4.0,5.0,2.0,5.0,6.0,12.0,1.0,0.0,7.0,13.0,9.0,4.0,4.0,0.0,1.0,2.0,2.0,5.0,0.0,2.0,2.0,5.0,5.0,5.0,5.0,0.0,1.0,5.0,5.0,3.0,5.0,2.0,1.0,5.0,5.0,4.0,5.0,4.0,5.0,4.0,5.0,4.0,3.0,5.0,4.0,1.0,1.0,5.0,0.0,0.0,1.0,1.0,1.0,,5.0,4.0,1.0,5.0,0.0,4.0,5.0,,2.0,3.0,3.0,3.0,3.0,4.0,4.0,5.0,5.0,4.0,3.5,12.0,8.0,3.0,3.0,0.0,1.0,0.0,4.0,3.0,4.0,4.0,2.0,,1.0,1.0,5.0,0.0,4.0,5.0,2.0,1.0,0.0,0.0,10.0,4.0,5.0,5.0,5.0,5.0,5.0,5.0,5.0,4.0,3.0,4.0,5.0,5.0,1.0,2.0,4.0,4.0,4.0,5.0,4.0,1.0,0.0,3.0,0.0,2.0,3.0,0.0,1.0,1.0,1.0,3.0,5.0,3.0,3.0,0.0,3.0,5.0,5.0,1.0,1.0,3.0,5.0,4.0,5.0,5.0,5.0,3.0,1.0,3.0,5.0,0.0,5.0,3.0,3.0,0.0,5.0,1.0,5.0,1.0,1.0,0.0,5.0,1.0,5.0,5.0,5.0,0.0,2.0,0.0,4.0,0.0,5.0,5.0,5.0,5.0,5.0,5.0,5.0,5.0,5.0,1.0,2.0,0.0,5.0,5.0,5.0,2.0,0.0,2.0,2.0,3.0,0.0,0.0,0.0,0.0,0.0,0.0,0.0,0.0,3.0,0.0,5.0,0.0,3.0,3.0,2.0,5.0,3.0,5.0,5.0,0.0,2.0,5.0,4.0,1.0,10.0,4.0,4.0,3.0,10.0,1.0,12.0,7.0,1.0,4.0,1.0,5.0,2.0,3.0,1.0,0.0,1.0,0.0,2.0,2.0,5.0,3.0,2.0,2.0,2.0,2.0,5.0,0.0,5.0,3.0,5.0,1.0,,0.0,2.0,4.0,1.0,2.0,5.0,1.0,,,5.0,5.0,5.0,4.0,4.0,4.0,13.0,5.0,0.0,3.0,5.0,5.0,5.0,2.0,1.0,2.0,5.0,5.0,2.0,3.0,3.0,6.0,0.0,0.0,3.0,5.0,5.0,3.0,2.0,3.0,1.0,1.0,0.0,0.0,0.0,0.0,1.0,4.0,4.0,5.0,0.0,2.0,3.0,,5.0,3.0,,,,,,,,,,,,,,1.0,0.0,2.0,1.0,1.0,5.0,2.0,5.0,5.0,5.0,3.0,,,2.0,2.0,2.0,5.0,0.0,2.0,0.0,0.0,0.0,2.0,0.0,0.0,0.0,0.0,2.0,0.0,0.0,1.0,0.0,3.0,0.0,0.0,3.0,5.0,0.0,2.0,5.0,2.0,5.0,5.0,4.0,5.0,2.0,5.0,5.0,2.0,5.0,5.0,3.0,4.0,3.0,3.0,4.0,2.0,5.0,2.0,3.0,2.0,5.0,2.0,5.0,5.0,3.0,4.0,5.0,4.0,3.0,0.0,0.0,0.0,0.0,0.0,0.0,0.0,0.0,0.0,0.0,0.0,0.0,0.0,0.0,1.0,0.0,0.0,0.0,5.0,5.0,4.0,5.0,1.0,5.0,5.0,5.0,5.0,5.0,3.0,5.0,5.0,4.0,3.0,5.0,6.0,1.0,0.0,3.0,0.0,5.0,4.0,0.0,0.0,0.0,0.0,0.0,0.0,0.0,0.0,0.0,0.0,0.0,0.0,0.0,8.0,0.0,0.0,0.0,0.0,0.0,0.0,0.0,5.0,9.0,6.0,0.0,0.0,0.0,0.0,0.0,0.0,2.0,1.0,2.5714285714285716,0.0,0.0,3.0,0.0,1.5,7.0,3.0,6.0,6.0,0.0,1.0,1.0,1.0,8.0,7.0,5.0,4.0,0.0,0.0,0.0,0.0,0.0,4.0,0.0,2.0,0.0,3.0,0.0,0.0,5.0,0.0,7.0,5.0,1.0,7.0,0.0,1.5,0.0,0.0,0.0,0.0,7.0,0.0,6.0,4.0,4.0,0.0,3.0,0.0,0.0,2.0,3.0,3.0,4.0,0.0,1.0,3.0,2.5,2.0,0.0,9.0,1.8333333333333333,0.0,0.0,4.0,0.0,1.0,0.0,3.0,10.0,0.0,5.0,5.0,9.0,0.0,0.0,0.0,4.0,0.0,5.0,5.0,7.0,0.0,6.0,7.0,0.0,4.0,0.0,1.0,0.0,0.0,5.0,2.0,0.0,0.0,12.0,0.0,1.0,5.0,0.0,0.0,5.0,0.0,0.0,2.0,6.0,0.0,6.0,0.0,0.0,1.0,1.0,0.0,0.0,2.5,1.0,0.0,1.0,2.0,0.0,4.0,0.0,4.0,0.0,2.0,0.0,0.0,0.0,1.0,0.0,5.0,0.0,0.0,0.0,0.0,2.0,2.0,7.0,4.0,7.0,5.0,0.0,3.0,6.0,6.0,3.0,0.0,4.0,0.0,0.0,2.0,1.0,0.0,0.0,6.0,3.0,7.0,1.0,5.0,0.0,3.0,3.0,6.0,0.0,0.0,0.0,6.0,4.0,0.0,2.0,0.0,0.0,1.0,5.0,6.0,2.0,0.0,2.0,9.0,5.0,0.0,0.0,2.0,0.0,0.0,1.5,5.0,0.0,0.0,2.0,3.0,0.0,0.0,3.0,4.0,0.0,0.0,6.0,2.0,4.0,0.0,5.0,1.5,7.0,0.0,6.0,2.0,2.0,4.0,2.0,10.0,0.0,4.0,0.0,6.0,5.0,0.0,2.0,0.0,0.0,3.0,6.0,4.0,1.0,0.0,4.0,6.0,0.0,0.0,2.0,0.0,0.0,0.0,0.0,6.0,3.0,0.0,0.0,2.0,3.0,1.5,0.0,0.0,0.0,3.0,1.0,1.0,3.0,4.0,4.0,3.0,2.0,0.0,5.0,3.0,1.0,5.0,5.0,4.0,1.0,0.0,5.0,5.0,0.0,5.0,5.0,0.0,2.0,5.0,,,,,,,,,,,,,,,,,,,,,,,,,,,,,,,,,,,,,,,,,,,,,,,,,,,,,,,,,,,,,,,,,,,,,,,,,,,,,,,,,,,,,,,,,,,,,,,,,,,,,,,,,,,,,,,,,,,,,,,,,,,,,,,,,,,,,,,,,,,0.0,3.0,0.0,0.0,3.0,0.0,4.0,0.0,0.0,1.0,3.0,0.0,5.0,3.0,4.0,0.0,9.0,10.0,16.0,8.0,0.0,0.0,0.0,0.0,0.0,0.0,0.0,0.0,0.0,0.0,0.0,0.0,0.0,0.0,0.0,0.0,0.0,0.0,4.0,9.0,3.0,3.0,0.0,5.0,5.0,5.0,5.0,5.0,5.0,0.0,0.0,0.0,0.0,0.0,2.0,5.0,0.0,5.0,5.0,5.0,4.0,5.0,2.0,5.0,0.0,5.0,2.0,2.0,5.0,5.0,12.0,18.0,14.0,4.0,2.0,15.0,8.0,19.0,0.0,16.0,14.0,9.0,7.0,2.0,1.0,5.0,6.0,11.0,1.0,12.0,11.0,4.0,8.0,6.0,7.0,13.0,9.0,,11.0,12.0,5.0,5.0,5.0,5.0,5.0,5.0,5.0,5.0,5.0,5.0,5.0,5.0,5.0,5.0,5.0,5.0,5.0,4.0,5.0,5.0,5.0,5.0,5.0,5.0,0.0,,,5.0,8.0,5.0,0.0,3.0,2.0,2.0,9.0,2.0,3.0,2.0,4.0,7.0,2.0,5.0,4.0,1.0,0.0,0.0,1.0,2.0,6.0,5.0,5.0,0.0,1.0,2.0,3.0,0.0,2.0,1.0,1.0,4.0,5.0,2.0,3.0,4.0,2.0,4.0,5.0,4.0,2.0,2.0,3.0,2.0,2.0,5.0,8.0,0.0,3.0,2.0,4.0,1.0,10.0,8.0,2.0,1.0,2.0,1.0,2.0,1.0,0.0,1.0,4.0,1.0,1.0,2.0,1.0,1.0,0.0,1.0,3.0,0.0,0.0,1.0,2.0,0.0,1.0,4.0,1.0,0.0,5.0,4.0,4.0,7.0,1.0,2.0,3.0,2.0,0.0,2.0,3.0,2.0,5.0,4.0,3.0,4.0,2.0,4.0,2.0,1.0,0.0,4.0,0.0,2.0,2.0,0.0,1.0,0.0,4.0,3.0,0.0,0.0,2.0,3.0,9.0,6.0,4.0,0.0,3.0,7.0,3.0,3.0,4.0,1.0,4.0,3.0,0.0,1.0,1.0,0.0,0.0,0.0,0.0,0.0,0.0,0.0,0.0,0.0,0.0,0.0,0.0,0.0,0.0,0.0,0.0,0.0,0.0,0.0,0.0,0.0,0.0,0.0,0.0,0.0,0.0,0.0,0.0,0.0,0.0,1.0,0.0,0.0,0.0,0.0,0.0,0.0,0.0,1.0,5.0,1.0,0.0,0.0,0.0,0.0,0.0,5.0,5.0,5.0,5.0,5.0,2.0,5.0,2.0,5.0,1.0,5.0,5.0,5.0,2.0,3.5,1.0,5.0,5.0,5.0,5.0,5.0,5.0,4.0,5.0,5.0,5.0,9.0,3.0,9.0,8.5,6.0,8.0,5.0,5.0,8.5,10.0,8.0,8.0,5.0,5.0,9.0,6.0,7.0,8.0,10.0,6.0,8.0,7.0,5.0,6.0,8.0,6.0,7.0,3.0,7.0,10.0,8.0,10.0,8.0,6.0,8.0,3.0,3.0,8.0,10.0,2.0,7.0,5.0,6.0,9.0,7.0,10.0,7.0,6.0,4.0,4.0,0.0,11.0,9.0,8.0,8.0,10.0,8.0,8.0,4.0,7.0,9.0,7.0,5.0,4.0,6.0,4.0,7.0,7.0,7.0,10.0,9.0,6.0,7.0,6.0,6.0,8.0,5.0,12.0,6.0,6.0,11.0,6.0,7.0,8.0,11.0,7.0,0.0,13.0,9.0,7.0,11.0,7.0,5.0,8.0,5.0,9.0,7.0,8.0,7.0,8.0,5.0,8.0,10.0,8.0,7.0,9.0,9.0,10.0,9.0,8.0,8.0,6.0,7.0,10.0,8.0,9.0,11.0,8.0,8.0,8.0,7.0,3.0,5.0,6.0,2.0,,,,,,,,,,,,,,,,,,,,,,,,,,,,,,,,7.0,9.0,8.0,7.0,10.0,15.0,7.0,7.0,10.0,4.0,8.0,6.0,7.0,9.0,5.0,15.0,1.0,5.0,6.0,10.0,8.0,15.0,13.0,13.0,12.0,6.0,16.0,10.0,6.0,6.0,12.0,4.0,17.0,5.0,12.0,7.0,5.0,11.0,14.0,6.0,11.0,13.0,8.0,11.0,13.0,12.0,7.0,5.0,4.0,9.0,6.0,10.0,13.0,12.0,8.0,7.0,7.0,5.0,9.0,8.0,6.0,13.0,10.0,6.0,0.0,0.0,0.0,0.0,0.0,0.0,0.0,0.0,0.0,0.0,3.0,2.0,2.0,6.0,3.0,1.0,0.0,7.0,8.0,9.0,1.0,0.0,0.0,2.0,1.0,1.0,0.0,0.0,0.0,2.0,4.0,1.0,3.0,2.0,2.0,1.0,4.0,3.0,0.0,3.0,0.0,0.0,0.0,1.0,3.0,0.0,0.0,0.0,3.0,8.0,0.0,19.0,13.0,6.0,3.0,54.0,2.0,12.0,14.0,15.0,1.0,11.0,14.0,19.0,5.0,25.0,12.0,1.0,2.0,4.0,45.0,30.0,6.0,0.0,26.0,23.0,8.0,20.0,6.0,0.0,33.0,8.0,1.0,2.0,17.0,3.0,41.0,8.0,20.0,12.0,0.0,25.0,27.0,9.0,2.0,21.0,27.0,21.0,1.0,7.0,10.0,26.0,0.0,17.0,1.0,4.0,28.0,0.0,27.0,32.0,4.0,3.0,2.0,0.0,3.0,4.0,24.0,6.0,6.0,8.0,7.0,3.0,21.0,12.0,2.0,22.0,20.0,14.0,11.0,2.0,20.0,45.0,9.0,14.0,1.0,8.0,25.0,6.0,3.0,11.0,37.0,6.0,3.0,0.0,18.0,6.0,20.0,3.0,1.0,21.0,16.0,34.0,3.0,6.0,17.0,20.0,7.0,11.0,4.0,2.0,26.0,5.0,1.0,0.0,7.0,6.0,13.0,0.0,3.0,3.0,19.0,6.0,6.0,10.0,3.0,3.0,7.0,13.0,41.0,13.0,18.0,1.0,7.0,28.0,8.0,27.0,12.0,33.0,20.0,1.0,8.0,4.0,5.0,4.0,1.0,2.0,9.0,7.0,12.0,18.0,2.0,7.0,0.0,0.0,3.0,1.0,25.0,16.0,13.0,36.0,17.0,1.0,10.0,19.0,5.0,9.0,2.0,12.0,12.0,4.0,1.0,31.0,15.0,5.0,13.0,1.0,7.0,8.0,18.0,14.0,2.0,15.0,20.0,20.0,7.0,1.0,9.0,7.0,13.0,29.0,18.0,18.0,1.0,14.0,17.0,3.0,1.0,3.0,4.0,10.0,1.0,9.0,0.0,4.0,0.0,0.0,1.0,0.0,7.0,15.0,12.0,2.0,14.0,23.0,16.0,0.0,2.0,3.0,14.0,0.0,2.0,7.0,6.0,15.0,6.0,0.0,15.0,9.0,9.0,0.0,7.0,15.0,17.0,11.0,1.0,2.0,14.0,1.0,4.0,0.0,6.0,0.0,16.0,11.0,16.0,18.0,1.0,0.0,5.0,25.0,1.0,1.0,9.0,18.0,24.0,1.0,1.0,0.0,11.0,1.0,7.0,4.0,2.0,8.0,7.0,1.0,6.0,19.0,15.0,5.0,2.0,26.0,13.0,1.0,12.0,7.0,9.0,21.0,6.0,20.0,4.0,0.0,1.0,2.0,27.0,18.0,8.0,13.0,9.0,27.0,2.0,9.0,1.0,6.0,26.0,13.0,0.0,4.0,17.0,1.0,5.0,7.0,1.0,19.0,9.0,7.0,13.0,7.0,0.0,1.0,14.0,11.0,10.0,7.0,7.0,0.0,12.0,0.0,22.0,1.0,6.0,21.0,19.0,17.0,16.0,15.0,14.0,24.0,18.0,9.0,5.0,0.0,4.0,23.0,3.0,11.0,17.0,12.0,21.0,1.0,30.0,5.0,0.0,7.0,6.0,,2.0,2.0,2.0,5.0,8.0,11.0,9.0,6.0,6.0,15.0,0.0,14.0,16.0,2.0,0.0,6.0,15.0,22.0,34.0,1.0,14.0,1.0,18.0,8.0,3.0,4.0,16.0,7.0,16.0,32.0,11.0,1.0,17.0,11.0,13.0,1.0,14.0,8.0,0.0,4.0,21.0,14.0,2.0,7.0,9.0,0.0,26.0,25.0,5.0,17.0,11.0,1.0,24.0,22.0,6.0,4.0,0.0,9.0,0.0,16.0,6.0,35.0,9.0,5.0,2.0,18.0,6.0,3.0,0.0,17.0,2.0,3.0,7.0,8.0,1.0,24.0,5.0,3.0,2.0,9.0,4.0,6.0,11.0,3.0,7.0,6.0,5.0,9.0,5.0,31.0,14.0,2.0,0.0,4.0,1.0,16.0,15.0,18.0,5.0,1.0,18.0,0.0,1.0,5.0,12.0,1.0,6.0,17.0,20.0,8.0,9.0,7.0,6.0,11.0,17.0,6.0,0.0,1.0,2.0,4.0,0.0,17.0,8.0,19.0,12.0,4.0,2.0,9.0,35.0,3.0,1.0,1.0,5.0,14.0,2.0,15.0,3.0,2.0,5.0,5.0,2.0,3.0,17.0,3.0,6.0,3.0,16.0,12.0,23.0,8.0,12.0,6.0,11.0,22.0,12.0,0.0,32.0,20.0,0.0,18.0,0.0,0.0,5.0,0.0,14.0,3.0,9.0,1.0,1.0,0.0,6.0,12.0,5.0,9.0,2.0,1.0,3.0,21.0,0.0,20.0,34.0,2.0,11.0,8.0,3.0,19.0,0.0,25.0,2.0,18.0,8.0,13.0,1.0,30.0,2.0,11.0,7.0,3.0,1.0,13.0,0.0,13.0,1.0,12.0,5.0,12.0,15.0,0.0,22.0,28.0,4.0,26.0,6.0,0.0,5.0,12.0,21.0,18.0,3.0,15.0,0.0,7.0,14.0,15.0,11.0,7.0,4.0,5.0,1.0,1.0,18.0,3.0,9.0,1.0,2.0,17.0,1.0,0.0,15.0,3.0,0.0,5.0,24.0,3.0,1.0,1.0,0.0,16.0,16.0,5.0,16.0,2.0,0.0,22.0,0.0,0.0,5.0,18.0,4.0,0.0,8.0,3.0,8.0,6.0,1.0,1.0,13.0,25.0,4.0,5.0,1.0,19.0,0.0,32.0,0.0,23.0,0.0,3.0,2.0,2.0,0.0,5.0,19.0,0.0,10.0,5.0,5.0,7.0,6.0,6.0,13.0,2.0,17.0,21.0,15.0,0.0,4.0,1.0,0.0,12.0,1.0,11.0,0.0,3.0,3.0,0.0,7.0,3.0,5.0,6.0,1.0,19.0,0.0,4.0,2.0,21.0,8.0,0.0,2.0,9.0,2.0,1.0,25.0,8.0,8.0,22.0,1.0,22.0,0.0,0.0,6.0,3.0,1.0,0.0,9.0,0.0,3.0,0.0,3.0,7.0,3.0,3.0,36.0,20.0,8.0,2.0,1.0,3.0,14.0,6.0,5.0,0.0,4.0,7.0,3.0,1.0,1.0,22.0,18.0,10.0,6.0,14.0,0.0,15.0,1.0,1.0,17.0,13.0,5.0,21.0,6.0,6.0,1.0,9.0,3.0,13.0,4.0,0.0,14.0,19.0,0.0,9.0,1.0,1.0,30.0,3.0,3.0,6.0,0.0,4.0,4.0,20.0,5.0,29.0,0.0,1.0,3.0,0.0,3.0,31.0,8.0,19.0,26.0,2.0,19.0,9.0,0.0,24.0,23.0,0.0,11.0,14.0,8.0,29.0,17.0,0.0,23.0,18.0,9.0,18.0,1.0,25.0,7.0,1.0,1.0,20.0,0.0,16.0,2.0,4.0,2.0,1.0,3.0,12.0,1.0,4.0,4.0,5.0,4.0,5.0,5.0,5.0,1.0,3.0,5.0,5.0,3.0,5.0,5.0,5.0,5.0,5.0,4.0,5.0,4.0,5.0,2.0,2.0,0.0,5.0,3.0,5.0,4.0,5.0,0.0,4.0,2.0,3.0,2.0,3.0,1.0,0.0,0.0,5.0,2.0,0.0,2.0,2.0,1.0,0.0,0.0,0.0,0.0,0.0,0.0,0.0,0.0,0.0,4.0,1.0,0.0,0.0,3.0,0.0,3.0,0.0,0.0,0.0,7.0,11.0,20.0,3.0,19.0,1.0,1.0,13.0,15.0,3.0,8.0,10.0,4.0,2.0,3.0,1.0,4.0,2.0,12.0,2.0,6.0,14.0,4.0,1.0,19.0,7.0,12.0,14.0,15.0,6.0,2.0,6.0,5.0,7.0,11.0,5.0,6.0,0.0,2.0,28.0,2.0,2.0,3.0,3.0,3.0,0.0,1.0,1.0,9.0,1.0,2.0,21.0,15.0,1.0,6.0,9.0,10.0,3.0,10.0,11.0,18.0,10.0,15.0,7.0,3.0,6.0,17.0,1.0,6.0,32.0,10.0,7.0,10.0,2.0,16.0,14.0,10.0,1.0,3.0,18.0,11.0,15.0,4.0,13.0,16.0,2.0,22.0,4.0,5.0,0.0,5.0,3.0,2.0,5.0,4.0,4.0,7.0,2.0,29.0,6.0,33.0,11.0,20.0,4.0,18.0,10.0,7.0,15.0,9.0,17.0,14.0,6.0,8.0,24.0,15.0,3.0,10.0,17.0,5.0,15.0,13.0,16.0,17.0,15.0,13.0,21.0,13.0,15.0,11.0,16.0,19.0,19.0,14.0,7.0,13.0,16.0,15.0,14.0,12.0,9.0,16.0,12.0,12.0,14.0,6.0,17.0,3.0,1.0,2.0,4.0,6.0,7.0,17.0,10.0,14.0,15.0,8.0,8.0,18.0,0.0,15.0,4.0,3.0,15.0,11.0,11.0,12.0,17.0,5.0,7.0,11.0,7.0,4.0,18.0,2.0,2.0,13.0,4.0,13.0,6.0,11.0,15.0,19.0,14.0,14.0,18.0,18.0,6.0,5.0,6.0,6.0,4.0,14.0,14.0,16.0,13.0,19.0,16.0,7.0,15.0,10.0,12.0,13.0,4.0,9.0,12.0,11.0,2.0,6.0,2.0,11.0,11.0,8.0,10.0,11.0,1.0,15.0,14.0,3.0,3.0,7.0,2.0,7.0,4.0,2.0,7.0,14.0,15.0,12.0,8.0,6.0,0.0,1.0,5.0,0.0,13.0,6.0,19.0,7.0,15.0,10.0,11.0,27.0,14.0,10.0,12.0,5.0,1.0,8.0,6.0,8.0,1.0,8.0,13.0,23.0,18.0,0.0,0.0,0.0,0.0,0.0,0.0,0.0,0.0,0.0,0.0,0.0,0.0,0.0,0.0,0.0,0.0,0.0,0.0,0.0,0.0,0.0,0.0,0.0,0.0,0.0,0.0,0.0,0.0,0.0,0.0,0.0,0.0,0.0,0.0,0.0,0.0,0.0,0.0,0.0,0.0,0.0,0.0,0.0,0.0,0.0,0.0,0.0,0.0,0.0,0.0,0.0,0.0,0.0,0.0,0.0,0.0,0.0,5.0,2.0,5.0,1.0,0.0,1.0,2.0,1.0,5.0,1.0,3.0,5.0,3.0,2.0,1.0,1.0,5.0,1.0,1.0,1.0,2.0,2.0,1.0,2.0,3.0,1.0,5.0,4.0,5.0,1.0,4.0,5.0,5.0,5.0,5.0,2.0,5.0,5.0,5.0,5.0,3.0,5.0,5.0,5.0,5.0,3.0,0.0,5.0,5.0,5.0,5.0,3.0,5.0,5.0,2.0,1.0,4.0,5.0,5.0,3.0,4.0,4.0,5.0,5.0,5.0,4.0,5.0,5.0,5.0,5.0,3.0,5.0,5.0,5.0,5.0,4.0,4.0,5.0,7.0,6.0,3.0,7.0,1.0,1.0,6.0,4.0,2.0,5.0,3.0,1.0,1.0,5.0,6.0,1.0,3.0,5.0,2.0,5.0,5.0,5.0,5.0,5.0,5.0,5.0,1.0,5.0,2.0,5.0,5.0,5.0,5.0,5.0,5.0,5.0,5.0,2.0,2.0,5.0,4.0,5.0,2.0,5.0,5.0,5.0,5.0,5.0,5.0,5.0,2.0,4.0,5.0,5.0,5.0,5.0,5.0,5.0,5.0,5.0,5.0,5.0,5.0,4.0,5.0,5.0,3.0,3.0,11.0,5.0,6.0,8.0,,1.0,2.0,3.0,0.0,3.0,1.0,3.0,3.0,4.0,7.0,5.0,1.0,12.0,2.0,4.0,9.0,16.0,4.0,2.0,12.0,0.0,0.0,2.0,0.0,0.0,7.0,2.0,4.0,6.0,2.0,4.0,2.0,4.0,2.0,3.0,5.0,2.0,0.0,1.0,3.0,1.0,7.0,7.0,5.0,7.0,3.0,7.0,5.0,4.0,1.0,0.0,8.0,2.0,8.0,2.0,3.0,2.0,11.0,1.0,0.0,1.0,0.0,8.0,0.0,3.0,8.0,5.0,0.0,2.0,2.0,0.0,1.0,5.0,7.0,7.0,3.0,9.0,0.0,5.0,2.0,1.0,4.0,2.0,3.0,4.0,5.0,1.0,8.0,3.0,6.0,4.0,4.0,2.0,1.0,6.0,2.0,6.0,6.0,6.0,2.0,8.0,4.0,5.0,3.0,1.0,0.0,1.0,4.0,4.0,0.0,6.0,5.0,2.0,0.0,2.0,0.0,5.0,0.0,1.0,0.0,2.0,0.0,2.0,4.0,4.0,5.0,6.0,6.0,6.0,1.0,2.0,2.0,2.0,5.0,3.0,4.0,5.0,4.0,7.0,7.0,0.0,0.0,1.0,0.0,7.0,12.0,14.0,13.0,7.0,15.0,5.0,6.0,14.0,5.0,6.0,6.0,5.0,4.0,2.0,6.0,8.0,4.0,2.0,4.0,4.0,10.0,3.0,8.0,9.0,4.0,2.0,1.0,5.0,1.0,4.0,1.0,3.0,7.0,8.0,10.0,7.0,8.0,5.0,16.0,21.0,49.0,11.0,0.0,15.0,23.0,22.0,21.0,5.0,7.0,21.0,13.0,5.0,15.0,4.0,11.0,23.0,10.0,28.0,19.0,9.0,25.0,22.0,9.0,3.0,14.0,1.0,16.0,10.0,64.0,17.0,14.0,16.0,5.0,5.0,3.0,2.0,5.0,2.0,5.0,5.0,5.0,5.0,5.0,5.0,1.0,5.0,1.0,5.0,4.0,1.0,5.0,5.0,5.0,3.0,0.0,5.0,5.0,4.0,5.0,5.0,5.0,3.0,5.0,5.0,5.0,5.0,5.0,5.0,5.0,5.0,4.0,5.0,5.0,5.0,5.0,4.0,5.0,17.0,1.0,0.0,15.0,0.0,2.0,0.0,18.0,10.0,5.0,0.0,0.0,4.0,7.0,6.0,1.0,0.0,5.0,0.0,29.0,36.0,32.0,14.0,19.0,0.0,1.0,0.0,0.0,4.0,0.0,4.0,1.0,23.0,0.0,12.0,6.0,15.0,12.0,15.0,4.0,1.0,17.0,20.0,0.0,19.0,17.0,5.0,27.0,20.0,5.0,9.0,4.0,14.0,3.0,0.0,21.0,18.0,16.0,40.0,1.0,2.0,8.0,4.0,0.0,0.0,1.0,2.0,31.0,27.0,11.0,4.0,4.0,10.0,5.0,9.0,4.0,3.0,7.0,3.0,7.0,1.0,2.0,5.0,12.0,15.0,5.0,5.0,5.0,5.0,5.0,5.0,4.0,3.0,2.0,16.0,9.0,10.0,5.0,14.0,5.0,10.0,16.0,13.0,9.0,2.0,0.0,3.0,3.0,2.0,3.0,0.0,0.0,0.0,4.0,3.0,2.0,2.0,2.0,2.0,3.0,2.0,0.0,7.0,2.0,4.0,5.0,2.0,16.0,2.0,45.0,6.0,2.0,2.0,2.0,0.0,5.0,4.0,0.0,0.0,0.0,0.0,1.0,2.0,2.0,1.0,2.0,1.0,0.0,1.0,0.0,0.0,1.0,0.0,0.0,0.0,1.0,1.0,1.0,0.0,1.0,1.0,1.0,0.0,0.0,1.0,1.0,1.0,1.0,2.0,1.0,0.0,0.0,1.0,0.0,2.0,2.0,0.0,1.0,5.0,1.0,1.0,1.0,1.0,1.0,2.0,1.0,0.0,1.0,1.0,0.0,1.0,2.0,1.0,1.0,1.0,0.0,3.0,1.0,0.0,0.0,1.0,1.0,1.0,1.0,0.0,1.0,0.0,0.0,1.0,0.0,1.0,0.0,0.0,1.0,0.0,1.0,0.0,1.0,1.0,1.0,2.0,0.0,4.0,3.0,2.0,3.0,0.0,7.0,0.0,4.0,1.0,9.0,0.0,2.0,1.0,0.0,0.0,0.0,0.0,1.0,0.0,1.0,1.0,0.0,0.0,0.0,2.0,1.0,1.0,4.0,1.0,1.0,2.0,2.0,7.0,0.0,2.0,0.0,0.0,2.0,4.0,0.0,2.0,1.0,1.0,1.0,2.0,1.0,2.0,0.0,7.0,2.0,0.0,0.0,1.0,1.0,0.0,2.0,2.0,0.0,1.0,4.0,3.0,0.0,0.0,9.0,7.0,1.0,0.0,0.0,0.0,0.0,1.0,1.0,1.0,4.0,0.0,0.0,0.0,2.0,0.0,1.0,0.0,0.0,1.0,0.0,0.0,0.0,0.0,4.0,0.0,2.0,1.0,1.0,2.0,1.0,11.0,1.0,0.0,0.0,0.0,0.0,0.0,2.0,1.0,2.0,4.0,0.0,0.0,4.0,0.0,10.0,0.0,0.0,0.0,0.0,0.0,0.0,2.0,1.0,0.0,7.0,0.0,0.0,5.0,0.0,3.0,0.0,0.0,0.0,1.0,0.0,0.0,0.0,0.0,0.0,0.0,0.0,6.0,4.0,2.0,3.0,7.0,4.0,4.0,2.0,8.0,2.0,1.0,2.0,2.0,3.0,5.0,6.0,6.0,5.0,2.0,4.0,2.0,2.0,3.0,3.0,4.0,5.0,4.0,0.0,5.0,3.0,3.0,18.0,14.0,9.0,9.0,15.0,10.0,12.0,5.0,7.0,7.0,18.0,8.0,12.0,11.0,9.0,9.0,8.0,5.0,5.0,5.0,5.0,5.0,5.0,5.0,2.0,5.0,1.0,2.0,2.0,3.0,0.0,3.0,3.0,0.0,9.0,1.0,4.0,6.0,0.0,7.0,2.0,1.0,1.0,5.0,4.0,0.0,5.0,3.0,2.0,5.0,4.0,6.0,2.0,3.0,6.0,9.0,2.0,1.0,2.0,5.0,2.0,1.0,6.0,3.0,5.0,5.0,3.0,5.0,3.0,1.0,2.0,9.0,0.0,0.0,1.0,0.0,7.0,0.0,,,,,,,,,,,,,,,,,,,,,,,,,,,,,,,,,,,,,,,,,,,,,,,,,,,,,,,,,,,,,,,,,,,,,,,,,,,,,,,,,,,,,,,,,,,,,,,,,,,,,,,,,,,,,,,,,,,,,,,,,0.0,0.0,0.0,0.0,7.0,2.0,9.0,10.0,27.0,25.0,13.0,7.0,18.0,13.0,5.0,5.0,5.0,6.0,6.0,5.0,8.0,20.0,27.0,14.0,6.0,23.0,18.0,30.0,13.0,13.0,14.0,21.0,19.0,28.0,3.0,9.0,9.0,3.0,20.0,1.0,5.0,14.0,23.0,21.0,16.0,9.0,6.0,15.0,3.0,6.0,20.0,20.0,4.0,14.0,3.0,13.0,2.0,5.0,7.0,1.0,13.0,13.0,1.0,6.0,6.0,5.0,12.0,9.0,7.0,17.0,19.0,0.0,19.0,14.0,20.0,16.0,16.0,11.0,8.0,0.0,12.0,10.0,5.0,9.0,10.0,1.0,1.0,14.0,6.0,15.0,5.0,0.0,13.0,14.0,16.0,6.0,8.0,7.0,13.0,4.0,16.0,11.0,19.0,25.0,25.0,6.0,3.0,11.0,15.0,18.0,23.0,11.0,16.0,15.0,10.0,18.0,9.0,24.0,17.0,17.0,15.0,4.0,12.0,10.0,10.0,9.0,2.0,31.0,34.0,3.0,16.0,20.0,21.0,21.0,8.0,5.0,23.0,3.0,6.0,11.0,22.0,13.0,16.0,11.0,7.0,15.0,13.0,2.0,17.0,11.0,5.0,22.0,38.0,2.0,0.0,13.0,15.0,16.0,16.0,3.0,4.0,3.0,12.0,7.0,11.0,1.0,10.0,7.0,13.0,5.0,6.0,12.0,11.0,10.0,7.0,3.0,16.0,6.0,20.0,6.0,6.0,17.0,0.0,23.0,8.0,16.0,7.0,22.0,11.0,8.0,1.0,31.0,6.0,19.0,9.0,7.0,11.0,18.0,6.0,9.0,19.0,26.0,4.0,2.0,14.0,7.0,6.0,14.0,3.0,19.0,8.0,10.0,17.0,1.0,18.0,9.0,8.0,1.0,15.0,11.0,9.0,5.0,2.0,11.0,7.0,9.0,11.0,16.0,10.0,2.0,13.0,2.0,6.0,10.0,20.0,15.0,15.0,4.0,7.0,9.0,6.0,13.0,18.0,22.0,5.0,17.0,14.0,13.0,4.0,23.0,2.0,6.0,20.0,7.0,2.0,19.0,28.0,12.0,8.0,2.0,18.0,11.0,15.0,18.0,23.0,21.0,15.0,4.0,8.0,3.0,3.0,27.0,16.0,18.0,18.0,13.0,26.0,7.0,10.0,8.0,7.0,9.0,1.0,10.0,7.0,7.0,7.0,13.0,19.0,31.0,11.0,8.0,10.0,15.0,4.0,6.0,11.0,11.0,5.0,13.0,11.0,14.0,5.0,5.0,3.0,9.0,3.0,4.0,18.0,3.0,27.0,11.0,16.0,2.0,10.0,24.0,1.0,7.0,9.0,4.0,13.0,13.0,5.0,13.0,8.0,13.0,14.0,14.0,11.0,19.0,19.0,21.0,6.0,21.0,10.0,14.0,14.0,3.0,12.0,4.0,14.0,12.0,16.0,12.0,12.0,4.0,7.0,10.0,16.0,16.0,11.0,22.0,12.0,9.0,10.0,16.0,7.0,2.0,1.0,1.0,3.0,2.0,1.0,5.0,1.0,0.0,0.0,0.0,0.0,1.0,4.0,1.0,2.0,4.0,0.0,1.0,0.0,1.0,0.0,1.0,1.0,0.0,0.0,5.0,1.0,0.0,1.0,5.0,2.0,,3.0,5.0,5.0,1.0,0.0,0.0,1.0,0.0,2.0,0.0,4.0,2.0,0.0,2.0,0.0,1.0,1.0,1.0,0.0,0.0,1.0,1.0,0.0,1.0,0.0,3.0,0.0,1.0,1.0,2.0,5.0,2.0,1.0,0.0,1.0,1.0,5.0,1.0,0.0,0.0,2.0,0.0,2.0,0.0,1.0,1.0,1.0,3.0,1.0,4.0,0.0,0.0,0.0,0.0,0.0,0.0,5.0,1.0,0.0,0.0,0.0,1.0,2.0,2.0,1.0,0.0,3.0,1.0,3.0,2.0,1.0,0.0,1.0,0.0,0.0,5.0,0.0,3.0,2.0,0.0,1.0,4.0,10.0,1.0,4.0,1.0,0.0,3.0,2.0,2.0,2.0,5.0,10.0,1.0,1.0,0.0,5.0,4.0,2.0,5.8,1.0,0.0,0.0,2.0,7.0,1.0,3.0,1.0,4.0,5.0,3.0,7.0,1.0,5.0,14.0,0.0,5.0,1.0,6.0,0.0,0.0,3.0,0.0,3.0,2.0,4.0,10.0,2.0,6.0,8.0,1.0,5.0,0.0,3.0,4.0,3.0,2.0,7.0,0.0,7.0,6.0,10.0,2.0,5.0,1.0,4.0,7.0,3.0,0.0,8.0,4.0,0.0,2.0,2.0,6.0,6.0,3.0,2.0,5.0,3.0,5.0,5.0,4.0,3.0,0.0,9.0,1.0,0.0,4.0,5.0,5.0,1.0,2.0,1.0,5.0,6.0,0.0,3.0,2.0,6.0,2.0,0.0,3.0,0.0,1.0,2.0,1.0,2.0,8.0,3.0,3.0,2.0,4.0,4.0,1.0,6.0,14.0,3.0,1.0,0.0,4.0,4.0,4.0,6.0,1.0,12.0,7.0,6.0,8.0,5.0,0.0,1.0,4.0,6.0,9.0,3.0,2.0,2.0,1.0,2.0,5.0,4.0,1.0,6.0,4.0,1.0,6.0,6.0,0.0,2.0,3.0,3.0,4.0,1.0,2.0,6.0,7.0,5.0,1.0,8.0,4.0,9.0,2.0,4.0,8.0,1.0,3.0,13.0,14.0,0.0,0.0,1.0,4.0,3.0,3.0,3.0,7.0,1.0,5.0,2.0,6.0,6.0,1.0,1.0,2.0,0.0,9.0,3.0,7.0,5.0,4.0,3.0,2.0,1.0,4.0,5.0,3.0,9.0,1.0,0.0,11.0,4.0,11.0,0.0,0.0,17.0,6.0,21.0,20.0,10.0,12.0,17.0,12.0,16.0,18.0,5.0,7.0,5.0,0.0,16.0,2.0,7.0,10.0,14.0,20.0,12.0,7.0,6.0,6.0,0.0,0.0,3.0,9.0,4.0,1.0,7.0,2.0,13.0,6.0,2.0,8.0,8.0,6.0,15.0,20.0,6.0,10.0,6.0,21.0,19.0,5.0,17.0,7.0,3.0,2.0,10.0,14.0,15.0,0.0,3.0,4.0,14.0,3.0,2.0,17.0,24.0,10.0,8.0,8.0,29.0,4.0,7.0,9.0,13.0,29.0,27.0,19.0,8.0,4.0,4.0,5.0,4.0,12.0,14.0,14.0,3.0,6.0,20.0,13.0,3.0,8.0,11.0,7.0,1.0,8.0,6.0,4.0,5.0,10.0,1.0,5.0,2.0,8.0,12.0,12.0,8.0,19.0,6.0,3.0,15.0,10.0,10.0,10.0,0.0,18.0,12.0,0.0,0.0,13.0,12.0,0.0,15.0,15.0,17.0,3.0,15.0,19.0,20.0,5.0,20.0,12.0,18.0,13.0,19.0,19.0,10.0,16.0,5.0,1.0,7.0,6.0,6.0,10.0,4.0,19.0,6.0,1.0,2.0,14.0,4.0,11.0,7.0,16.0,9.0,18.0,5.0,17.0,10.0,14.0,7.0,5.0,2.0,17.0,9.0,5.0,3.0,2.0,7.0,10.0,9.0,1.0,2.0,4.0,9.0,12.0,12.0,12.0,15.0,1.0,15.0,15.0,0.0,4.0,3.0,6.0,15.0,10.0,14.0,12.0,1.0,0.0,18.0,9.0,9.0,10.0,10.0,3.0,7.0,3.0,7.0,5.0,4.0,1.0,12.0,15.0,1.0,6.0,15.0,13.0,3.0,12.0,2.0,7.0,15.0,12.0,10.0,15.0,15.0,11.0,6.0,5.0,13.0,7.0,12.0,16.0,5.0,20.0,9.0,18.0,1.0,5.0,6.0,4.0,1.0,0.0,0.0,15.0,8.0,1.0,4.0,19.0,0.0,10.0,3.0,2.0,2.0,11.0,6.0,5.0,4.0,4.0,6.0,8.0,7.0,4.0,7.0,21.0,7.0,3.0,15.0,2.0,6.0,4.0,9.0,1.0,9.0,14.0,20.0,12.0,3.0,5.0,8.0,12.0,8.0,11.0,6.0,10.0,11.0,24.0,9.0,6.0,12.0,7.0,8.0,11.0,7.0,11.0,7.0,9.0,8.0,13.0,10.0,12.0,11.0,11.0,8.0,10.0,9.0,9.0,0.0,0.0,0.0,0.0,0.0,0.0,16.0,6.0,0.0,4.0,5.0,1.0,17.0,25.0,6.0,1.0,3.0,3.0,9.0,7.0,20.0,18.0,7.0,12.0,2.0,0.0,2.0,9.0,7.0,8.0,19.0,13.0,11.0,3.0,2.0,11.0,2.0,0.0,2.0,1.0,8.0,18.0,6.0,17.0,2.0,17.0,2.0,12.0,6.0,7.0,0.0,1.0,6.0,20.0,10.0,5.0,2.0,5.0,3.0,3.0,2.0,6.0,2.0,2.0,18.0,8.0,9.0,30.0,0.0,4.0,4.0,13.0,0.0,8.0,5.0,0.0,2.0,5.0,1.0,13.0,8.0,13.0,4.0,8.0,2.0,19.0,5.0,4.0,5.0,6.0,3.0,1.0,4.0,9.0,10.0,3.0,2.0,3.0,5.0,12.0,43.0,22.0,22.0,7.0,21.0,2.0,0.0,19.0,9.0,9.0,16.0,0.0,20.0,14.0,10.0,21.0,9.0,23.0,8.0,1.0,3.0,1.0,4.0,8.0,5.0,11.0,3.0,1.0,8.0,4.0,3.0,12.0,14.0,5.0,4.0,5.0,12.0,41.0,6.0,9.0,1.0,17.0,7.0,1.0,22.0,3.0,1.0,12.0,3.0,0.0,16.0,41.0,7.0,11.0,4.0,3.0,1.0,3.0,2.0,11.0,11.0,4.0,6.0,3.0,28.0,18.0,4.0,11.0,4.0,9.0,1.0,8.0,2.0,2.0,8.0,4.0,0.0,6.0,17.0,2.0,8.0,7.0,1.0,3.0,8.0,12.0,16.0,17.0,4.0,10.0,5.0,22.0,10.0,3.0,0.0,16.0,1.0,3.0,14.0,2.0,8.0,5.0,2.0,5.0,11.0,8.0,0.0,5.0,4.0,2.0,2.0,6.0,17.0,8.0,7.0,6.0,3.0,5.0,2.0,8.0,5.0,5.0,8.0,3.0,4.0,0.0,22.0,5.0,3.0,1.0,10.0,2.0,3.0,18.0,11.0,9.0,23.0,2.0,3.0,1.0,12.0,5.0,4.0,19.0,7.0,3.0,23.0,2.0,1.0,8.0,9.0,0.0,9.0,3.0,6.0,19.0,3.0,5.0,3.0,4.0,9.0,1.0,17.0,26.0,8.0,14.0,3.0,7.0,11.0,26.0,3.0,2.0,3.0,5.0,8.0,39.0,0.0,7.0,5.0,18.0,4.0,7.0,16.0,3.0,0.0,0.0,24.0,4.0,18.0,16.0,0.0,8.0,17.0,1.0,2.0,2.0,10.0,9.0,29.0,2.0,10.0,0.0,3.0,3.0,3.0,9.0,1.0,12.0,4.0,7.0,6.0,9.0,2.0,6.0,5.0,11.0,0.0,2.0,11.0,9.0,3.0,4.0,2.0,5.0,1.0,0.0,0.0,7.0,8.0,2.0,4.0,2.0,3.0,8.0,5.0,12.0,1.0,4.0,10.0,1.0,6.0,4.0,3.0,13.0,11.0,2.0,11.0,14.0,1.0,3.0,3.0,38.0,0.0,8.0,5.0,18.0,3.0,11.0,5.0,2.0,10.0,10.0,2.0,3.0,3.0,3.0,8.0,6.0,10.0,6.0,5.0,7.0,8.0,4.0,4.0,8.0,3.0,5.0,7.0,30.0,4.0,14.0,22.0,9.0,45.0,3.0,4.0,2.0,4.0,7.0,0.0,3.0,1.0,13.0,8.0,0.0,3.0,1.0,10.0,21.0,27.0,7.0,3.0,19.0,2.0,17.0,4.0,6.0,21.0,11.0,8.0,1.0,14.0,7.0,2.0,6.0,15.0,13.0,3.0,7.0,4.0,0.0,4.0,9.0,9.0,12.0,5.0,1.0,5.0,10.0,0.0,13.0,19.0,3.0,14.0,0.0,8.0,12.0,6.0,14.0,7.0,17.0,6.0,15.0,3.0,23.0,8.0,6.0,17.0,7.0,0.0,4.0,13.0,3.0,14.0,10.0,3.0,12.0,23.0,30.0,37.0,8.0,25.0,6.0,9.0,16.0,5.0,2.0,7.0,8.0,2.0,2.0,6.0,1.0,0.0,2.0,8.0,6.0,2.0,5.0,13.0,8.0,7.0,4.0,0.0,15.0,0.0,4.0,22.0,6.0,7.0,2.0,5.0,13.0,14.0,21.0,7.0,4.0,5.0,9.0,8.0,9.0,18.0,3.0,1.0,6.0,25.0,7.0,26.0,6.0,3.0,0.0,3.0,9.0,0.0,8.0,0.0,7.0,9.0,14.0,5.0,8.0,6.0,13.0,11.0,9.0,1.0,2.0,16.0,10.0,17.0,3.0,5.0,12.0,3.0,5.0,6.0,10.0,0.0,3.0,1.0,12.0,11.0,0.0,8.0,10.0,2.0,3.0,16.0,50.0,6.0,10.0,11.0,8.875,12.0,7.0,7.0,4.0,4.0,3.0,3.0,12.0,14.0,3.0,4.0,11.0,3.0,0.0,16.0,16.0,2.0,6.0,9.0,2.0,2.0,14.0,5.0,4.0,5.0,2.0,6.0,5.0,2.0,4.0,11.0,3.0,7.0,8.0,4.0,27.0,8.0,2.0,8.0,7.0,11.0,3.0,4.0,5.0,21.0,5.0,2.0,5.0,5.0,1.0,4.0,5.0,6.0,1.0,1.0,3.0,8.0,4.0,8.0,10.0,1.0,2.0,3.0,7.0,4.0,14.0,2.0,8.0,6.0,1.0,5.0,7.0,15.0,0.0,6.0,3.0,0.0,3.0,2.0,0.0,8.0,4.0,8.0,7.0,4.0,24.0,24.0,25.0,24.0,1.0,1.0,0.0,8.0,10.0,6.0,8.0,2.0,13.0,3.0,3.0,2.0,1.0,9.0,2.0,5.0,27.0,7.0,9.0,4.0,5.0,6.0,14.0,3.0,4.0,4.0,1.0,3.0,5.0,1.0,12.0,14.0,5.0,17.0,8.0,12.0,5.0,7.0,31.0,1.0,10.0,6.0,16.0,18.0,1.0,4.0,3.0,1.0,2.0,13.0,11.0,5.0,7.0,6.0,4.0,27.0,0.0,11.0,6.0,11.0,15.0,4.0,2.0,1.0,0.0,28.0,4.0,0.0,7.0,17.0,6.0,0.0,3.0,9.0,4.0,2.0,9.0,1.0,21.0,4.0,3.0,6.0,8.0,13.0,4.0,19.0,7.0,2.0,5.0,4.0,6.0,6.0,1.0,18.0,1.0,1.0,1.0,3.0,18.0,4.0,16.0,16.0,5.0,15.0,5.0,16.0,21.0,54.0,6.0,1.0,6.0,2.0,12.0,11.0,6.0,2.0,2.0,18.0,14.0,7.0,6.0,8.0,2.0,9.0,7.0,3.0,12.0,2.0,3.0,20.0,7.0,12.0,6.0,3.0,9.0,27.0,30.0,2.0,9.0,6.0,12.0,10.0,8.0,0.0,12.0,10.0,7.0,7.0,11.0,0.0,34.0,4.0,6.0,2.0,3.0,4.0,5.0,5.0,8.0,6.0,7.0,7.0,5.0,8.0,10.0,17.0,8.0,3.0,5.0,2.0,9.0,24.0,7.0,8.0,9.0,1.0,7.0,7.0,2.0,1.0,21.0,5.0,3.0,12.0,5.0,7.0,3.0,8.0,10.0,2.0,11.0,5.0,18.0,16.0,3.0,4.0,5.0,8.0,2.0,1.0,5.0,4.0,8.0,1.0,5.0,17.0,16.0,10.0,4.0,8.0,0.0,3.0,9.0,6.0,7.0,15.0,6.0,3.0,22.0,10.0,7.0,8.0,3.0,11.0,3.0,3.0,6.0,4.0,0.0,13.0,8.0,10.0,42.0,8.0,6.0,2.0,24.0,37.0,2.0,32.0,16.0,11.0,5.0,3.0,6.0,1.0,5.0,2.0,5.0,15.0,6.0,12.0,14.0,7.0,11.0,14.0,17.0,4.0,9.0,10.0,3.0,17.0,8.0,22.0,12.0,3.0,3.0,15.0,10.0,1.0,3.0,3.0,2.0,9.0,14.0,19.0,6.0,3.0,6.0,15.0,16.0,3.0,7.0,2.0,3.0,3.0,8.0,1.0,10.0,16.0,4.0,10.0,19.0,9.0,4.0,7.0,0.0,9.0,10.0,6.0,7.0,19.0,3.0,8.0,4.0,10.0,6.0,9.0,11.0,39.0,15.0,8.0,10.0,20.0,8.0,2.0,22.0,1.0,8.0,7.0,0.0,4.0,8.0,12.0,7.0,4.0,11.0,5.0,6.0,13.0,11.0,18.0,19.0,12.0,22.0,12.0,3.0,10.0,2.0,2.0,0.0,5.0,6.5,9.0,3.0,3.0,6.0,5.0,28.0,22.0,14.0,14.0,2.0,6.0,0.0,4.0,0.0,11.0,37.0,16.0,2.0,8.0,18.0,0.0,4.0,14.0,9.0,10.0,16.0,5.0,0.0,24.0,0.0,15.0,13.0,11.0,9.0,25.0,9.0,4.0,2.0,32.0,52.0,7.0,6.0,3.0,12.0,5.0,4.0,2.0,8.0,18.0,21.0,4.0,19.0,14.0,6.0,4.0,2.0,6.0,19.0,19.0,21.0,5.0,15.0,20.0,6.0,1.0,2.0,2.0,7.0,6.0,4.0,11.0,0.0,7.0,0.0,18.0,15.0,12.0,4.0,17.0,3.0,0.0,31.0,1.0,,8.0,3.0,15.0,0.0,19.0,19.0,1.0,14.0,7.0,14.0,5.0,20.0,17.0,6.0,3.0,5.0,4.0,2.0,2.0,1.0,3.0,0.0,0.0,22.0,40.0,20.0,2.0,3.0,0.0,1.0,10.0,8.0,5.0,4.0,8.0,9.0,12.0,3.0,7.0,4.0,2.0,13.0,3.0,6.0,19.0,24.0,7.0,6.0,16.0,8.0,2.0,8.0,8.0,7.0,18.0,6.0,9.0,10.0,2.0,1.0,0.0,2.0,2.0,13.0,3.0,6.0,16.0,7.0,20.0,13.0,6.0,5.0,6.0,13.0,1.0,27.0,36.0,6.0,16.0,5.0,7.0,5.0,34.0,20.0,3.0,9.0,0.0,10.0,5.0,5.0,0.0,1.0,5.0,5.0,0.0,3.0,5.0,4.0,3.0,10.0,4.0,4.0,1.0,2.0,12.0,8.0,19.0,11.0,1.0,3.0,35.0,10.0,6.0,2.0,24.0,24.0,4.0,7.0,14.0,7.0,6.0,21.0,10.0,5.0,11.0,15.0,2.0,8.0,5.0,5.0,5.0,10.0,0.0,11.0,10.0,6.0,3.0,5.0,10.0,3.0,6.0,4.0,3.0,5.0,2.0,8.0,2.0,4.0,1.0,8.0,18.0,1.0,9.0,16.0,3.0,3.0,7.0,5.0,9.0,37.0,0.0,20.0,11.0,6.0,2.0,15.0,1.0,7.0,0.0,13.0,9.0,3.0,3.0,15.0,1.0,21.0,4.0,3.0,0.0,2.0,1.0,4.0,2.0,0.0,7.0,2.0,1.0,11.0,7.0,6.0,0.0,17.0,4.0,0.0,4.0,3.0,6.0,2.0,8.0,20.0,0.0,0.0,0.0,17.0,12.0,13.0,17.0,1.0,3.0,3.0,6.0,3.0,26.0,2.0,2.0,10.0,11.0,21.0,0.0,6.0,9.0,4.0,1.0,2.0,2.0,2.0,1.0,8.0,13.0,15.0,26.0,6.0,10.0,0.0,20.0,19.0,22.0,12.0,5.0,16.0,16.0,5.0,7.0,14.0,2.0,11.0,17.0,8.0,18.0,13.0,6.0,17.0,9.0,0.0,2.0,0.0,15.0,1.0,0.0,22.0,20.0,12.0,4.0,7.0,0.0,7.0,6.0,1.0,4.0,4.0,20.0,1.0,3.0,6.0,28.0,0.0,7.0,4.0,10.0,4.0,24.0,3.0,10.0,2.0,0.0,7.0,1.0,23.0,6.0,10.0,13.0,3.0,12.0,7.0,34.0,10.0,6.0,5.0,20.0,18.0,14.0,11.0,4.0,8.0,33.0,7.0,13.0,9.0,5.0,30.0,13.0,20.0,26.0,11.0,16.0,5.0,2.0,18.0,14.0,12.0,12.0,25.0,4.0,10.0,17.0,24.0,2.0,2.0,7.0,8.0,34.0,22.0,17.0,28.0,25.0,14.0,21.0,27.0,3.0,17.0,12.0,6.0,12.0,4.0,18.0,22.0,3.0,5.0,17.0,7.0,9.0,9.0,29.0,3.0,11.0,5.0,4.0,20.0,13.0,7.0,5.0,9.0,14.0,10.0,0.0,8.0,16.0,13.0,10.0,24.0,25.0,2.0,10.0,0.0,13.0,1.0,0.0,3.0,19.0,7.0,14.0,10.0,7.0,13.0,12.0,15.0,8.0,20.0,0.0,2.0,2.0,13.0,5.0,10.0,16.0,26.0,4.0,17.0,8.0,1.0,7.0,7.0,12.0,15.0,6.0,3.0,0.0,6.0,2.0,8.0,8.0,31.0,11.0,13.0,1.0,12.0,34.0,33.0,2.0,31.0,20.0,13.0,17.0,9.0,13.0,10.0,16.0,8.0,7.0,7.0,28.0,13.0,19.0,4.0,22.0,23.0,1.0,15.0,9.0,29.0,8.0,24.0,20.0,5.0,8.0,13.0,27.0,2.0,11.0,12.0,22.0,14.0,11.0,4.0,3.0,25.0,14.0,2.0,18.0,8.0,12.0,21.0,13.0,12.0,6.0,16.0,28.0,9.0,19.0,19.0,20.0,9.0,4.0,8.0,19.0,23.0,21.0,18.0,2.0,10.0,1.0,27.0,17.0,12.0,15.0,7.0,5.0,24.0,21.0,23.0,23.0,11.0,13.0,6.0,9.0,9.0,2.0,1.0,12.0,12.0,13.0,8.0,8.0,20.0,25.0,13.0,8.0,17.0,12.0,25.0,3.0,4.0,0.0,21.0,5.0,11.0,8.0,17.0,11.0,20.0,7.0,6.0,4.0,15.0,6.0,7.0,9.0,12.0,7.0,13.0,8.0,15.0,17.0,11.0,18.0,8.0,20.0,19.0,10.0,21.0,11.0,7.0,10.0,3.0,10.0,8.0,17.0,5.0,20.0,24.0,6.0,9.0,13.0,6.0,7.0,5.0,16.0,6.0,12.0,19.0,13.0,22.0,10.0,11.0,11.0,6.0,7.0,6.0,1.0,24.0,8.0,19.0,20.0,13.0,16.0,25.0,19.0,22.0,19.0,8.0,10.0,6.0,0.0,21.0,20.0,18.0,7.0,3.0,7.0,2.0,8.0,3.0,5.0,10.0,3.0,7.0,6.0,7.0,9.0,11.0,9.0,6.0,7.0,8.0,16.0,22.0,4.0,6.0,8.0,15.0,5.0,8.0,3.0,8.0,6.0,6.0,7.0,6.0,6.0,5.0,11.0,7.0,5.0,6.0,6.0,5.0,2.0,4.0,5.0,1.0,4.0,2.0,7.0,6.0,1.0,7.0,0.0,3.0,0.0,15.0,18.0,2.0,14.0,12.0,11.0,15.0,7.0,15.0,15.0,7.0,3.0,15.0,6.0,7.0,1.0,8.0,12.0,3.0,1.0,2.0,0.0,0.0,5.0,13.0,5.0,8.0,1.0,16.0,4.0,0.0,3.0,16.0,10.0,13.0,0.0,1.0,9.0,10.0,8.0,3.0,4.0,5.0,4.0,7.0,12.0,12.0,19.0,0.0,4.0,6.0,3.0,4.0,5.0,7.0,4.0,5.0,3.0,3.0,2.0,3.0,1.0,5.0,8.0,2.0,10.0,9.0,9.0,12.0,0.0,3.0,5.0,1.0,8.0,7.0,0.0,,5.0,9.0,9.0,1.0,2.0,5.0,3.0,3.0,0.0,3.0,0.0,0.0,1.0,2.0,0.0,0.0,4.0,7.0,9.0,7.0,3.0,2.0,2.0,3.0,5.0,9.0,27.0,14.0,3.0,8.0,1.0,5.0,14.0,17.0,7.0,1.0,,4.0,8.0,12.0,11.0,13.0,7.0,,,4.0,16.0,6.0,3.0,7.0,6.0,8.0,18.0,10.0,17.0,17.0,8.0,13.0,8.0,0.0,5.0,2.0,6.0,18.0,12.0,8.0,1.0,10.0,5.0,6.0,2.0,8.0,9.0,24.0,4.0,7.0,1.0,3.0,13.0,2.0,2.0,3.0,8.0,14.0,3.0,5.0,5.0,8.0,0.0,7.0,18.0,7.0,20.0,4.0,5.0,2.0,19.0,10.0,11.0,11.0,11.0,6.0,6.0,20.0,14.0,9.0,0.0,9.0,11.0,8.0,10.0,,14.0,4.0,13.0,3.0,11.0,3.0,13.0,7.0,14.0,23.0,10.0,14.0,10.0,2.0,18.0,3.0,11.0,11.0,17.0,,0.0,3.0,10.0,4.0,,4.0,7.0,10.0,6.0,14.0,3.0,17.0,5.0,14.0,17.0,13.0,10.0,9.0,8.0,11.0,12.0,2.0,2.0,8.0,0.0,3.0,11.0,15.0,3.0,4.0,3.0,16.0,6.0,5.0,1.0,32.0,12.0,19.0,9.0,8.0,0.0,0.0,2.0,13.0,8.0,9.0,11.0,12.0,5.0,11.0,4.0,6.0,8.0,6.0,10.0,1.0,10.0,4.0,11.0,9.0,9.0,1.0,6.0,4.0,4.0,2.0,6.0,9.0,4.0,5.0,5.0,6.0,3.0,2.0,6.0,3.0,5.0,6.0,0.0,2.0,8.0,7.0,0.0,5.0,0.0,5.0,5.0,4.0,3.0,0.0,3.0,4.0,8.0,5.0,5.0,3.0,3.0,2.0,4.0,4.0,9.0,9.0,0.0,2.0,13.0,5.0,7.0,17.0,6.0,1.0,0.0,12.0,5.0,2.0,8.0,14.0,9.0,7.0,14.0,11.0,7.0,19.0,8.0,6.0,4.0,19.0,6.0,11.0,0.0,6.0,19.0,13.0,17.0,1.0,3.0,3.0,11.0,0.0,0.0,7.0,3.0,0.0,0.0,3.0,5.0,15.0,2.0,9.0,6.0,5.0,6.0,4.0,0.0,0.0,4.0,4.0,0.0,18.0,1.0,9.0,3.0,1.0,4.0,1.0,7.0,4.0,13.0,5.0,11.0,2.0,0.0,6.0,10.0,6.0,12.0,1.0,3.0,7.0,3.0,8.0,11.0,6.0,5.0,24.0,8.0,10.0,1.0,3.0,5.0,4.0,8.0,6.0,11.0,9.0,7.0,1.0,8.0,9.0,2.0,3.0,7.0,15.0,4.0,7.0,6.0,18.0,9.0,9.0,11.0,9.0,21.0,2.0,5.0,10.0,6.0,1.0,6.0,0.0,5.0,8.0,5.0,8.0,3.0,10.0,16.0,4.0,13.0,1.0,4.0,2.0,1.0,8.0,8.0,8.0,11.0,5.0,13.0,12.0,12.0,12.0,27.0,1.0,4.0,12.0,4.0,9.0,2.0,9.0,6.0,1.0,6.0,15.0,9.0,10.0,5.0,6.0,8.0,3.0,7.0,1.0,7.0,9.0,2.0,2.0,1.0,6.0,7.0,5.0,1.0,9.0,11.0,9.0,8.0,0.0,5.0,6.0,0.0,0.0,2.0,6.0,8.0,0.0,14.0,23.0,1.0,1.0,5.0,2.0,2.0,1.0,18.0,1.0,1.0,0.0,3.0,1.0,5.0,23.0,5.0,0.0,0.0,14.0,6.0,1.0,0.0,15.0,2.0,0.0,2.0,1.0,10.0,1.0,12.0,5.0,2.0,19.0,8.0,9.0,15.0,2.0,0.0,0.0,3.0,1.0,1.0,0.0,4.0,1.0,3.0,4.0,2.0,3.0,11.0,2.0,3.0,1.0,2.0,0.0,3.0,2.0,0.0,9.0,1.0,9.0,0.0,3.0,7.0,3.0,2.0,9.0,1.0,0.0,17.0,3.0,0.0,2.0,2.0,5.0,6.0,4.0,3.0,2.0,0.0,4.0,13.0,2.0,6.0,4.0,9.0,8.0,5.0,0.0,5.0,3.0,0.0,11.0,10.0,9.0,0.0,28.0,5.0,25.0,40.0,20.0,12.0,10.0,11.0,18.0,10.0,24.0,10.0,18.0,20.0,18.0,10.0,7.0,28.0,6.0,13.0,15.0,11.0,0.0,7.0,7.0,14.0,29.0,7.0,3.0,2.0,24.0,2.0,5.0,49.0,3.0,5.0,12.0,8.0,11.0,5.0,1.0,3.0,9.0,16.0,16.0,34.0,8.0,12.0,14.0,0.0,2.0,2.0,13.0,0.0,0.0,1.0,1.0,19.0,25.0,3.0,14.0,22.0,0.0,2.0,19.0,12.0,1.0,1.0,7.0,11.0,2.0,4.0,2.0,2.0,1.0,1.0,5.0,13.0,4.0,5.0,1.0,12.0,0.0,7.0,1.0,12.0,2.0,4.0,15.0,3.0,7.0,16.0,10.0,0.0,9.0,17.0,15.0,25.0,1.0,12.0,6.0,13.0,5.0,16.0,8.0,13.0,6.0,5.0,8.0,0.0,10.0,7.0,6.0,4.0,10.0,9.0,7.0,7.0,3.0,0.0,11.0,8.0,13.0,19.0,7.0,3.0,8.0,18.0,22.0,1.0,8.0,7.0,4.0,9.0,7.0,1.0,6.0,5.0,0.0,8.0,14.0,2.0,16.0,9.0,11.0,28.0,31.0,7.0,8.0,1.0,6.0,10.0,3.0,8.0,10.0,7.0,5.0,8.0,12.0,1.0,11.0,18.0,8.0,10.0,0.0,16.0,2.0,5.0,11.0,0.0,1.0,9.0,14.0,1.0,20.0,3.0,0.0,3.0,2.0,5.0,11.0,13.0,24.0,0.0,12.0,4.0,1.0,6.0,8.0,4.0,3.0,5.0,2.0,0.0,4.0,1.0,10.0,0.0,7.0,5.0,1.0,1.0,2.0,1.0,0.0,0.0,6.0,13.0,12.0,0.0,2.0,4.0,1.0,10.0,0.0,4.0,0.0,6.0,0.0,1.0,1.0,3.0,3.0,0.0,2.0,0.0,4.0,7.0,8.0,7.0,9.0,7.0,2.0,14.0,4.0,16.0,11.0,3.0,8.0,4.0,5.0,9.0,0.0,16.0,14.0,16.0,6.0,8.0,0.0,0.0,0.0,19.0,5.0,7.0,7.0,6.0,8.0,2.0,5.0,4.0,10.0,8.0,11.0,5.0,5.0,4.0,4.0,11.0,7.0,4.0,6.0,4.0,8.0,9.0,4.0,6.0,4.0,4.0,12.0,7.0,2.0,9.0,5.0,2.0,8.0,3.0,9.0,4.0,5.0,4.0,5.0,7.0,5.0,6.0,4.0,8.0,5.0,4.0,2.0,3.0,4.0,5.0,4.0,4.0,10.0,6.0,5.0,9.0,4.0,5.0,6.0,7.0,7.0,3.0,6.0,9.0,5.0,5.0,5.0,6.0,4.0,13.0,10.0,3.0,7.0,12.0,14.0,8.0,8.0,0.0,9.0,5.0,5.0,12.0,4.0,4.0,5.0,4.0,0.0,19.0,21.0,1.0,1.0,16.0,5.0,13.0,6.0,13.0,23.0,12.0,7.0,1.0,14.0,4.0,15.0,14.0,14.0,13.0,10.0,15.0,0.0,2.0,16.0,14.0,3.0,8.0,4.0,0.0,7.0,7.0,9.0,5.0,15.0,4.0,6.0,16.0,9.0,3.0,6.0,6.0,14.0,4.0,9.0,13.0,15.0,17.0,8.0,17.0,16.0,9.0,6.0,6.0,7.0,4.0,8.0,11.0,15.0,7.0,10.0,12.0,16.0,6.0,9.0,15.0,6.0,2.0,8.0,13.0,6.0,6.0,10.0,12.0,9.0,16.0,9.0,6.0,7.0,15.0,23.0,27.0,8.0,10.0,15.0,9.0,8.0,6.0,9.0,18.0,15.0,7.0,11.0,7.0,22.0,9.0,16.0,8.0,12.0,5.0,5.0,5.0,6.0,5.0,13.0,11.0,13.0,8.0,13.0,16.0,7.0,15.0,16.0,17.0,12.0,4.0,0.0,11.0,4.0,2.0,10.0,13.0,0.0,17.0,14.0,17.0,2.0,15.0,8.0,7.0,4.0,1.0,8.0,10.0,3.0,10.0,6.0,5.0,7.0,5.0,17.0,16.0,8.0,13.0,1.0,12.0,7.0,6.0,17.0,9.0,5.0,5.0,2.0,6.0,13.0,5.0,18.0,3.0,10.0,6.0,10.0,9.0,14.0,12.0,5.0,5.0,9.0,4.0,5.0,2.0,8.0,9.0,13.0,7.0,10.0,1.0,10.0,7.0,4.0,5.0,4.0,3.0,9.0,5.0,4.0,17.0,9.0,13.0,11.0,11.0,8.0,6.0,8.0,6.0,1.0,4.0,9.0,7.0,13.0,1.0,9.0,14.0,11.0,5.0,2.0,0.0,1.0,0.0,6.0,4.0,14.0,13.0,4.0,8.0,6.0,6.0,7.0,7.0,0.0,9.0,16.0,14.0,8.0,1.0,7.0,12.0,5.0,1.0,4.0,1.0,8.0,6.0,7.0,12.0,14.0,10.0,10.0,13.0,6.0,5.0,6.0,9.0,11.0,10.0,8.0,6.0,3.0,1.0,7.0,9.0,8.0,3.0,7.0,13.0,5.0,7.0,7.0,4.0,9.0,8.0,9.0,6.0,10.0,10.0,2.0,6.0,0.0,11.0,0.0,11.0,3.0,5.0,12.0,16.0,6.0,8.0,5.0,3.0,14.0,9.0,7.0,10.0,2.0,6.0,16.0,4.0,0.0,2.0,0.0,1.0,0.0,0.0,0.0,1.0,0.0,3.0,0.0,0.0,0.0,1.0,2.0,5.0,1.0,0.0,0.0,2.0,0.0,0.0,5.0,0.0,2.0,1.0,0.0,5.0,0.0,1.0,0.0,3.0,0.0,5.0,4.0,1.0,1.0,0.0,0.0,0.0,0.0,1.0,3.0,2.0,0.0,1.0,0.0,0.0,5.0,3.0,2.0,0.0,2.0,0.0,0.0,1.0,4.0,5.0,2.0,0.0,4.0,0.0,5.0,2.0,2.0,2.0,3.0,0.0,0.0,1.0,0.0,4.0,1.0,2.0,1.0,3.0,0.0,1.0,0.0,2.0,4.0,4.0,16.0,3.0,1.0,1.0,2.0,0.0,4.0,3.0,14.0,2.0,2.0,1.0,2.0,12.0,2.0,2.0,4.0,3.0,7.0,10.0,2.0,13.0,1.0,14.0,2.0,5.0,3.0,1.0,5.0,4.0,3.0,5.0,1.0,6.0,0.0,0.0,0.0,5.0,1.0,5.0,5.0,7.0,0.0,10.0,2.0,5.0,62.0,6.0,16.0,1.0,0.0,7.0,11.0,2.0,12.0,6.0,8.0,3.0,9.0,7.0,0.0,0.0,4.0,13.0,9.0,11.0,2.0,15.0,2.0,5.0,1.0,8.0,3.0,0.0,12.0,14.0,5.0,5.0,5.0,4.0,26.0,3.0,2.0,1.0,1.0,3.0,4.0,3.0,1.0,2.0,3.0,0.0,2.0,9.0,20.0,1.0,1.0,17.0,10.0,4.0,17.0,13.0,9.0,1.0,5.0,3.0,14.0,15.0,13.0,22.0,0.0,5.0,8.0,5.0,0.0,7.0,4.0,1.0,2.0,12.0,2.0,13.0,1.0,3.0,0.0,8.0,15.0,1.0,6.0,0.0,10.0,2.0,7.0,4.0,11.0,6.0,3.0,37.0,2.0,0.0,1.0,0.0,7.0,5.0,7.0,12.0,5.0,4.0,6.0,12.0,2.0,1.0,8.0,0.0,9.0,1.0,2.0,3.0,1.0,26.0,2.0,11.0,31.0,4.0,10.0,2.0,20.0,10.0,10.0,0.0,6.0,1.0,4.0,9.0,5.0,0.0,1.0,4.0,4.0,6.0,14.0,3.0,6.0,9.0,5.0,9.0,1.0,6.0,0.0,4.0,0.0,8.0,6.0,29.0,3.0,3.0,3.0,2.0,1.0,5.0,0.0,2.0,8.0,24.0,14.0,12.0,6.0,4.0,9.0,19.0,4.0,5.0,7.0,9.0,10.0,2.0,8.0,4.0,6.0,1.0,11.0,5.0,5.0,0.0,3.0,1.0,1.0,18.0,7.0,7.0,0.0,5.0,3.0,0.0,6.0,4.0,2.0,5.0,1.0,1.0,11.0,4.0,5.0,6.0,1.0,0.0,3.0,11.0,0.0,0.0,0.0,12.0,1.0,0.0,12.0,11.0,2.0,0.0,1.0,8.0,18.0,10.0,2.0,11.0,1.0,8.0,2.0,6.0,5.0,8.0,3.0,8.0,10.0,7.0,0.0,11.0,9.0,11.0,0.0,4.0,4.0,3.0,7.0,0.0,2.0,15.0,6.0,0.0,7.0,6.0,1.0,0.0,6.0,1.0,15.0,7.0,1.0,1.0,9.0,4.0,4.0,3.0,4.0,1.0,3.0,0.0,0.0,16.0,1.0,8.0,4.0,7.0,1.0,0.0,5.0,1.0,10.0,0.0,6.0,1.0,1.0,1.0,17.0,2.0,3.0,12.0,7.0,4.0,7.0,2.0,1.0,1.0,2.0,3.0,3.0,13.0,10.0,1.0,3.0,12.0,2.0,8.0,3.0,4.0,7.0,5.0,1.0,5.0,0.0,2.0,3.0,2.0,3.0,5.0,3.0,4.0,2.0,7.0,25.0,8.0,15.0,15.0,7.0,1.0,0.0,6.0,17.0,9.0,14.0,17.0,1.0,0.0,0.0,1.0,12.0,0.0,1.0,0.0,0.0,1.0,3.0,0.0,0.0,2.0,0.0,2.0,9.0,5.0,0.0,1.0,1.0,1.0,1.0,0.0,1.0,0.0,0.0,1.0,2.0,0.0,3.0,1.0,0.0,2.0,0.0,0.0,0.0,1.0,4.0,0.0,0.0,3.0,0.0,0.0,0.0,1.0,1.0,0.0,3.0,2.0,1.0,1.0,0.0,1.0,0.0,0.0,0.0,1.0,0.0,0.0,1.0,3.0,1.0,3.0,4.0,2.0,0.0,0.0,2.0,1.0,3.0,0.0,2.0,0.0,1.0,0.0,0.0,0.0,1.0,4.0,0.0,1.0,0.0,1.0,3.0,7.0,10.0,3.0,12.0,7.0,6.0,9.0,5.0,5.0,5.0,5.0,5.0,5.0,5.0,5.0,1.0,5.0,5.0,1.0,2.0,5.0,5.0,4.0,5.0,5.0,5.0,5.0,5.0,5.0,5.0,5.0,5.0,5.0,5.0,5.0,5.0,5.0,5.0,5.0,5.0,5.0,4.0,3.0,5.0,5.0,5.0,5.0,0.0,0.0,0.0,0.0,0.0,2.0,0.0,1.0,0.0,0.0,0.0,2.0,0.0,3.0,0.0,0.0,0.0,0.0,1.0,1.0,1.0,0.0,0.0,0.0,0.0,0.0,0.0,0.0,0.0,1.0,0.0,2.0,0.0,1.0,0.0,4.0,2.0,5.0,2.0,2.0,1.0,1.0,7.0,2.0,0.0,0.0,3.0,2.0,0.0,7.0,2.0,6.0,0.0,0.0,0.0,5.0,1.0,0.0,2.0,0.0,1.0,1.0,0.0,1.0,0.0,0.0,0.0,0.0,0.0,1.0,1.0,0.0,0.0,0.0,4.0,2.0,0.0,0.0,1.0,1.0,0.0,0.0,0.0,0.0,0.0,3.0,0.0,1.0,3.0,0.0,0.0,0.0,4.0,2.0,4.0,2.0,0.0,3.0,1.0,0.0,0.0,1.0,0.0,0.0,0.0,0.0,2.0,0.0,0.0,0.0,1.0,0.0,0.0,2.0,8.0,0.0,1.0,0.0,0.0,0.0,0.0,1.0,2.0,1.0,8.0,0.0,0.0,0.0,6.0,0.0,0.0,0.0,5.0,0.0,0.0,1.0,3.0,6.0,2.0,3.0,0.0,0.0,0.0,1.0,1.0,7.0,0.0,0.0,4.0,0.0,3.0,4.0,2.0,1.0,0.0,1.0,3.0,0.0,4.0,0.0,0.0,0.0,2.0,0.0,2.0,1.0,3.0,0.0,3.0,0.0,0.0,1.0,2.0,0.0,0.0,1.0,4.0,1.0,0.0,0.0,0.0,0.0,0.0,0.0,0.0,4.0,0.0,3.0,0.0,2.0,0.0,0.0,0.0,0.0,1.0,1.0,0.0,3.0,1.0,4.0,0.0,5.0,5.0,0.0,5.0,11.0,11.0,6.0,4.0,3.0,9.0,8.0,11.0,14.0,7.0,8.0,8.0,8.0,9.0,18.0,9.0,4.0,18.0,7.0,4.0,6.0,11.0,6.0,19.0,4.0,3.0,9.0,14.0,9.0,8.0,15.0,12.0,15.0,11.0,13.0,12.0,9.0,0.0,16.0,7.0,9.0,9.0,9.0,5.0,3.0,2.0,6.0,7.0,1.0,37.0,7.0,0.0,9.0,1.0,0.0,0.0,3.0,3.0,0.0,20.0,21.0,0.0,34.0,3.0,3.0,6.0,6.0,2.0,18.0,1.0,11.0,2.0,19.0,28.0,33.0,25.0,28.0,27.0,1.0,29.0,0.0,0.0,0.0,32.0,0.0,0.0,0.0,2.0,23.0,1.0,38.0,33.0,14.0,5.0,2.0,20.0,27.0,39.0,1.0,0.0,0.0,0.0,0.0,1.0,10.0,0.0,1.0,4.0,1.0,0.0,2.0,13.0,36.0,6.0,3.0,28.0,40.0,14.0,15.0,0.0,24.0,0.0,0.0,18.0,28.0,4.0,11.0,3.0,16.0,1.0,0.0,1.0,14.0,10.0,2.0,3.0,11.0,0.0,0.0,4.0,27.0,36.0,0.0,7.0,18.0,17.0,0.0,19.0,19.0,5.0,30.0,5.0,2.0,0.0,2.0,33.0,5.0,15.0,11.0,1.0,3.0,3.0,2.0,4.0,3.0,3.0,3.0,0.0,2.0,2.0,4.0,3.0,1.0,0.0,3.0,4.0,2.0,0.0,3.0,0.0,1.0,3.0,0.0,3.0,4.0,3.0,0.0,8.0,1.0,3.0,3.0,1.0,0.0,2.0,1.0,1.0,5.0,1.0,4.0,2.0,3.0,1.0,5.0,2.0,4.0,3.0,0.0,1.0,3.0,0.0,5.0,0.0,0.0,0.0,0.0,0.0,0.0,1.0,1.0,2.0,1.0,0.0,0.0,0.0,0.0,0.0,0.0,2.0,5.0,2.0,0.0,3.0,5.0,2.0,2.0,1.0,1.0,2.0,0.0,4.0,2.0,4.0,4.0,1.0,5.0,1.0,5.0,1.0,4.0,4.0,0.0,1.0,2.0,0.5,3.0,4.0,2.0,0.0,1.0,2.0,2.0,3.0,1.0,1.0,2.0,0.0,5.0,4.0,3.0,0.0,1.0,4.0,5.0,4.5,0.0,3.0,2.0,5.0,3.0,0.0,1.0,4.0,3.0,0.0,2.0,1.0,5.0,5.0,0.0,2.0,1.0,0.0,0.0,3.0,2.0,1.0,1.0,5.0,0.0,3.0,1.0,0.0,2.0,1.0,2.0,1.0,2.0,1.0,2.0,1.0,1.0,1.0,4.0,5.0,3.0,4.0,2.0,2.0,0.0,3.0,2.5,1.0,5.0,3.0,5.0,2.0,5.0,3.5,5.0,5.0,1.0,4.0,1.0,0.0,1.0,0.0,2.0,0.0,5.0,0.0,0.0,4.0,0.0,0.0,0.0,1.0,1.0,1.0,1.0,0.0,2.0,0.0,2.0,3.0,3.0,5.0,2.0,5.0,1.0,1.0,2.0,2.0,1.0,5.0,0.0,2.0,2.0,0.0,2.0,0.0,1.0,1.0,0.0,0.0,3.0,0.0,0.0,0.0,1.0,0.0,1.0,3.0,5.0,1.0,1.0,2.0,1.0,0.0,2.0,1.0,0.0,1.0,4.0,3.0,2.0,0.0,1.0,4.0,2.0,1.0,1.0,4.0,1.0,4.0,5.0,0.0,0.0,3.0,5.0,2.0,0.0,0.0,0.0,2.0,2.0,1.0,0.0,1.0,2.0,0.0,4.0,0.0,0.0,1.0,0.0,5.0,4.0,2.0,1.0,0.0,2.0,5.0,5.0,0.0,0.0,0.0,5.0,2.0,0.0,1.0,0.0,2.0,2.0,2.0,1.0,0.0,2.0,1.0,1.0,0.0,0.0,0.0,5.0,0.0,0.0,3.0,1.5,1.0,0.0,3.0,2.0,4.0,2.0,0.0,1.0,0.0,1.0,0.0,0.0,1.0,1.0,2.0,2.0,2.0,1.0,2.0,0.0,1.0,0.0,3.0,5.0,0.0,3.0,0.0,2.0,2.0,1.0,5.0,2.0,2.0,1.0,0.0,1.0,1.0,0.0,1.0,3.0,0.0,0.0,5.0,1.0,5.0,0.0,0.0,5.0,2.0,1.0,0.0,2.0,4.0,2.0,2.0,5.0,0.0,4.0,5.0,4.0,5.0,0.0,0.0,1.0,3.0,2.0,5.0,4.0,1.0,5.0,2.0,0.0,1.0,5.0,1.0,1.0,1.0,5.0,2.0,3.0,2.0,1.0,1.0,5.0,5.0,2.0,2.0,5.0,4.0,1.0,1.0,3.0,3.0,0.0,0.0,0.0,5.0,4.0,3.0,0.0,2.0,3.0,5.0,1.0,0.0,0.0,0.0,0.0,0.0,0.0,2.0,2.0,1.0,2.0,1.0,0.0,2.0,5.0,3.0,0.0,3.0,0.0,5.0,0.0,0.0,3.0,3.0,0.0,0.0,5.0,4.0,0.0,3.0,1.0,0.0,2.0,1.0,0.0,2.0,0.0,1.0,0.0,2.0,0.0,2.0,2.0,0.0,1.0,0.0,5.0,4.0,2.0,5.0,1.0,1.0,0.0,0.0,0.0,0.0,0.0,2.0,5.0,3.0,3.0,4.0,2.0,0.0,0.0,4.0,3.0,0.0,5.0,1.0,0.0,5.0,0.0,0.0,1.0,5.0,4.0,1.0,2.0,0.0,0.0,0.0,0.0,1.0,2.0,2.0,2.0,0.0,0.0,4.0,2.0,0.0,1.0,3.0,2.0,4.0,1.0,0.0,1.0,1.0,0.0,2.0,2.0,0.0,1.0,3.0,4.0,5.0,1.0,0.0,2.0,1.0,0.0,1.0,5.0,0.0,5.0,0.0,0.0,5.0,0.0,1.0,1.0,3.0,0.0,0.0,3.0,2.0,1.0,0.0,3.0,3.0,2.0,4.0,4.0,1.0,3.0,0.0,3.0,1.0,3.0,4.0,5.0,0.0,3.0,0.0,0.0,0.0,1.0,2.0,3.0,2.0,1.0,0.0,2.0,2.0,1.0,0.0,1.0,0.0,1.0,2.0,5.0,9.0,13.0,14.0,3.0,0.0,17.0,13.0,0.0,10.0,11.0,3.0,22.0,15.0,22.0,12.0,17.0,19.0,4.0,11.0,31.0,22.0,8.0,7.0,0.0,17.0,19.0,8.0,19.0,9.0,17.0,18.0,23.0,7.0,27.0,1.0,10.0,5.0,0.0,8.0,1.0,10.0,15.0,5.0,9.0,2.0,13.0,20.0,15.0,5.0,7.0,32.0,15.0,12.0,2.0,18.0,30.0,14.0,4.0,18.0,20.0,1.0,12.0,17.0,13.0,6.0,20.0,20.0,6.0,7.0,12.0,15.0,11.0,4.0,19.0,11.0,7.0,9.0,4.0,9.0,5.0,6.0,11.0,18.0,9.0,7.0,22.0,5.0,9.0,11.0,16.0,7.0,6.0,9.0,8.0,1.0,5.0,7.0,5.0,11.0,10.0,13.0,16.0,9.0,14.0,2.0,3.0,14.0,2.0,7.0,18.0,10.0,4.0,12.0,13.0,16.0,8.0,17.0,0.0,16.0,11.0,18.0,14.0,0.0,4.0,3.0,0.0,4.0,22.0,17.0,18.0,14.0,6.0,7.0,13.0,6.0,42.0,21.0,13.0,13.0,11.0,10.0,14.0,16.0,17.0,13.0,6.0,18.0,8.0,7.0,0.0,4.0,1.0,8.0,13.0,13.0,19.0,16.0,16.0,9.0,19.0,7.0,6.0,15.0,2.0,8.0,21.0,4.0,7.0,12.0,15.0,7.0,11.0,19.0,14.0,5.0,1.0,0.0,9.0,12.0,14.0,0.0,14.0,1.0,12.0,12.0,22.0,3.0,12.0,14.0,17.0,10.0,8.0,3.0,9.0,20.0,5.0,7.0,18.0,4.0,14.0,9.0,7.0,22.0,8.0,0.0,9.0,8.0,18.0,13.0,14.0,8.0,12.0,8.0,13.0,13.0,17.0,4.0,10.0,9.0,13.0,15.0,15.0,11.0,9.0,8.0,13.0,7.0,7.0,4.0,14.0,14.0,5.0,21.0,5.0,17.0,13.0,9.0,6.0,13.0,9.0,3.0,12.0,6.0,19.0,9.0,9.0,13.0,16.0,0.0,14.0,18.0,6.0,10.0,10.0,8.0,12.0,6.0,9.0,14.0,4.0,18.0,11.0,10.0,9.0,24.0,14.0,11.0,8.0,13.0,15.0,17.0,14.0,9.0,7.0,18.0,2.0,9.0,9.0,10.0,4.0,1.0,14.0,13.0,12.0,8.0,11.0,15.0,1.0,10.0,20.0,10.0,5.0,8.0,5.0,14.0,14.0,11.0,15.0,23.0,7.0,0.0,16.0,9.0,6.0,11.0,12.0,14.0,16.0,10.0,14.0,4.0,10.0,8.0,12.0,3.0,19.0,11.0,12.0,5.0,4.0,5.0,9.0,2.0,19.0,7.0,1.0,7.0,13.0,14.0,10.0,6.0,13.0,4.0,4.0,4.0,3.0,20.0,16.0,3.0,12.0,17.0,9.0,11.0,13.0,14.0,8.0,7.0,6.0,9.0,6.0,13.0,9.0,8.5,1.0,24.0,6.5,2.0,3.0,5.0,4.0,29.0,23.0,2.0,4.5,3.0,8.0,3.0,13.0,14.0,5.0,12.0,3.0,5.5,9.0,8.0,12.5,6.0,16.0,5.0,5.0,5.0,0.0,5.0,5.0,5.0,5.0,5.0,5.0,1.0,3.0,5.0,4.0,5.0,0.0,5.0,5.0,5.0,5.0,2.0,5.0,0.0,2.0,5.0,5.0,5.0,5.0,1.0,3.0,5.0,5.0,5.0,5.0,1.0,5.0,2.0,5.0,5.0,5.0,5.0,5.0,5.0,5.0,5.0,5.0,5.0,5.0,5.0,4.0,5.0,5.0,5.0,4.0,5.0,5.0,5.0,0.0,5.0,5.0,5.0,5.0,5.0,5.0,1.0,3.0,0.0,1.0,5.0,5.0,5.0,5.0,5.0,3.0,5.0,,4.0,5.0,5.0,0.0,5.0,0.0,4.0,5.0,5.0,2.0,5.0,4.0,2.0,0.0,5.0,3.0,5.0,5.0,2.0,3.0,3.0,1.0,5.0,3.0,2.0,5.0,2.0,5.0,1.0,5.0,5.0,5.0,5.0,4.0,0.0,2.0,3.0,5.0,2.0,5.0,5.0,3.0,2.0,4.0,5.0,5.0,2.0,5.0,5.0,5.0,5.0,1.0,1.0,5.0,1.0,5.0,5.0,5.0,4.0,2.0,5.0,0.0,5.0,5.0,3.0,5.0,5.0,5.0,5.0,5.0,4.0,2.0,3.0,3.0,5.0,3.0,5.0,5.0,5.0,4.0,17.0,16.0,11.0,1.0,3.0,5.0
13,3.0,5.0,5.0,5.0,4.0,7.0,3.0,5.0,5.0,4.0,4.0,2.0,2.0,5.0,5.0,22.0,6.0,5.0,5.0,5.0,7.0,2.0,7.0,0.0,2.0,7.0,5.0,4.0,6.0,1.0,4.0,4.0,5.0,11.0,5.0,5.0,5.0,2.0,6.0,6.0,4.0,5.0,4.0,4.0,3.0,4.0,10.0,6.0,2.0,0.0,0.0,2.0,3.0,0.0,3.0,6.0,0.0,0.0,0.0,0.0,0.0,0.0,0.0,0.0,0.0,0.0,0.0,0.0,0.0,0.0,0.0,0.0,0.0,0.0,0.0,0.0,0.0,0.0,0.0,,5.0,3.0,5.0,5.0,5.0,5.0,5.0,0.0,0.0,0.0,0.0,0.0,10.0,0.0,0.0,0.0,0.0,0.0,0.0,0.0,0.0,0.0,0.0,0.0,0.0,0.0,0.0,0.0,0.0,0.0,0.0,0.0,0.0,1.0,6.0,5.0,4.0,5.0,2.0,5.0,3.0,17.0,4.0,4.0,4.0,16.0,2.0,0.0,9.0,5.0,8.0,3.0,10.0,5.0,10.0,2.0,9.0,4.0,7.0,3.0,2.0,3.0,1.0,4.0,4.0,8.0,11.0,8.0,10.0,5.0,5.0,8.0,1.0,4.0,2.0,7.0,3.0,5.0,5.0,1.0,4.0,3.0,15.0,0.0,5.0,5.0,5.0,5.0,4.0,3.0,6.0,10.0,11.0,2.0,8.0,7.0,4.0,7.0,5.0,2.0,5.0,3.0,0.0,11.0,5.0,6.0,4.0,4.0,2.0,3.0,4.0,4.0,7.0,7.0,3.0,4.0,1.0,7.0,12.0,5.0,5.0,1.0,7.0,3.0,5.0,2.0,4.0,2.0,3.0,4.0,3.0,4.0,3.0,3.0,1.0,3.0,7.0,8.0,0.0,0.0,5.0,10.0,4.0,6.0,0.0,5.0,8.0,7.0,6.0,3.0,7.0,3.0,0.0,1.0,1.0,6.0,7.0,0.0,4.0,10.0,3.0,6.0,0.0,3.0,0.0,0.0,2.0,7.0,0.0,5.0,3.0,9.0,11.0,13.0,4.0,0.0,19.0,4.0,10.0,2.0,0.0,7.0,11.0,4.0,8.0,2.0,5.0,6.0,0.0,4.0,10.0,3.0,7.0,12.0,8.0,7.0,6.0,2.0,7.0,7.0,4.0,11.0,3.0,8.0,4.0,5.0,10.0,4.0,8.0,9.0,8.0,4.0,11.0,2.0,1.0,1.0,4.0,5.0,4.0,3.0,2.0,3.0,0.0,1.0,3.0,0.0,4.0,4.0,0.0,8.0,13.0,18.0,7.0,4.0,6.0,6.0,1.0,12.0,12.0,3.0,13.0,14.0,2.0,12.0,11.0,5.0,8.0,6.0,11.0,5.0,4.0,12.0,8.0,5.0,14.0,15.0,12.0,9.0,6.0,13.0,10.0,11.0,9.0,9.0,12.0,3.0,11.0,5.0,12.0,7.0,3.0,13.0,13.0,8.0,6.0,21.0,4.0,12.0,8.0,10.0,6.0,7.0,1.0,13.0,6.0,0.0,5.0,4.0,5.0,15.0,5.0,24.0,4.0,9.0,1.0,1.0,2.0,2.0,1.0,3.0,0.0,1.0,2.0,0.0,3.0,2.0,8.0,0.0,5.0,2.0,1.0,7.0,0.0,2.0,2.0,3.0,1.0,0.0,0.0,2.0,0.0,0.0,1.0,3.0,0.0,3.0,0.0,0.0,0.0,0.0,1.0,0.0,0.0,1.0,1.0,2.0,4.0,3.0,4.0,0.0,2.0,1.0,8.0,3.0,6.0,0.0,0.0,1.0,5.0,6.0,7.0,2.0,7.0,9.0,15.0,2.0,6.0,7.0,7.0,3.0,4.0,4.0,4.0,10.0,10.0,20.0,9.0,2.0,4.0,0.0,15.0,1.0,8.0,8.0,1.0,7.0,3.0,3.0,5.0,5.0,1.0,1.0,2.0,0.0,4.0,2.0,4.0,0.0,3.0,1.0,1.0,1.0,2.0,1.0,0.0,0.0,2.0,4.0,1.0,4.0,4.0,3.0,3.0,0.0,5.0,7.0,5.0,3.0,4.0,5.0,6.0,1.0,2.0,5.0,0.0,1.0,6.0,4.0,5.0,10.0,12.0,1.0,0.0,1.0,13.0,6.0,6.0,2.0,3.0,1.0,3.0,6.0,0.0,8.0,4.0,3.0,7.0,2.0,2.0,8.0,8.0,5.0,8.0,1.0,5.0,5.0,5.0,5.0,5.0,2.0,0.0,2.0,6.0,6.0,1.0,4.0,0.0,6.0,1.0,6.0,3.0,4.0,1.0,2.0,2.0,2.0,,,,,,,,,,,,,,,,,,,,,,,,,,,,,,,,,,10.0,12.0,11.0,8.0,4.0,,,8.0,10.0,15.0,19.0,4.0,10.0,,,,19.0,,,,,,,,,11.0,,,,,,,,2.0,6.0,,,12.0,10.0,13.0,9.0,,16.0,12.0,,3.0,12.0,4.0,,12.0,,,15.0,24.0,24.0,,,9.0,,8.0,7.0,13.0,24.0,18.0,6.0,,,,,,,,,,,,,,,,,,,,,,,,5.0,3.0,1.0,5.0,0.0,0.0,0.0,0.0,5.0,0.0,0.0,0.0,0.0,5.0,5.0,4.0,0.0,5.0,5.0,5.0,2.0,1.0,5.0,5.0,0.0,5.0,1.0,5.0,0.0,0.0,5.0,1.0,3.0,0.0,5.0,0.0,2.0,1.0,2.0,5.0,0.0,4.0,5.0,5.0,5.0,5.0,5.0,5.0,5.0,5.0,0.0,7.0,2.0,0.0,2.0,0.0,0.0,2.0,0.0,0.0,5.0,0.0,0.0,0.0,4.0,1.0,0.0,0.0,1.0,0.0,0.0,0.0,4.0,3.0,6.0,4.0,3.0,4.0,3.0,5.0,3.0,0.0,0.0,4.0,4.0,3.0,1.0,4.0,7.0,2.0,4.0,17.0,6.0,6.0,8.0,14.0,9.0,9.0,10.0,10.0,9.0,10.0,10.0,10.0,6.0,8.0,8.0,8.0,1.0,7.0,12.0,10.0,11.0,5.0,14.0,6.0,4.0,3.0,5.0,3.0,3.0,7.0,5.0,3.0,9.0,0.0,5.0,5.0,6.0,6.0,6.0,6.0,5.0,4.0,3.0,5.0,10.0,6.0,7.0,6.0,6.0,6.0,9.0,7.0,5.0,7.0,13.0,4.0,8.0,6.0,4.0,0.0,2.0,4.0,6.0,7.0,4.0,4.0,5.0,5.0,5.0,4.0,5.0,7.0,3.0,5.0,6.0,6.0,16.0,7.0,5.0,13.0,5.0,6.0,6.0,5.0,6.0,6.0,6.0,7.0,5.0,3.0,2.0,10.0,6.0,4.0,5.0,1.0,4.0,0.0,14.0,5.0,7.0,2.0,3.0,9.0,11.0,9.0,10.0,9.0,6.0,13.0,4.0,20.0,3.0,12.0,12.0,4.0,12.0,13.0,2.0,4.0,3.0,0.0,11.0,9.0,8.0,17.0,18.0,9.0,9.0,6.0,10.0,19.0,10.0,7.0,12.0,10.0,14.0,15.0,3.0,10.0,4.0,2.0,3.0,5.0,0.0,7.0,13.0,7.0,8.0,10.0,3.0,3.0,13.0,6.0,9.0,13.0,18.0,4.0,8.0,7.0,14.0,6.0,9.0,12.0,15.0,7.0,0.0,4.0,0.0,3.0,8.0,1.0,4.0,24.0,11.0,4.0,11.0,21.0,2.0,1.0,9.0,11.0,4.0,4.0,3.0,7.0,9.0,10.0,12.0,0.0,15.0,19.0,10.0,8.0,3.0,2.0,3.0,10.0,9.0,1.0,3.0,8.0,2.0,8.0,12.0,5.0,5.0,4.0,11.0,9.0,7.0,9.0,5.0,16.0,15.0,9.0,6.0,12.0,5.0,6.0,4.0,11.0,12.0,2.0,5.0,3.0,12.0,2.0,4.0,6.0,14.0,3.0,0.0,3.0,9.0,12.0,10.0,5.0,2.0,4.0,8.0,13.0,5.0,5.0,3.0,2.0,8.0,3.0,12.0,5.0,1.0,4.0,7.0,12.0,3.0,0.0,8.0,12.0,12.0,8.0,6.0,3.0,6.0,19.0,6.0,8.0,3.0,3.0,3.0,4.0,9.0,10.0,6.0,4.0,3.0,15.0,10.0,11.0,0.0,4.0,5.0,6.0,11.0,10.0,9.0,10.0,8.0,8.0,1.0,4.0,3.0,1.0,3.0,0.0,0.0,6.0,3.0,0.0,2.0,6.0,3.0,2.0,4.0,4.0,3.0,0.0,0.0,1.0,4.0,7.0,1.0,4.0,3.0,1.0,2.0,0.0,1.0,3.0,1.0,1.0,5.0,3.0,5.0,2.0,0.0,1.0,0.0,2.0,2.0,1.0,0.0,1.0,1.0,2.0,0.0,1.0,2.0,1.0,0.0,1.0,1.0,0.0,5.0,6.0,0.0,4.0,0.0,6.0,1.0,1.0,2.0,3.0,4.0,4.0,2.0,1.0,2.0,2.0,4.0,4.0,1.0,3.0,2.0,1.0,2.0,2.0,8.0,2.0,3.0,10.0,3.0,0.0,0.0,0.0,2.0,7.0,7.0,9.0,9.0,12.0,2.0,4.0,6.0,3.0,2.0,3.0,4.0,3.0,3.0,11.0,1.0,2.0,0.0,6.0,0.0,14.0,2.0,6.0,10.0,2.0,0.0,0.0,6.0,1.0,4.0,1.0,4.0,1.0,6.0,4.0,1.0,7.0,7.0,2.0,0.0,4.0,2.0,2.0,4.0,8.0,1.0,3.0,7.0,12.0,1.0,5.0,3.0,7.0,4.0,1.0,10.0,11.0,0.0,1.0,3.0,1.0,1.0,6.0,2.0,4.0,9.0,1.0,8.0,1.0,2.0,2.0,2.0,0.0,4.0,3.0,4.0,6.0,13.0,5.0,0.0,2.0,9.0,5.0,2.0,1.0,2.0,8.0,0.0,7.0,2.0,8.0,3.0,9.0,11.0,1.0,0.0,15.0,8.0,1.0,0.0,0.0,10.0,1.0,4.0,2.0,2.0,8.0,14.0,6.0,8.0,1.0,2.0,1.0,3.0,0.0,11.0,13.0,0.0,7.0,0.0,9.0,3.0,12.0,4.0,8.0,5.0,3.0,3.0,10.0,3.0,1.0,0.0,8.0,5.0,4.0,8.0,0.0,9.0,11.0,4.0,6.0,2.0,5.0,4.0,1.0,0.0,1.0,0.0,0.0,0.0,0.0,0.0,0.0,0.0,0.0,0.0,0.0,0.0,0.0,0.0,0.0,0.0,0.0,0.0,0.0,0.0,0.0,0.0,0.0,0.0,0.0,0.0,0.0,0.0,5.0,0.0,0.0,0.0,3.0,0.0,2.0,0.0,0.0,2.0,0.0,0.0,3.0,0.0,0.0,2.0,2.0,0.0,0.0,0.0,0.0,3.0,0.0,0.0,0.0,0.0,0.0,0.0,0.0,0.0,0.0,0.0,0.0,5.0,2.0,0.0,0.0,0.0,0.0,0.0,0.0,5.0,3.0,0.0,0.0,0.0,0.0,0.0,2.0,8.0,6.0,0.0,3.0,2.0,0.0,0.0,0.0,0.0,0.0,0.0,0.0,0.0,0.0,0.0,0.0,0.0,0.0,0.0,1.0,0.0,0.0,0.0,0.0,0.0,0.0,0.0,0.0,4.0,0.0,0.0,0.0,0.0,0.0,0.0,0.0,0.0,0.0,0.0,6.0,0.0,0.0,0.0,0.0,0.0,0.0,0.0,0.0,0.0,5.0,0.0,4.0,0.0,2.0,0.0,0.0,4.0,0.0,0.0,0.0,0.0,0.0,0.0,0.0,0.0,1.0,2.0,0.0,0.0,0.0,0.0,0.0,0.0,0.0,1.0,1.0,0.0,0.0,0.0,0.0,0.0,3.0,0.0,0.0,1.0,3.0,4.0,0.0,1.0,0.0,3.0,0.0,2.0,0.0,2.1666666666666665,0.0,0.0,0.0,0.0,0.0,0.0,0.0,1.3333333333333333,0.0,2.0,0.0,1.0,0.0,2.0,0.0,0.0,1.0,0.0,0.0,0.0,0.0,0.0,0.0,0.0,0.0,0.0,0.0,0.0,0.0,0.0,0.0,0.0,0.0,0.0,0.0,0.0,0.0,0.0,1.0,0.0,0.0,0.0,0.0,0.0,0.0,0.0,0.0,0.0,1.0,2.0,1.0,0.0,0.0,0.0,2.0,0.0,0.0,0.0,0.0,0.0,0.0,0.0,0.0,0.0,0.0,0.0,0.0,0.0,0.0,0.0,0.0,0.0,0.0,0.0,1.0,0.0,3.5,0.0,0.0,0.0,3.0,0.0,2.0,1.5,0.0,0.0,0.0,0.0,0.0,0.0,7.0,0.0,0.0,0.0,2.0,0.0,1.0,0.0,0.0,0.0,0.0,0.0,0.0,0.0,0.0,4.0,0.0,0.0,9.0,16.0,17.0,18.0,12.0,19.0,4.0,5.0,26.0,1.0,3.0,0.0,9.0,22.0,20.0,0.0,2.0,3.0,3.0,9.0,6.0,5.0,13.0,4.0,3.0,4.0,21.0,20.0,14.0,21.0,11.0,2.0,6.0,2.0,2.0,26.0,8.0,18.0,20.0,19.0,26.0,35.0,22.0,27.0,9.0,15.0,16.0,19.0,17.0,13.0,14.0,23.0,13.0,9.0,29.0,5.0,23.0,22.0,10.0,12.0,5.0,7.0,11.0,11.0,6.0,20.0,20.0,8.0,4.0,3.0,4.0,6.0,29.0,24.0,17.0,12.0,22.0,4.0,22.0,20.0,14.0,18.0,12.0,35.0,50.0,12.0,13.0,11.0,16.0,9.0,18.0,6.0,4.0,49.0,8.0,11.0,23.0,13.0,7.0,4.0,16.0,18.0,4.0,20.0,5.0,9.0,1.0,5.0,3.0,16.0,2.0,2.0,2.0,5.0,1.0,0.0,2.0,1.0,1.0,5.0,1.0,0.0,0.0,6.0,5.0,5.0,16.0,2.0,14.0,5.0,3.0,0.0,0.0,6.0,2.0,3.0,1.0,1.0,0.0,1.0,5.0,1.0,0.0,0.0,1.0,0.0,13.0,2.0,1.0,3.0,3.0,1.0,5.0,2.0,3.0,15.0,17.0,10.0,23.0,7.0,8.0,6.0,7.0,6.0,1.0,17.0,6.0,6.0,9.0,12.0,9.0,2.0,0.0,2.0,10.0,1.0,15.0,4.0,12.0,9.0,7.0,4.0,6.0,15.0,3.0,4.0,7.0,13.0,1.0,1.0,1.0,10.0,12.0,2.0,3.0,21.0,0.0,12.0,4.0,1.0,3.0,14.0,2.0,0.0,1.0,6.0,1.0,4.0,10.0,6.0,9.0,3.0,1.0,1.0,1.0,0.0,2.0,1.0,2.0,0.0,17.0,6.0,8.0,3.0,0.0,4.0,0.0,5.0,14.0,0.0,1.0,1.0,1.0,15.0,13.0,11.0,4.0,8.0,2.0,6.0,15.0,25.0,3.0,2.0,22.0,2.0,0.0,1.0,2.0,2.0,10.0,1.0,10.0,16.0,9.0,16.0,1.0,13.0,1.0,19.0,8.0,12.0,6.0,20.0,20.0,12.0,11.0,13.0,5.0,25.0,23.0,32.0,31.0,20.0,15.0,23.0,11.0,2.0,29.0,18.0,10.0,5.0,0.0,0.0,22.0,10.0,8.0,6.0,27.0,3.0,21.0,4.0,1.0,3.0,5.0,10.0,20.0,1.0,13.0,20.0,25.0,0.0,17.0,25.0,25.0,16.0,20.0,13.0,14.0,5.0,1.0,18.0,14.0,5.0,9.0,37.0,22.0,12.0,16.0,17.0,6.0,30.0,24.0,24.0,4.0,11.0,28.0,19.0,22.0,5.0,2.0,23.0,13.0,14.0,18.0,18.0,22.0,16.0,18.0,8.0,1.0,2.0,29.0,1.0,3.0,7.0,15.0,7.0,9.0,13.0,8.0,23.0,17.0,8.0,29.0,24.0,5.0,9.0,14.0,17.0,1.0,6.0,0.0,12.0,18.0,6.0,18.0,22.0,9.0,18.0,17.0,10.0,14.0,21.0,20.0,19.0,18.0,10.0,0.0,4.0,15.0,12.0,4.0,1.0,2.0,0.0,1.0,0.0,1.0,3.0,3.0,1.0,8.0,4.0,16.0,18.0,10.0,4.0,1.0,0.0,0.0,0.0,0.0,1.0,0.0,0.0,1.0,8.0,3.0,0.0,,0.0,0.0,0.0,0.0,0.0,,0.0,,,0.0,0.0,0.0,0.0,0.0,14.0,3.0,14.0,7.0,6.0,0.0,0.0,8.0,6.0,4.0,1.0,15.0,8.0,7.0,8.0,0.0,10.0,9.0,6.0,4.0,7.0,4.0,6.0,10.0,0.0,9.0,4.0,14.0,7.0,2.0,3.0,14.0,6.0,4.0,13.0,7.0,9.0,9.0,10.0,15.0,2.0,7.0,6.0,12.0,16.0,4.0,20.0,11.0,11.0,0.0,4.0,10.0,6.0,7.0,9.0,6.0,9.0,10.0,6.0,0.0,5.0,8.0,9.0,10.0,5.0,22.0,5.0,8.0,9.0,5.0,4.0,8.0,18.0,6.0,12.0,2.0,6.0,19.0,22.0,0.0,6.0,8.0,7.0,5.0,2.0,13.0,9.0,6.0,21.0,7.0,9.0,13.0,10.0,6.0,9.0,5.0,8.0,4.0,5.0,4.0,12.0,12.0,6.0,8.0,2.0,12.0,7.0,1.0,7.0,9.0,12.0,10.0,1.0,11.0,5.0,9.0,9.0,15.0,3.0,7.0,6.0,5.0,1.0,8.0,5.0,11.0,19.0,9.0,18.0,6.0,0.0,6.0,6.0,6.0,10.0,8.0,10.0,13.0,0.0,1.0,6.0,4.0,5.0,10.0,5.0,10.0,10.0,1.0,8.0,1.0,4.0,9.0,2.0,4.0,11.0,0.0,5.0,0.0,3.0,2.0,2.0,3.0,2.0,2.0,3.0,0.0,0.0,4.0,1.0,5.0,4.0,4.0,1.0,1.0,3.0,3.0,0.0,5.0,8.0,7.0,7.0,4.0,2.0,9.0,11.0,0.0,1.0,,11.0,3.0,10.0,14.0,18.0,17.0,1.0,4.0,12.0,13.0,12.0,3.0,13.0,6.0,,3.0,4.0,1.0,10.0,1.0,1.0,22.0,5.0,0.0,7.0,13.0,7.0,30.0,0.0,1.0,1.0,8.0,22.0,0.0,32.0,1.0,0.0,10.0,8.0,5.0,4.0,6.0,0.0,3.0,6.0,0.0,4.0,3.0,11.0,0.0,1.0,1.0,2.0,0.0,,5.0,20.0,1.0,15.0,11.0,1.0,14.0,3.0,1.0,4.0,10.0,6.0,0.0,3.0,4.0,5.0,2.0,1.0,0.0,12.0,2.0,8.0,1.0,1.0,0.0,0.0,0.0,0.0,8.0,0.0,7.0,1.0,21.0,11.0,,1.0,1.0,0.0,0.0,3.0,8.0,3.0,8.0,16.0,11.0,2.0,10.0,14.0,8.0,17.0,3.0,12.0,12.0,16.0,4.0,3.0,4.0,7.0,7.0,9.0,0.0,6.0,3.0,0.0,6.0,0.0,7.0,2.0,5.0,,19.0,21.0,2.0,6.0,8.0,11.0,8.0,2.0,12.0,0.0,4.0,0.0,25.0,11.0,0.0,1.0,17.0,13.0,0.0,2.0,4.0,8.0,14.0,17.0,6.0,12.0,3.0,7.0,12.0,1.0,11.0,1.0,14.0,8.0,35.0,0.0,9.0,0.0,17.0,9.0,3.0,10.0,12.0,9.0,8.0,0.0,10.0,5.0,3.0,17.0,5.0,16.0,17.0,14.0,12.0,14.0,4.0,20.0,6.0,3.0,9.0,9.0,6.0,15.0,10.0,0.0,7.0,0.0,3.0,12.0,1.0,12.0,1.0,5.0,18.0,8.0,4.0,14.0,6.0,4.0,0.0,,0.0,17.0,7.0,11.0,11.0,10.0,2.0,1.0,5.0,0.0,2.0,0.0,0.0,10.0,7.0,11.0,12.0,21.0,5.0,1.0,17.0,10.0,,4.0,14.0,1.0,19.0,6.0,3.0,20.0,4.0,2.0,10.0,9.0,9.0,14.0,17.0,14.0,6.0,1.0,12.0,13.0,7.0,14.0,16.0,9.0,6.0,1.0,13.0,6.0,4.0,2.0,0.0,0.0,6.0,17.0,2.0,5.0,2.0,0.0,0.0,13.0,,12.0,9.0,15.0,9.0,2.0,2.0,9.0,11.0,8.0,1.0,14.0,0.0,10.0,0.0,2.0,6.0,26.0,12.0,6.0,10.0,5.0,5.0,0.0,4.0,31.0,2.0,2.0,16.0,2.0,16.0,15.0,15.0,3.0,5.0,6.0,8.0,8.0,6.0,3.0,4.0,0.0,3.0,11.0,0.0,28.0,13.0,0.0,1.0,8.0,12.0,11.0,11.0,10.0,3.0,17.0,15.0,1.0,6.0,,12.0,21.0,17.0,0.0,0.0,11.0,10.0,11.0,16.0,12.0,6.0,15.0,7.0,15.0,9.0,13.0,8.0,8.0,4.0,14.0,0.0,,11.0,0.0,4.0,4.0,10.0,7.0,0.0,1.0,0.0,0.0,4.0,0.0,3.0,1.0,3.0,0.0,5.0,0.0,0.0,9.0,3.0,11.0,0.0,8.0,1.0,0.0,1.0,17.0,7.0,26.0,13.0,24.0,12.0,4.0,6.0,15.0,0.0,1.0,23.0,0.0,0.0,1.0,0.0,4.0,7.0,4.0,9.0,12.0,4.0,11.0,13.0,1.0,5.0,,2.0,8.0,17.0,2.0,10.0,7.0,2.0,18.0,16.0,6.0,8.0,11.0,12.0,7.0,3.0,11.0,0.0,8.0,10.0,3.0,11.0,3.0,11.0,7.0,1.0,1.0,13.0,9.0,7.0,13.0,10.0,6.0,0.0,25.0,5.0,22.0,16.0,17.0,0.0,8.0,9.0,2.0,3.0,20.0,4.0,4.0,0.0,0.0,0.0,1.0,2.0,0.0,15.0,0.0,13.0,1.0,1.0,32.0,9.0,1.0,19.0,,,,,,,,,,,,,,,,,,,,,,,,,,,,,,,,,,,,,,,,,,,,,,,,,,,0.0,1.0,0.0,1.0,4.0,1.0,4.0,2.0,0.0,5.0,5.0,1.0,3.0,4.0,5.0,1.0,1.0,5.0,5.0,3.0,2.0,17.0,0.0,10.0,13.0,8.0,5.0,18.0,2.0,5.0,8.0,1.0,24.0,13.0,15.0,11.0,8.0,4.0,8.0,9.0,26.0,9.0,7.0,11.0,9.0,7.0,17.0,8.0,21.0,6.0,8.0,10.0,15.0,19.0,18.0,13.0,17.0,1.0,11.0,21.0,8.0,2.0,11.0,13.0,8.0,13.0,12.0,11.0,3.0,18.0,15.0,28.0,3.0,25.0,10.0,15.0,3.0,3.0,12.0,12.0,16.0,19.0,14.0,11.0,6.0,8.0,14.0,13.0,10.0,6.0,11.0,21.0,20.0,21.0,12.0,18.0,13.0,15.0,9.0,21.0,20.0,4.0,14.0,13.0,8.0,1.0,25.0,5.0,10.0,3.0,10.0,2.0,20.0,15.0,20.0,20.0,7.0,16.0,15.0,17.0,11.0,19.0,4.0,9.0,16.0,11.0,12.0,9.0,5.0,14.0,22.0,19.0,10.0,11.0,9.0,6.0,2.0,10.0,14.0,9.0,11.0,8.0,27.0,10.0,3.0,11.0,20.0,3.0,10.0,10.0,7.0,18.0,2.0,1.0,13.0,18.0,6.0,3.0,18.0,26.0,29.0,12.0,8.0,8.0,9.0,11.0,10.0,10.0,13.0,12.0,9.0,9.0,22.0,9.0,18.0,4.0,5.0,2.0,7.0,10.0,15.0,12.0,9.0,20.0,7.0,6.0,18.0,5.0,5.0,23.0,11.0,14.0,15.0,17.0,8.0,3.0,21.0,17.0,19.0,7.0,3.0,23.0,8.0,14.0,15.0,3.0,19.0,12.0,11.0,2.0,13.0,5.0,35.0,14.0,12.0,13.0,13.0,9.0,17.0,7.0,10.0,5.0,13.0,6.0,11.0,18.0,13.0,4.0,19.0,27.0,16.0,15.0,20.0,9.0,14.0,6.0,20.0,10.0,14.0,6.0,22.0,9.0,4.0,5.0,9.0,2.0,13.0,23.0,13.0,20.0,6.0,8.0,8.0,13.0,5.0,11.0,8.0,1.0,5.0,8.0,21.0,19.0,11.0,12.0,13.0,8.0,10.0,11.0,10.0,8.0,9.0,14.0,13.0,11.0,12.0,18.0,11.0,12.0,11.0,8.0,15.0,12.0,2.0,9.0,6.0,4.0,9.0,11.0,8.0,6.0,8.0,5.0,16.0,21.0,10.0,16.0,9.0,12.0,9.0,8.0,10.0,12.0,8.0,5.0,17.0,9.0,21.0,14.0,9.0,6.0,5.0,10.0,17.0,1.0,10.0,0.0,2.0,15.0,10.0,4.0,9.0,10.0,7.0,3.0,1.0,11.0,7.0,7.0,4.0,2.0,1.0,10.0,11.0,26.0,11.0,16.0,2.0,0.0,7.0,12.0,7.0,17.0,5.0,17.0,23.0,1.0,7.0,2.0,11.0,10.0,,,,,,,,11.0,6.0,14.0,17.0,15.0,1.0,8.0,10.0,12.0,3.0,8.0,15.0,9.0,2.0,11.0,10.0,10.0,11.0,7.0,13.0,5.0,8.0,23.0,9.0,7.0,11.0,3.0,12.0,9.0,16.0,7.0,4.0,11.0,22.0,1.0,14.0,15.0,3.0,7.0,13.0,2.0,18.0,0.0,10.0,14.0,2.0,2.0,8.0,5.0,11.0,15.0,11.0,6.0,4.0,0.0,8.0,26.0,1.0,7.0,8.0,10.0,14.0,2.0,0.0,7.0,2.0,17.0,4.0,0.0,10.0,4.0,13.0,4.0,11.0,14.0,1.0,21.0,19.0,14.0,9.0,0.0,0.0,0.0,1.0,0.0,2.0,0.0,0.0,16.0,0.0,4.0,0.0,0.0,0.0,1.0,1.0,7.0,2.0,0.0,2.0,0.0,1.0,0.0,2.0,0.0,0.0,4.0,0.0,0.0,0.0,0.0,0.0,0.0,4.0,14.0,0.0,1.0,0.0,0.0,2.0,0.0,2.0,0.0,0.0,0.0,13.0,3.0,1.0,10.0,0.0,0.0,1.0,1.0,1.0,1.0,1.0,2.0,0.0,3.0,9.0,15.0,0.0,2.0,4.0,6.0,25.0,17.0,0.0,1.0,6.0,4.0,4.0,0.0,0.0,0.0,1.0,3.0,5.0,2.0,0.0,13.0,15.0,13.0,4.0,1.0,6.0,9.0,2.0,2.0,9.0,4.0,13.0,0.0,0.0,0.0,1.0,3.0,0.0,7.0,0.0,0.0,3.0,12.0,14.0,17.0,12.0,6.0,10.0,14.0,2.0,11.0,0.0,0.0,1.0,8.0,20.0,7.0,0.0,0.0,2.0,0.0,2.0,2.0,0.0,8.0,1.0,1.0,8.0,0.0,1.0,0.0,8.0,9.0,15.0,10.0,7.0,6.0,6.0,7.0,5.0,10.0,3.0,2.0,1.0,1.0,4.0,2.0,6.0,1.0,9.0,1.0,9.0,1.0,8.0,1.0,0.0,7.0,4.0,0.0,16.0,0.0,2.0,23.0,11.0,3.0,0.0,1.0,0.0,0.0,8.0,0.0,4.0,1.0,5.0,6.0,9.0,1.0,3.0,0.0,1.0,5.0,2.0,13.0,0.0,6.0,0.0,1.0,5.0,4.0,20.0,1.0,2.0,5.0,9.0,8.0,12.0,0.0,0.0,0.0,0.0,0.0,15.0,9.0,5.0,8.0,4.0,15.0,4.0,3.0,0.0,0.0,3.0,19.0,4.0,1.0,0.0,3.0,5.0,1.0,2.0,0.0,1.0,7.0,7.0,0.0,0.0,0.0,16.0,1.0,2.0,1.0,1.0,0.0,1.0,6.0,2.0,5.0,0.0,22.0,1.0,0.0,1.0,13.0,5.0,0.0,11.0,6.0,6.0,1.0,1.0,8.0,1.0,0.0,1.0,0.0,1.0,2.0,1.0,0.0,1.0,36.0,6.0,8.0,4.0,14.0,20.0,3.0,3.0,6.0,2.0,13.0,1.0,10.0,10.0,8.0,0.0,6.0,12.0,3.0,20.0,17.0,7.0,6.0,1.0,2.0,0.0,1.0,0.0,0.0,2.0,0.0,0.0,2.0,10.0,3.0,3.0,0.0,14.0,19.0,10.0,17.0,8.0,14.0,10.0,6.0,21.0,5.0,5.0,13.0,1.0,14.0,2.0,9.0,16.0,6.0,9.0,2.0,0.0,0.0,1.0,0.0,1.0,1.0,3.0,20.0,0.0,3.0,0.0,4.0,0.0,0.0,0.0,0.0,4.0,1.0,9.0,2.0,0.0,2.0,0.0,0.0,0.0,0.0,0.0,4.0,6.0,1.0,6.0,2.0,0.0,4.0,6.0,5.0,8.0,3.0,14.0,10.0,7.0,15.0,13.0,4.0,6.0,7.0,5.0,5.0,4.0,2.0,34.0,5.0,10.0,0.0,4.0,3.0,6.0,2.0,2.0,3.0,6.0,8.0,4.0,6.0,1.0,5.0,7.0,5.0,3.0,5.0,8.0,2.0,3.0,3.0,17.0,1.0,11.0,4.0,10.0,8.0,7.0,0.0,5.0,2.0,7.0,0.0,3.0,0.0,2.0,4.0,1.0,3.0,4.0,0.0,9.0,7.0,0.0,0.0,2.0,1.0,0.0,1.0,0.0,5.0,1.0,1.0,1.0,0.0,5.0,5.0,8.0,0.0,5.0,8.0,6.0,12.0,10.0,0.0,21.0,11.0,4.0,7.0,10.0,9.0,16.0,4.0,3.0,2.0,13.0,7.0,5.0,5.0,2.0,4.0,13.0,11.0,9.0,6.0,8.0,8.0,5.0,1.0,3.0,5.0,0.0,10.0,2.0,4.0,3.0,6.0,0.0,4.0,4.0,6.0,7.0,3.0,3.0,3.0,2.0,1.0,8.0,10.0,7.0,5.0,7.0,3.0,3.0,1.0,2.0,20.0,5.0,6.0,5.0,6.0,7.0,9.0,6.0,14.0,13.0,1.0,3.0,9.0,16.0,7.0,3.0,2.0,7.0,7.0,7.0,1.0,7.0,3.0,4.0,4.0,4.0,5.0,5.0,6.0,6.0,8.0,7.0,8.0,6.0,7.0,5.0,3.0,12.0,13.0,6.0,16.0,8.0,4.0,8.0,9.0,11.0,6.0,5.0,13.0,6.0,12.0,9.0,10.0,12.0,12.0,4.0,5.0,4.0,8.0,6.0,7.0,14.0,5.0,7.0,10.0,7.0,4.0,5.0,8.0,8.0,6.0,9.0,10.0,12.0,9.0,8.0,4.0,12.0,2.0,3.0,9.0,24.0,7.0,4.0,5.0,14.0,4.0,11.0,18.0,10.0,12.0,11.0,7.0,13.0,18.0,8.0,3.0,11.0,16.0,7.0,8.0,4.0,6.0,7.0,16.0,8.0,7.0,4.0,5.0,9.0,14.0,10.0,6.0,12.0,0.0,8.0,6.0,1.0,13.0,10.0,9.0,4.0,6.0,9.0,7.0,11.0,8.0,11.0,6.0,11.0,6.0,4.0,10.0,4.0,9.0,15.0,9.0,2.0,0.0,9.0,16.0,7.0,4.0,3.0,7.0,5.0,19.0,8.0,8.0,7.0,0.0,5.0,8.0,7.0,10.0,9.0,6.0,0.0,11.0,12.0,14.0,5.0,7.0,14.0,17.0,8.0,4.0,15.0,9.0,14.0,10.0,12.0,4.0,7.0,5.0,19.0,15.0,6.0,2.0,5.0,7.0,7.0,10.0,5.0,8.0,11.0,10.0,11.0,7.0,11.0,5.0,5.0,8.0,8.0,1.0,5.0,9.0,5.0,5.0,5.0,9.0,6.0,3.0,2.0,5.0,6.0,7.0,6.0,13.0,4.0,3.0,8.0,10.0,10.0,12.0,6.0,21.0,9.0,9.0,10.0,8.0,3.0,8.0,4.0,5.0,8.0,7.0,6.0,8.0,6.0,4.0,3.0,7.0,9.0,3.0,0.0,0.0,6.0,1.0,5.0,14.0,1.0,0.0,3.0,0.0,1.0,1.0,4.0,15.0,12.0,1.0,2.0,12.0,0.0,0.0,2.0,11.0,3.0,0.0,1.0,2.0,8.0,7.0,0.0,5.0,11.0,2.0,7.0,5.0,5.0,5.0,3.0,1.0,0.0,3.0,3.0,5.0,0.0,5.0,5.0,5.0,1.0,2.0,5.0,3.0,5.0,1.0,0.0,5.0,5.0,3.0,5.0,4.0,1.0,3.0,5.0,2.0,5.0,2.0,0.0,3.0,3.0,5.0,5.0,5.0,3.0,0.0,5.0,5.0,5.0,5.0,4.0,5.0,2.0,0.0,5.0,4.0,0.0,1.0,5.0,2.0,5.0,2.0,5.0,5.0,4.0,5.0,5.0,5.0,5.0,5.0,5.0,5.0,5.0,5.0,2.0,5.0,3.0,5.0,5.0,5.0,5.0,5.0,5.0,3.0,1.0,4.0,5.0,1.0,5.0,3.0,5.0,5.0,5.0,5.0,1.0,0.0,1.0,0.0,2.0,1.0,0.0,0.0,7.0,0.0,0.0,2.0,1.0,7.0,5.0,0.0,3.0,9.0,1.0,1.0,6.0,0.0,0.0,1.0,5.0,1.0,0.0,3.0,1.0,6.0,0.0,0.0,0.0,3.0,0.0,0.0,1.0,2.0,1.0,3.0,2.0,12.0,4.0,0.0,3.0,16.0,15.0,13.0,1.0,0.0,1.0,1.0,14.0,5.0,11.0,4.0,5.0,6.0,0.0,1.0,1.0,7.0,4.0,4.0,11.0,1.0,9.0,7.0,0.0,0.0,6.0,10.0,5.0,1.0,7.0,0.0,4.0,6.0,21.0,0.0,0.0,19.0,6.0,1.0,1.0,0.0,1.0,6.0,0.0,14.0,3.0,3.0,0.0,24.0,0.0,3.0,0.0,0.0,3.0,1.0,10.0,3.0,1.0,25.0,4.0,1.0,6.0,7.0,0.0,2.0,7.0,5.0,0.0,1.0,10.0,2.0,12.0,11.0,5.0,22.0,0.0,17.0,3.0,10.0,6.0,6.0,0.0,1.0,0.0,13.0,15.0,11.0,4.0,7.0,4.0,7.0,15.0,25.0,0.0,0.0,2.0,1.0,7.0,0.0,0.0,0.0,23.0,24.0,11.0,10.0,13.0,8.0,22.0,13.0,0.0,17.0,4.0,17.0,2.0,22.0,11.0,3.0,10.0,2.0,11.0,0.0,2.0,14.0,8.0,0.0,17.0,3.0,0.0,2.0,1.0,2.0,12.0,12.0,30.0,0.0,3.0,2.0,14.0,0.0,11.0,0.0,1.0,4.0,12.0,6.0,6.0,0.0,0.0,20.0,13.0,18.0,6.0,16.0,2.0,0.0,1.0,20.0,3.0,2.0,17.0,11.0,17.0,12.0,0.0,0.0,8.0,0.0,5.0,5.0,12.0,0.0,7.0,1.0,17.0,0.0,0.0,5.0,2.0,7.0,17.0,2.0,3.0,0.0,4.0,26.0,1.0,16.0,2.0,1.0,2.0,15.0,10.0,10.0,2.0,10.0,26.0,9.0,15.0,4.0,0.0,17.0,1.0,14.0,16.0,15.0,33.0,18.0,0.0,14.0,0.0,9.0,8.0,14.0,4.0,6.0,6.0,1.0,14.0,4.0,2.0,1.0,10.0,0.0,0.0,1.0,8.0,12.0,6.0,0.0,14.0,17.0,10.0,4.0,0.0,1.0,8.0,0.0,0.0,18.0,7.0,8.0,17.0,0.0,11.0,19.0,23.0,,15.0,8.0,2.0,7.0,0.0,11.0,8.0,8.0,7.0,5.0,7.0,14.0,0.0,0.0,0.0,7.0,22.0,17.0,14.0,21.0,0.0,18.0,12.0,22.0,3.0,14.0,1.0,7.0,36.0,6.0,1.0,0.0,1.0,5.0,7.0,4.0,17.0,3.0,18.0,33.0,11.0,17.0,1.0,15.0,1.0,3.0,21.0,8.0,13.0,11.0,16.0,24.0,12.0,16.0,3.0,10.0,1.0,19.0,16.0,0.0,14.0,17.0,12.0,17.0,2.0,28.0,30.0,24.0,15.0,25.0,28.0,2.0,2.0,16.0,13.0,5.0,25.0,10.0,5.0,38.0,9.0,46.0,1.0,6.0,11.0,10.0,2.0,1.0,11.0,7.0,18.0,24.0,19.0,11.0,2.0,8.0,1.0,7.0,4.0,5.0,4.0,19.0,2.0,4.0,3.0,7.0,21.0,10.0,4.0,17.0,18.0,0.0,8.0,8.0,12.0,0.0,17.0,10.0,16.0,7.0,1.0,1.0,4.0,0.0,1.0,10.0,16.0,3.0,24.0,9.0,16.0,15.0,0.0,15.0,11.0,17.0,15.0,5.0,1.0,12.0,3.0,12.0,8.0,47.0,1.0,1.0,0.0,0.0,6.0,14.0,31.0,8.0,0.0,2.0,11.0,16.0,13.0,0.0,2.0,1.0,4.0,2.0,7.0,5.0,19.0,0.0,6.0,15.0,12.0,4.0,10.0,27.0,1.0,0.0,5.0,16.0,4.0,14.0,7.0,5.0,9.0,14.0,0.0,24.0,5.0,17.0,0.0,6.0,8.0,3.0,12.0,31.0,27.0,4.0,1.0,6.0,31.0,11.0,12.0,18.0,7.0,4.0,13.0,9.0,5.0,5.0,9.0,35.0,14.0,13.0,19.0,42.0,23.0,15.0,15.0,8.0,0.0,23.0,13.0,14.0,2.0,3.0,6.0,6.0,0.0,5.0,22.0,1.0,4.0,29.0,8.0,7.0,17.0,2.0,29.0,12.0,10.0,9.0,1.0,0.0,2.0,11.0,7.0,3.0,5.0,17.0,2.0,0.0,3.0,1.0,12.0,2.0,18.0,0.0,8.0,0.0,5.0,9.0,24.0,2.0,7.0,4.0,5.0,0.0,0.0,0.0,10.0,7.0,2.0,1.0,0.0,6.0,0.0,8.0,20.0,21.0,0.0,8.0,1.0,15.0,10.0,0.0,7.0,24.0,0.0,4.0,7.0,23.0,20.0,0.0,13.0,21.0,5.0,0.0,0.0,14.0,14.0,13.0,30.0,14.0,18.0,16.0,12.0,,1.0,9.0,0.0,12.0,0.0,0.0,5.0,9.0,14.0,1.0,3.0,8.0,2.0,1.0,0.0,1.0,0.0,5.0,1.0,1.0,8.0,40.0,28.0,65.0,23.0,37.0,0.0,0.0,26.0,0.0,11.0,0.0,6.0,0.0,0.0,14.0,10.0,5.0,9.0,0.0,12.0,22.0,1.0,19.0,0.0,4.0,1.0,1.0,0.0,23.0,23.0,5.0,9.0,11.0,8.0,6.0,0.0,13.0,17.0,9.0,4.0,0.0,9.0,0.0,13.0,11.0,14.0,15.0,11.0,8.0,6.0,1.0,11.0,11.0,12.0,9.0,12.0,6.0,18.0,18.0,15.0,3.0,6.0,9.0,7.0,12.0,15.0,8.0,11.0,10.0,4.0,14.0,14.0,13.0,13.0,0.0,5.0,12.0,12.0,6.0,9.0,14.0,8.0,14.0,11.0,5.0,8.0,21.0,13.0,9.0,12.0,0.0,11.0,2.0,14.0,8.0,9.0,7.0,13.0,0.0,9.0,12.0,5.0,9.0,0.0,3.0,7.0,16.0,10.0,11.0,1.0,3.0,9.0,17.0,14.0,8.0,12.0,19.0,5.0,9.0,12.0,3.0,17.0,3.0,13.0,2.0,18.0,8.0,14.0,17.0,14.0,19.0,7.0,4.0,4.0,8.0,12.0,16.0,5.0,2.0,2.0,14.0,7.0,7.0,9.0,16.0,9.0,16.0,0.0,12.0,1.0,7.0,10.0,12.0,12.0,13.0,9.0,11.0,11.0,6.0,4.0,8.0,6.0,10.0,14.0,15.0,5.0,15.0,14.0,5.0,11.0,11.0,17.0,8.0,19.0,7.0,10.0,5.0,11.0,1.0,14.0,0.0,15.0,3.0,0.0,4.0,15.0,6.0,7.0,10.0,5.0,7.0,0.0,0.0,1.0,0.0,4.0,1.0,6.0,3.0,11.0,0.0,13.0,15.0,11.0,4.0,2.0,0.0,18.0,4.0,8.0,17.0,6.0,12.0,12.0,16.0,7.0,0.0,9.0,0.0,2.0,5.0,0.0,12.0,5.0,8.0,0.0,9.0,7.0,5.0,3.0,10.0,0.0,1.0,7.0,11.0,0.0,1.0,10.0,3.0,15.0,4.0,4.0,0.0,11.0,6.0,2.0,2.0,17.0,3.0,5.0,0.0,6.0,0.0,1.0,0.0,1.0,10.0,1.0,0.0,2.0,17.0,5.0,11.0,10.0,6.0,11.0,6.0,0.0,5.0,9.0,10.0,0.0,0.0,9.0,10.0,1.0,13.0,5.0,7.0,10.0,6.0,1.0,6.0,7.0,2.0,2.0,13.0,6.0,9.0,11.0,4.0,26.0,6.0,1.0,2.0,0.0,9.0,12.0,3.0,18.0,6.0,9.0,2.0,4.0,17.0,1.0,2.0,0.0,21.0,5.0,12.0,19.0,8.0,15.0,11.0,2.0,0.0,2.0,2.0,6.0,0.0,8.0,2.0,0.0,12.0,12.0,6.0,8.0,10.0,1.0,8.0,6.0,11.0,18.0,3.0,8.0,13.0,0.0,6.0,0.0,0.0,3.0,0.0,30.0,11.0,25.0,0.0,0.0,2.0,7.0,9.0,3.0,3.0,0.0,0.0,15.0,0.0,12.0,11.0,5.0,5.0,9.0,5.0,2.0,2.0,3.0,1.0,0.0,10.0,2.0,3.0,5.0,3.0,8.0,0.0,14.0,18.0,17.0,6.0,1.0,0.0,0.0,6.0,7.0,8.0,12.0,5.0,9.0,7.0,14.0,4.0,2.0,3.0,14.0,6.0,6.0,12.0,1.0,9.0,5.0,1.0,4.0,12.0,14.0,9.0,9.0,4.0,4.0,0.0,10.0,9.0,0.0,4.0,0.0,1.0,7.0,2.0,28.0,17.0,0.0,13.0,11.0,11.0,7.0,9.0,12.0,11.0,0.0,4.0,1.0,8.0,5.0,2.0,12.0,0.0,0.0,4.0,0.0,1.0,3.0,2.0,14.0,11.0,9.0,3.0,2.0,0.0,0.0,10.0,5.0,0.0,9.0,13.0,6.0,10.0,14.0,6.0,0.0,12.0,1.0,0.0,15.0,4.0,12.0,12.0,8.0,1.0,0.0,0.0,0.0,0.0,0.0,2.0,5.0,3.0,3.0,1.0,0.0,4.0,1.0,0.0,1.0,11.0,0.0,4.0,0.0,1.0,6.0,0.0,5.0,0.0,0.0,0.0,0.0,0.0,0.0,5.0,1.0,0.0,0.0,0.0,0.0,0.0,4.0,1.0,1.0,1.0,0.0,0.0,2.0,0.0,0.0,0.0,1.0,0.0,2.0,2.0,4.0,4.0,0.0,1.0,0.0,3.0,2.0,0.0,0.0,0.0,0.0,1.0,0.0,0.0,3.0,2.0,0.0,2.0,0.0,0.0,2.0,0.0,2.0,2.0,0.0,0.0,0.0,0.0,0.0,1.0,0.0,2.0,0.0,1.0,4.0,2.0,0.0,0.0,0.0,0.0,0.0,0.0,3.0,0.0,1.0,1.0,0.0,0.0,3.0,8.0,5.0,0.0,4.0,3.0,6.0,3.0,6.0,6.0,3.0,3.0,10.0,12.0,9.0,11.0,5.0,2.0,6.0,4.0,12.0,8.0,8.0,8.0,7.0,6.0,1.0,4.0,2.0,2.0,2.0,4.0,8.0,2.0,6.0,0.0,9.0,12.0,9.0,5.0,7.0,7.0,4.0,8.0,0.0,1.0,4.0,3.0,2.0,2.0,4.0,3.0,4.0,7.0,5.0,2.0,2.0,8.0,3.0,4.0,3.0,5.0,2.0,1.0,5.0,1.0,2.0,5.0,3.0,3.0,5.0,4.0,2.0,2.0,8.0,6.0,3.0,4.0,6.0,1.0,3.0,10.0,3.0,4.0,5.0,4.0,0.0,3.0,5.0,5.0,4.0,0.0,2.0,8.0,0.0,0.0,3.0,2.0,4.0,5.0,2.0,0.0,3.0,2.0,3.0,6.0,7.0,1.0,2.0,4.0,4.0,0.0,2.0,2.0,4.0,0.0,0.0,2.0,8.0,6.0,7.0,5.0,2.0,2.0,4.0,9.0,3.0,4.0,3.0,2.0,2.0,5.0,6.0,6.0,6.0,4.0,0.0,5.0,3.0,5.0,4.0,4.0,4.0,0.0,3.0,2.0,11.0,3.0,7.0,14.0,5.0,11.0,7.0,6.0,2.0,3.0,3.0,4.0,4.0,2.0,12.0,7.0,3.0,6.0,0.0,1.0,8.0,3.0,4.0,0.0,2.0,7.0,0.0,1.0,1.0,1.0,3.0,2.0,0.0,0.0,2.0,0.0,2.0,6.0,1.0,1.0,6.0,0.0,0.0,0.0,0.0,0.0,4.0,8.0,11.0,6.0,5.0,4.0,5.0,4.0,6.0,8.0,4.0,5.0,5.0,6.0,3.0,4.0,9.0,7.0,4.0,6.0,7.0,6.0,1.0,7.0,8.0,6.0,8.0,3.0,12.0,2.0,7.0,5.0,9.0,6.0,5.0,4.0,5.0,2.0,9.0,1.0,6.0,5.0,5.0,9.0,6.0,2.0,2.0,9.0,5.0,5.0,8.0,4.0,2.0,4.0,7.0,4.0,3.0,8.0,8.0,5.0,5.0,6.0,2.0,6.0,7.0,3.0,6.0,5.0,2.0,3.0,10.0,2.0,2.0,8.0,14.0,7.0,10.0,2.0,11.0,2.0,2.0,11.0,8.0,2.0,6.0,3.0,4.0,7.0,6.0,2.0,6.0,5.0,10.0,11.0,5.0,6.0,6.0,8.0,5.0,3.0,2.0,2.0,4.0,2.0,6.0,6.0,8.0,6.0,5.0,7.0,4.0,3.0,4.0,5.0,4.0,4.0,0.0,0.0,4.0,4.0,5.0,5.0,5.0,5.0,5.0,5.0,4.0,4.0,5.0,5.0,5.0,4.0,4.0,3.0,3.0,5.0,5.0,5.0,5.0,0.0,2.0,4.0,5.0,3.0,4.0,3.0,4.0,5.0,0.0,5.0,1.0,0.0,0.0,0.0,1.0,2.0,6.0,0.0,11.0,0.0,4.0,0.0,17.0,3.0,2.0,0.0,1.0,0.0,0.0,4.0,2.0,2.0,5.0,0.0,5.0,1.0,10.0,2.0,9.0,9.0,0.0,3.0,12.0,5.0,3.0,0.0,0.0,10.0,1.0,0.0,15.0,2.0,3.0,14.0,1.0,1.0,4.0,0.0,0.0,1.0,11.0,0.0,1.0,1.0,3.0,0.0,14.0,0.0,11.0,0.0,12.0,0.0,2.0,7.0,0.0,0.0,0.0,3.0,1.0,1.0,6.0,0.0,0.0,4.0,1.0,0.0,0.0,0.0,4.0,18.0,1.0,12.0,0.0,11.0,1.0,1.0,1.0,2.0,0.0,0.0,0.0,0.0,0.0,1.0,8.0,2.0,4.0,0.0,2.0,6.0,9.0,14.0,6.0,6.0,9.0,4.0,2.0,6.0,3.0,8.0,17.0,3.0,10.0,4.0,8.0,2.0,3.0,2.0,3.0,4.0,3.0,0.0,0.0,7.0,11.0,4.0,0.0,3.0,0.0,5.0,12.0,1.0,0.0,6.0,2.0,4.0,7.0,1.0,10.0,1.0,2.0,4.0,3.0,8.0,5.0,4.0,2.0,6.0,9.0,7.0,9.0,0.0,0.0,8.0,8.0,2.0,7.0,5.0,0.0,10.0,0.0,6.0,17.0,1.0,10.0,2.0,6.0,0.0,1.0,10.0,5.0,10.0,15.0,6.0,5.0,11.0,5.0,11.0,6.0,13.0,11.0,11.0,1.0,14.0,11.0,9.0,6.0,5.0,5.0,11.0,11.0,1.0,7.0,9.0,5.0,1.0,15.0,1.0,0.0,7.0,3.0,6.0,14.0,10.0,9.0,12.0,7.0,2.0,5.0,11.0,15.0,7.0,12.0,0.0,11.0,8.0,5.0,7.0,9.0,9.0,19.0,16.0,7.0,0.0,0.0,10.0,5.0,5.0,3.0,5.0,4.0,13.0,8.0,0.0,38.0,6.0,7.0,1.0,9.0,1.0,8.0,24.0,21.0,18.0,2.0,0.0,13.0,24.0,1.0,12.0,12.0,7.0,3.0,3.0,0.0,0.0,2.0,14.0,21.0,22.0,3.0,0.0,9.0,2.0,9.0,26.0,15.0,6.0,18.0,9.0,14.0,7.0,13.0,13.0,6.0,0.0,1.0,0.0,5.0,5.0,6.0,4.0,1.0,17.0,1.0,4.0,1.0,8.0,0.0,11.0,0.0,15.0,13.0,8.0,0.0,15.0,4.0,4.0,18.0,3.0,0.0,20.0,0.0,10.0,0.0,11.0,2.0,25.0,9.0,2.0,4.0,14.0,28.0,0.0,0.0,17.0,1.0,6.0,8.0,5.0,4.0,10.0,26.0,4.0,15.0,20.0,2.0,5.0,3.0,10.0,1.0,4.0,0.0,1.0,0.0,16.0,0.0,0.0,24.0,8.0,0.0,0.0,14.0,0.0,15.0,1.0,7.0,3.0,12.0,0.0,2.0,10.0,0.0,0.0,0.0,1.0,1.0,9.0,0.0,15.0,15.0,21.0,19.0,2.0,0.0,11.0,16.0,14.0,4.0,2.0,21.0,6.0,12.0,9.0,2.0,12.0,1.0,11.0,4.0,6.0,3.0,2.0,0.0,7.0,1.0,2.0,12.0,13.0,5.0,6.0,0.0,4.0,19.0,0.0,0.0,8.0,20.0,0.0,19.0,0.0,19.0,0.0,10.0,0.0,5.0,9.0,17.0,3.0,0.0,17.0,3.0,1.0,9.0,0.0,12.0,2.0,0.0,3.0,16.0,0.0,3.0,10.0,8.0,7.0,3.0,0.0,26.0,8.0,1.0,12.0,17.0,0.0,3.0,6.0,2.0,0.0,2.0,12.0,0.0,1.0,2.0,23.0,2.0,2.0,3.0,8.0,0.0,0.0,0.0,10.0,2.0,1.0,20.0,24.0,5.0,0.0,9.0,3.0,20.0,13.0,12.0,2.0,12.0,11.0,17.5,11.0,0.0,1.0,2.0,25.0,12.0,2.0,13.0,22.0,9.0,24.0,6.0,7.0,17.0,30.0,4.0,0.0,1.0,6.0,19.0,27.0,2.0,0.0,0.0,6.0,5.0,20.0,39.0,18.0,37.0,6.0,1.0,14.0,10.0,2.0,15.0,8.0,1.0,10.0,3.0,11.5,7.0,24.0,8.0,1.0,2.0,4.0,28.0,23.0,19.0,19.0,4.0,28.0,2.0,24.0,5.0,4.0,26.0,6.0,18.0,36.0,16.0,0.0,5.0,6.0,6.0,0.0,10.0,0.0,2.0,2.0,,27.0,18.0,7.0,0.0,0.0,0.0,2.0,3.0,19.0,10.0,2.0,1.0,0.0,11.0,1.0,10.0,11.0,1.0,13.0,12.0,0.0,2.0,12.0,2.0,26.0,11.0,1.0,11.0,30.0,4.0,3.0,8.0,2.0,0.0,8.0,3.0,9.0,23.0,16.0,20.0,25.0,29.0,0.0,8.0,14.0,12.0,13.0,24.0,4.0,9.0,11.0,1.0,2.0,0.0,7.0,8.0,20.0,0.0,0.0,1.0,4.0,0.0,5.0,2.0,36.0,14.0,11.0,7.0,20.0,11.0,8.0,6.0,10.0,11.0,2.0,0.0,6.0,17.0,0.0,8.0,8.0,0.0,1.0,1.0,0.0,2.0,0.0,2.0,0.0,0.0,0.0,2.0,0.0,0.0,0.0,0.0,1.0,0.0,0.0,0.0,4.0,0.0,0.0,1.0,0.0,0.0,2.0,0.0,0.0,0.0,1.0,2.0,1.0,0.0,0.0,0.0,0.0,0.0,0.0,0.0,0.0,1.0,1.0,0.0,0.0,2.0,0.0,2.0,1.0,0.0,0.0,0.0,0.0,2.0,1.0,3.0,2.0,1.0,0.0,0.0,0.0,0.0,1.0,1.0,2.0,2.0,1.0,1.0,5.0,9.0,10.0,8.0,7.0,6.0,5.0,3.0,11.0,16.0,15.0,11.0,6.0,11.0,13.0,11.0,15.0,11.0,4.0,3.0,11.0,5.0,20.0,10.0,5.0,3.0,6.0,8.0,8.0,7.0,6.0,9.0,10.0,17.0,8.0,15.0,9.0,15.0,11.0,6.0,4.0,14.0,22.0,10.0,10.0,5.0,5.0,1.0,11.0,9.0,7.0,0.0,0.0,0.0,3.0,3.0,0.0,4.0,0.0,4.0,4.0,14.0,0.0,22.0,9.0,10.0,0.0,21.0,13.0,1.0,15.0,0.0,4.0,1.0,7.0,0.0,2.0,0.0,2.0,0.0,6.0,0.0,0.0,5.0,2.0,5.0,0.0,8.0,17.0,9.0,14.0,18.0,0.0,8.0,0.0,19.0,11.0,0.0,0.0,1.0,8.0,0.0,9.0,15.0,0.0,4.0,0.0,8.0,1.0,21.0,23.0,15.0,1.0,0.0,6.0,2.0,8.0,10.0,0.0,1.0,8.0,0.0,0.0,12.0,21.0,20.0,12.0,0.0,8.0,12.0,7.0,11.0,12.0,1.0,1.0,21.0,4.0,2.0,0.0,10.0,12.0,14.0,21.0,6.0,8.0,12.0,11.0,10.0,2.0,13.0,8.0,1.0,0.0,1.0,8.0,11.0,10.0,11.0,9.0,0.0,15.0,17.0,10.0,12.0,3.0,13.0,9.0,4.0,9.0,9.0,12.0,14.0,12.0,13.0,3.0,3.0,7.0,6.0,0.0,1.0,16.0,5.0,11.0,1.0,12.0,9.0,13.0,11.0,9.0,0.0,1.0,1.0,1.0,8.0,21.0,6.0,8.0,5.0,7.0,10.0,11.0,34.0,13.0,7.0,0.0,16.0,2.0,0.0,10.0,15.0,13.0,0.0,8.0,1.0,6.0,0.0,0.0,11.0,6.0,10.0,10.0,0.0,,0.0,0.0,7.0,0.0,0.0,0.0,7.0,0.0,3.0,0.0,5.0,3.0,2.0,11.0,9.0,6.0,6.0,6.0,10.0,2.0,5.0,12.0,9.0,3.0,4.0,7.0,11.0,21.0,13.0,14.0,9.0,3.0,4.0,5.0,6.0,9.0,10.0,2.0,5.0,3.0,5.0,6.0,7.0,0.0,2.0,12.0,7.0,8.0,0.0,8.0,5.0,10.0,6.0,1.0,0.0,1.0,11.0,0.0,7.0,3.0,5.0,2.0,1.0,0.0,0.0,4.0,4.0,11.0,5.0,0.0,1.0,2.0,4.0,17.0,10.0,6.0,2.0,8.0,2.0,14.0,13.0,9.0,5.0,3.0,10.0,9.0,3.0,10.0,5.0,11.0,15.0,6.0,8.0,0.0,2.0,6.0,6.0,12.0,8.0,5.0,8.0,14.0,3.0,1.0,2.0,10.0,1.0,2.0,2.0,6.0,8.0,9.0,3.0,3.0,2.0,6.0,8.0,2.0,3.0,6.0,8.0,13.0,13.0,6.0,10.0,1.0,11.0,1.0,0.0,10.0,5.0,5.0,12.0,6.0,2.0,6.0,9.0,5.0,9.0,12.0,0.0,4.0,9.0,6.0,8.0,3.0,1.0,3.0,3.0,4.0,5.0,6.0,0.0,4.0,7.0,0.0,5.0,7.0,12.0,4.0,14.0,12.0,10.0,11.0,4.0,7.0,6.0,7.0,5.0,8.0,4.0,10.0,4.0,18.0,6.0,5.0,4.0,11.0,10.0,4.0,11.0,9.0,15.0,10.0,6.0,0.0,11.0,3.0,7.0,3.0,0.0,7.0,7.0,2.0,6.0,3.0,1.0,0.0,1.0,11.0,3.0,14.0,10.0,12.0,11.0,11.0,0.0,10.0,10.0,5.0,10.0,16.0,0.0,0.0,18.0,9.0,7.0,1.0,8.0,4.0,27.0,7.0,12.0,7.0,8.0,0.0,6.0,9.0,9.0,10.0,4.0,0.0,8.0,13.0,1.0,8.0,2.0,3.0,1.0,1.0,6.0,8.0,0.0,4.0,4.0,15.0,7.0,10.0,13.0,12.0,16.0,2.0,0.0,0.0,14.0,19.0,6.0,5.0,1.0,17.0,7.0,9.0,6.0,9.0,7.0,10.0,5.0,7.0,6.0,6.0,0.0,7.0,6.0,7.0,10.0,12.0,0.0,4.0,13.0,6.0,9.0,8.0,17.0,7.0,13.0,9.0,8.0,8.0,9.0,9.0,5.0,6.0,6.0,8.0,6.0,7.0,6.0,3.0,7.0,19.0,7.0,17.0,3.0,14.0,4.0,12.0,12.0,8.0,4.0,3.0,3.0,11.0,7.0,6.0,4.0,15.0,6.0,14.0,5.0,6.0,6.0,7.0,3.0,4.0,18.0,11.0,7.0,13.0,6.0,1.0,7.0,8.0,9.0,4.0,5.0,9.0,0.0,13.0,6.0,2.0,8.0,19.0,11.0,1.0,5.0,11.0,4.0,5.0,9.0,10.0,5.0,0.0,2.0,4.0,2.0,6.0,5.0,14.0,6.0,2.0,5.0,3.0,14.0,25.0,7.0,10.0,0.0,7.0,5.0,6.0,1.0,10.0,10.0,23.0,12.0,2.0,3.0,12.0,7.0,7.0,6.0,4.0,9.0,6.0,3.0,3.0,6.0,0.0,3.0,6.0,3.0,1.0,10.0,12.0,12.0,15.0,5.0,4.0,11.0,0.0,2.0,5.0,0.0,0.0,0.0,0.0,0.0,0.0,0.0,0.0,1.0,0.0,3.0,4.0,0.0,4.0,2.0,2.0,3.0,8.0,5.0,9.0,3.0,2.0,7.0,4.0,16.0,8.0,6.0,3.0,3.0,4.0,2.0,5.0,2.0,4.0,7.0,2.0,2.0,3.0,6.0,3.0,4.0,8.0,2.0,2.0,2.0,2.0,2.0,0.0,1.0,2.0,2.0,3.0,2.0,2.0,3.0,2.0,3.0,2.0,2.0,2.0,1.0,3.0,2.0,3.0,5.0,4.0,2.0,4.0,2.0,2.0,2.0,2.0,4.0,3.0,0.0,0.0,4.0,3.0,2.0,4.0,4.0,4.0,5.0,3.0,2.0,1.0,0.0,3.0,0.0,2.0,4.0,5.0,2.0,2.0,3.0,2.0,4.0,2.0,3.0,0.0,4.0,3.0,3.0,2.0,0.0,2.0,3.0,2.0,1.0,2.0,2.0,1.0,2.0,3.0,3.0,2.0,2.0,3.0,2.0,2.0,3.0,2.0,3.0,3.0,2.0,3.0,5.0,5.0,3.0,1.0,3.0,0.0,2.0,0.0,1.0,3.0,5.0,2.0,6.0,4.0,2.0,1.0,9.0,4.0,7.0,6.0,3.0,3.0,4.0,6.0,4.0,3.0,5.0,7.0,11.0,6.0,6.0,5.0,4.0,4.0,7.0,5.0,4.0,0.0,0.0,0.0,10.0,0.0,0.0,7.0,5.0,0.0,0.0,0.0,0.0,0.0,0.0,0.0,0.0,0.0,4.0,0.0,6.0,0.0,8.0,1.0,0.0,3.0,0.0,0.0,0.0,0.0,0.0,0.0,0.0,0.0,12.0,0.0,0.0,0.0,0.0,5.0,5.0,5.0,5.0,5.0,4.0,5.0,5.0,5.0,2.0,9.0,8.0,5.0,10.0,7.0,3.0,6.0,7.0,6.0,4.0,8.0,5.0,7.0,6.0,7.0,7.0,6.0,5.0,5.0,8.0,2.0,2.0,8.0,13.0,5.0,7.0,6.0,7.0,4.0,7.0,2.0,5.0,5.0,8.0,7.0,5.0,9.0,4.0,9.0,5.0,9.0,6.0,6.0,8.0,4.0,8.0,4.0,5.0,5.0,10.0,4.0,6.0,12.0,11.0,6.0,3.0,6.0,13.0,8.0,8.0,12.0,4.0,6.0,2.0,8.0,10.0,6.0,8.0,17.0,3.0,13.0,10.0,8.0,6.0,10.0,13.0,10.0,4.0,15.0,7.0,14.0,8.0,1.0,5.0,8.0,11.0,8.0,5.0,6.0,0.0,1.0,9.0,5.0,13.0,7.0,16.0,10.0,9.0,4.0,8.0,15.0,9.0,7.0,11.0,6.0,8.0,2.0,7.0,12.0,5.0,6.0,9.0,7.0,4.0,10.0,13.0,8.0,6.0,15.0,0.0,11.0,3.0,2.0,6.0,10.0,3.0,3.0,5.0,4.0,6.0,15.0,10.0,7.0,8.0,5.0,5.0,0.0,9.0,4.0,7.0,9.0,10.0,6.0,4.0,3.0,3.0,4.0,3.0,8.0,13.0,9.0,9.0,,8.0,7.0,8.0,8.0,5.0,6.0,3.0,8.0,7.0,6.0,8.0,5.0,3.0,5.0,5.0,2.0,3.0,7.0,8.0,7.0,4.0,6.0,6.0,6.0,6.0,2.0,5.0,6.0,4.0,7.0,4.0,4.0,7.0,5.0,6.0,6.0,6.0,5.0,3.0,7.0,6.0,11.0,8.0,8.0,4.0,3.0,7.0,5.0,5.0,6.0,12.0,0.0,0.0,29.0,50.0,3.0,42.0,2.0,12.0,2.0,32.0,19.0,14.0,0.0,28.0,1.0,1.0,17.0,15.0,17.0,17.0,0.0,1.0,9.0,41.0,27.0,17.0,1.0,2.0,39.0,23.0,15.0,17.0,8.0,15.0,14.0,17.0,21.0,14.0,16.0,5.0,17.0,15.0,22.0,8.0,0.0,2.0,1.0,14.0,23.0,25.0,23.0,17.0,20.0,0.0,1.0,2.0,14.0,27.0,1.0,16.0,0.0,10.0,17.0,17.0,6.0,12.0,10.0,26.0,13.0,26.0,31.0,33.0,11.0,7.0,14.0,13.0,33.0,8.0,12.0,14.0,5.0,3.0,14.0,3.0,24.0,5.0,32.0,25.0,11.0,4.0,14.0,24.0,5.0,1.0,17.0,16.0,23.0,18.0,1.0,4.0,33.0,20.0,54.0,5.0,9.0,2.0,2.0,2.0,1.0,20.0,0.0,15.0,0.0,0.0,46.0,24.0,1.0,3.0,2.0,20.0,2.0,19.0,22.0,0.0,0.0,1.0,22.0,1.0,0.0,26.0,14.0,21.0,26.0,11.0,1.0,8.0,0.0,1.0,1.0,4.0,39.0,0.0,0.0,0.0,22.0,5.0,20.0,19.0,31.0,2.0,0.0,0.0,0.0,1.0,14.0,0.0,0.0,23.0,16.0,3.0,4.0,0.0,0.0,38.0,0.0,2.0,9.0,35.0,2.0,5.0,1.0,5.0,0.0,7.0,14.0,24.0,31.0,19.0,9.0,0.0,20.0,5.0,7.0,0.0,7.0,26.0,26.0,4.0,13.0,14.0,2.0,33.0,45.0,30.0,22.0,21.0,12.0,25.0,0.0,0.0,31.0,8.0,9.0,4.0,17.0,10.0,12.0,26.0,0.0,0.0,0.0,22.0,14.0,4.0,14.0,1.0,8.0,17.0,4.0,22.0,1.0,3.0,2.0,18.0,1.0,13.0,18.0,12.0,18.0,48.0,5.0,10.0,13.0,20.0,0.0,3.0,2.0,31.0,27.0,0.0,1.0,2.0,6.0,4.0,0.0,0.0,15.0,15.0,6.0,20.0,16.0,20.0,0.0,21.0,0.0,18.0,5.0,14.0,16.0,21.0,0.0,17.0,0.0,0.0,0.0,28.0,6.0,18.0,11.0,1.0,13.0,23.0,17.0,16.0,8.0,5.0,4.0,10.0,14.0,1.0,0.0,49.0,0.0,0.0,18.0,4.0,29.0,10.0,9.0,12.0,2.0,13.0,18.0,1.0,1.0,1.0,7.0,22.0,17.0,16.0,0.0,29.0,0.0,8.0,30.0,23.0,1.0,0.0,5.0,14.0,34.0,23.0,27.0,17.0,23.0,0.0,0.0,0.0,4.0,25.0,24.0,25.0,27.0,11.0,30.0,15.0,25.0,0.0,0.0,27.0,8.0,11.0,0.0,45.0,10.0,62.0,0.0,1.0,0.0,1.0,0.0,0.0,0.0,27.0,0.0,7.0,1.0,1.0,26.0,21.0,0.0,34.0,23.0,24.0,0.0,25.0,0.0,11.0,24.0,41.0,31.0,31.0,46.0,26.0,54.0,12.0,0.0,32.0,49.0,9.0,35.0,12.0,8.0,3.0,33.0,34.0,0.0,0.0,3.0,2.0,5.0,6.0,0.0,10.0,0.0,2.0,2.0,3.0,0.0,8.0,1.0,0.0,0.0,0.0,2.0,0.0,1.0,1.0,0.0,0.0,3.0,0.0,1.0,0.0,0.0,9.0,0.0,36.0,5.0,0.0,6.0,2.0,1.0,2.0,0.0,6.0,13.0,0.0,0.0,25.0,0.0,3.0,19.0,13.0,0.0,16.0,25.0,23.0,29.0,25.0,11.0,17.0,39.0,29.0,1.0,37.0,21.0,0.0,0.0,26.0,8.0,0.0,21.0,22.0,0.0,16.0,0.0,18.0,4.0,0.0,1.0,28.0,0.0,0.0,3.0,8.0,1.0,17.0,25.0,0.0,2.0,2.0,6.0,1.0,15.0,14.0,0.0,16.0,1.0,10.0,13.0,22.0,9.0,2.0,1.0,10.0,3.0,0.0,5.0,18.0,0.0,4.0,20.0,2.0,25.0,17.0,37.0,17.0,41.0,20.0,19.0,19.0,1.0,2.0,2.0,0.0,34.0,4.0,1.0,0.0,30.0,4.0,16.0,9.0,40.0,4.0,20.0,20.0,3.0,15.0,0.0,7.0,1.0,5.0,0.0,2.0,36.0,30.0,23.0,34.0,2.0,23.0,10.0,27.0,31.0,4.0,0.0,17.0,20.0,1.0,24.0,9.0,14.0,1.0,0.0,28.0,23.0,21.0,3.0,1.0,0.0,5.0,2.0,25.0,11.0,0.0,38.0,15.0,27.0,27.0,2.0,18.0,27.0,1.0,35.0,0.0,0.0,24.0,9.0,9.0,7.0,2.0,0.0,7.0,12.0,22.0,7.0,33.0,50.0,2.0,3.0,6.0,27.0,0.0,0.0,1.0,1.0,1.0,10.0,0.0,9.0,5.0,0.0,0.0,15.0,16.0,39.0,14.0,20.0,5.0,15.0,8.0,10.0,24.0,13.0,0.0,5.0,0.0,9.0,5.0,14.0,0.0,0.0,5.0,18.0,0.0,29.0,2.0,1.0,7.0,5.0,11.0,12.0,12.0,0.0,1.0,14.0,27.0,15.0,1.0,2.0,7.0,34.0,20.0,18.0,2.0,0.0,2.0,21.0,18.0,0.0,2.0,18.0,13.0,6.0,11.0,0.0,0.0,0.0,1.0,1.0,0.0,18.0,11.0,21.0,19.0,2.0,2.0,1.0,0.0,0.0,0.0,0.0,4.0,0.0,0.0,0.0,8.0,0.0,0.0,3.0,1.0,0.0,26.0,16.0,7.0,1.0,20.0,28.0,9.0,13.0,23.0,22.0,25.0,37.0,13.0,0.0,1.0,0.0,0.0,1.0,9.0,25.0,3.0,2.0,0.0,0.0,0.0,31.0,16.0,0.0,0.0,15.0,17.0,0.0,14.0,3.0,20.0,7.0,13.0,0.0,0.0,1.0,10.0,11.0,15.0,27.0,0.0,22.0,29.0,6.0,23.0,20.0,4.0,19.0,27.0,15.0,25.0,21.0,42.0,2.0,34.0,0.0,1.0,0.0,0.0,41.0,0.0,3.0,5.0,3.0,0.0,6.0,4.0,11.0,26.0,2.0,38.0,32.0,58.0,3.0,24.0,33.0,1.0,12.0,20.0,3.0,1.0,6.0,17.0,3.0,2.0,19.0,0.0,0.0,53.0,2.0,4.0,30.0,0.0,2.0,31.0,2.0,1.0,0.0,1.0,17.0,33.0,1.0,2.0,0.0,1.0,0.0,7.0,4.0,2.0,3.0,0.0,9.0,11.0,2.0,0.0,0.0,1.0,1.0,1.0,0.0,0.0,33.0,0.0,0.0,0.0,0.0,0.0,1.0,1.0,7.0,0.0,18.0,0.0,16.0,0.0,0.0,22.0,1.0,7.0,31.0,6.0,21.0,5.0,0.0,1.0,8.0,23.0,8.0,17.0,21.0,0.0,7.0,10.0,17.0,30.0,18.0,13.0,5.0,19.0,6.0,32.0,4.0,1.0,15.0,28.0,3.0,0.0,7.0,16.0,1.0,8.0,7.0,17.0,5.0,7.0,8.0,8.0,17.0,4.0,5.0,0.0,4.0,8.0,11.0,7.0,2.0,5.0,8.0,23.0,15.0,5.0,6.0,4.0,3.0,2.0,2.0,9.0,4.0,0.0,0.0,13.0,0.0,5.0,9.0,13.0,5.0,1.0,3.0,9.0,16.0,0.0,7.0,0.0,11.0,15.0,10.0,12.0,0.0,0.0,14.0,12.0,5.0,6.0,1.0,1.0,0.0,21.0,9.0,15.0,10.0,2.0,7.0,5.0,0.0,6.0,3.0,7.0,12.0,9.0,14.0,2.0,27.0,2.0,20.0,5.0,3.0,9.0,2.0,22.0,4.0,3.0,0.0,7.0,0.0,9.0,5.0,8.0,7.0,20.0,1.0,0.0,8.0,4.0,5.0,12.0,13.0,1.0,27.0,3.0,4.0,41.0,13.0,13.0,38.0,6.0,0.0,0.0,4.0,9.0,31.0,0.0,5.0,2.0,13.0,1.0,10.0,1.0,8.0,2.0,3.0,8.0,5.0,2.0,10.0,6.0,3.0,27.0,7.0,32.0,1.0,8.0,5.0,14.0,8.0,15.0,7.0,5.0,12.0,9.0,23.0,10.0,15.0,6.0,4.0,5.0,12.0,9.0,4.0,12.0,2.0,3.0,11.0,10.0,4.0,15.0,4.0,1.0,8.0,1.0,30.0,15.0,9.0,2.0,9.0,2.0,10.0,2.0,8.0,10.0,4.0,5.0,0.0,8.0,8.0,14.0,6.0,11.0,9.0,27.0,36.0,15.0,8.0,13.0,10.0,8.0,4.0,6.0,8.0,23.0,7.0,3.0,11.0,12.0,7.0,5.0,10.0,9.0,12.0,31.0,12.0,12.0,0.0,0.0,10.0,19.0,15.0,8.0,2.0,10.0,12.0,37.0,7.0,2.0,8.0,1.0,7.0,17.0,13.0,6.0,9.0,34.0,11.0,2.0,49.0,3.0,0.0,2.0,13.0,7.0,4.0,5.0,1.0,8.0,10.0,0.0,13.0,25.0,11.0,1.0,22.0,2.0,9.0,25.0,13.0,0.0,4.0,2.0,19.0,8.0,1.0,4.0,14.0,23.0,11.0,9.0,9.0,29.0,7.0,3.0,6.0,12.0,8.0,14.0,8.0,20.0,0.0,2.0,3.0,2.0,3.0,35.0,4.0,1.0,12.0,5.0,1.0,4.0,9.0,3.0,17.0,10.0,5.0,5.0,9.0,14.0,3.0,2.0,0.0,12.0,16.0,1.0,5.0,11.0,8.0,0.0,8.0,9.0,0.0,4.0,13.0,6.0,14.0,4.0,2.0,5.0,4.0,14.0,8.0,11.0,1.0,0.0,2.0,1.0,9.0,12.0,25.0,38.0,4.0,18.0,1.0,10.0,5.0,7.0,3.0,11.0,11.0,10.0,6.0,3.0,5.0,7.0,9.0,2.0,35.0,4.0,7.0,0.0,12.0,4.0,10.0,20.0,8.0,1.0,7.0,11.0,2.0,12.0,0.0,6.0,6.0,5.0,0.0,11.0,35.0,13.0,23.0,0.0,1.0,1.0,5.0,0.0,9.0,4.0,9.0,8.0,10.0,16.0,6.0,7.0,16.0,9.0,13.0,17.0,7.0,3.0,8.0,7.0,2.0,0.0,2.0,4.0,1.0,2.0,5.0,19.0,18.0,12.0,11.0,5.0,0.0,3.0,2.0,0.0,19.0,8.0,4.0,3.0,7.0,7.0,4.0,2.0,11.0,6.0,42.0,5.0,10.0,9.0,3.0,63.0,11.0,15.0,8.0,9.0,1.0,4.0,2.0,40.0,3.0,4.0,6.0,13.0,9.0,10.0,14.0,7.0,0.0,1.0,2.0,3.0,0.0,3.0,15.0,11.0,5.0,1.0,12.0,1.0,5.0,4.0,7.0,12.0,4.0,13.0,4.0,11.0,4.0,1.0,3.0,4.0,5.0,8.0,15.0,11.0,19.0,22.0,6.0,10.0,3.0,9.0,14.0,13.0,12.0,14.0,9.0,7.0,12.0,17.0,1.0,3.0,5.0,11.0,12.0,1.0,8.0,5.0,10.0,4.0,15.0,18.0,6.0,18.0,16.0,18.0,31.0,11.0,10.0,29.0,0.0,15.0,17.0,19.0,23.0,17.0,25.0,18.0,15.0,7.0,32.0,9.0,16.0,8.0,21.0,20.0,23.0,17.0,12.0,13.0,13.0,4.0,3.0,4.0,0.0,15.0,0.0,0.0,11.0,11.0,0.0,9.0,20.0,0.0,0.0,0.0,3.0,6.0,1.0,5.0,16.0,15.0,12.0,22.0,1.0,12.0,0.0,13.0,1.0,2.0,1.0,1.0,18.0,1.0,5.0,0.0,8.0,10.0,17.0,6.0,1.0,5.0,2.0,5.0,8.0,14.0,12.0,6.0,4.0,8.0,13.0,15.0,20.0,1.0,18.0,0.0,1.0,8.0,2.0,11.0,13.0,16.0,6.0,3.0,19.0,9.0,0.0,9.0,9.0,17.0,26.0,0.0,15.0,23.0,12.0,13.0,13.0,15.0,15.0,9.0,12.0,17.0,27.0,16.0,16.0,5.0,19.0,10.0,3.0,16.0,5.0,4.0,14.0,3.0,1.0,11.0,12.0,17.0,19.0,12.0,11.0,24.0,1.0,6.0,18.0,3.0,20.0,1.0,0.0,8.0,6.0,5.0,20.0,1.0,8.0,12.0,3.0,2.0,11.0,1.0,1.0,18.0,24.0,16.0,12.0,15.0,5.0,2.0,19.0,20.0,22.0,15.0,12.0,16.0,3.0,16.0,13.0,2.0,15.0,4.0,5.0,3.0,19.0,11.0,4.0,2.0,22.0,5.0,21.0,17.0,0.0,35.0,11.0,20.0,15.0,13.0,16.0,9.0,2.0,13.0,19.0,25.0,21.0,23.0,0.0,8.0,0.0,1.0,1.0,3.0,14.0,0.0,10.0,3.0,16.0,3.0,16.0,8.0,19.0,14.0,31.0,8.0,5.0,10.0,5.0,6.0,9.0,13.0,16.0,10.0,14.0,6.0,24.0,1.0,16.0,18.0,0.0,11.0,4.0,8.0,7.0,2.0,25.0,2.0,4.0,1.0,2.0,29.0,26.0,20.0,16.0,11.0,0.0,0.0,0.0,0.0,13.0,8.0,10.0,7.0,11.0,9.0,2.0,8.0,10.0,16.0,3.0,9.0,7.0,8.0,13.0,4.0,3.0,4.0,4.0,13.0,0.0,6.0,10.0,3.0,6.0,1.0,7.0,4.0,12.0,13.0,5.0,2.0,14.0,4.0,15.0,2.0,14.0,11.0,17.0,13.0,4.0,10.0,2.0,14.0,6.0,15.0,3.0,12.0,4.0,7.0,0.0,0.0,0.0,0.0,0.0,0.0,0.0,7.0,8.0,9.0,5.0,6.0,9.0,12.0,7.0,4.0,5.0,6.0,4.0,4.0,5.0,12.0,8.0,6.0,7.0,13.0,5.0,5.0,4.0,4.0,4.0,11.0,9.0,12.0,9.0,6.0,4.0,8.0,6.0,8.0,6.0,3.0,8.0,5.0,4.0,6.0,7.0,7.0,3.0,6.0,7.0,3.0,5.0,7.0,8.0,7.0,9.0,8.0,8.0,5.0,6.0,6.0,5.0,4.0,4.0,5.0,10.0,10.0,6.0,7.0,4.0,4.0,7.0,6.0,4.0,8.0,4.0,6.0,8.0,11.0,10.0,3.0,9.0,2.0,10.0,13.0,3.0,11.0,6.0,7.0,13.0,4.0,8.0,5.0,4.0,8.0,6.0,12.0,9.0,5.0,5.0,3.0,7.0,6.0,5.0,7.0,7.0,5.0,0.0,0.0,1.0,1.0,2.0,2.0,2.0,0.0,1.0,0.0,0.0,0.0,3.0,0.0,0.0,2.0,0.0,0.0,4.0,6.0,9.0,8.0,18.0,16.0,4.0,8.0,8.0,5.0,2.0,6.0,3.0,0.0,14.0,5.0,2.0,17.0,0.0,14.0,9.0,6.0,9.0,0.0,9.0,10.0,2.0,4.0,14.0,8.0,5.0,0.0,6.0,8.0,4.0,0.0,3.0,8.0,7.0,8.0,11.0,7.0,0.0,15.0,16.0,8.0,10.0,10.0,11.0,7.0,6.0,6.0,8.0,18.0,10.0,11.0,7.0,5.0,6.0,5.0,4.0,2.0,11.0,8.0,8.0,9.0,8.0,1.0,4.0,10.0,5.0,7.0,18.0,3.0,6.0,9.0,10.0,1.0,9.0,13.0,6.0,1.0,6.0,0.0,0.0,0.0,5.0,13.0,2.0,3.0,10.0,8.0,9.0,4.0,12.0,3.0,11.0,0.0,0.0,0.0,0.0,0.0,0.0,0.0,0.0,0.0,9.0,8.0,8.0,9.0,7.0,13.0,11.0,8.0,10.0,14.0,6.0,15.0,1.0,11.0,8.0,8.0,9.0,9.0,14.0,2.0,4.0,11.0,9.0,8.0,9.0,6.0,10.0,5.0,3.0,2.0,10.0,5.0,10.0,0.0,3.0,8.0,12.0,0.0,0.0,0.0,0.0,0.0,0.0,0.0,0.0,0.0,0.0,0.0,0.0,0.0,0.0,0.0,0.0,0.0,0.0,0.0,0.0,0.0,20.0,16.0,1.0,2.0,0.0,0.0,0.0,1.0,4.0,0.0,0.0,0.0,0.0,0.0,1.0,0.0,4.0,0.0,0.0,1.0,2.0,0.0,2.0,2.0,0.0,0.0,0.0,0.0,0.0,13.0,11.0,2.0,4.0,9.0,8.0,9.0,7.0,8.0,12.0,15.0,14.0,2.0,12.0,9.0,9.0,4.0,5.0,9.0,4.0,9.0,7.0,7.0,2.0,3.0,7.0,7.0,6.0,7.0,3.0,4.0,6.0,11.0,5.0,3.0,4.0,6.0,10.0,6.0,4.0,6.0,7.0,4.0,6.0,5.0,6.0,7.0,7.0,4.0,3.0,5.0,9.0,6.0,4.0,8.0,6.0,6.0,0.0,12.0,4.0,7.0,5.0,6.0,5.0,6.0,6.0,5.0,2.0,7.0,1.0,4.0,3.0,9.0,6.0,4.0,6.0,8.0,4.0,9.0,10.0,6.0,7.0,2.0,4.0,11.0,12.0,7.0,2.0,11.0,11.0,7.0,5.0,12.0,13.0,7.0,5.0,5.0,4.0,6.0,5.0,17.0,4.0,9.0,4.0,9.0,8.0,10.0,5.0,14.0,7.0,2.0,4.0,8.0,11.0,6.0,1.0,6.0,3.0,7.0,8.0,5.0,4.0,3.0,4.0,12.0,4.0,8.0,5.0,7.0,2.0,5.0,8.0,12.0,11.0,4.0,3.0,5.0,10.0,6.0,5.0,7.0,12.0,2.0,5.0,2.0,6.0,3.0,3.0,6.0,10.0,18.0,7.0,4.5,3.0,5.0,6.0,6.0,3.0,4.0,5.0,5.0,3.0,3.0,5.0,8.0,8.0,4.5,6.0,5.0,1.0,6.0,7.0,6.0,4.0,6.0,9.0,5.0,0.0,0.0,6.0,7.0,5.0,8.0,3.0,6.0,6.0,10.0,0.0,5.0,6.0,6.0,1.0,4.0,6.0,0.0,7.0,2.0,0.0,2.0,4.0,5.0,0.0,8.0,10.0,5.0,13.0,2.0,5.0,2.0,3.0,11.0,7.0,6.0,0.0,6.0,2.0,2.0,1.0,3.0,2.0,2.0,9.0,6.0,11.0,10.0,2.0,4.0,17.0,5.0,22.0,2.0,7.0,11.0,18.0,5.0,3.0,9.0,8.0,5.0,3.0,10.0,15.0,6.0,1.0,11.0,8.0,7.0,0.0,7.0,7.0,7.0,5.0,8.0,6.0,5.0,9.0,10.0,1.0,7.0,1.0,1.0,0.0,13.0,1.0,0.0,3.0,2.0,0.0,3.0,11.0,0.0,8.0,6.0,2.0,3.0,0.0,1.0,1.0,3.0,11.0,3.0,4.0,6.0,4.0,12.0,1.0,2.0,19.0,13.0,1.0,1.0,9.0,1.0,0.0,5.0,16.0,0.0,6.0,12.0,3.0,10.0,27.0,15.0,0.0,17.0,11.0,2.0,2.0,38.0,0.0,14.0,6.0,0.0,9.0,1.0,3.0,5.0,14.0,11.0,21.0,0.0,1.0,2.0,3.0,0.0,24.0,9.0,5.0,7.0,0.0,4.0,8.0,10.0,8.0,2.0,4.0,4.0,0.0,12.0,20.0,5.0,7.0,2.0,6.0,4.0,0.0,5.0,7.0,0.0,2.0,12.0,12.0,7.0,12.0,6.0,9.0,16.0,9.0,12.0,8.0,7.0,2.0,19.0,4.0,38.0,1.0,0.0,3.0,2.0,2.0,4.0,3.0,3.0,3.0,1.0,7.0,10.0,6.0,5.0,2.0,3.0,0.0,3.0,12.0,4.0,4.0,6.0,7.0,14.0,10.0,6.0,12.0,16.0,1.0,0.0,4.0,14.0,8.0,3.0,9.0,6.0,0.0,8.0,6.0,1.0,14.0,0.0,6.0,33.0,25.0,10.0,21.0,5.0,2.0,0.0,13.0,9.0,6.0,6.0,0.0,3.0,5.0,3.0,1.0,0.0,7.0,5.0,4.0,5.0,9.0,1.0,2.0,12.0,8.0,1.0,4.0,1.0,5.0,2.0,3.0,3.0,2.0,14.0,5.0,6.0,0.0,12.0,9.0,5.0,4.0,0.0,3.0,0.0,4.0,8.0,6.0,2.0,1.0,3.0,8.0,5.0,6.0,4.0,10.0,16.0,2.0,4.0,4.0,7.0,4.0,7.0,9.0,4.0,8.0,16.0,6.0,10.0,3.0,0.0,2.0,2.0,0.0,15.0,21.0,32.0,14.0,12.0,6.0,0.0,12.0,2.0,11.0,18.0,4.0,6.0,6.0,13.0,14.0,1.0,4.0,2.0,3.0,4.0,1.0,36.0,3.0,1.0,3.0,11.0,2.0,5.0,14.0,0.0,14.0,0.0,3.0,3.0,7.0,16.0,6.0,5.0,14.0,11.0,12.0,10.0,7.0,5.0,5.0,21.0,7.0,0.0,0.0,10.0,9.0,0.0,5.0,5.0,10.0,0.0,8.0,7.0,17.0,6.0,5.0,11.0,3.0,1.0,0.0,31.0,8.0,5.0,0.0,2.0,1.0,0.0,1.0,3.0,33.0,15.0,17.0,14.0,37.0,5.0,11.0,6.0,25.0,6.0,3.0,15.0,8.0,9.0,16.0,0.0,0.0,9.0,22.0,2.0,3.0,1.0,0.0,1.0,10.0,3.0,1.0,4.0,0.0,6.0,1.0,0.0,6.0,16.0,3.0,7.0,16.0,6.0,3.0,3.0,1.0,4.0,5.0,1.0,11.0,4.0,8.0,2.0,6.0,5.0,8.0,7.0,0.0,0.0,0.0,7.0,3.0,3.0,9.0,1.0,9.0,3.0,6.0,1.0,0.0,7.0,6.0,18.0,45.0,5.0,1.0,5.0,0.0,6.0,0.0,6.0,0.0,4.0,9.0,6.0,1.0,8.0,6.0,1.0,0.0,2.0,4.0,3.0,3.0,25.0,8.0,25.0,10.0,10.0,1.0,18.0,8.0,5.0,4.0,27.0,3.0,13.0,20.0,15.0,2.0,0.0,5.0,13.0,10.0,2.0,6.0,12.0,6.0,2.0,11.0,7.0,1.0,2.0,15.0,15.0,9.0,8.0,7.0,6.0,10.0,12.0,5.0,1.0,7.0,11.0,0.0,3.0,3.0,0.0,29.0,16.0,0.0,13.0,8.0,0.0,5.0,1.0,3.0,2.0,9.0,5.0,3.0,5.0,1.0,9.0,9.0,15.0,0.0,4.0,12.0,10.0,6.0,6.0,1.0,10.0,8.0,2.0,2.0,18.0,3.0,4.0,2.0,22.0,4.0,18.0,0.0,19.0,19.0,9.0,5.0,1.0,7.0,2.0,6.0,7.0,0.0,0.0,0.0,26.0,5.0,0.0,5.0,7.0,3.0,2.0,4.0,12.0,10.0,6.0,3.0,9.0,11.0,7.0,1.0,5.0,18.0,13.0,10.0,8.0,10.0,3.0,0.0,24.0,21.0,2.0,4.0,9.0,15.0,7.0,22.0,10.0,1.0,11.0,12.0,9.0,19.0,6.0,5.0,3.0,1.0,0.0,3.0,,4.0,3.0,0.0,0.0,0.0,0.0,,2.0,1.0,0.0,4.25,9.0,1.0,7.0,0.0,0.0,2.0,2.0,1.0,1.0,3.0,1.0,,,2.0,4.0,6.0,2.0,,2.0,,0.0,2.0,,,3.0,,1.0,4.0,,,3.0,4.0,5.0,50.0,50.0,30.0,30.0,40.0,1.0,2.0,9.0,4.0,10.0,0.0,3.0,15.0,10.0,23.0,7.0,15.0,10.0,0.0,4.0,20.0,15.0,21.0,8.0,18.0,19.0,10.0,1.0,5.0,12.0,9.0,9.0,2.0,2.0,12.0,10.0,3.0,8.0,36.0,20.0,7.0,7.0,6.0,4.0,1.0,2.0,9.0,9.0,36.0,3.0,13.0,16.0,1.0,9.0,0.0,1.0,0.0,7.0,17.0,23.0,17.0,17.0,15.0,2.0,4.0,0.0,17.0,1.0,13.0,27.0,11.0,2.0,13.0,8.0,0.0,0.0,0.0,0.0,0.0,27.0,10.0,0.0,7.0,0.0,1.0,0.0,8.0,0.0,1.0,6.0,5.0,5.0,7.0,7.0,9.0,13.0,0.0,2.0,0.0,0.0,24.0,1.0,15.0,1.0,1.0,0.0,9.0,14.0,24.0,11.0,4.0,5.0,27.0,17.0,13.0,9.0,9.0,13.0,24.0,10.0,0.0,23.0,8.0,8.0,1.0,9.0,5.0,12.0,6.0,3.0,28.0,12.0,22.0,27.0,11.0,4.0,0.0,7.0,21.0,21.0,14.0,0.0,7.0,18.0,6.0,12.0,12.0,0.0,12.0,21.0,12.0,0.0,0.0,19.0,9.0,9.0,30.0,19.0,6.0,0.0,4.0,2.0,5.0,1.0,25.0,0.0,2.0,6.0,2.0,16.0,5.0,1.0,5.0,4.0,30.0,4.0,9.0,23.0,19.0,0.0,0.0,8.0,20.0,36.0,24.0,0.0,0.0,0.0,0.0,24.0,14.0,9.0,5.0,13.0,23.0,27.0,10.0,0.0,9.0,5.0,0.0,0.0,8.0,0.0,4.0,32.0,16.0,10.0,17.0,13.0,6.0,21.0,13.0,5.0,2.0,2.0,18.0,11.0,28.0,13.0,10.0,13.0,7.0,8.0,9.0,7.0,10.0,3.0,1.0,14.0,4.0,7.0,10.0,8.0,14.0,7.0,19.0,11.0,0.0,0.0,0.0,12.0,2.0,6.0,9.0,8.0,8.0,9.0,11.0,7.0,5.0,13.0,10.0,2.0,2.0,0.0,11.0,20.0,5.0,4.0,19.0,15.0,6.0,6.0,12.0,0.0,1.0,0.0,5.0,6.0,0.0,0.0,7.0,6.0,12.0,5.0,11.0,0.0,5.0,10.0,12.0,0.0,9.0,2.0,9.0,2.0,7.0,5.0,14.0,12.0,8.0,2.0,1.0,1.0,0.0,13.0,10.0,3.0,11.0,8.0,29.0,16.0,11.0,6.0,4.0,0.0,20.0,8.0,0.0,5.0,2.0,7.0,1.0,3.0,6.0,0.0,15.0,15.0,11.0,2.0,6.0,15.0,9.0,13.0,6.0,0.0,11.0,16.0,6.0,1.0,7.0,10.0,10.0,1.0,7.0,2.0,15.0,14.0,12.0,15.0,0.0,5.0,2.0,8.0,7.0,13.0,8.0,0.0,5.0,8.0,13.0,9.0,2.0,12.0,12.0,23.0,7.0,11.0,9.0,7.0,11.0,22.0,9.0,13.0,7.0,1.0,10.0,8.0,0.0,10.0,4.0,22.0,2.0,5.0,18.0,5.0,7.0,9.0,3.0,16.0,6.0,20.0,19.0,20.0,1.0,2.0,11.0,6.0,1.0,11.0,13.0,11.0,10.0,2.0,2.0,10.0,3.0,24.0,3.0,6.0,0.0,2.0,11.0,0.0,11.0,8.0,6.0,6.0,15.0,10.0,2.0,17.0,23.0,4.0,0.0,25.0,2.0,18.0,12.0,7.0,3.0,2.0,7.0,0.0,14.0,11.0,27.0,7.0,9.0,15.0,8.0,1.0,0.0,12.0,2.0,8.0,10.0,17.0,11.0,7.0,0.0,1.0,0.0,5.0,15.0,8.0,12.0,13.0,10.0,5.0,8.0,6.0,8.0,2.0,4.0,17.0,10.0,7.0,6.0,2.0,0.0,5.0,11.0,9.0,5.0,12.0,1.0,2.0,8.0,9.0,13.0,11.0,13.0,16.0,20.0,14.0,4.0,12.0,3.0,17.0,4.0,6.0,5.0,3.0,5.0,2.0,0.0,7.0,14.0,2.0,7.0,0.0,1.0,0.0,4.0,0.0,0.0,0.0,3.0,9.0,4.0,0.0,0.0,0.0,5.0,6.0,4.0,1.0,2.0,0.0,8.0,0.0,0.0,0.0,0.0,0.0,5.0,2.0,5.0,5.0,10.0,2.0,1.0,0.0,11.0,2.0,4.0,0.0,0.0,3.0,7.0,10.0,0.0,15.0,0.0,1.0,6.0,2.0,0.0,3.0,4.0,0.0,0.0,16.0,5.0,1.0,9.0,1.0,0.0,1.0,2.0,1.0,0.0,0.0,0.0,4.0,1.0,0.0,1.0,1.0,0.0,4.0,13.0,1.0,7.0,0.0,1.0,2.0,0.0,0.0,0.0,0.0,0.0,0.0,0.0,0.0,0.0,2.0,13.0,0.0,0.0,11.0,0.0,1.0,3.0,3.0,5.0,1.0,0.0,0.0,0.0,19.0,0.0,0.0,29.0,0.0,3.0,22.0,2.0,1.0,2.0,0.0,1.0,0.0,0.0,1.0,0.0,0.0,2.0,0.0,0.0,4.0,1.0,1.0,0.0,11.0,5.0,0.0,0.0,9.0,15.0,3.0,0.0,1.0,1.0,1.0,2.0,1.0,0.0,0.0,5.0,0.0,2.0,24.0,12.0,11.0,3.0,1.0,0.0,1.0,1.0,11.0,6.0,1.0,0.0,0.0,11.0,17.0,0.0,1.0,1.0,0.0,0.0,0.0,0.0,1.0,1.0,1.0,6.0,4.0,0.0,1.0,0.0,0.0,0.0,0.0,0.0,0.0,0.0,0.0,0.0,0.0,3.0,0.0,0.0,0.0,0.0,1.0,0.0,4.0,0.0,1.0,1.0,0.0,1.0,2.0,1.0,1.0,0.0,4.0,5.0,4.0,0.0,2.0,2.0,0.0,10.0,3.0,3.0,0.0,2.0,3.0,2.0,0.0,4.0,0.0,0.0,0.0,5.0,12.0,11.0,1.0,1.0,1.0,0.0,0.0,1.0,0.0,0.0,0.0,20.0,1.0,0.0,1.0,1.0,2.0,2.0,0.0,0.0,1.0,0.0,6.0,0.0,3.0,0.0,0.0,0.0,1.0,4.0,3.0,0.0,0.0,0.0,0.0,7.0,0.0,0.0,1.0,2.0,1.0,0.0,3.0,7.0,3.0,1.0,0.0,0.0,2.0,2.0,2.0,1.0,0.0,0.0,0.0,0.0,12.0,0.0,2.0,1.0,1.0,1.0,5.0,4.0,5.0,0.0,0.0,1.0,0.0,0.0,0.0,1.0,1.0,1.0,0.0,14.0,7.0,0.0,0.0,0.0,2.0,0.0,5.0,1.0,15.0,0.0,4.0,6.0,1.0,2.0,1.0,0.0,6.0,7.0,2.0,4.0,1.0,0.0,15.0,0.0,0.0,0.0,7.0,2.0,0.0,0.0,0.0,1.0,0.0,10.0,7.0,3.0,1.0,1.0,1.0,0.0,9.0,2.0,1.0,7.0,3.0,0.0,3.0,8.0,11.0,1.0,14.0,1.0,0.0,0.0,5.0,0.0,4.0,2.0,2.0,3.0,4.0,18.0,1.0,2.0,1.0,3.0,8.0,2.0,1.0,2.0,3.0,6.0,3.0,2.0,0.0,0.0,0.0,0.0,6.0,0.0,0.0,0.0,0.0,1.0,19.0,1.0,3.0,0.0,1.0,6.0,0.0,2.0,2.0,1.0,2.0,0.0,14.0,0.0,9.0,5.0,7.0,3.0,3.0,7.0,10.0,9.0,7.0,11.0,10.0,11.0,10.0,6.0,10.0,0.0,0.0,0.0,0.0,0.0,0.0,0.0,0.0,0.0,0.0,0.0,3.0,0.0,15.0,1.0,14.0,3.0,7.0,2.0,1.0,11.0,13.0,2.0,6.0,9.0,1.0,9.0,3.0,4.0,15.0,0.0,7.0,4.0,7.0,5.0,5.0,0.0,11.0,1.0,10.0,3.0,2.0,3.0,2.0,3.0,5.0,0.0,20.0,1.0,0.0,8.0,13.0,6.0,1.0,5.0,14.0,0.0,2.0,17.0,3.0,12.0,5.0,2.0,3.0,16.0,0.0,7.0,16.0,0.0,17.0,6.0,0.0,6.0,0.0,19.0,2.0,1.0,2.0,16.0,1.0,6.0,7.0,17.0,10.0,1.0,1.0,8.0,1.0,16.0,7.0,2.0,3.0,4.0,4.0,3.0,5.0,7.0,0.0,1.0,6.0,6.0,0.0,0.0,22.0,15.0,20.0,3.0,7.0,17.0,0.0,1.0,2.0,3.0,5.0,2.0,1.0,6.0,1.0,1.0,0.0,2.0,13.0,7.0,3.0,12.0,0.0,1.0,0.0,16.0,1.0,1.0,3.0,9.0,4.0,0.0,2.0,1.0,0.0,2.0,0.0,4.0,5.0,0.0,3.0,3.0,4.0,6.0,6.0,2.0,14.0,4.0,21.0,2.0,2.0,6.0,5.0,0.0,3.0,6.0,2.0,0.0,0.0,5.0,14.0,6.0,10.0,6.0,2.0,6.0,6.0,10.0,0.0,1.0,2.0,7.0,6.0,6.0,3.0,3.0,0.0,11.0,0.0,12.0,0.0,0.0,21.0,5.0,3.0,3.0,5.0,20.0,17.0,0.0,9.0,5.0,4.0,2.0,12.0,5.0,7.0,0.0,0.0,0.0,16.0,1.0,11.0,1.0,1.0,17.0,0.0,3.0,14.0,15.0,5.0,18.0,20.0,8.0,4.0,4.0,8.0,1.0,0.0,0.0,0.0,1.0,0.0,2.0,1.0,10.0,4.0,14.0,11.0,3.0,0.0,3.0,15.0,7.0,2.0,8.0,6.0,13.0,12.0,3.0,3.0,3.0,10.0,1.0,14.0,0.0,9.0,0.0,0.0,4.0,2.0,12.0,0.0,1.0,7.0,12.0,20.0,12.0,1.0,17.0,6.0,8.0,3.0,4.0,5.0,8.0,9.0,6.0,10.0,1.0,1.0,0.0,2.0,3.0,1.0,0.0,11.0,5.0,1.0,4.0,4.0,4.0,1.0,0.0,3.0,3.0,11.0,0.0,3.0,3.0,12.0,16.0,4.0,1.0,4.0,1.0,1.0,0.0,0.0,1.0,3.0,0.0,2.0,5.0,1.0,0.0,3.0,15.0,2.0,13.0,7.0,1.0,3.0,14.0,16.0,17.0,1.0,0.0,3.0,6.0,3.0,0.0,0.0,1.0,0.0,3.0,0.0,3.0,3.0,25.0,0.0,2.0,6.0,14.0,7.0,0.0,2.0,2.0,12.0,8.0,7.0,0.0,2.0,2.0,4.0,0.0,2.0,19.0,5.0,2.0,3.0,9.0,5.0,1.0,0.0,0.0,6.0,3.0,9.0,2.0,3.0,11.0,0.0,0.0,1.0,23.0,2.0,19.0,18.0,4.0,3.0,1.0,0.0,14.0,4.0,16.0,2.0,1.0,9.0,2.0,4.0,9.0,6.0,6.0,13.0,4.0,6.0,8.0,6.0,5.0,6.0,5.0,3.0,12.0,8.0,6.0,6.0,6.0,5.0,9.0,5.0,2.0,11.0,6.0,5.0,7.0,6.0,5.0,8.0,4.0,4.0,13.0,9.0,6.0,9.0,6.0,8.0,15.0,10.0,10.0,7.0,4.0,6.0,5.0,4.0,5.0,5.0,5.0,0.0,5.0,0.0,5.0,1.0,5.0,4.0,5.0,3.0,2.0,5.0,0.0,5.0,0.0,1.0,2.0,5.0,5.0,5.0,3.0,5.0,5.0,0.0,5.0,1.0,0.0,0.0,1.0,1.0,5.0,1.0,5.0,5.0,5.0,0.0,5.0,2.0,5.0,5.0,5.0,1.0,0.0,4.0,5.0,3.0,5.0,0.0,3.0,1.0,0.0,0.0,0.0,1.0,0.0,0.0,3.0,0.0,5.0,0.0,0.0,2.0,5.0,0.0,0.0,1.0,0.0,1.0,0.0,0.0,1.0,0.0,0.0,5.0,1.0,4.0,1.0,0.0,3.0,0.0,1.0,3.0,1.0,0.0,1.0,2.0,0.0,2.0,1.0,0.0,8.0,3.0,3.0,0.0,12.0,0.0,0.0,3.0,14.0,0.0,0.0,0.0,0.0,0.0,11.0,7.0,10.0,0.0,0.0,0.0,2.0,0.0,0.0,12.0,15.0,13.0,0.0,0.0,0.0,0.0,4.0,4.0,6.0,4.0,4.0,2.0,0.0,0.0,2.0,4.0,0.0,0.0,0.0,3.0,0.0,0.0,0.0,0.0,2.0,0.0,0.0,0.0,0.0,0.0,5.0,0.0,0.0,0.0,0.0,3.0,0.0,2.0,3.0,9.0,2.0,0.0,3.0,4.0,0.0,4.0,0.0,0.0,0.0,0.0,0.0,6.0,3.0,5.0,0.0,0.0,0.0,0.0,0.0,0.0,6.0,0.0,6.0,4.0,0.0,0.0,4.0,12.0,0.0,12.0,0.0,0.0,6.0,0.0,7.0,12.0,13.0,9.0,6.0,13.0,9.0,11.0,13.0,9.0,6.0,13.0,13.0,5.0,0.0,10.0,10.0,10.0,12.0,3.0,13.0,10.0,9.0,8.0,8.0,8.0,11.0,5.0,11.0,12.0,16.0,7.0,14.0,3.0,1.0,5.0,5.0,5.0,5.0,5.0,5.0,4.0,5.0,5.0,4.0,0.0,0.0,0.0,0.0,0.0,0.0,0.0,0.0,0.0,0.0,0.0,0.0,0.0,0.0,10.0,3.0,10.0,5.0,19.0,1.0,0.0,0.0,0.0,3.0,7.0,2.0,4.0,2.0,2.0,4.0,0.0,8.0,1.0,0.0,6.0,6.0,8.0,11.0,19.0,10.0,0.0,7.0,3.0,4.0,2.0,1.0,4.0,4.0,11.0,9.0,4.0,8.0,6.0,1.0,13.0,6.0,11.0,8.0,11.0,6.0,4.0,1.0,8.0,3.0,16.0,3.0,1.0,3.0,7.0,0.0,15.0,3.0,10.0,6.0,7.0,7.0,4.0,0.0,7.0,4.0,11.0,6.0,6.0,4.0,2.0,1.0,3.0,0.0,18.0,10.0,4.0,1.0,11.0,9.0,19.0,9.0,1.0,10.0,2.0,4.0,12.0,2.0,13.0,10.0,4.0,7.0,7.0,6.0,0.0,4.0,4.0,5.0,0.0,4.0,0.0,7.0,1.0,0.0,0.0,4.0,2.0,1.0,0.0,0.0,3.0,2.0,0.0,1.0,2.0,0.0,0.0,8.0,0.0,0.0,5.0,5.0,4.0,4.0,5.0,0.0,0.0,4.0,5.0,4.0,5.0,3.0,5.0,4.0,4.0,5.0,4.0,3.0,5.0,2.0,1.0,3.0,4.0,1.0,4.0,4.0,1.0,4.0,5.0,1.0,0.0,10.0,5.0,7.0,8.0,8.0,17.0,14.0,7.0,5.0,2.0,1.0,1.0,0.0,0.0,0.0,0.0,3.0,1.0,4.0,2.0,0.0,2.0,3.0,4.0,1.0,4.0,4.0,2.0,5.0,7.0,3.0,2.0,0.0,1.0,0.0,0.0,0.0,2.0,0.0,1.0,2.0,2.0,3.0,1.0,1.0,2.0,5.0,2.0,4.0,0.0,1.0,4.0,5.0,0.0,0.0,1.0,4.0,0.0,1.0,7.0,0.0,6.0,5.0,6.0,1.0,2.0,8.0,4.0,0.0,1.0,0.0,6.0,1.0,2.0,3.0,5.0,5.0,2.0,10.0,9.0,3.0,0.0,1.0,5.0,0.0,2.0,0.0,0.0,4.0,1.0,2.0,1.0,5.0,5.0,0.0,0.0,7.0,3.0,5.0,10.0,6.0,2.0,3.0,6.0,5.0,3.0,11.0,3.0,3.0,7.0,7.0,5.0,10.0,6.0,5.0,5.0,8.0,5.0,4.0,5.0,11.0,8.0,7.0,3.0,5.0,6.0,0.0,6.0,3.0,7.0,10.0,3.0,13.0,6.0,8.0,0.0,8.0,4.0,9.0,7.0,6.0,4.0,0.0,6.0,9.0,3.0,0.0,9.0,9.0,5.0,4.0,4.0,6.0,3.0,3.0,2.0,5.0,7.0,6.0,1.0,0.0,0.0,3.0,2.0,1.0,3.0,7.0,0.0,7.0,3.0,2.0,0.0,1.0,4.0,3.0,3.0,0.0,5.0,1.0,9.0,4.0,5.0,2.0,0.0,10.0,0.0,1.0,5.0,1.0,2.0,5.0,2.0,2.0,4.0,2.0,1.0,4.0,4.0,3.0,4.0,6.0,0.0,8.0,1.0,2.0,0.0,14.0,7.0,5.0,3.0,5.0,1.0,2.0,3.0,4.0,3.0,1.0,0.0,2.0,2.0,0.0,4.0,4.0,1.0,3.0,0.0,10.0,2.0,5.0,5.0,9.0,1.0,1.0,0.0,1.0,1.0,2.0,2.0,0.0,1.0,2.0,0.0,2.0,1.0,5.0,1.0,3.0,4.0,4.0,1.0,3.0,2.0,4.0,5.0,2.0,3.0,2.0,6.0,2.0,6.0,9.0,6.0,6.0,8.0,4.0,3.0,5.0,4.0,7.0,7.0,5.0,2.0,5.0,6.0,6.0,4.0,6.0,5.0,3.0,3.0,5.0,2.0,4.0,4.0,4.0,2.0,5.0,3.0,4.0,6.0,1.0,2.0,0.0,5.0,2.0,3.0,3.0,3.0,5.0,3.0,3.0,3.0,2.0,5.0,6.0,3.0,3.0,4.0,0.0,6.0,4.0,3.0,2.0,10.0,2.0,8.0,3.0,7.0,4.0,4.0,3.0,4.0,4.0,4.0,4.0,8.0,4.0,5.0,7.0,4.0,4.0,4.0,7.0,6.0,5.0,2.0,7.0,3.0,10.0,5.0,3.0,3.0,8.0,3.0,4.0,4.0,6.0,3.0,4.0,10.0,7.0,6.0,4.0,6.0,10.0,5.0,5.0,7.0,5.0,3.0,7.0,10.0,7.0,0.0,9.0,2.0,3.0,3.0,3.0,5.0,7.0,7.0,3.0,3.0,6.0,6.0,9.0,4.0,6.0,4.0,3.0,0.0,4.0,6.0,5.0,9.0,6.0,2.0,10.0,9.0,3.0,6.0,6.0,9.0,7.0,7.0,8.0,7.0,0.0,5.0,5.0,8.0,4.0,5.0,4.0,5.0,7.0,2.0,9.0,4.0,5.0,8.0,6.0,4.0,5.0,2.0,6.0,15.0,8.0,10.0,4.0,3.0,8.0,5.0,11.0,6.0,8.0,15.0,10.0,6.0,7.0,4.0,8.0,4.0,7.0,9.0,2.0,6.0,8.0,14.0,9.0,21.0,12.0,14.0,9.0,16.0,7.0,10.0,8.0,10.0,20.0,19.0,5.0,12.0,4.0,17.0,1.0,20.0,11.0,23.0,14.0,3.0,3.0,0.0,8.0,19.0,10.0,1.0,3.0,12.0,2.0,2.0,16.0,4.0,16.0,8.0,12.0,8.0,17.0,1.0,4.0,2.0,3.0,11.0,6.0,1.0,13.0,3.0,1.0,7.0,0.0,13.0,2.0,0.0,0.0,1.0,12.0,8.0,3.0,11.0,11.0,3.0,6.0,16.0,3.0,2.0,3.0,9.0,9.0,5.0,7.0,17.0,5.0,12.0,9.0,2.0,13.0,9.0,9.0,9.0,14.0,24.0,20.0,13.0,2.0,12.0,1.0,4.0,9.0,16.0,15.0,15.0,12.0,11.0,4.0,6.0,8.0,25.0,21.0,8.0,9.0,6.0,7.0,2.0,8.0,8.0,2.0,4.0,9.0,8.0,5.0,14.0,17.0,11.0,10.0,32.0,5.0,1.0,8.0,0.0,3.0,3.0,14.0,18.0,5.0,3.0,0.0,4.0,9.0,6.0,4.0,2.0,5.0,2.0,6.0,5.0,3.0,7.0,4.0,0.0,0.0,8.0,11.0,3.0,8.0,6.0,1.0,1.0,1.0,7.0,1.0,3.0,0.0,0.0,3.0,2.0,1.0,3.0,2.0,4.0,0.0,4.0,4.0,0.0,0.0,5.0,2.0,0.0,0.0,0.0,1.0,0.0,7.0,4.0,3.0,3.0,0.0,4.0,0.0,0.0,0.0,3.0,1.0,3.0,0.0,1.0,0.0,0.0,0.0,1.0,0.0,2.0,0.0,0.0,1.0,35.0,0.0,10.0,3.0,3.0,2.0,2.0,0.0,1.0,0.0,1.0,1.0,1.0,0.0,0.0,1.0,0.0,0.0,0.0,1.0,0.0,1.0,1.0,13.0,1.0,0.0,1.0,1.0,1.0,0.0,0.0,3.0,0.0,3.0,0.0,12.0,0.0,0.0,3.0,0.0,0.0,0.0,7.0,0.0,0.0,0.0,0.0,1.0,0.0,0.0,1.0,5.0,5.0,5.0,5.0,5.0,5.0,1.0,5.0,5.0,0.0,0.0,1.0,0.0,1.0,0.0,1.0,2.0,0.0,1.0,0.0,3.0,0.0,1.0,0.0,0.0,3.0,13.0,2.0,8.0,6.0,36.0,9.0,23.0,7.0,12.0,7.0,11.0,13.0,7.0,4.0,9.0,4.0,1.0,14.0,0.0,10.0,15.0,9.0,9.0,6.0,7.0,16.0,6.0,8.0,4.0,5.0,4.0,1.0,4.0,5.0,8.0,9.0,3.0,10.0,10.0,5.0,16.0,1.0,15.0,2.0,5.0,5.0,4.0,5.0,5.0,5.0,4.0,5.0,2.0,2.0,4.0,5.0,5.0,5.0,5.0,5.0,5.0,3.0,5.0,3.0,5.0,2.0,3.0,5.0,1.0,4.0,5.0,5.0,5.0,5.0,5.0,0.0,4.0,2.0,5.0,5.0,2.0,1.0,4.0,0.0,4.0,1.0,5.0,3.0,3.0,0.0,2.0,5.0,5.0,3.0,5.0,5.0,3.0,1.0,5.0,5.0,5.0,5.0,5.0,4.0,5.0,5.0,0.0,5.0,1.0,0.0,3.0,2.0,5.0,5.0,3.0,3.0,3.0,5.0,2.0,2.0,5.0,3.0,5.0,0.0,1.0,5.0,5.0,5.0,0.0,5.0,3.0,3.0,5.0,1.0,5.0,5.0,2.0,5.0,5.0,5.0,5.0,5.0,5.0,2.0,5.0,3.0,2.0,0.0,5.0,0.0,5.0,5.0,1.0,2.0,5.0,1.0,5.0,5.0,1.0,5.0,2.0,9.0,18.0,10.0,7.0,16.0,10.0,7.0,1.0,11.0,5.0,16.0,17.0,15.0,18.0,9.0,1.0,3.0,5.0,4.0,0.0,5.0,5.0,5.0,3.0,0.0,5.0,5.0,5.0,4.0,3.0,5.0,3.0,4.0,5.0,5.0,5.0,2.0,5.0,5.0,2.0,5.0,1.0,5.0,4.0,5.0,5.0,1.0,0.0,1.0,1.0,5.0,3.0,5.0,5.0,5.0,0.0,5.0,5.0,5.0,4.0,5.0,5.0,1.0,5.0,1.0,1.0,0.0,3.0,0.0,5.0,5.0,5.0,5.0,5.0,5.0,1.0,3.0,5.0,0.0,5.0,5.0,2.0,0.0,0.0,5.0,3.0,3.0,5.0,5.0,5.0,5.0,5.0,5.0,5.0,5.0,5.0,5.0,5.0,5.0,1.0,4.0,5.0,5.0,5.0,5.0,5.0,5.0,5.0,5.0,5.0,2.0,5.0,5.0,5.0,5.0,5.0,5.0,1.0,5.0,4.0,5.0,2.0,5.0,4.0,5.0,5.0,10.0,12.0,6.0,7.0,9.0,2.0,9.0,6.0,3.0,4.0,9.0,9.0,0.0,2.0,11.0,7.0,2.0,10.0,11.0,13.0,15.0,9.0,5.0,13.0,3.0,9.0,6.0,5.0,2.0,4.0,6.0,6.0,9.0,14.0,2.0,2.0,3.0,9.0,6.0,0.0,6.0,8.0,7.0,8.0,9.0,5.0,4.0,8.0,8.0,1.0,9.0,1.0,2.0,10.0,7.0,0.0,2.0,3.0,4.0,5.0,10.0,1.0,4.0,6.0,7.0,5.0,1.0,8.0,7.0,7.0,0.0,0.0,7.0,2.0,7.0,7.0,4.0,3.0,7.0,11.0,7.0,6.0,8.0,1.0,2.0,4.0,6.0,7.0,7.0,11.0,5.0,8.0,3.0,6.0,4.0,12.0,12.0,6.0,10.0,11.0,12.0,6.0,3.0,1.0,5.0,8.0,6.0,4.0,6.0,6.0,14.0,0.0,5.0,1.0,5.0,14.0,6.0,9.0,11.0,1.0,4.0,11.0,6.0,6.0,7.0,3.0,14.0,10.0,9.0,6.0,6.0,12.0,7.0,9.0,13.0,10.0,2.0,7.0,9.0,6.0,9.0,6.0,6.0,7.0,11.0,6.0,9.0,9.0,11.0,7.0,10.0,0.0,3.0,6.0,15.0,11.0,1.0,9.0,4.0,4.0,5.0,3.0,10.0,6.0,5.0,5.0,3.0,3.0,9.0,1.0,4.0,4.0,12.0,4.0,11.0,5.0,1.0,11.0,9.0,7.0,9.0,8.0,4.0,8.0,7.0,6.0,4.0,6.0,6.0,6.0,11.0,5.0,8.0,9.0,11.0,8.0,8.0,2.0,8.0,8.0,7.0,4.0,4.0,7.0,4.0,0.0,0.0,0.0,0.0,0.0,13.0,17.0,8.0,2.0,4.0,6.0,10.0,36.0,24.0,13.0,3.0,6.0,11.0,20.0,10.0,0.0,8.0,14.0,1.0,5.0,2.0,5.0,0.0,1.0,0.0,4.0,0.0,2.0,3.0,11.0,9.0,9.0,3.0,4.0,7.0,2.0,4.0,3.0,1.0,0.0,2.0,4.0,0.0,6.0,9.0,2.0,12.0,7.0,7.0,0.0,1.0,3.0,0.0,7.0,7.0,10.0,14.0,5.0,12.0,19.0,8.0,4.0,0.0,1.0,0.0,6.0,3.0,9.0,10.0,12.0,8.0,2.0,1.0,4.0,1.0,5.0,15.0,10.0,9.0,7.0,8.0,0.0,10.0,5.0,3.0,3.0,9.0,6.0,2.0,1.0,1.0,5.0,3.0,7.0,12.0,3.0,9.0,4.0,9.0,9.0,10.0,10.0,13.0,4.0,0.0,15.0,2.0,13.0,7.0,4.0,8.0,4.0,0.0,0.0,6.0,8.0,6.0,7.0,7.0,2.0,6.0,0.0,0.0,8.0,2.0,9.0,0.0,1.0,0.0,1.0,8.0,,13.0,6.0,10.0,9.0,11.0,9.0,13.0,8.0,7.0,17.0,4.0,19.0,5.0,12.0,15.0,12.0,10.0,6.0,11.0,1.0,1.0,4.0,4.0,15.0,5.0,3.0,2.0,1.0,1.0,8.0,8.0,1.0,0.0,3.0,6.0,4.0,0.0,7.0,15.0,0.0,4.0,3.0,3.0,6.0,9.0,4.0,7.0,12.0,9.0,7.0,11.0,12.0,7.0,7.0,4.0,6.0,2.0,4.0,6.0,9.0,4.0,4.0,10.0,7.0,0.0,1.0,16.0,10.0,13.0,3.0,6.0,1.0,17.0,18.0,9.0,5.0,5.0,19.0,7.0,5.0,2.0,1.0,15.0,9.0,10.0,6.0,5.0,12.0,12.0,5.0,0.0,9.0,4.0,2.0,5.0,7.0,5.0,5.0,3.0,8.0,5.0,0.0,7.0,5.0,3.0,0.0,6.0,5.0,0.0,0.0,3.0,8.0,2.0,4.0,5.0,11.0,2.0,4.0,4.0,4.0,11.0,3.0,2.0,15.0,13.0,2.0,5.0,8.0,4.0,6.0,10.0,0.0,4.0,5.0,7.0,7.0,1.0,7.0,0.0,2.0,2.0,9.0,3.0,6.0,6.0,7.0,4.0,5.0,9.0,9.0,2.0,5.0,6.0,13.0,22.0,4.0,6.0,14.0,10.0,15.0,22.0,13.0,12.0,10.0,10.0,9.0,9.0,12.0,12.0,13.0,12.0,0.0,0.0,9.0,8.0,15.0,13.0,13.0,12.0,7.0,12.0,13.0,15.0,16.0,6.0,25.0,0.0,10.0,7.0,11.0,8.0,0.0,15.0,11.0,24.0,0.0,11.0,14.0,8.0,13.0,4.0,11.0,9.0,9.0,16.0,10.0,10.0,5.0,20.0,11.0,15.0,18.0,18.0,18.0,10.0,7.0,9.0,8.0,11.0,6.0,15.0,11.0,9.0,14.0,15.0,16.0,11.0,16.0,11.0,11.0,7.0,18.0,14.0,17.0,17.0,16.0,13.0,24.0,18.0,24.0,12.0,11.0,14.0,20.0,16.0,18.0,17.0,9.0,14.0,17.0,10.0,11.0,11.0,9.0,12.0,18.0,16.0,19.0,21.0,12.0,9.0,16.0,11.0,11.0,10.0,11.0,9.0,12.0,10.0,17.0,15.0,9.0,13.0,13.0,8.0,11.0,16.0,14.0,13.0,11.0,13.0,7.0,23.0,10.0,9.0,17.0,12.0,14.0,6.0,15.0,9.0,11.0,13.0,13.0,16.0,12.0,13.0,8.0,12.0,4.0,6.0,14.0,6.0,4.0,0.0,5.0,1.0,5.0,8.0,10.0,8.0,6.0,7.0,0.0,5.0,14.0,12.0,2.0,4.0,11.0,4.0,16.0,9.0,14.0,3.0,6.0,6.0,9.0,8.0,5.0,11.0,5.0,11.0,7.0,21.0,11.0,6.0,8.0,7.0,17.0,8.0,8.0,17.0,4.0,8.0,4.0,3.0,4.0,4.0,18.0,9.0,3.0,0.0,0.0,4.0,3.0,3.0,1.0,0.0,0.0,9.0,0.0,0.0,0.0,1.0,0.0,0.0,0.0,0.0,18.0,4.0,10.0,9.0,5.0,11.0,24.0,10.0,12.0,3.0,7.0,4.0,25.0,7.0,1.0,5.0,10.0,2.0,14.0,23.0,14.0,3.0,12.0,12.0,9.0,3.0,18.0,12.0,4.0,7.0,7.0,6.0,2.0,9.0,8.0,3.0,12.0,11.0,24.0,1.0,7.0,3.0,1.0,1.0,3.0,10.0,2.0,3.0,6.0,6.0,6.0,8.0,10.0,13.0,9.0,16.0,9.0,6.0,7.0,12.0,11.0,12.0,9.0,7.0,14.0,10.0,9.0,2.0,5.0,11.0,12.0,11.0,10.0,8.0,11.0,8.0,7.0,12.0,13.0,13.0,10.0,7.0,0.0,4.0,6.0,9.0,15.0,12.0,10.0,9.0,9.0,11.0,10.0,7.0,11.0,1.0,3.0,10.0,3.0,13.0,10.0,8.0,6.0,11.0,11.0,3.0,10.0,2.0,8.0,8.0,8.0,8.0,8.0,7.0,11.0,12.0,8.0,25.0,3.0,13.0,15.0,4.0,11.0,6.0,6.0,8.0,11.0,18.0,16.0,8.0,9.0,4.0,14.0,8.0,3.0,11.0,8.0,13.0,14.0,5.0,18.0,9.0,13.0,11.0,9.0,4.0,5.0,4.0,9.0,23.0,15.0,1.0,5.0,5.0,8.0,11.0,11.0,9.0,7.0,7.0,3.0,6.0,7.0,5.0,8.0,14.0,9.0,8.0,4.0,14.0,5.0,7.0,7.0,4.0,6.0,2.0,2.0,7.0,7.0,6.0,8.0,1.0,8.0,7.0,5.0,3.0,13.0,4.0,8.0,6.0,3.0,5.0,14.0,4.0,4.0,11.0,6.0,5.0,0.0,0.5,10.0,0.0,0.0,0.0,0.0,5.0,0.0,0.0,2.0,0.0,4.0,4.0,0.0,0.0,0.0,13.0,0.0,8.0,10.0,6.0,0.0,0.0,0.0,0.0,0.0,1.0,1.0,2.0,2.0,0.0,1.0,3.0,3.0,2.0,0.0,0.0,0.0,3.0,0.0,2.0,1.0,0.0,0.0,0.0,4.0,0.0,3.0,0.0,0.0,4.0,0.0,0.0,2.0,3.0,3.0,2.0,5.0,7.0,0.0,0.0,0.0,1.0,0.0,4.0,0.0,0.0,0.0,0.0,0.0,0.0,0.0,0.0,0.0,0.0,0.0,0.0,0.0,0.0,0.0,0.0,0.0,0.0,0.0,0.0,0.0,0.0,0.0,0.0,0.0,6.0,0.0,5.0,1.0,4.0,4.0,0.0,0.0,0.0,2.0,0.0,0.0,2.0,4.0,1.0,0.0,2.0,1.0,0.0,0.0,0.0,0.0,0.0,0.0,0.0,2.0,0.0,0.0,0.0,0.0,0.0,14.0,10.0,13.0,14.0,21.0,7.0,9.0,11.0,3.0,17.0,0.0,9.0,2.0,2.0,22.0,4.0,5.0,5.0,4.0,6.0,8.0,11.0,10.0,22.0,5.0,7.0,9.0,0.0,1.0,11.0,14.0,12.0,13.0,9.0,0.0,23.0,15.0,13.0,12.0,17.0,3.0,54.0,8.0,5.0,19.0,3.0,1.0,7.0,0.0,4.0,7.0,5.0,8.0,10.0,14.0,16.0,4.0,5.0,7.0,13.0,20.0,0.0,13.0,18.0,17.0,14.0,16.0,8.0,16.0,4.0,4.0,10.0,12.0,15.0,4.0,9.0,2.0,7.0,3.0,4.0,11.0,12.0,4.0,6.0,3.0,2.0,7.0,6.0,2.0,10.0,6.0,5.0,8.0,18.0,4.0,3.0,15.0,5.0,10.0,1.0,18.0,16.0,4.0,16.0,4.0,1.0,3.0,2.0,3.0,8.0,6.0,12.0,6.0,9.0,20.0,13.0,11.0,5.0,10.0,0.0,3.0,13.0,6.0,14.0,8.0,9.0,0.0,13.0,4.0,5.0,1.0,12.0,7.0,1.0,1.0,0.0,17.0,2.0,6.0,13.0,8.0,11.0,9.0,13.0,8.0,13.0,12.0,2.0,1.0,9.0,7.0,11.0,5.0,27.0,10.0,6.0,0.0,4.0,5.0,2.0,10.0,1.0,4.0,2.0,3.0,9.0,3.0,9.0,5.0,11.0,7.0,6.0,2.0,8.0,4.0,8.0,3.0,6.0,12.0,15.0,10.0,9.0,11.0,9.0,11.0,9.0,6.0,2.0,4.0,1.0,0.0,0.0,0.0,0.0,0.0,0.0,0.0,0.0,0.0,0.0,0.0,0.0,0.0,0.0,0.0,0.0,0.0,0.0,0.0,0.0,0.0,0.0,0.0,0.0,0.0,0.0,0.0,0.0,0.0,0.0,0.0,0.0,0.0,0.0,0.0,0.0,0.0,0.0,0.0,0.0,0.0,0.0,0.0,0.0,0.0,0.0,0.0,0.0,0.0,0.0,0.0,0.0,0.0,0.0,0.0,0.0,0.0,0.0,0.0,0.0,0.0,3.0,0.0,0.0,0.0,4.0,0.0,1.0,0.0,0.0,0.0,,0.0,0.0,0.0,0.0,0.0,0.0,0.0,0.0,0.0,0.0,0.0,0.0,0.0,0.0,0.0,0.0,0.0,0.0,0.0,0.0,0.0,0.0,0.0,0.0,0.0,0.0,0.0,0.0,0.0,0.0,0.0,0.0,0.0,0.0,0.0,0.0,1.0,5.0,0.0,0.0,2.0,0.0,0.0,5.0,5.0,3.0,5.0,5.0,2.0,5.0,5.0,0.0,2.0,5.0,0.0,0.0,2.0,1.0,4.0,2.0,0.0,1.0,7.0,0.0,1.0,1.0,0.0,0.0,0.0,4.0,2.0,5.0,5.0,1.0,2.0,5.0,0.0,2.0,3.0,0.0,0.0,3.0,1.0,0.0,5.0,5.0,4.0,3.0,4.0,4.0,2.0,4.0,0.0,2.0,0.0,3.0,2.0,3.0,2.0,1.0,3.0,5.0,5.0,5.0,1.0,5.0,0.0,22.0,5.0,1.0,5.0,3.0,,5.0,4.0,3.0,5.0,0.0,2.0,0.0,0.0,2.0,5.0,4.0,1.0,5.0,2.0,0.0,0.0,5.0,3.0,5.0,3.0,5.0,5.0,5.0,5.0,3.0,5.0,4.0,3.0,5.0,4.5,5.0,5.0,0.0,5.0,2.0,4.0,0.0,0.0,0.0,3.0,2.0,5.0,0.0,1.0,1.0,1.0,5.0,4.0,2.0,2.0,2.0,4.0,1.0,4.0,2.0,1.0,3.0,4.0,5.0,5.0,5.0,5.0,5.0,2.0,0.0,5.0,,3.0,0.0,3.0,5.0,5.0,0.0,2.0,10.0,4.0,3.0,4.0,5.0,,,2.0,0.0,5.0,3.0,1.0,2.0,0.0,1.0,1.0,0.0,2.0,5.0,2.0,3.0,2.0,4.0,3.0,0.0,2.0,2.0,0.0,3.0,2.0,0.0,0.0,5.0,5.0,3.0,3.0,4.0,5.0,0.0,24.0,1.0,2.0,5.0,1.0,0.0,2.0,3.0,5.0,1.0,3.0,0.0,4.0,6.0,0.0,1.0,3.0,3.0,0.0,2.0,5.0,5.0,4.0,5.0,1.0,0.0,0.0,6.0,1.0,5.0,1.0,1.0,0.0,1.0,0.0,0.0,0.0,1.0,0.0,0.0,2.0,2.0,0.0,4.0,0.0,0.0,0.0,0.0,0.0,3.0,5.0,3.0,2.0,9.0,5.0,0.0,0.0,5.0,0.0,1.0,5.0,5.0,28.0,27.0,5.0,10.0,3.0,4.0,5.0,2.0,3.0,1.0,5.0,0.0,2.0,2.0,3.0,0.0,0.0,3.0,1.0,0.0,4.0,6.0,0.0,3.0,6.0,3.0,4.0,5.0,14.0,5.0,9.0,15.0,5.0,4.0,1.0,1.0,5.0,5.0,5.0,5.0,5.0,4.0,0.0,1.0,4.0,0.0,3.0,3.5,2.0,4.0,0.0,2.0,1.0,5.0,2.0,15.0,1.0,0.0,5.0,3.0,2.0,2.0,5.0,1.0,1.0,3.0,3.0,3.0,0.0,1.0,2.0,0.0,1.0,0.0,0.0,0.0,1.0,1.0,11.0,2.0,3.0,4.0,1.0,0.0,3.0,5.0,1.0,5.0,,3.0,5.0,2.0,0.0,4.0,4.0,5.0,5.0,6.0,2.0,5.0,5.0,0.0,4.0,4.0,0.0,6.0,2.0,2.0,4.0,0.0,5.0,1.0,5.0,10.0,7.0,5.0,2.0,0.0,5.0,3.0,4.0,5.0,3.0,2.0,3.0,0.0,5.0,1.0,1.0,1.0,0.0,0.0,4.0,4.0,1.0,,1.0,0.0,0.0,1.0,5.0,1.0,3.0,5.0,0.0,0.0,3.0,5.0,16.0,0.0,3.0,2.0,5.0,2.0,3.0,5.0,0.0,2.0,3.0,3.0,0.0,2.0,5.0,2.0,4.0,4.0,10.0,13.0,5.0,5.0,6.0,5.0,0.0,8.0,6.0,6.0,2.0,30.0,,5.0,1.0,3.0,3.0,0.0,4.0,5.0,5.0,11.0,3.0,5.0,0.0,0.0,5.0,0.0,0.0,1.0,2.0,5.0,5.0,3.0,2.0,5.0,5.0,5.0,5.0,3.0,0.0,1.0,,0.0,4.0,5.0,4.0,8.0,1.0,2.0,5.0,0.0,5.0,5.0,0.0,0.0,0.0,,3.0,0.0,2.0,2.0,,0.0,4.0,0.0,0.0,0.0,0.0,0.0,5.0,5.0,0.0,0.0,1.0,0.0,5.0,2.0,0.0,2.0,5.0,5.0,0.0,1.0,5.0,0.0,5.0,3.0,5.0,5.0,5.0,5.0,0.0,,5.0,3.0,5.0,1.0,4.0,5.0,5.0,5.0,5.0,5.0,4.0,1.0,,4.0,3.0,1.0,5.0,3.0,5.0,1.0,3.0,4.0,5.0,3.0,5.0,1.0,3.0,5.0,4.0,0.0,1.0,5.0,1.0,4.0,0.0,5.0,5.0,0.0,0.0,4.0,9.0,5.0,5.0,5.0,0.0,5.0,5.0,5.0,5.0,5.0,5.0,5.0,5.0,5.0,3.0,5.0,3.0,5.0,5.0,0.0,1.0,5.0,0.0,1.0,0.0,1.0,1.0,2.0,5.0,5.0,1.0,4.0,5.0,5.0,4.0,0.0,4.0,1.0,1.0,1.0,1.0,4.0,2.0,0.0,2.0,3.0,0.0,0.0,1.0,2.0,5.0,0.0,5.0,5.0,3.0,5.0,5.0,2.0,5.0,6.0,1.0,2.0,5.0,0.0,2.0,1.0,0.0,4.0,2.0,5.0,4.0,2.0,5.0,1.0,0.0,,,,1.0,0.0,0.0,0.0,1.0,2.0,0.0,5.0,0.0,5.0,5.0,1.0,2.0,1.0,1.0,,,,,,,,,,3.0,2.0,2.0,1.0,3.0,5.0,5.0,2.0,0.0,0.0,2.0,0.0,1.0,5.0,1.0,1.0,1.0,2.0,5.0,5.0,5.0,3.0,5.0,4.0,3.0,1.0,3.0,5.0,4.0,4.0,2.0,5.0,5.0,0.0,0.0,5.0,4.0,1.0,5.0,1.0,0.0,0.0,,4.0,1.0,3.0,4.0,5.0,5.0,5.0,4.0,2.0,5.0,,,,,,4.0,2.0,2.0,3.0,2.0,2.0,12.0,5.0,4.0,1.0,3.0,0.0,3.0,0.0,0.0,5.0,0.0,2.0,1.0,1.0,4.0,3.0,0.0,2.0,5.0,5.0,3.0,4.0,3.0,3.0,5.0,1.0,5.0,5.0,5.0,0.0,3.0,5.0,5.0,2.0,0.0,5.0,5.0,5.0,5.0,5.0,0.0,6.0,2.0,5.0,0.0,1.0,0.0,5.0,0.0,0.0,4.0,5.0,5.0,2.0,0.0,5.0,4.0,0.0,0.0,,,5.0,4.0,1.0,2.0,0.0,0.0,2.0,4.0,3.0,1.0,5.0,5.0,0.0,5.0,5.0,0.0,3.0,1.0,0.0,1.0,0.0,0.0,0.0,1.0,1.0,5.0,5.0,7.0,0.0,3.0,0.0,5.0,0.0,4.0,5.0,5.0,2.0,4.0,4.0,0.0,2.0,,0.0,1.0,5.0,5.0,0.0,3.0,0.0,1.0,2.0,0.0,7.0,5.0,4.0,0.0,0.0,1.0,1.0,0.0,0.0,5.0,5.0,3.0,4.0,5.0,1.0,0.0,3.0,3.0,4.0,5.0,3.0,0.0,2.0,5.0,0.0,4.0,3.0,2.0,2.0,1.0,4.0,3.0,2.0,1.0,5.0,1.0,5.0,2.0,4.0,0.0,3.0,5.0,0.0,1.0,4.0,5.0,0.0,2.0,5.0,0.0,1.0,0.0,0.0,2.0,0.0,1.0,2.0,0.0,0.0,0.0,5.0,0.0,1.0,0.0,0.0,0.0,0.0,0.0,0.0,0.0,0.0,4.0,2.0,5.0,5.0,4.0,0.0,7.0,2.0,3.0,5.0,2.0,0.0,1.0,1.0,5.0,6.0,4.0,5.0,5.0,1.0,4.0,1.0,1.0,2.0,2.0,5.0,5.0,1.0,4.0,3.0,2.0,2.0,1.0,4.0,1.0,3.0,5.0,2.0,4.0,3.0,0.0,5.0,3.0,3.0,0.0,5.0,3.0,4.0,0.0,5.0,4.0,1.0,3.0,0.0,0.0,0.0,4.0,3.0,2.0,3.0,4.0,2.0,5.0,2.0,2.0,1.0,5.0,2.0,5.0,1.0,5.0,0.0,0.0,5.0,5.0,9.0,2.0,0.0,0.0,5.0,5.0,5.0,5.0,5.0,4.0,3.0,5.0,1.0,4.0,5.0,2.0,0.0,5.0,3.0,5.0,5.0,5.0,3.0,4.0,5.0,2.0,1.0,2.0,3.0,,0.0,5.0,1.0,5.0,5.0,0.0,0.0,0.0,5.0,3.0,2.0,0.0,5.0,2.0,1.0,3.0,1.0,5.0,1.0,2.0,2.0,0.0,1.0,0.0,2.0,0.0,4.0,3.0,,5.0,1.0,2.0,0.0,5.0,0.0,0.0,0.0,8.0,0.0,0.0,1.0,3.0,6.0,0.0,3.0,2.0,4.0,3.0,5.0,4.0,2.0,1.0,1.0,0.0,0.0,4.0,4.0,1.0,1.0,5.0,3.0,1.0,1.0,3.0,5.0,2.0,5.0,3.0,2.0,2.0,5.0,0.0,2.0,0.0,0.0,0.0,3.0,0.0,1.0,5.0,5.0,5.0,1.0,5.0,0.0,3.0,5.0,5.0,2.0,9.0,12.0,0.0,0.0,0.0,2.0,1.0,5.0,1.0,2.0,2.0,,5.0,5.0,0.0,4.0,0.0,3.0,5.0,5.0,3.0,5.0,1.0,1.0,5.0,5.0,1.0,3.0,3.0,2.0,5.0,2.0,11.0,6.0,1.0,5.0,2.0,2.0,3.0,3.0,2.0,3.0,3.0,0.0,2.0,1.0,4.0,1.0,1.0,5.0,2.0,0.0,,2.0,2.0,2.0,5.0,1.0,3.0,1.0,0.0,0.0,1.0,5.0,5.0,3.0,2.0,1.0,3.0,5.0,1.0,5.0,4.0,1.0,5.0,1.0,12.0,4.0,0.0,4.0,5.0,5.0,3.0,,5.0,0.0,6.0,3.0,5.0,0.0,0.0,4.0,5.0,6.0,5.0,5.0,3.0,1.0,2.0,2.0,2.0,4.0,5.0,0.0,4.0,0.0,1.0,5.0,2.0,5.0,6.0,,,5.0,4.0,4.0,4.0,5.0,1.0,5.0,6.0,12.0,1.0,0.0,7.0,19.0,9.0,,,,1.0,2.0,2.0,5.0,0.0,2.0,3.0,5.0,5.0,5.0,5.0,0.0,1.0,5.0,5.0,3.0,3.0,1.0,1.0,5.0,5.0,4.0,5.0,4.0,3.0,4.0,5.0,5.0,2.0,5.0,4.0,0.0,1.0,5.0,0.0,0.0,1.0,0.0,1.0,0.0,,4.0,3.0,,1.0,3.0,5.0,4.0,2.0,3.0,2.0,4.0,,,,5.0,5.0,4.0,3.5,9.0,9.0,3.0,3.0,0.0,1.0,,4.0,3.0,4.0,4.0,3.0,5.0,1.0,1.0,5.0,0.0,4.0,5.0,2.0,1.0,0.0,1.0,10.0,4.0,5.0,5.0,5.0,5.0,5.0,5.0,5.0,4.0,3.0,4.0,5.0,5.0,1.0,3.0,4.0,4.0,4.0,4.0,4.0,1.0,0.0,3.0,0.0,2.0,3.0,0.0,1.0,1.0,0.0,4.0,5.0,3.0,1.0,0.0,3.0,5.0,5.0,0.0,1.0,3.0,5.0,4.0,5.0,4.0,5.0,3.0,1.0,4.0,5.0,0.0,5.0,3.0,3.0,0.0,5.0,1.0,5.0,1.0,1.0,0.0,5.0,1.0,5.0,4.0,5.0,1.0,2.0,0.0,4.0,0.0,5.0,5.0,5.0,5.0,5.0,5.0,5.0,5.0,5.0,1.0,2.0,0.0,3.0,5.0,5.0,0.0,0.0,3.0,1.0,3.0,0.0,0.0,0.0,0.0,0.0,0.0,0.0,0.0,3.0,0.0,5.0,0.0,1.0,3.0,2.0,5.0,3.0,,,0.0,0.0,5.0,4.0,1.0,9.0,4.0,4.0,4.0,8.0,0.0,11.0,7.0,1.0,3.0,0.0,5.0,2.0,5.0,1.0,0.0,1.0,0.0,2.0,2.0,5.0,3.0,2.0,2.0,2.0,1.0,5.0,0.0,5.0,3.0,5.0,1.0,4.0,1.0,2.0,4.0,1.0,2.0,5.0,1.0,0.0,5.0,5.0,5.0,5.0,4.0,4.0,4.0,14.0,5.0,1.0,2.0,5.0,5.0,5.0,2.0,2.0,2.0,5.0,5.0,1.0,3.0,3.0,6.0,0.0,0.0,3.0,5.0,5.0,3.0,2.0,3.0,2.0,1.0,0.0,0.0,0.0,0.0,0.0,4.0,5.0,5.0,0.0,2.0,3.0,2.0,5.0,2.0,3.0,5.0,5.0,5.0,4.0,2.0,2.0,5.0,4.0,5.0,5.0,5.0,2.0,0.0,0.0,1.0,1.0,1.0,5.0,2.0,5.0,5.0,5.0,3.0,3.0,2.0,2.0,2.0,2.0,5.0,0.0,2.0,0.0,0.0,0.0,2.0,0.0,0.0,0.0,0.0,2.0,0.0,0.0,1.0,0.0,3.0,0.0,0.0,3.0,5.0,1.0,2.0,5.0,1.0,5.0,5.0,4.0,5.0,2.0,5.0,5.0,4.0,1.0,5.0,3.0,4.0,3.0,3.0,3.0,5.0,5.0,3.0,4.0,3.0,5.0,5.0,5.0,5.0,3.0,4.0,5.0,4.0,3.0,0.0,0.0,0.0,0.0,0.0,0.0,0.0,0.0,0.0,0.0,0.0,0.0,0.0,0.0,1.0,0.0,0.0,0.0,5.0,5.0,3.0,5.0,2.0,5.0,4.0,5.0,5.0,5.0,3.0,5.0,5.0,3.0,3.0,5.0,6.0,1.0,0.0,3.0,0.0,5.0,4.0,0.0,0.0,0.0,0.0,0.0,0.0,0.0,0.0,0.0,0.0,0.0,0.0,0.0,8.0,0.0,0.0,0.0,0.0,0.0,0.0,0.0,5.0,9.0,6.0,0.0,0.0,0.0,0.0,0.0,0.0,2.0,1.0,2.5714285714285716,0.0,0.0,3.0,0.0,1.5,7.0,3.0,6.0,6.0,0.0,1.0,1.0,1.0,8.0,8.0,5.0,4.0,0.0,0.0,0.0,0.0,0.0,4.0,0.0,2.0,0.0,3.0,0.0,0.0,5.0,0.0,7.0,5.0,1.0,7.0,0.0,1.5,0.0,0.0,0.0,0.0,7.0,0.0,6.0,4.0,4.0,0.0,3.0,0.0,0.0,2.0,3.0,3.0,4.0,0.0,1.0,3.0,2.5,2.0,0.0,9.0,1.8333333333333333,0.0,0.0,5.0,0.0,1.0,0.0,3.0,10.0,0.0,5.0,6.0,9.0,0.0,0.0,0.0,4.0,0.0,5.0,5.0,6.0,0.0,6.0,7.0,0.0,4.0,0.0,1.0,0.0,0.0,5.0,2.0,0.0,0.0,12.0,0.0,1.0,5.0,0.0,0.0,5.0,0.0,0.0,2.0,5.0,0.0,6.0,0.0,0.0,1.0,1.0,0.0,0.0,2.5,1.0,0.0,1.0,2.0,0.0,4.0,0.0,4.0,0.0,2.0,0.0,0.0,0.0,1.0,0.0,5.0,0.0,4.0,0.0,0.0,2.0,2.0,7.0,4.0,7.0,5.0,0.0,3.0,6.0,6.0,3.0,0.0,4.0,0.0,0.0,2.0,1.0,0.0,0.0,6.0,3.0,7.0,1.0,5.0,0.0,3.0,3.0,6.0,0.0,0.0,0.0,6.0,4.0,0.0,2.0,0.0,0.0,1.0,6.0,6.0,2.0,0.0,2.0,9.0,5.0,0.0,0.0,2.0,0.0,0.0,1.5,5.0,0.0,0.0,2.0,3.0,0.0,0.0,3.0,4.0,0.0,0.0,5.0,2.0,4.0,0.0,5.0,1.5,7.0,0.0,6.0,2.0,2.0,4.0,2.0,10.0,0.0,4.0,0.0,6.0,5.0,0.0,2.0,0.0,0.0,3.0,3.0,4.0,1.0,0.0,4.0,6.0,0.0,0.0,2.0,0.0,0.0,0.0,0.0,6.0,3.0,0.0,0.0,2.0,3.0,1.5,0.0,0.0,0.0,3.0,1.0,1.0,3.0,4.0,4.0,5.0,1.0,0.0,5.0,1.0,2.0,5.0,5.0,2.0,1.0,0.0,5.0,5.0,0.0,5.0,5.0,2.0,2.0,5.0,17.0,7.0,18.0,2.0,2.0,2.0,7.0,9.0,5.0,7.0,3.0,4.0,3.0,5.0,10.0,3.0,4.0,11.0,9.0,13.0,8.0,10.0,10.0,7.0,6.0,12.0,5.0,3.0,5.0,3.0,7.0,4.0,5.0,9.0,10.0,9.0,8.0,4.0,12.0,2.0,9.0,5.0,14.0,3.0,3.0,11.0,3.0,2.0,22.0,10.0,5.0,14.0,11.0,15.0,5.0,5.0,3.0,10.0,6.0,4.0,5.0,3.0,4.0,4.0,2.0,3.0,3.0,5.5,9.0,6.0,10.0,8.0,12.0,5.0,2.0,7.0,5.0,10.0,6.0,10.0,13.0,10.0,10.0,2.0,10.0,6.0,2.0,5.0,3.0,5.0,2.0,5.0,3.0,13.0,11.0,9.0,7.0,6.0,7.0,10.0,17.0,6.0,13.0,6.0,5.0,3.0,11.0,15.0,5.0,6.0,8.0,5.0,3.0,4.0,4.0,11.0,4.0,7.0,11.0,12.0,8.0,11.0,8.0,7.0,8.0,4.0,7.0,4.0,3.0,5.0,14.0,7.0,2.0,3.0,7.0,3.0,3.0,8.0,0.0,3.0,0.0,0.0,3.0,0.0,4.0,0.0,0.0,1.0,3.0,0.0,5.0,0.0,4.0,0.0,9.0,10.0,16.0,8.0,0.0,0.0,0.0,0.0,0.0,0.0,0.0,0.0,0.0,0.0,0.0,0.0,0.0,0.0,0.0,0.0,0.0,0.0,4.0,9.0,3.0,3.0,1.0,5.0,5.0,5.0,5.0,5.0,5.0,0.0,0.0,0.0,0.0,0.0,0.0,2.0,0.0,5.0,5.0,5.0,4.0,5.0,2.0,5.0,3.0,4.0,2.0,5.0,5.0,5.0,12.0,18.0,11.0,7.0,3.0,11.0,10.0,19.0,1.0,19.0,15.0,8.0,10.0,1.0,3.0,5.0,5.0,13.0,2.0,10.0,3.0,3.0,9.0,2.0,6.0,14.0,9.0,,9.0,12.0,5.0,5.0,5.0,5.0,5.0,5.0,5.0,5.0,5.0,5.0,5.0,5.0,5.0,5.0,5.0,5.0,5.0,2.0,5.0,5.0,5.0,5.0,5.0,5.0,1.0,,,4.0,6.0,5.0,0.0,3.0,5.0,4.0,9.0,2.0,3.0,2.0,4.0,6.0,2.0,5.0,4.0,1.0,0.0,0.0,1.0,2.0,7.0,3.0,5.0,0.0,2.0,2.0,3.0,0.0,2.0,1.0,1.0,4.0,5.0,2.0,3.0,4.0,2.0,4.0,5.0,3.0,2.0,1.0,3.0,2.0,2.0,5.0,8.0,0.0,3.0,2.0,4.0,1.0,9.0,8.0,2.0,1.0,2.0,1.0,2.0,1.0,0.0,1.0,4.0,1.0,1.0,2.0,1.0,1.0,0.0,1.0,3.0,0.0,0.0,1.0,2.0,0.0,1.0,5.0,1.0,0.0,5.0,5.0,4.0,7.0,1.0,2.0,2.0,2.0,0.0,2.0,3.0,2.0,5.0,4.0,3.0,4.0,2.0,4.0,2.0,1.0,0.0,4.0,0.0,2.0,2.0,0.0,1.0,0.0,4.0,3.0,0.0,0.0,2.0,3.0,9.0,6.0,4.0,0.0,3.0,7.0,3.0,3.0,3.0,1.0,4.0,3.0,0.0,1.0,1.0,0.0,0.0,0.0,0.0,0.0,0.0,0.0,0.0,0.0,0.0,0.0,0.0,0.0,0.0,0.0,0.0,0.0,0.0,0.0,0.0,0.0,0.0,0.0,0.0,0.0,0.0,0.0,0.0,0.0,0.0,1.0,0.0,0.0,0.0,0.0,0.0,0.0,0.0,1.0,5.0,1.0,0.0,0.0,0.0,0.0,0.0,5.0,5.0,5.0,5.0,5.0,5.0,5.0,5.0,5.0,1.0,5.0,5.0,5.0,2.0,3.0,5.0,5.0,5.0,5.0,4.0,5.0,5.0,3.0,5.0,5.0,4.0,9.0,3.0,9.0,6.5,4.0,7.0,4.0,4.0,8.5,10.0,7.0,9.0,8.0,5.0,9.0,6.0,7.0,8.0,10.0,5.0,8.0,7.0,5.0,6.0,8.0,6.0,7.0,3.0,6.0,7.0,10.0,9.0,8.0,6.0,8.0,2.0,3.0,9.0,9.5,2.0,6.0,5.0,6.0,8.0,7.0,8.0,7.0,6.0,3.0,4.0,6.0,11.0,9.0,8.0,8.0,10.0,9.0,8.0,8.0,6.0,9.0,9.0,4.0,4.0,6.0,2.0,7.0,6.0,7.0,10.0,8.0,6.0,6.0,6.0,6.0,8.0,4.0,12.0,6.0,6.0,12.0,7.0,7.0,8.0,11.0,7.0,0.0,10.0,9.0,7.0,10.0,7.0,5.0,7.0,5.0,8.0,7.0,8.0,7.0,8.0,5.0,8.0,10.0,8.0,7.0,8.0,8.0,10.0,8.0,8.0,10.0,10.0,7.0,10.0,7.0,9.0,11.0,8.0,8.0,8.0,7.0,4.0,5.0,6.0,2.0,2.0,6.0,4.0,3.0,2.0,6.0,6.0,1.0,4.0,4.0,2.0,3.0,2.0,6.0,8.0,2.0,8.0,3.0,4.0,4.0,4.0,4.0,7.0,5.0,4.0,0.0,3.0,6.0,4.0,2.0,3.0,7.0,9.0,8.0,7.0,7.0,15.0,7.0,7.0,10.0,4.0,8.0,6.0,7.0,9.0,5.0,15.0,17.0,5.0,7.0,9.0,8.0,15.0,13.0,13.0,12.0,7.0,16.0,10.0,6.0,6.0,12.0,4.0,17.0,5.0,11.0,7.0,5.0,11.0,1.0,6.0,11.0,13.0,8.0,11.0,14.0,12.0,7.0,5.0,4.0,9.0,6.0,10.0,13.0,12.0,8.0,7.0,7.0,5.0,9.0,8.0,6.0,12.0,10.0,6.0,0.0,0.0,0.0,0.0,0.0,0.0,0.0,0.0,0.0,0.0,2.0,2.0,2.0,5.0,2.0,1.0,0.0,8.0,9.0,10.0,1.0,0.0,0.0,2.0,1.0,1.0,0.0,0.0,0.0,2.0,3.0,1.0,3.0,2.0,1.0,1.0,5.0,3.0,0.0,2.0,0.0,0.0,0.0,1.0,4.0,1.0,0.0,1.0,3.0,8.0,0.0,27.0,19.0,5.0,5.0,54.0,1.0,14.0,15.0,16.0,2.0,10.0,11.0,16.0,5.0,31.0,15.0,2.0,3.0,3.0,46.0,31.0,12.0,1.0,28.0,19.0,9.0,17.0,5.0,0.0,33.0,9.0,1.0,2.0,11.0,7.0,42.0,6.0,21.0,11.0,2.0,23.0,27.0,8.0,3.0,23.0,24.0,22.0,2.0,6.0,17.0,27.0,0.0,11.0,1.0,5.0,26.0,3.0,24.0,32.0,15.0,3.0,5.0,4.0,3.0,1.0,25.0,7.0,8.0,8.0,5.0,0.0,21.0,7.0,1.0,6.0,20.0,15.0,11.0,1.0,20.0,41.0,9.0,13.0,0.0,9.0,29.0,7.0,4.0,9.0,38.0,11.0,2.0,1.0,17.0,6.0,18.0,7.0,1.0,18.0,17.0,34.0,4.0,7.0,14.0,20.0,7.0,10.0,15.0,2.0,27.0,1.0,2.0,2.0,6.0,5.0,16.0,0.0,2.0,5.0,20.0,8.0,11.0,14.0,8.0,3.0,6.0,8.0,42.0,13.0,18.0,1.0,0.0,27.0,5.0,26.0,4.0,34.0,20.0,0.0,8.0,2.0,4.0,10.0,3.0,2.0,9.0,5.0,6.0,20.0,3.0,8.0,0.0,0.0,5.0,2.0,17.0,15.0,11.0,32.0,16.0,3.0,9.0,19.0,3.0,4.0,5.0,12.0,15.0,5.0,0.0,31.0,14.0,5.0,11.0,2.0,2.0,12.0,17.0,15.0,2.0,17.0,22.0,20.0,8.0,1.0,11.0,3.0,14.0,33.0,20.0,19.0,4.0,9.0,15.0,1.0,2.0,3.0,4.0,13.0,5.0,8.0,0.0,5.0,1.0,2.0,3.0,0.0,9.0,10.0,15.0,1.0,13.0,25.0,13.0,5.0,1.0,5.0,15.0,0.0,7.0,6.0,6.0,16.0,0.0,1.0,11.0,7.0,9.0,0.0,9.0,15.0,17.0,10.0,2.0,0.0,18.0,3.0,2.0,0.0,5.0,0.0,11.0,13.0,17.0,18.0,2.0,0.0,4.0,25.0,1.0,7.0,7.0,19.0,26.0,0.0,1.0,0.0,16.0,2.0,4.0,6.0,0.0,4.0,7.0,1.0,5.0,19.0,17.0,7.0,2.0,25.0,14.0,1.0,15.0,10.0,8.0,18.0,4.0,22.0,2.0,1.0,4.0,1.0,24.0,18.0,9.0,12.0,12.0,33.0,2.0,9.0,1.0,7.0,24.0,13.0,0.0,6.0,14.0,11.0,5.0,7.0,1.0,19.0,7.0,6.0,15.0,6.0,2.0,0.0,7.0,7.0,8.0,3.0,6.0,0.0,10.0,0.0,22.0,0.0,9.0,20.0,22.0,15.0,18.0,16.0,15.0,21.0,17.0,10.0,6.0,2.0,4.0,26.0,3.0,11.0,18.0,11.0,16.0,1.0,29.0,6.0,0.0,7.0,4.0,,3.0,3.0,3.0,6.0,7.0,13.0,7.0,9.0,4.0,14.0,0.0,11.0,15.0,0.0,0.0,6.0,15.0,23.0,34.0,1.0,11.0,1.0,18.0,9.0,1.0,3.0,16.0,7.0,17.0,30.0,9.0,3.0,19.0,9.0,11.0,2.0,16.0,8.0,0.0,7.0,19.0,15.0,0.0,8.0,12.0,1.0,25.0,24.0,3.0,17.0,10.0,1.0,20.0,23.0,3.0,2.0,0.0,9.0,0.0,15.0,8.0,39.0,8.0,5.0,6.0,12.0,5.0,6.0,1.0,17.0,3.0,4.0,7.0,7.0,1.0,23.0,1.0,2.0,2.0,9.0,0.0,4.0,11.0,3.0,10.0,5.0,1.0,9.0,3.0,30.0,11.0,4.0,0.0,1.0,2.0,17.0,13.0,17.0,11.0,3.0,16.0,0.0,1.0,3.0,12.0,1.0,6.0,19.0,18.0,7.0,10.0,3.0,10.0,11.0,17.0,5.0,1.0,1.0,1.0,4.0,2.0,15.0,8.0,18.0,12.0,4.0,11.0,9.0,35.0,1.0,1.0,2.0,3.0,15.0,1.0,12.0,2.0,1.0,5.0,3.0,0.0,3.0,18.0,4.0,5.0,3.0,16.0,12.0,24.0,11.0,12.0,6.0,5.0,19.0,12.0,1.0,30.0,17.0,0.0,19.0,1.0,1.0,3.0,0.0,10.0,2.0,8.0,1.0,1.0,1.0,5.0,10.0,5.0,9.0,1.0,0.0,3.0,18.0,1.0,19.0,35.0,0.0,12.0,8.0,4.0,19.0,1.0,24.0,1.0,24.0,7.0,14.0,0.0,29.0,4.0,13.0,9.0,0.0,1.0,13.0,0.0,13.0,0.0,14.0,6.0,11.0,15.0,0.0,22.0,22.0,3.0,28.0,4.0,0.0,6.0,14.0,22.0,23.0,4.0,13.0,1.0,7.0,14.0,16.0,10.0,5.0,5.0,5.0,1.0,1.0,14.0,5.0,8.0,2.0,1.0,24.0,0.0,2.0,13.0,2.0,0.0,1.0,24.0,3.0,0.0,1.0,0.0,12.0,14.0,3.0,16.0,3.0,0.0,22.0,1.0,0.0,7.0,16.0,5.0,0.0,8.0,2.0,9.0,7.0,5.0,0.0,0.0,25.0,1.0,5.0,0.0,20.0,0.0,34.0,1.0,25.0,0.0,3.0,2.0,1.0,1.0,4.0,18.0,0.0,9.0,9.0,5.0,8.0,0.0,7.0,10.0,2.0,18.0,20.0,13.0,0.0,4.0,6.0,1.0,12.0,0.0,10.0,0.0,9.0,3.0,3.0,8.0,2.0,4.0,6.0,2.0,17.0,1.0,4.0,2.0,20.0,6.0,1.0,0.0,6.0,2.0,6.0,29.0,8.0,7.0,19.0,1.0,22.0,0.0,0.0,5.0,2.0,1.0,0.0,9.0,1.0,3.0,2.0,3.0,5.0,3.0,3.0,38.0,18.0,7.0,2.0,2.0,0.0,14.0,5.0,5.0,1.0,5.0,11.0,2.0,0.0,0.0,24.0,18.0,8.0,5.0,14.0,0.0,14.0,0.0,6.0,18.0,14.0,5.0,22.0,5.0,5.0,0.0,6.0,3.0,15.0,3.0,2.0,12.0,19.0,0.0,7.0,1.0,1.0,29.0,4.0,3.0,5.0,0.0,4.0,3.0,20.0,5.0,28.0,7.0,1.0,0.0,1.0,4.0,33.0,6.0,22.0,26.0,5.0,20.0,11.0,0.0,20.0,18.0,1.0,10.0,19.0,5.0,30.0,17.0,1.0,25.0,19.0,9.0,25.0,4.0,27.0,2.0,1.0,0.0,22.0,2.0,15.0,2.0,4.0,9.0,1.0,3.0,9.0,1.0,3.0,4.0,5.0,3.0,5.0,5.0,5.0,1.0,3.0,5.0,5.0,3.0,5.0,5.0,5.0,5.0,5.0,4.0,5.0,3.0,5.0,2.0,3.0,0.0,5.0,2.0,5.0,4.0,5.0,1.0,4.0,3.0,3.0,2.0,3.0,1.0,0.0,0.0,5.0,0.0,0.0,0.0,2.0,1.0,0.0,0.0,0.0,0.0,0.0,0.0,0.0,0.0,0.0,4.0,1.0,0.0,0.0,3.0,0.0,3.0,0.0,0.0,0.0,10.0,9.0,13.0,0.0,17.0,0.0,1.0,2.0,8.0,3.0,9.0,11.0,3.0,9.0,2.0,3.0,7.0,4.0,14.0,0.0,12.0,16.0,4.0,1.0,19.0,8.0,12.0,15.0,14.0,1.0,0.0,8.0,6.0,9.0,11.0,4.0,8.0,1.0,3.0,28.0,5.0,3.0,1.0,1.0,2.0,1.0,3.0,4.0,12.0,2.0,9.0,16.0,17.0,1.0,2.0,10.0,5.0,1.0,9.0,11.0,18.0,10.0,17.0,4.0,4.0,4.0,6.0,2.0,7.0,35.0,6.0,7.0,8.0,4.0,14.0,12.0,12.0,2.0,2.0,13.0,9.0,12.0,3.0,13.0,12.0,0.0,26.0,0.0,1.0,0.0,7.0,5.0,7.0,8.0,4.0,6.0,6.0,2.0,27.0,5.0,32.0,14.0,20.0,6.0,19.0,9.0,6.0,14.0,2.0,14.0,17.0,7.0,14.0,21.0,16.0,0.0,8.0,17.0,5.0,15.0,14.0,15.0,16.0,15.0,14.0,21.0,13.0,16.0,9.0,15.0,16.0,18.0,14.0,8.0,14.0,16.0,13.0,14.0,10.0,12.0,16.0,13.0,12.0,9.0,6.0,17.0,8.0,4.0,5.0,7.0,9.0,10.0,17.0,9.0,16.0,16.0,9.0,10.0,17.0,2.0,16.0,4.0,3.0,15.0,12.0,14.0,15.0,13.0,7.0,9.0,13.0,10.0,5.0,17.0,4.0,2.0,13.0,3.0,16.0,7.0,12.0,14.0,20.0,18.0,18.0,19.0,20.0,4.0,4.0,7.0,6.0,5.0,14.0,15.0,15.0,14.0,19.0,16.0,7.0,17.0,10.0,12.0,13.0,5.0,10.0,12.0,11.0,2.0,6.0,2.0,11.0,12.0,9.0,10.0,12.0,2.0,14.0,12.0,3.0,3.0,7.0,2.0,7.0,4.0,2.0,7.0,14.0,15.0,12.0,8.0,6.0,0.0,1.0,5.0,0.0,14.0,2.0,20.0,6.0,15.0,11.0,12.0,22.0,14.0,9.0,12.0,7.0,1.0,8.0,6.0,8.0,1.0,8.0,13.0,24.0,18.0,0.0,0.0,0.0,0.0,0.0,0.0,0.0,0.0,0.0,0.0,0.0,0.0,0.0,0.0,0.0,0.0,0.0,0.0,0.0,0.0,0.0,0.0,0.0,0.0,0.0,0.0,0.0,0.0,0.0,0.0,0.0,0.0,0.0,0.0,0.0,0.0,0.0,0.0,0.0,0.0,0.0,0.0,0.0,0.0,0.0,0.0,0.0,0.0,0.0,0.0,0.0,0.0,0.0,0.0,0.0,0.0,0.0,5.0,2.0,5.0,,0.0,1.0,2.0,1.0,,1.0,3.0,5.0,3.0,2.0,0.0,1.0,,1.0,1.0,1.0,2.0,2.0,1.0,2.0,4.0,1.0,3.0,4.0,5.0,1.0,4.0,5.0,5.0,5.0,5.0,1.0,5.0,5.0,4.0,5.0,2.0,5.0,5.0,4.0,5.0,3.0,0.0,5.0,5.0,5.0,5.0,5.0,5.0,5.0,2.0,0.0,4.0,5.0,5.0,5.0,1.0,4.0,5.0,5.0,5.0,5.0,5.0,5.0,5.0,5.0,4.0,5.0,5.0,5.0,5.0,3.0,3.0,5.0,7.0,6.0,3.0,7.0,1.0,1.0,6.0,4.0,2.0,5.0,3.0,1.0,1.0,5.0,6.0,1.0,3.0,5.0,2.0,5.0,5.0,5.0,5.0,5.0,5.0,5.0,1.0,5.0,1.0,5.0,5.0,5.0,5.0,5.0,5.0,5.0,5.0,5.0,3.0,5.0,4.0,5.0,2.0,5.0,5.0,5.0,5.0,5.0,5.0,5.0,2.0,4.0,5.0,5.0,5.0,5.0,5.0,5.0,5.0,5.0,5.0,5.0,5.0,2.0,5.0,5.0,3.0,3.0,11.0,4.0,2.0,10.0,,1.0,2.0,3.0,0.0,3.0,0.0,3.0,2.0,3.0,11.0,3.0,1.0,10.0,2.0,4.0,8.0,16.0,4.0,1.0,14.0,0.0,0.0,2.0,0.0,1.0,8.0,1.0,3.0,6.0,2.0,3.0,2.0,5.0,3.0,3.0,3.0,2.0,0.0,1.0,3.0,1.0,7.0,7.0,6.0,8.0,3.0,9.0,5.0,4.0,1.0,0.0,9.0,1.0,4.0,2.0,3.0,2.0,11.0,1.0,0.0,1.0,6.0,5.0,3.0,3.0,9.0,4.0,0.0,1.0,6.0,0.0,0.0,4.0,7.0,7.0,4.0,9.0,0.0,3.0,4.0,0.0,4.0,2.0,3.0,4.0,4.0,1.0,8.0,4.0,6.0,4.0,4.0,2.0,1.0,10.0,3.0,15.0,7.0,7.0,4.0,10.0,3.0,4.0,3.0,0.0,0.0,1.0,5.0,4.0,0.0,4.0,4.0,1.0,0.0,4.0,0.0,2.0,3.0,1.0,0.0,2.0,0.0,1.0,3.0,4.0,4.0,7.0,5.0,6.0,1.0,2.0,2.0,4.0,4.0,3.0,2.0,4.0,4.0,7.0,9.0,0.0,0.0,1.0,0.0,9.0,12.0,14.0,12.0,3.0,13.0,6.0,6.0,15.0,5.0,6.0,6.0,5.0,4.0,2.0,6.0,0.0,5.0,0.0,3.0,3.0,8.0,4.0,8.0,9.0,4.0,2.0,1.0,5.0,1.0,4.0,0.0,3.0,7.0,10.0,8.0,7.0,5.0,4.0,12.0,20.0,39.0,11.0,2.0,15.0,25.0,22.0,23.0,5.0,7.0,22.0,16.0,5.0,15.0,0.0,12.0,19.0,10.0,29.0,14.0,6.0,23.0,21.0,9.0,6.0,12.0,2.0,14.0,8.0,58.0,18.0,19.0,17.0,4.0,5.0,3.0,1.0,5.0,3.0,5.0,5.0,5.0,5.0,5.0,5.0,1.0,5.0,1.0,5.0,4.0,1.0,5.0,5.0,5.0,5.0,0.0,5.0,5.0,5.0,5.0,5.0,5.0,3.0,4.0,5.0,5.0,5.0,5.0,5.0,5.0,5.0,4.0,5.0,5.0,5.0,5.0,3.0,3.0,19.0,1.0,0.0,14.0,0.0,1.0,0.0,16.0,12.0,3.0,0.0,0.0,5.0,6.0,7.0,4.0,1.0,8.0,0.0,28.0,35.0,31.0,9.0,17.0,2.0,1.0,0.0,1.0,2.0,0.0,2.0,2.0,21.0,0.0,9.0,9.0,13.0,12.0,15.0,4.0,2.0,18.0,20.0,0.0,21.0,19.0,9.0,24.0,19.0,5.0,9.0,7.0,15.0,0.0,0.0,21.0,18.0,15.0,40.0,4.0,0.0,6.0,3.0,0.0,0.0,1.0,4.0,31.0,27.0,13.0,2.0,5.0,8.0,4.0,12.0,3.0,3.0,6.0,3.0,8.0,6.0,1.0,4.0,12.0,14.0,5.0,5.0,5.0,5.0,5.0,5.0,4.0,3.0,2.0,16.0,8.0,11.0,5.0,14.0,10.0,9.0,16.0,9.0,10.0,3.0,0.0,3.0,3.0,2.0,3.0,0.0,0.0,0.0,4.0,3.0,2.0,2.0,2.0,2.0,3.0,2.0,0.0,7.0,2.0,5.0,5.0,2.0,16.0,2.0,46.0,6.0,2.0,2.0,2.0,0.0,5.0,4.0,0.0,0.0,0.0,0.0,1.0,2.0,2.0,1.0,3.0,1.0,0.0,1.0,0.0,0.0,1.0,0.0,0.0,0.0,1.0,1.0,1.0,0.0,1.0,1.0,1.0,0.0,0.0,1.0,1.0,1.0,1.0,2.0,1.0,0.0,0.0,1.0,0.0,2.0,2.0,0.0,1.0,5.0,1.0,1.0,1.0,1.0,1.0,2.0,1.0,0.0,1.0,1.0,0.0,1.0,2.0,1.0,1.0,1.0,0.0,3.0,1.0,0.0,0.0,1.0,1.0,1.0,1.0,0.0,1.0,0.0,0.0,1.0,0.0,1.0,0.0,0.0,1.0,0.0,1.0,0.0,1.0,1.0,1.0,2.0,0.0,4.0,3.0,2.0,3.0,0.0,7.0,0.0,4.0,1.0,9.0,0.0,2.0,1.0,0.0,0.0,0.0,0.0,1.0,0.0,1.0,1.0,0.0,0.0,0.0,2.0,1.0,1.0,4.0,1.0,1.0,2.0,2.0,7.0,0.0,2.0,0.0,0.0,2.0,4.0,0.0,2.0,1.0,1.0,1.0,2.0,1.0,2.0,0.0,6.0,2.0,0.0,0.0,1.0,1.0,0.0,2.0,2.0,0.0,1.0,4.0,3.0,0.0,0.0,9.0,7.0,1.0,0.0,0.0,0.0,0.0,1.0,1.0,1.0,4.0,0.0,0.0,0.0,2.0,0.0,1.0,0.0,0.0,1.0,0.0,0.0,0.0,0.0,4.0,0.0,2.0,1.0,1.0,2.0,1.0,11.0,1.0,0.0,0.0,0.0,0.0,0.0,2.0,2.0,2.0,4.0,0.0,0.0,4.0,0.0,10.0,0.0,0.0,0.0,0.0,0.0,0.0,2.0,1.0,0.0,7.0,0.0,0.0,5.0,0.0,2.0,0.0,0.0,0.0,1.0,0.0,0.0,0.0,0.0,0.0,0.0,0.0,6.0,4.0,3.0,3.0,6.0,4.0,4.0,2.0,8.0,2.0,1.0,2.0,3.0,3.0,4.0,6.0,5.0,5.0,2.0,0.0,2.0,2.0,3.0,3.0,4.0,5.0,4.0,0.0,5.0,3.0,2.0,18.0,12.0,9.0,9.0,15.0,10.0,12.0,5.0,7.0,7.0,16.0,8.0,12.0,11.0,9.0,9.0,8.0,5.0,5.0,5.0,5.0,5.0,5.0,5.0,2.0,5.0,1.0,2.0,2.0,3.0,0.0,3.0,3.0,0.0,9.0,1.0,4.0,6.0,0.0,7.0,2.0,1.0,1.0,4.0,5.0,0.0,5.0,3.0,2.0,5.0,4.0,6.0,2.0,3.0,5.0,9.0,2.0,1.0,2.0,7.0,2.0,2.0,6.0,3.0,3.0,7.0,2.0,5.0,2.0,1.0,2.0,9.0,0.0,0.0,1.0,0.0,7.0,0.0,5.0,2.0,5.0,5.0,5.0,4.0,3.0,0.0,5.0,5.0,2.0,5.0,0.0,5.0,5.0,5.0,5.0,5.0,5.0,5.0,3.0,5.0,4.0,1.0,0.0,4.0,4.0,5.0,5.0,5.0,3.0,5.0,5.0,5.0,5.0,1.0,5.0,5.0,5.0,4.0,5.0,4.0,4.0,2.0,4.0,5.0,5.0,5.0,5.0,4.0,5.0,5.0,4.0,5.0,2.0,4.0,3.0,4.0,5.0,5.0,5.0,5.0,5.0,2.0,5.0,4.0,5.0,4.0,5.0,4.0,5.0,5.0,4.0,5.0,4.0,4.0,5.0,5.0,5.0,5.0,4.0,5.0,4.0,5.0,5.0,4.0,5.0,5.0,4.0,4.0,5.0,3.0,2.0,3.0,5.0,5.0,5.0,5.0,5.0,5.0,5.0,5.0,3.0,5.0,5.0,4.0,5.0,2.0,5.0,4.0,3.0,5.0,2.0,5.0,5.0,5.0,5.0,4.0,0.0,5.0,0.0,0.0,0.0,0.0,3.0,2.0,7.0,11.0,27.0,29.0,13.0,5.0,19.0,15.0,3.0,8.0,5.0,7.0,8.0,5.0,9.0,19.0,24.0,13.0,3.0,12.0,19.0,30.0,13.0,13.0,11.0,21.0,18.0,28.0,5.0,8.0,15.0,4.0,21.0,2.0,6.0,14.0,26.0,18.0,11.0,5.0,11.0,15.0,3.0,5.0,22.0,16.0,1.0,15.0,2.0,6.0,4.0,4.0,7.0,3.0,13.0,9.0,0.0,8.0,7.0,5.0,5.0,7.0,7.0,13.0,11.0,1.0,19.0,15.0,20.0,14.0,16.0,8.0,8.0,3.0,10.0,12.0,5.0,1.0,5.0,1.0,2.0,13.0,6.0,14.0,4.0,1.0,15.0,14.0,15.0,5.0,11.0,7.0,15.0,9.0,14.0,7.0,17.0,7.0,22.0,7.0,4.0,2.0,14.0,22.0,21.0,8.0,17.0,18.0,12.0,14.0,4.0,22.0,16.0,14.0,15.0,7.0,16.0,9.0,15.0,11.0,9.0,33.0,36.0,7.0,10.0,17.0,22.0,21.0,13.0,1.0,24.0,3.0,8.0,17.0,20.0,17.0,16.0,13.0,6.0,13.0,16.0,4.0,15.0,12.0,6.0,23.0,42.0,4.0,4.0,13.0,13.0,15.0,15.0,2.0,16.0,1.0,13.0,7.0,11.0,6.0,10.0,9.0,14.0,5.0,7.0,12.0,8.0,10.0,8.0,3.0,13.0,9.0,19.0,5.0,6.0,11.0,1.0,19.0,8.0,22.0,4.0,23.0,7.0,7.0,19.0,30.0,8.0,15.0,11.0,10.0,12.0,17.0,11.0,3.0,16.0,31.0,5.0,2.0,10.0,8.0,5.0,11.0,1.0,17.0,11.0,5.0,19.0,1.0,16.0,11.0,8.0,4.0,16.0,13.0,8.0,0.0,2.0,11.0,11.0,6.0,17.0,15.0,10.0,2.0,13.0,2.0,9.0,9.0,20.0,17.0,15.0,7.0,8.0,8.0,9.0,15.0,15.0,17.0,6.0,14.0,16.0,10.0,4.0,20.0,1.0,3.0,25.0,5.0,2.0,19.0,29.0,11.0,8.0,2.0,11.0,12.0,14.0,18.0,23.0,21.0,15.0,10.0,7.0,3.0,6.0,27.0,15.0,15.0,11.0,13.0,31.0,7.0,11.0,8.0,13.0,5.0,1.0,10.0,7.0,14.0,7.0,11.0,19.0,37.0,10.0,8.0,10.0,15.0,5.0,6.0,11.0,11.0,5.0,17.0,6.0,15.0,5.0,8.0,4.0,7.0,4.0,1.0,19.0,2.0,27.0,11.0,14.0,2.0,9.0,23.0,9.0,4.0,8.0,3.0,13.0,13.0,5.0,12.0,6.0,17.0,13.0,16.0,7.0,16.0,18.0,27.0,5.0,20.0,14.0,13.0,11.0,3.0,14.0,4.0,15.0,12.0,20.0,12.0,13.0,2.0,5.0,7.0,17.0,14.0,10.0,23.0,10.0,15.0,6.0,13.0,6.0,4.0,1.0,1.0,3.0,2.0,1.0,5.0,1.0,0.0,0.0,0.0,0.0,1.0,4.0,1.0,2.0,4.0,0.0,1.0,0.0,1.0,0.0,1.0,1.0,0.0,0.0,5.0,1.0,0.0,1.0,5.0,1.0,,3.0,5.0,5.0,0.0,0.0,0.0,1.0,0.0,2.0,0.0,4.0,2.0,0.0,2.0,0.0,1.0,1.0,1.0,0.0,0.0,2.0,1.0,0.0,1.0,0.0,3.0,0.0,1.0,1.0,3.0,5.0,2.0,1.0,0.0,1.0,1.0,5.0,1.0,0.0,0.0,2.0,0.0,2.0,0.0,1.0,1.0,1.0,3.0,2.0,4.0,0.0,0.0,0.0,0.0,0.0,0.0,5.0,1.0,0.0,0.0,0.0,1.0,2.0,4.0,1.0,0.0,3.0,1.0,3.0,2.0,1.0,0.0,1.0,0.0,0.0,5.0,0.0,3.0,2.0,0.0,1.0,4.0,5.0,1.0,4.0,1.0,2.0,2.0,0.0,2.0,3.0,4.0,10.0,1.0,1.0,0.0,5.0,4.0,2.0,5.8,1.0,0.0,0.0,1.0,8.0,1.0,3.0,1.0,4.0,6.0,3.0,7.0,1.0,5.0,14.0,0.0,5.0,1.0,6.0,0.0,0.0,5.0,1.0,3.0,2.0,4.0,10.0,2.0,6.0,8.0,1.0,5.0,0.0,3.0,4.0,3.0,2.0,6.0,0.0,7.0,6.0,10.0,2.0,4.0,1.0,8.0,6.0,2.0,0.0,8.0,4.0,1.0,2.0,2.0,6.0,5.0,3.0,2.0,5.0,4.0,5.0,5.0,4.0,3.0,0.0,10.0,1.0,0.0,4.0,5.0,5.0,1.0,2.0,1.0,5.0,6.0,0.0,3.0,2.0,6.0,3.0,0.0,3.0,0.0,2.0,2.0,2.0,2.0,8.0,3.0,4.0,1.0,3.0,5.0,2.0,6.0,14.0,3.0,1.0,6.0,4.0,3.0,1.0,7.0,1.0,12.0,7.0,8.0,8.0,4.0,0.0,1.0,4.0,7.0,9.0,4.0,2.0,2.0,2.0,2.0,5.0,3.0,1.0,6.0,4.0,0.0,5.0,6.0,0.0,2.0,4.0,3.0,4.0,1.0,2.0,6.0,6.0,5.0,2.0,8.0,4.0,9.0,2.0,4.0,7.0,2.0,3.0,13.0,14.0,0.0,0.0,1.0,4.0,2.0,7.0,3.0,3.0,1.0,2.0,4.0,4.0,6.0,1.0,1.0,2.0,0.0,9.0,3.0,7.0,5.0,4.0,2.0,2.0,1.0,4.0,5.0,3.0,9.0,3.0,0.0,10.0,2.0,14.0,0.0,1.0,13.0,6.0,12.0,19.0,9.0,10.0,14.0,10.0,7.0,22.0,2.0,10.0,6.0,0.0,15.0,2.0,6.0,9.0,15.0,15.0,11.0,6.0,8.0,4.0,3.0,3.0,1.0,8.0,8.0,1.0,3.0,5.0,6.0,5.0,1.0,9.0,8.0,13.0,13.0,19.0,11.0,12.0,3.0,22.0,18.0,5.0,9.0,2.0,16.0,3.0,7.0,13.0,14.0,0.0,7.0,3.0,10.0,7.0,6.0,20.0,30.0,15.0,7.0,8.0,27.0,4.0,8.0,6.0,12.0,26.0,27.0,17.0,8.0,4.0,4.0,6.0,5.0,12.0,14.0,10.0,5.0,5.0,20.0,15.0,4.0,5.0,15.0,10.0,0.0,7.0,4.0,5.0,8.0,9.0,4.0,5.0,0.0,9.0,15.0,17.0,2.0,16.0,14.0,0.0,15.0,9.0,3.0,3.0,2.0,19.0,15.0,3.0,1.0,13.0,8.0,2.0,15.0,15.0,17.0,4.0,14.0,19.0,20.0,17.0,20.0,13.0,7.0,14.0,20.0,18.0,11.0,16.0,5.0,0.0,7.0,6.0,4.0,7.0,4.0,17.0,6.0,6.0,7.0,15.0,3.0,13.0,7.0,0.0,1.0,17.0,7.0,19.0,13.0,14.0,6.0,5.0,2.0,18.0,9.0,5.0,2.0,1.0,6.0,7.0,12.0,3.0,2.0,6.0,8.0,10.0,13.0,12.0,13.0,6.0,14.0,16.0,1.0,2.0,3.0,9.0,14.0,10.0,13.0,13.0,1.0,1.0,17.0,8.0,10.0,10.0,10.0,5.0,9.0,8.0,8.0,5.0,4.0,2.0,12.0,15.0,2.0,5.0,16.0,14.0,0.0,9.0,1.0,8.0,15.0,13.0,8.0,14.0,15.0,10.0,9.0,5.0,14.0,7.0,12.0,15.0,6.0,19.0,10.0,18.0,2.0,5.0,7.0,4.0,1.0,2.0,1.0,13.0,10.0,2.0,3.0,19.0,1.0,15.0,5.0,3.0,0.0,7.0,6.0,7.0,5.0,11.0,9.0,9.0,16.0,5.0,7.0,21.0,3.0,4.0,16.0,0.0,8.0,5.0,8.0,6.0,9.0,15.0,16.0,5.0,1.0,5.0,10.0,13.0,7.0,11.0,5.0,10.0,11.0,24.0,9.0,6.0,13.0,7.0,8.0,11.0,6.0,11.0,7.0,9.0,8.0,16.0,10.0,12.0,11.0,11.0,8.0,10.0,8.0,9.0,0.0,0.0,0.0,0.0,0.0,0.0,16.0,6.0,0.0,3.0,3.0,1.0,18.0,26.0,7.0,2.0,2.0,2.0,9.0,7.0,20.0,15.0,8.0,12.0,0.0,0.0,1.0,11.0,7.0,8.0,12.0,13.0,11.0,3.0,3.0,11.0,4.0,0.0,4.0,3.0,10.0,14.0,7.0,16.0,2.0,15.0,2.0,4.0,6.0,8.0,0.0,1.0,8.0,14.0,13.0,4.0,2.0,5.0,5.0,3.0,2.0,6.0,3.0,2.0,19.0,7.0,10.0,28.0,0.0,4.0,5.0,12.0,0.0,12.0,5.0,0.0,15.0,3.0,2.0,15.0,10.0,16.0,8.0,7.0,2.0,9.0,6.0,2.0,5.0,6.0,2.0,0.0,4.0,8.0,8.0,3.0,1.0,2.0,6.0,11.0,41.0,21.0,22.0,9.0,21.0,3.0,0.0,18.0,9.0,8.0,17.0,0.0,21.0,13.0,8.0,25.0,9.0,12.0,8.0,1.0,1.0,0.0,6.0,7.0,9.0,12.0,3.0,0.0,12.0,5.0,2.0,10.0,13.0,3.0,3.0,4.0,8.0,43.0,6.0,10.0,2.0,19.0,5.0,0.0,22.0,0.0,2.0,11.0,3.0,0.0,16.0,43.0,9.0,13.0,6.0,1.0,1.0,4.0,1.0,11.0,15.0,4.0,6.0,4.0,33.0,16.0,5.0,8.0,3.0,9.0,2.0,8.0,2.0,5.0,8.0,6.0,0.0,5.0,17.0,2.0,7.0,7.0,1.0,2.0,11.0,10.0,18.0,17.0,4.0,6.0,9.0,21.0,8.0,1.0,0.0,12.0,1.0,4.0,15.0,2.0,7.0,1.0,1.0,5.0,14.0,8.0,1.0,4.0,4.0,2.0,4.0,5.0,18.0,7.0,7.0,4.0,4.0,7.0,1.0,12.0,4.0,9.0,5.0,2.0,3.0,0.0,23.0,4.0,3.0,5.0,9.0,0.0,4.0,18.0,6.0,8.0,22.0,3.0,2.0,2.0,12.0,3.0,4.5,21.0,7.0,2.0,23.0,1.0,1.0,4.0,10.0,0.0,8.0,2.0,7.0,18.0,5.0,3.0,3.0,8.0,4.0,2.0,18.0,22.0,10.0,14.0,2.0,7.0,10.0,27.0,2.0,3.0,3.0,5.0,8.0,41.0,0.0,8.0,6.0,14.0,3.0,5.0,14.0,2.0,0.0,0.0,25.0,6.0,18.0,10.0,1.0,4.0,18.0,0.0,1.0,2.0,8.0,13.0,32.0,1.0,6.0,0.0,3.0,6.0,3.0,8.0,0.0,13.0,6.0,6.0,8.0,10.0,2.0,3.0,4.0,12.0,0.0,2.0,8.0,8.0,4.0,5.0,2.0,5.0,2.0,1.0,0.0,5.0,5.0,5.0,1.0,1.0,3.0,7.0,7.0,10.0,2.0,5.0,11.0,2.0,5.0,3.0,3.0,13.0,12.0,2.0,19.0,13.0,3.0,3.0,6.0,36.0,0.0,8.0,7.0,19.0,4.0,12.0,5.0,2.0,10.0,10.0,2.0,5.0,3.0,1.0,3.0,7.0,10.0,5.0,5.0,3.0,10.0,3.0,3.0,5.0,3.0,5.0,5.0,29.0,3.0,14.0,23.0,5.0,42.0,8.0,2.0,4.0,2.0,5.0,14.0,4.0,1.0,13.0,9.0,0.0,0.0,1.0,10.0,21.0,26.0,6.0,2.0,15.0,3.0,16.0,4.0,7.0,20.0,10.0,8.0,0.0,17.0,7.0,1.0,6.0,14.0,11.0,5.0,7.0,1.0,0.0,4.0,9.0,8.0,14.0,6.0,1.0,12.0,10.0,0.0,11.0,19.0,3.0,12.0,0.0,7.0,11.0,6.0,13.0,9.0,23.0,5.0,13.0,2.0,23.0,10.0,5.0,19.0,5.0,0.0,6.0,13.0,3.0,14.0,10.0,5.0,14.0,27.0,31.0,35.0,8.0,25.0,5.0,12.0,16.0,4.0,1.0,6.0,7.0,3.0,2.0,5.0,0.0,2.0,5.0,3.0,5.0,1.0,5.0,12.0,8.0,7.0,4.0,0.0,14.0,1.0,4.0,23.0,6.0,7.0,1.0,5.0,11.0,16.0,21.0,5.0,2.0,6.0,10.0,8.0,6.0,19.0,3.0,2.0,5.0,27.0,10.0,28.0,5.0,2.0,0.0,2.0,9.0,0.0,6.0,0.0,3.0,5.0,14.0,5.0,4.0,8.0,13.0,13.0,11.0,4.0,2.0,16.0,8.0,17.0,1.0,7.0,8.0,1.0,4.0,6.0,9.0,0.0,4.0,1.0,12.0,11.0,0.0,10.0,9.0,2.0,4.0,12.0,52.0,7.0,10.0,10.0,8.75,12.0,7.0,5.0,3.0,6.0,3.0,4.0,9.0,14.0,5.0,4.0,11.0,1.0,3.0,18.0,16.0,1.0,6.0,9.0,2.0,4.0,17.0,5.0,3.0,4.0,2.0,6.0,4.0,2.0,4.0,10.0,4.0,6.0,2.0,6.0,25.0,4.0,2.0,11.0,7.0,11.0,3.0,3.0,5.0,19.0,8.0,2.0,3.0,6.0,0.0,5.0,5.0,8.0,0.0,1.0,3.0,9.0,3.0,1.0,9.0,3.0,3.0,3.0,4.0,5.0,18.0,2.0,8.0,6.0,1.0,4.0,6.0,11.0,0.0,6.0,2.0,0.0,3.0,2.0,0.0,6.0,4.0,8.0,6.0,3.0,26.0,24.0,21.0,25.0,1.0,3.0,0.0,8.0,12.0,6.0,7.0,0.0,11.0,1.0,5.0,3.0,3.0,9.0,4.0,2.0,28.0,4.0,9.0,4.0,6.0,6.0,14.0,5.0,7.0,5.0,1.0,3.0,3.0,2.0,11.0,13.0,9.0,17.0,8.0,6.0,4.0,5.0,31.0,2.0,15.0,7.0,14.0,25.0,1.0,2.0,2.0,1.0,1.0,14.0,11.0,4.0,8.0,3.0,4.0,25.0,1.0,12.0,5.0,12.0,16.0,4.0,4.0,0.0,0.0,32.0,5.0,0.0,6.0,16.0,5.0,0.0,4.0,7.0,5.0,3.0,9.0,4.0,23.0,5.0,3.0,3.0,10.0,13.0,1.0,19.0,7.0,2.0,4.0,8.0,7.0,5.0,3.0,15.0,3.0,2.0,1.0,2.0,17.0,5.0,17.0,16.0,5.0,14.0,6.0,16.0,20.0,56.0,5.0,2.0,3.0,4.0,13.0,11.0,6.0,4.0,3.0,18.0,14.0,7.0,6.0,8.0,2.0,6.0,5.0,2.0,8.0,1.0,7.0,17.0,8.0,11.0,9.0,2.0,11.0,23.0,33.0,2.0,8.0,6.0,12.0,7.0,8.0,3.0,10.0,12.0,6.0,10.0,11.0,0.0,34.0,4.0,6.0,3.0,2.0,5.0,4.0,6.0,7.0,4.0,8.0,5.0,6.0,7.0,10.0,17.0,8.0,2.0,7.0,2.0,5.0,33.0,6.0,7.0,6.0,2.0,2.0,8.0,2.0,3.0,17.0,4.0,3.0,12.0,8.0,7.0,2.0,8.0,10.0,1.0,9.0,8.0,17.0,19.0,3.0,8.0,5.0,15.0,2.0,0.0,4.0,4.0,8.0,4.0,6.0,17.0,11.0,11.0,4.0,7.0,0.0,5.0,9.0,6.0,7.0,19.0,3.0,4.0,22.0,8.0,6.0,6.0,5.0,7.0,6.0,2.0,5.0,6.0,0.0,13.0,2.0,10.0,41.0,7.0,4.0,2.0,24.0,38.0,1.0,30.0,15.0,14.0,6.0,3.0,6.0,15.0,5.0,2.0,5.0,14.0,6.0,9.0,19.0,5.0,13.0,14.0,23.0,1.0,9.0,3.0,1.0,14.0,9.0,23.0,10.0,1.0,4.0,15.0,11.0,0.0,8.0,1.0,1.0,7.0,16.0,19.0,7.0,3.0,3.0,14.0,14.0,1.0,7.0,2.0,3.0,2.0,10.0,2.0,9.0,16.0,3.0,17.0,17.0,9.0,1.0,13.0,1.0,9.0,7.0,6.0,8.0,15.0,6.0,8.0,4.0,11.0,5.0,5.0,13.0,38.0,16.0,9.0,8.0,21.0,6.0,4.0,22.0,1.0,8.5,4.0,0.0,4.0,5.0,11.0,7.0,5.0,11.0,5.0,8.0,11.0,8.0,17.0,9.0,12.0,23.0,14.0,3.0,11.0,2.0,2.0,0.0,5.0,9.5,10.0,12.0,1.0,6.0,3.0,28.0,21.0,15.0,12.0,2.0,5.0,0.0,4.0,0.0,12.0,38.0,14.0,4.0,5.0,18.0,1.0,6.0,14.0,7.0,7.0,16.0,5.0,0.0,27.0,1.0,19.0,10.0,10.0,7.5,25.0,7.0,6.0,3.0,35.0,52.0,7.0,6.0,4.0,9.0,5.0,2.0,2.0,11.0,19.0,21.0,5.0,21.0,18.0,2.0,2.0,4.0,6.0,23.0,20.0,22.0,5.0,15.0,24.0,5.0,1.0,10.0,3.0,8.0,7.0,2.0,12.0,0.0,4.0,0.0,21.0,14.0,11.0,2.0,17.0,4.0,0.0,28.0,1.0,,7.0,2.0,12.0,0.0,18.0,19.0,2.0,18.0,6.0,14.0,6.0,19.0,17.0,6.0,3.0,2.0,2.0,2.0,0.0,1.0,1.0,5.0,0.0,26.0,41.0,22.0,1.0,2.0,0.0,1.0,10.0,9.0,4.0,7.0,9.0,6.0,11.0,6.0,7.0,4.0,6.0,14.0,2.0,8.0,15.0,25.0,4.0,5.0,15.0,11.0,2.0,7.0,6.0,7.0,19.0,4.0,8.0,9.0,5.0,2.0,1.0,2.0,3.0,10.0,4.0,5.0,17.0,2.0,20.0,14.0,4.0,5.0,7.0,13.0,1.0,28.0,38.0,5.0,15.0,8.0,7.0,3.0,35.0,21.0,4.0,8.0,0.0,11.0,5.0,5.0,0.0,3.0,5.0,4.0,0.0,2.0,5.0,5.0,1.0,12.0,5.0,4.0,1.0,3.0,8.0,3.0,18.0,9.0,2.0,11.0,33.0,13.0,7.0,1.0,18.0,24.0,16.0,10.0,17.0,6.0,8.0,19.0,11.0,5.0,11.0,16.0,0.0,4.0,7.0,7.0,2.0,10.0,0.0,13.0,10.0,11.0,4.0,5.0,10.0,6.0,5.0,3.0,8.0,10.0,4.0,7.0,3.0,4.0,0.0,7.0,17.0,2.0,6.0,16.0,6.0,5.0,7.0,7.0,8.0,35.0,0.0,20.0,11.0,7.0,2.0,21.0,1.0,9.0,0.0,11.0,5.0,1.0,3.0,15.0,0.0,20.0,4.0,2.0,0.0,3.0,1.0,3.0,4.0,0.0,3.0,4.0,1.0,10.0,7.0,6.0,0.0,18.0,4.0,0.0,4.0,1.0,5.0,2.0,8.0,19.0,0.0,0.0,0.0,15.0,12.0,17.0,13.0,3.0,1.0,5.0,7.0,1.0,25.0,2.0,2.0,13.0,8.0,19.0,0.0,7.0,9.0,1.0,1.0,1.0,4.0,5.0,1.0,6.0,12.0,24.0,28.0,13.0,11.0,0.0,19.0,23.0,27.0,11.0,5.0,16.0,15.0,3.0,5.0,14.0,2.0,11.0,16.0,8.0,19.0,12.0,5.0,15.0,9.0,0.0,2.0,0.0,13.0,4.0,0.0,22.0,21.0,14.0,5.0,7.0,4.0,5.0,3.0,2.0,5.0,4.0,19.0,3.0,1.0,6.0,28.0,0.0,11.0,1.0,11.0,3.0,24.0,7.0,11.0,3.0,0.0,6.0,1.0,22.0,7.0,17.0,10.0,3.0,13.0,4.0,13.0,2.0,2.0,6.0,8.0,18.0,19.0,11.0,7.0,5.0,30.0,10.0,20.0,14.0,5.0,31.0,12.0,28.0,27.0,12.0,12.0,6.0,3.0,27.0,10.0,11.0,9.0,24.0,1.0,17.0,9.0,33.0,8.0,3.0,7.0,6.0,31.0,28.0,22.0,19.0,25.0,11.0,22.0,28.0,0.0,16.0,11.0,2.0,8.0,14.0,19.0,22.0,2.0,11.0,18.0,8.0,6.0,13.0,29.0,3.0,12.0,5.0,4.0,24.0,15.0,5.0,0.0,6.0,20.0,7.0,19.0,13.0,10.0,14.0,11.0,18.0,13.0,16.0,9.0,0.0,11.0,0.0,9.0,9.0,19.0,4.0,14.0,9.0,6.0,12.0,14.0,14.0,6.0,21.0,3.0,3.0,10.0,6.0,8.0,9.0,25.0,25.0,8.0,14.0,6.0,5.0,12.0,5.0,14.0,13.0,4.0,16.0,4.0,6.0,0.0,6.0,9.0,18.0,8.0,16.0,6.0,23.0,27.0,32.0,6.0,31.0,13.0,15.0,15.0,13.0,13.0,13.0,17.0,7.0,9.0,8.0,27.0,12.0,18.0,3.0,20.0,23.0,2.0,14.0,11.0,30.0,8.0,21.0,17.0,5.0,9.0,12.0,28.0,1.0,11.0,12.0,20.0,13.0,11.0,4.0,6.0,24.0,14.0,2.0,21.0,7.0,13.0,20.0,12.0,12.0,6.0,16.0,32.0,10.0,6.0,10.0,18.0,9.0,6.0,6.0,19.0,22.0,21.0,20.0,0.0,12.0,2.0,24.0,16.0,11.0,15.0,7.0,5.0,29.0,21.0,22.0,23.0,11.0,9.0,7.0,7.0,10.0,2.0,3.0,13.0,14.0,13.0,8.0,7.0,21.0,33.0,13.0,10.0,16.0,11.0,23.0,3.0,5.0,5.0,20.0,3.0,9.0,5.0,15.0,10.0,21.0,9.0,4.0,4.0,15.0,4.0,9.0,9.0,12.0,7.0,13.0,8.0,16.0,14.0,11.0,18.0,8.0,21.0,16.0,10.0,25.0,8.0,8.0,11.0,1.0,9.0,8.0,18.0,5.0,25.0,24.0,6.0,9.0,13.0,6.0,7.0,6.0,16.0,7.0,12.0,19.0,13.0,22.0,10.0,11.0,7.0,4.0,8.0,6.0,1.0,24.0,8.0,19.0,20.0,11.0,16.0,26.0,18.0,21.0,19.0,8.0,10.0,10.0,2.0,20.0,19.0,25.0,7.0,3.0,7.0,2.0,8.0,7.0,5.0,10.0,3.0,7.0,6.0,7.0,9.0,11.0,4.0,6.0,7.0,5.0,16.0,22.0,4.0,7.0,8.0,15.0,6.0,8.0,7.0,6.0,6.0,6.0,7.0,6.0,6.0,5.0,6.0,7.0,5.0,6.0,6.0,5.0,2.0,0.0,4.0,0.0,3.0,3.0,7.0,5.0,1.0,7.0,1.0,0.0,3.0,11.0,11.0,1.0,15.0,15.0,10.0,15.0,7.0,15.0,17.0,6.0,5.0,13.0,4.0,5.0,4.0,10.0,8.0,2.0,1.0,2.0,0.0,0.0,7.0,13.0,5.0,8.0,1.0,13.0,4.0,1.0,3.0,16.0,12.0,11.0,0.0,3.0,10.0,10.0,7.0,6.0,1.0,5.0,4.0,7.0,12.0,12.0,18.0,1.0,3.0,7.0,3.0,3.0,4.0,7.0,5.0,6.0,4.0,4.0,2.0,4.0,3.0,3.0,8.0,2.0,10.0,9.0,9.0,11.0,3.0,3.0,6.0,1.0,8.0,7.0,0.0,,5.0,9.0,0.0,2.0,1.0,5.0,3.0,3.0,0.0,3.0,0.0,0.0,1.0,2.0,0.0,0.0,4.0,7.0,9.0,7.0,3.0,2.0,2.0,3.0,10.0,8.0,26.0,13.0,2.0,7.0,0.0,7.0,13.0,18.0,7.0,0.0,,4.0,8.0,12.0,10.0,12.0,7.0,16.0,,2.0,12.0,4.0,3.0,10.0,6.0,8.0,18.0,9.0,16.0,12.0,10.0,13.0,6.0,0.0,5.0,4.0,6.0,17.0,13.0,8.0,1.0,10.0,5.0,8.0,3.0,8.0,8.0,27.0,4.0,5.0,2.0,1.0,16.0,2.0,0.0,4.0,8.0,14.0,5.0,5.0,1.0,11.0,2.0,7.0,17.0,7.0,20.0,4.0,4.0,1.0,20.0,10.0,11.0,11.0,11.0,5.0,6.0,18.0,14.0,9.0,2.0,8.0,12.0,8.0,12.0,4.0,14.0,6.0,12.0,7.0,12.0,3.0,13.0,8.0,14.0,26.0,10.0,15.0,11.0,2.0,19.0,3.0,15.0,12.0,18.0,,1.0,0.0,10.0,6.0,,3.0,3.0,11.0,6.0,14.0,3.0,16.0,5.0,11.0,17.0,13.0,3.0,7.0,5.0,13.0,12.0,1.0,3.0,6.0,0.0,4.0,6.0,12.0,4.0,3.0,1.0,16.0,9.0,3.0,1.0,33.0,13.0,19.0,6.0,6.0,1.0,0.0,0.0,14.0,6.0,11.0,10.0,12.0,6.0,13.0,4.0,6.0,1.0,5.0,10.0,0.0,10.0,4.0,11.0,10.0,10.0,1.0,2.0,10.0,6.0,2.0,4.0,7.0,4.0,6.0,4.0,5.0,3.0,2.0,5.0,3.0,5.0,5.0,0.0,5.0,7.0,9.0,5.0,6.0,0.0,5.0,5.0,4.0,3.0,0.0,3.0,4.0,8.0,2.0,5.0,5.0,3.0,2.0,4.0,3.0,9.0,9.0,0.0,2.0,13.0,8.0,7.0,17.0,5.0,1.0,0.0,9.0,5.0,4.0,10.0,13.0,6.0,8.0,17.0,13.0,8.0,15.0,10.0,6.0,4.0,18.0,7.0,8.0,0.0,3.0,22.0,13.0,14.0,1.0,3.0,1.0,8.0,0.0,0.0,10.0,2.0,0.0,0.0,4.0,5.0,14.0,2.0,8.0,8.0,5.0,4.0,1.0,0.0,0.0,4.0,5.0,0.0,7.0,1.0,8.0,4.0,1.0,4.0,1.0,9.0,5.0,11.0,3.0,7.0,0.0,0.0,5.0,10.0,9.0,10.0,5.0,3.0,8.0,0.0,7.0,15.0,8.0,3.0,21.0,13.0,8.0,1.0,3.0,4.0,5.0,7.0,5.0,11.0,9.0,6.0,1.0,8.0,8.0,7.0,1.0,4.0,14.0,4.0,7.0,6.0,16.0,9.0,8.0,11.0,11.0,21.0,4.0,2.0,9.0,6.0,1.0,6.0,0.0,5.0,8.0,6.0,9.0,4.0,10.0,13.0,4.0,13.0,8.0,4.0,2.0,7.0,9.0,9.0,10.0,11.0,5.0,13.0,14.0,12.0,10.0,27.0,1.0,3.0,12.0,4.0,9.0,2.0,9.0,6.0,1.0,7.0,15.0,9.0,10.0,8.0,6.0,8.0,2.0,5.0,1.0,6.0,10.0,2.0,2.0,0.0,6.0,8.0,5.0,1.0,9.0,11.0,9.0,9.0,0.0,6.0,8.0,0.0,1.0,1.0,5.0,7.0,0.0,11.0,27.0,0.0,2.0,4.0,0.0,1.0,1.0,20.0,1.0,2.0,0.0,5.0,1.0,10.0,22.0,5.0,0.0,0.0,16.0,7.0,2.0,0.0,11.0,2.0,0.0,2.0,2.0,10.0,3.0,12.0,2.0,3.0,16.0,4.0,10.0,15.0,2.0,1.0,1.0,1.0,2.0,1.0,0.0,3.0,0.0,4.0,6.0,2.0,1.0,8.0,2.0,2.0,0.0,4.0,0.0,3.0,5.0,0.0,9.0,1.0,11.0,1.0,3.0,6.0,3.0,2.0,10.0,1.0,0.0,20.0,1.0,2.0,1.0,5.0,5.0,4.0,8.0,5.0,2.0,0.0,5.0,16.0,1.0,7.0,1.0,8.0,7.0,2.0,0.0,3.0,4.0,0.0,16.0,12.0,10.0,0.0,21.0,1.0,22.0,38.0,15.0,9.0,14.0,14.0,17.0,13.0,27.0,12.0,16.0,14.0,19.0,13.0,8.0,27.0,6.0,14.0,15.0,10.0,2.0,10.0,5.0,11.0,29.0,6.0,2.0,2.0,20.0,1.0,6.0,36.0,1.0,4.0,11.0,8.0,7.0,3.0,0.0,2.0,7.0,17.0,11.0,32.0,4.0,10.0,17.0,0.0,1.0,2.0,11.0,0.0,0.0,2.0,0.0,17.0,21.0,9.0,10.0,26.0,2.0,0.0,20.0,12.0,0.0,0.0,6.0,7.0,3.0,3.0,4.0,1.0,1.0,1.0,3.0,9.0,8.0,1.0,1.0,13.0,0.0,6.0,1.0,11.0,16.0,3.0,14.0,4.0,7.0,16.0,10.0,0.0,8.0,15.0,15.0,31.0,2.0,12.0,4.0,13.0,7.0,18.0,8.0,14.0,6.0,5.0,8.0,0.0,7.0,4.0,3.0,4.0,10.0,9.0,6.0,6.0,3.0,0.0,11.0,12.0,12.0,13.0,10.0,4.0,7.0,19.0,23.0,1.0,1.0,10.0,6.0,14.0,8.0,1.0,7.0,5.0,1.0,11.0,14.0,5.0,15.0,9.0,11.0,25.0,31.0,2.0,4.0,3.0,5.0,4.0,1.0,8.0,8.0,5.0,7.0,5.0,13.0,1.0,11.0,14.0,7.0,10.0,0.0,11.0,2.0,5.0,15.0,0.0,4.0,12.0,13.0,2.0,22.0,4.0,0.0,5.0,2.0,6.0,13.0,13.0,24.0,0.0,20.0,2.0,7.0,6.0,11.0,4.0,3.0,0.0,8.0,1.0,4.0,0.0,4.0,0.0,8.0,8.0,1.0,2.0,0.0,3.0,0.0,0.0,7.0,14.0,13.0,0.0,2.0,1.0,1.0,10.0,2.0,3.0,1.0,6.0,0.0,0.0,4.0,5.0,5.0,0.0,3.0,1.0,2.0,6.0,12.0,7.0,14.0,9.0,1.0,14.0,3.0,16.0,13.0,2.0,8.0,4.0,7.0,8.0,0.0,12.0,13.0,14.0,5.0,10.0,0.0,0.0,0.0,19.0,8.0,6.0,6.0,7.0,8.0,0.0,5.0,5.0,8.0,6.0,13.0,5.0,5.0,4.0,3.0,11.0,8.0,3.0,7.0,4.0,8.0,11.0,4.0,7.0,3.0,6.0,11.0,7.0,2.0,9.0,5.0,2.0,10.0,3.0,10.0,5.0,4.0,4.0,3.0,5.0,5.0,6.0,3.0,6.0,7.0,3.0,2.0,5.0,4.0,5.0,2.0,4.0,10.0,6.0,5.0,9.0,4.0,5.0,6.0,7.0,7.0,3.0,9.0,10.0,5.0,5.0,4.0,6.0,4.0,13.0,10.0,3.0,7.0,12.0,14.0,8.0,8.0,0.0,9.0,5.0,5.0,12.0,4.0,4.0,5.0,4.0,0.0,15.0,23.0,4.0,1.0,15.0,8.0,16.0,8.0,13.0,21.0,13.0,5.0,1.0,7.0,5.0,16.0,16.0,17.0,13.0,9.0,15.0,0.0,2.0,17.0,18.0,4.0,5.0,5.0,0.0,8.0,8.0,5.0,3.0,12.0,10.0,9.0,18.0,9.0,1.0,7.0,5.0,13.0,3.0,13.0,12.0,13.0,19.0,9.0,18.0,16.0,9.0,6.0,4.0,10.0,3.0,9.0,13.0,14.0,4.0,8.0,12.0,17.0,7.0,9.0,14.0,7.0,1.0,6.0,10.0,5.0,7.0,10.0,14.0,8.0,15.0,9.0,5.0,11.0,16.0,23.0,28.0,8.0,11.0,13.0,8.0,7.0,5.0,11.0,18.0,17.0,13.0,13.0,4.0,25.0,11.0,20.0,11.0,12.0,5.0,7.0,8.0,3.0,6.0,13.0,10.0,11.0,10.0,14.0,19.0,7.0,14.0,11.0,17.0,12.0,3.0,3.0,12.0,0.0,0.0,8.0,10.0,0.0,19.0,14.0,22.0,4.0,15.0,7.0,8.0,2.0,3.0,7.0,8.0,0.0,10.0,5.0,5.0,6.0,5.0,16.0,16.0,8.0,12.0,4.0,10.0,6.0,7.0,18.0,7.0,7.0,6.0,5.0,7.0,14.0,5.0,18.0,3.0,9.0,5.0,9.0,10.0,15.0,12.0,6.0,3.0,8.0,5.0,5.0,2.0,9.0,10.0,13.0,6.0,12.0,1.0,10.0,10.0,4.0,5.0,3.0,3.0,5.0,5.0,4.0,18.0,7.0,14.0,12.0,5.0,9.0,6.0,8.0,5.0,0.0,2.0,9.0,6.0,12.0,1.0,9.0,13.0,10.0,5.0,1.0,1.0,1.0,0.0,6.0,4.0,14.0,13.0,4.0,8.0,6.0,5.0,7.0,6.0,1.0,9.0,16.0,14.0,8.0,1.0,7.0,11.0,5.0,0.0,4.0,0.0,8.0,2.0,7.0,11.0,15.0,11.0,12.0,13.0,2.0,5.0,6.0,9.0,12.0,9.0,8.0,9.0,3.0,0.0,7.0,8.0,8.0,4.0,7.0,13.0,2.0,7.0,7.0,4.0,8.0,8.0,10.0,6.0,10.0,10.0,2.0,5.0,0.0,10.0,0.0,11.0,2.0,5.0,12.0,16.0,6.0,8.0,5.0,2.0,13.0,9.0,6.0,10.0,3.0,7.0,15.0,3.0,0.0,3.0,0.0,1.0,0.0,0.0,0.0,1.0,0.0,3.0,0.0,0.0,0.0,1.0,1.0,5.0,1.0,0.0,0.0,2.0,0.0,0.0,5.0,0.0,2.0,1.0,0.0,5.0,0.0,1.0,0.0,3.0,0.0,5.0,4.0,1.0,1.0,0.0,0.0,0.0,0.0,1.0,3.0,1.0,0.0,1.0,0.0,0.0,5.0,1.0,2.0,0.0,2.0,0.0,0.0,0.0,4.0,5.0,2.0,0.0,4.0,0.0,5.0,2.0,1.0,2.0,3.0,0.0,0.0,1.0,0.0,4.0,0.0,2.0,1.0,2.0,0.0,1.0,0.0,2.0,3.0,4.0,16.0,1.0,4.0,1.0,4.0,2.0,4.0,3.0,13.0,0.0,2.0,1.0,3.0,8.0,2.0,3.0,4.0,2.0,24.0,16.0,7.0,5.0,1.0,13.0,6.0,5.0,2.0,1.0,4.0,5.0,4.0,5.0,1.0,7.0,0.0,0.0,0.0,4.0,2.0,5.0,6.0,4.0,1.0,9.0,3.0,5.0,58.0,5.0,8.0,1.0,6.0,8.0,6.0,3.0,13.0,6.0,4.0,0.0,0.0,6.0,3.0,1.0,3.0,16.0,8.0,11.0,1.0,18.0,0.0,4.0,1.0,8.0,7.0,1.0,0.0,12.0,5.0,5.0,5.0,6.0,27.0,3.0,2.0,1.0,3.0,4.0,1.0,5.0,0.0,3.0,5.0,0.0,1.0,8.0,22.0,2.0,4.0,18.0,10.0,6.0,16.0,13.0,9.0,3.0,4.0,8.0,13.0,15.0,15.0,12.0,1.0,1.0,9.0,5.0,1.0,9.0,0.0,1.0,0.0,11.0,2.0,14.0,0.0,3.0,2.0,2.0,15.0,1.0,1.0,1.0,8.0,3.0,6.0,2.0,5.0,7.0,2.0,26.0,2.0,1.0,1.0,4.0,7.0,5.0,6.0,12.0,4.0,4.0,5.0,18.0,2.0,0.0,3.0,1.0,11.0,1.0,1.0,3.0,1.0,26.0,1.0,12.0,26.0,12.0,10.0,2.0,24.0,5.0,1.0,1.0,9.0,1.0,3.0,10.0,2.0,0.0,0.0,3.0,0.0,3.0,12.0,1.0,7.0,9.0,4.0,0.0,0.0,5.0,8.0,3.0,0.0,8.0,6.0,6.0,9.0,2.0,4.0,5.0,1.0,3.0,2.0,3.0,7.0,14.0,15.0,11.0,2.0,1.0,15.0,12.0,2.0,3.0,1.0,11.0,15.0,2.0,3.0,2.0,11.0,0.0,13.0,6.0,8.0,0.0,0.0,0.0,0.0,15.0,4.0,13.0,0.0,4.0,1.0,1.0,3.0,6.0,2.0,5.0,2.0,3.0,10.0,3.0,7.0,5.0,1.0,0.0,3.0,11.0,0.0,1.0,2.0,11.0,0.0,1.0,14.0,11.0,1.0,0.0,0.0,0.0,18.0,9.0,2.0,9.0,1.0,6.0,2.0,7.0,6.0,8.0,2.0,8.0,4.0,9.0,0.0,11.0,8.0,11.0,1.0,3.0,3.0,1.0,7.0,1.0,3.0,14.0,6.0,2.0,1.0,6.0,2.0,0.0,6.0,1.0,14.0,9.0,2.0,4.0,3.0,2.0,4.0,5.0,4.0,0.0,5.0,1.0,2.0,15.0,0.0,8.0,3.0,9.0,2.0,0.0,4.0,1.0,11.0,0.0,3.0,0.0,2.0,1.0,16.0,2.0,1.0,16.0,9.0,4.0,9.0,3.0,1.0,2.0,5.0,5.0,6.0,15.0,11.0,0.0,4.0,13.0,2.0,9.0,3.0,3.0,3.0,6.0,3.0,6.0,1.0,2.0,1.0,1.0,1.0,3.0,5.0,6.0,3.0,7.0,9.0,5.0,16.0,15.0,3.0,0.0,0.0,5.0,12.0,3.0,8.0,14.0,2.0,5.0,0.0,0.0,12.0,0.0,1.0,0.0,0.0,1.0,3.0,0.0,0.0,2.0,0.0,2.0,9.0,5.0,0.0,1.0,2.0,1.0,1.0,0.0,1.0,0.0,0.0,1.0,2.0,0.0,3.0,1.0,0.0,2.0,0.0,0.0,0.0,1.0,4.0,0.0,0.0,3.0,0.0,0.0,0.0,1.0,1.0,0.0,2.0,2.0,1.0,0.0,0.0,1.0,0.0,0.0,1.0,1.0,0.0,0.0,2.0,2.0,0.0,3.0,4.0,2.0,0.0,0.0,2.0,1.0,3.0,0.0,2.0,0.0,1.0,0.0,0.0,0.0,1.0,4.0,0.0,0.0,0.0,1.0,5.0,7.0,10.0,3.0,12.0,7.0,6.0,10.0,5.0,5.0,5.0,5.0,5.0,5.0,5.0,5.0,1.0,5.0,5.0,1.0,1.0,1.0,5.0,1.0,5.0,5.0,5.0,5.0,5.0,5.0,5.0,5.0,5.0,4.0,5.0,5.0,4.0,5.0,5.0,5.0,5.0,5.0,3.0,5.0,5.0,5.0,5.0,5.0,0.0,0.0,0.0,0.0,0.0,2.0,0.0,0.0,0.0,0.0,0.0,2.0,0.0,3.0,0.0,0.0,0.0,0.0,1.0,1.0,1.0,0.0,0.0,0.0,0.0,0.0,0.0,0.0,0.0,1.0,0.0,2.0,0.0,1.0,0.0,4.0,1.0,5.0,2.0,0.0,2.0,0.0,0.0,1.0,0.0,0.0,3.0,2.0,0.0,7.0,0.0,5.0,0.0,0.0,0.0,5.0,0.0,1.0,0.0,0.0,0.0,1.0,0.0,1.0,0.0,0.0,0.0,0.0,0.0,1.0,2.0,0.0,0.0,0.0,4.0,0.0,0.0,0.0,1.0,1.0,0.0,0.0,0.0,0.0,0.0,0.0,0.0,2.0,2.0,0.0,0.0,0.0,4.0,2.0,0.0,0.0,0.0,3.0,1.0,1.0,0.0,1.0,0.0,0.0,0.0,0.0,1.0,0.0,0.0,0.0,0.0,0.0,0.0,1.0,8.0,0.0,1.0,0.0,0.0,0.0,0.0,1.0,2.0,1.0,7.0,0.0,0.0,0.0,0.0,0.0,0.0,0.0,5.0,0.0,0.0,1.0,2.0,6.0,0.0,2.0,0.0,0.0,0.0,1.0,0.0,7.0,0.0,0.0,4.0,0.0,3.0,3.0,2.0,1.0,0.0,1.0,3.0,0.0,4.0,0.0,0.0,0.0,3.0,0.0,3.0,1.0,2.0,0.0,2.0,0.0,0.0,1.0,2.0,0.0,0.0,1.0,4.0,2.0,0.0,0.0,0.0,0.0,0.0,0.0,0.0,5.0,0.0,3.0,0.0,2.0,0.0,0.0,0.0,0.0,1.0,1.0,0.0,3.0,1.0,4.0,0.0,5.0,5.0,0.0,5.0,10.0,10.0,6.0,11.0,7.0,11.0,8.0,11.0,14.0,8.0,7.0,7.0,9.0,10.0,18.0,10.0,4.0,11.0,5.0,3.0,6.0,12.0,6.0,17.0,4.0,2.0,9.0,16.0,9.0,8.0,14.0,13.0,15.0,11.0,12.0,14.0,9.0,0.0,16.0,7.0,9.0,9.0,9.0,6.0,3.0,1.0,5.0,7.0,0.0,36.0,10.0,0.0,6.0,0.0,0.0,2.0,11.0,0.0,2.0,19.0,23.0,1.0,35.0,6.0,2.0,0.0,3.0,3.0,20.0,1.0,10.0,2.0,22.0,24.0,34.0,27.0,28.0,21.0,3.0,10.0,4.0,0.0,4.0,31.0,5.0,6.0,8.0,3.0,22.0,3.0,33.0,30.0,13.0,3.0,1.0,18.0,27.0,40.0,3.0,7.0,1.0,0.0,0.0,8.0,1.0,0.0,6.0,5.0,0.0,0.0,3.0,11.0,35.0,6.0,9.0,30.0,37.0,14.0,10.0,0.0,35.0,4.0,16.0,29.0,29.0,2.0,3.0,7.0,16.0,5.0,1.0,6.0,20.0,12.0,1.0,0.0,20.0,0.0,1.0,3.0,32.0,35.0,0.0,10.0,25.0,7.0,0.0,24.0,17.0,4.0,37.0,6.0,1.0,4.0,7.0,31.0,3.0,18.0,7.0,1.0,3.0,3.0,2.0,4.0,2.0,3.0,3.0,0.0,1.0,2.0,4.0,3.0,1.0,0.0,3.0,4.0,2.0,0.0,3.0,0.0,2.0,3.0,1.0,3.0,2.0,1.0,0.0,7.0,1.0,3.0,1.0,1.0,0.0,2.0,1.0,1.0,6.0,1.0,3.0,3.0,2.0,1.0,5.0,2.0,4.0,3.0,0.0,1.0,3.0,0.0,5.0,0.0,0.0,0.0,0.0,0.0,0.0,1.0,2.0,3.0,0.0,0.0,0.0,1.0,0.0,0.0,1.0,2.0,,2.0,0.0,3.0,5.0,2.0,4.0,1.0,1.0,2.0,0.0,3.0,2.0,3.0,4.0,,5.0,1.0,5.0,,5.0,4.0,1.0,1.0,2.0,0.5,3.0,4.0,2.0,0.0,1.0,2.0,2.0,3.0,1.0,1.0,2.0,0.0,5.0,5.0,,0.0,1.0,2.0,5.0,4.0,0.0,3.0,1.0,5.0,2.0,0.0,1.0,4.0,3.0,0.0,2.0,3.0,4.0,4.0,0.0,2.0,0.0,0.0,,3.0,2.0,1.0,0.0,5.0,0.0,3.0,2.0,0.0,2.0,1.0,3.0,1.0,3.0,1.0,2.0,,1.0,1.0,4.0,5.0,3.0,3.0,2.0,2.0,0.0,3.0,2.5,,5.0,3.0,5.0,1.0,5.0,5.0,5.0,5.0,0.0,2.0,1.0,0.0,0.0,,2.0,0.0,5.0,1.0,0.0,4.0,0.0,0.0,0.0,0.0,1.0,1.0,1.0,1.0,1.0,0.0,2.0,4.0,4.0,5.0,2.0,4.0,1.0,1.0,2.0,2.0,1.0,5.0,0.0,2.0,2.0,0.0,2.0,0.0,1.0,1.0,0.0,0.0,3.0,1.0,0.0,0.0,1.0,0.0,1.0,2.0,5.0,1.0,1.0,2.0,1.0,0.0,2.0,0.0,0.0,1.0,4.0,3.0,2.0,0.0,0.0,4.0,2.0,1.0,1.0,3.0,,4.0,5.0,0.0,0.0,3.0,5.0,0.0,0.0,0.0,0.0,,1.0,1.0,0.0,,2.0,0.0,3.0,0.0,0.0,0.0,0.0,5.0,3.0,2.0,1.0,0.0,2.0,5.0,5.0,0.0,0.0,0.0,5.0,2.0,0.0,2.0,1.0,0.0,2.0,2.0,0.0,0.0,2.0,0.0,1.0,0.0,0.0,0.0,5.0,0.0,2.0,2.0,1.5,1.0,0.0,5.0,4.0,,2.0,,1.0,0.0,2.0,0.0,0.0,1.0,1.0,2.0,2.0,3.0,2.0,2.0,0.0,1.0,0.0,3.0,5.0,0.0,2.0,0.0,2.0,2.0,1.0,3.0,3.0,3.0,2.0,0.0,1.0,2.0,0.0,1.0,0.0,0.0,0.0,5.0,1.0,5.0,0.0,0.0,5.0,2.0,0.0,0.0,1.0,4.0,2.0,0.0,5.0,0.0,4.0,3.0,3.0,5.0,0.0,0.0,2.0,2.0,1.0,5.0,3.0,0.0,3.0,2.0,0.0,1.0,5.0,1.0,0.0,1.0,5.0,2.0,3.0,2.0,1.0,1.0,5.0,5.0,2.0,2.0,5.0,4.0,1.0,1.0,3.0,3.0,0.0,0.0,1.0,,4.0,3.0,,4.0,3.0,5.0,1.0,,0.0,0.0,0.0,0.0,0.0,1.0,1.0,1.0,2.0,1.0,2.0,3.0,5.0,3.0,0.0,0.0,0.0,5.0,1.0,0.0,3.0,3.0,0.0,0.0,5.0,4.0,0.0,1.0,1.0,0.0,2.0,3.0,0.0,2.0,0.0,1.0,0.0,0.0,0.0,1.0,2.0,0.0,0.0,0.0,5.0,4.0,2.0,5.0,1.0,0.0,1.0,0.0,1.0,1.0,1.0,2.0,5.0,3.0,3.0,4.0,4.0,0.0,2.0,5.0,5.0,0.0,5.0,1.0,0.0,5.0,0.0,0.0,2.0,5.0,4.0,1.0,2.0,0.0,0.0,0.0,0.0,1.0,1.0,3.0,2.0,0.0,1.0,4.0,2.0,0.0,0.0,3.0,2.0,4.0,1.0,0.0,2.0,1.0,0.0,2.0,2.0,0.0,0.0,3.0,4.0,5.0,0.0,1.0,1.0,0.0,0.0,0.0,4.0,0.0,5.0,0.0,1.0,5.0,0.0,1.0,3.0,3.0,0.0,1.0,4.0,2.0,0.0,0.0,3.0,5.0,2.0,2.0,3.0,1.0,2.0,0.0,3.0,1.0,1.0,4.0,5.0,0.0,2.0,0.0,0.0,0.0,1.0,0.0,0.0,5.0,1.0,0.0,1.0,1.0,1.0,0.0,0.0,0.0,0.0,2.0,5.0,9.0,13.0,13.0,2.0,0.0,16.0,14.0,0.0,9.0,10.0,2.0,6.0,14.0,22.0,11.0,17.0,19.0,4.0,10.0,33.0,23.0,10.0,7.0,0.0,16.0,19.0,8.0,19.0,9.0,17.0,16.0,24.0,3.0,28.0,12.0,10.0,5.0,0.0,9.0,1.0,10.0,16.0,3.0,11.0,2.0,13.0,18.0,16.0,8.0,5.0,34.0,15.0,15.0,3.0,18.0,33.0,15.0,4.0,18.0,19.0,1.0,11.0,20.0,14.0,3.0,18.0,19.0,13.0,7.0,11.0,15.0,11.0,5.0,18.0,10.0,6.0,9.0,4.0,8.0,5.0,5.0,11.0,18.0,8.0,7.0,22.0,4.0,10.0,11.0,16.0,6.0,7.0,8.0,7.0,1.0,5.0,8.0,2.0,11.0,10.0,14.0,15.0,9.0,11.0,9.0,9.0,14.0,9.0,7.0,19.0,10.0,1.0,13.0,13.0,16.0,6.0,16.0,0.0,16.0,12.0,18.0,14.0,0.0,4.0,4.0,0.0,4.0,21.0,17.0,18.0,15.0,6.0,8.0,13.0,7.0,28.0,21.0,14.0,13.0,13.0,11.0,14.0,16.0,17.0,13.0,6.0,19.0,9.0,6.0,0.0,4.0,6.0,8.0,12.0,13.0,13.0,16.0,17.0,9.0,19.0,7.0,6.0,15.0,13.0,8.0,18.0,4.0,7.0,12.0,15.0,8.0,11.0,19.0,15.0,5.0,1.0,0.0,8.0,12.0,14.0,0.0,14.0,1.0,13.0,12.0,20.0,3.0,13.0,14.0,17.0,10.0,8.0,3.0,9.0,20.0,6.0,7.0,18.0,4.0,14.0,9.0,7.0,22.0,8.0,0.0,9.0,8.0,18.0,12.0,16.0,8.0,11.0,8.0,13.0,13.0,17.0,4.0,10.0,8.0,13.0,15.0,14.0,11.0,9.0,8.0,13.0,7.0,7.0,4.0,14.0,14.0,4.0,21.0,5.0,17.0,13.0,9.0,7.0,13.0,9.0,3.0,12.0,6.0,18.0,9.0,9.0,13.0,16.0,0.0,14.0,17.0,6.0,12.0,10.0,9.0,12.0,5.0,9.0,13.0,4.0,18.0,11.0,10.0,9.0,24.0,14.0,11.0,8.0,13.0,15.0,5.0,11.0,8.0,7.0,18.0,2.0,9.0,9.0,10.0,4.0,1.0,14.0,13.0,12.0,8.0,11.0,14.0,2.0,10.0,20.0,10.0,5.0,0.0,5.0,16.0,15.0,10.0,15.0,5.0,7.0,2.0,16.0,9.0,6.0,11.0,13.0,12.0,16.0,10.0,14.0,4.0,10.0,8.0,12.0,4.0,19.0,11.0,12.0,5.0,4.0,5.0,9.0,2.0,19.0,7.0,1.0,7.0,13.0,14.0,10.0,5.0,13.0,4.0,4.0,4.0,3.0,19.0,16.0,3.0,12.0,17.0,9.0,11.0,13.0,15.0,8.0,7.0,5.0,9.0,6.0,13.0,9.0,7.0,1.0,24.0,7.0,2.0,3.0,6.0,3.0,29.0,22.0,1.0,5.0,1.0,8.0,3.0,13.0,14.0,7.0,12.0,2.0,5.0,7.0,8.0,12.0,6.0,15.0,5.0,5.0,5.0,0.0,5.0,5.0,2.0,5.0,5.0,5.0,2.0,2.0,5.0,4.0,5.0,3.0,5.0,5.0,5.0,5.0,2.0,5.0,0.0,1.0,5.0,5.0,0.0,5.0,1.0,2.0,5.0,3.0,5.0,5.0,2.0,5.0,5.0,5.0,5.0,5.0,5.0,5.0,5.0,5.0,5.0,3.0,5.0,5.0,5.0,2.0,5.0,5.0,5.0,2.0,5.0,0.0,5.0,0.0,5.0,5.0,5.0,5.0,5.0,5.0,1.0,2.0,3.0,3.0,5.0,2.0,5.0,5.0,3.0,5.0,5.0,,5.0,5.0,4.0,0.0,5.0,3.0,3.0,5.0,5.0,3.0,5.0,2.0,4.0,1.0,5.0,3.0,5.0,5.0,3.0,5.0,4.0,0.0,4.0,2.0,3.0,5.0,3.0,4.0,1.0,5.0,5.0,5.0,5.0,3.0,1.0,2.0,3.0,5.0,5.0,5.0,4.0,0.0,0.0,3.0,2.0,5.0,3.0,5.0,5.0,5.0,5.0,2.0,2.0,5.0,5.0,5.0,5.0,5.0,2.0,2.0,5.0,1.0,5.0,5.0,5.0,5.0,5.0,5.0,5.0,5.0,4.0,2.0,5.0,2.0,5.0,1.0,5.0,5.0,5.0,5.0,18.0,15.0,12.0,1.0,3.0,5.0
14,4.0,5.0,5.0,5.0,3.0,7.0,3.0,5.0,5.0,4.0,4.0,2.0,2.0,5.0,5.0,18.0,6.0,5.0,5.0,5.0,7.0,2.0,7.0,0.0,2.0,7.0,5.0,4.0,6.0,0.0,4.0,4.0,5.0,11.0,5.0,5.0,5.0,2.0,6.0,5.0,4.0,5.0,4.0,4.0,3.0,4.0,10.0,6.0,2.0,0.0,0.0,0.0,3.0,0.0,0.0,0.0,0.0,0.0,0.0,0.0,0.0,0.0,0.0,0.0,0.0,0.0,0.0,0.0,0.0,0.0,0.0,0.0,0.0,0.0,0.0,0.0,0.0,0.0,0.0,,5.0,2.0,5.0,5.0,5.0,5.0,5.0,0.0,0.0,0.0,0.0,0.0,10.0,0.0,0.0,0.0,0.0,0.0,0.0,0.0,0.0,0.0,0.0,0.0,0.0,0.0,0.0,0.0,0.0,0.0,0.0,0.0,0.0,1.0,6.0,5.0,4.0,5.0,2.0,5.0,3.0,17.0,6.0,2.0,4.0,16.0,1.0,0.0,9.0,5.0,6.0,4.0,10.0,5.0,10.0,1.0,9.0,4.0,7.0,3.0,2.0,3.0,0.0,4.0,4.0,8.0,11.0,8.0,10.0,5.0,5.0,10.0,1.0,4.0,2.0,7.0,3.0,5.0,5.0,1.0,4.0,3.0,13.0,1.0,5.0,5.0,5.0,5.0,2.0,3.0,3.0,10.0,11.0,2.0,8.0,7.0,4.0,8.0,5.0,2.0,5.0,3.0,2.0,10.0,5.0,6.0,4.0,4.0,2.0,3.0,5.0,4.0,7.0,7.0,3.0,4.0,1.0,7.0,12.0,5.0,5.0,1.0,7.0,3.0,5.0,2.0,4.0,2.0,3.0,4.0,3.0,4.0,2.0,3.0,0.0,5.0,6.0,7.0,0.0,0.0,5.0,8.0,4.0,6.0,3.0,5.0,8.0,1.0,6.0,2.0,7.0,6.0,0.0,5.0,0.0,5.0,5.0,0.0,5.0,15.0,2.0,6.0,0.0,3.0,0.0,0.0,2.0,13.0,3.0,5.0,2.0,8.0,8.0,17.0,4.0,1.0,22.0,4.0,5.0,2.0,0.0,7.0,13.0,4.0,7.0,2.0,5.0,6.0,0.0,4.0,9.0,4.0,7.0,10.0,8.0,8.0,6.0,3.0,10.0,7.0,4.0,7.0,4.0,9.0,4.0,4.0,10.0,4.0,8.0,10.0,8.0,6.0,8.0,2.0,1.0,2.0,4.0,0.0,4.0,3.0,0.0,3.0,0.0,1.0,0.0,0.0,4.0,4.0,0.0,8.0,15.0,13.0,7.0,4.0,6.0,5.0,2.0,12.0,6.0,3.0,11.0,18.0,3.0,12.0,15.0,7.0,7.0,6.0,11.0,5.0,6.0,12.0,5.0,4.0,14.0,11.0,10.0,5.0,6.0,11.0,2.0,10.0,9.0,9.0,13.0,5.0,14.0,9.0,6.0,10.0,2.0,13.0,12.0,8.0,6.0,25.0,5.0,14.0,5.0,7.0,7.0,8.0,2.0,11.0,3.0,0.0,5.0,2.0,9.0,17.0,7.0,17.0,4.0,8.0,2.0,1.0,2.0,2.0,1.0,3.0,0.0,1.0,2.0,0.0,2.0,2.0,8.0,0.0,5.0,2.0,0.0,8.0,0.0,2.0,1.0,3.0,1.0,0.0,0.0,2.0,0.0,0.0,1.0,3.0,0.0,3.0,0.0,0.0,0.0,0.0,1.0,0.0,0.0,1.0,1.0,2.0,4.0,3.0,3.0,0.0,2.0,1.0,8.0,3.0,5.0,0.0,0.0,1.0,5.0,6.0,6.0,2.0,7.0,9.0,16.0,1.0,6.0,4.0,6.0,4.0,3.0,2.0,4.0,10.0,10.0,6.0,7.0,3.0,1.0,0.0,14.0,1.0,8.0,7.0,1.0,10.0,4.0,3.0,5.0,5.0,1.0,1.0,2.0,0.0,4.0,2.0,5.0,0.0,3.0,1.0,0.0,1.0,2.0,1.0,0.0,0.0,3.0,4.0,1.0,5.0,2.0,4.0,3.0,0.0,6.0,7.0,5.0,2.0,4.0,5.0,5.0,1.0,2.0,5.0,0.0,2.0,6.0,4.0,6.0,10.0,12.0,6.0,0.0,2.0,13.0,6.0,9.0,2.0,3.0,1.0,4.0,6.0,1.0,9.0,4.0,2.0,6.0,2.0,2.0,7.0,10.0,4.0,10.0,5.0,5.0,5.0,5.0,5.0,5.0,2.0,0.0,2.0,6.0,6.0,1.0,4.0,0.0,7.0,1.0,6.0,2.0,6.0,1.0,2.0,2.0,2.0,12.0,14.0,12.0,4.0,9.0,7.0,11.0,9.0,7.0,9.0,6.0,9.0,6.0,7.0,14.0,8.0,4.0,12.0,15.0,9.0,5.0,9.0,11.0,5.0,7.0,11.0,8.0,11.0,3.0,10.0,11.0,16.0,14.0,16.0,12.0,8.0,9.0,15.0,3.0,,8.0,14.0,15.0,20.0,4.0,9.0,12.0,9.0,8.0,19.0,,5.0,11.0,10.0,12.0,10.0,11.0,3.0,13.0,,7.0,6.0,9.0,4.0,6.0,,3.0,7.0,5.0,8.0,12.0,9.0,13.0,15.0,,16.0,12.0,2.0,4.0,12.0,8.0,12.0,12.0,,2.0,15.0,24.0,24.0,,10.0,9.0,,11.0,7.0,13.0,28.0,14.0,6.0,,0.0,0.0,0.0,18.0,0.0,0.0,0.0,0.0,0.0,1.0,0.0,2.0,6.0,0.0,3.0,0.0,2.0,3.0,0.0,0.0,2.0,4.0,5.0,3.0,1.0,5.0,1.0,0.0,0.0,0.0,5.0,0.0,0.0,0.0,0.0,5.0,5.0,4.0,1.0,5.0,3.0,5.0,5.0,1.0,5.0,5.0,0.0,5.0,1.0,5.0,0.0,0.0,5.0,2.0,3.0,0.0,2.0,0.0,0.0,1.0,2.0,5.0,0.0,4.0,4.0,5.0,5.0,5.0,4.0,5.0,5.0,5.0,0.0,7.0,0.0,0.0,3.0,0.0,0.0,0.0,0.0,0.0,5.0,0.0,0.0,0.0,3.0,0.0,0.0,0.0,0.0,0.0,0.0,0.0,4.0,3.0,0.0,4.0,4.0,4.0,3.0,5.0,3.0,0.0,0.0,4.0,4.0,3.0,1.0,4.0,6.0,2.0,5.0,18.0,6.0,7.0,8.0,14.0,9.0,8.0,10.0,11.0,9.0,10.0,10.0,10.0,6.0,7.0,8.0,8.0,2.0,7.0,11.0,10.0,11.0,6.0,12.0,6.0,4.0,7.0,5.0,3.0,3.0,6.0,7.0,3.0,8.0,0.0,5.0,5.0,6.0,6.0,7.0,5.0,5.0,4.0,3.0,5.0,9.0,6.0,7.0,6.0,6.0,6.0,9.0,7.0,6.0,7.0,13.0,4.0,8.0,6.0,4.0,0.0,2.0,4.0,6.0,7.0,4.0,4.0,5.0,5.0,5.0,4.0,5.0,7.0,4.0,5.0,6.0,3.0,16.0,7.0,5.0,13.0,5.0,6.0,8.0,5.0,6.0,6.0,6.0,7.0,5.0,3.0,2.0,10.0,6.0,4.0,5.0,1.0,4.0,9.0,13.0,3.0,6.0,3.0,3.0,11.0,10.0,8.0,6.0,7.0,4.0,12.0,7.0,20.0,3.0,10.0,10.0,5.0,15.0,12.0,10.0,3.0,2.0,0.0,13.0,4.0,12.0,15.0,13.0,10.0,12.0,7.0,9.0,18.0,8.0,6.0,10.0,7.0,11.0,21.0,3.0,10.0,0.0,1.0,2.0,9.0,7.0,11.0,13.0,6.0,7.0,16.0,3.0,0.0,13.0,6.0,8.0,15.0,18.0,3.0,7.0,18.0,14.0,0.0,10.0,9.0,11.0,5.0,4.0,1.0,2.0,2.0,13.0,3.0,7.0,12.0,9.0,3.0,10.0,13.0,1.0,0.0,7.0,9.0,3.0,4.0,2.0,15.0,12.0,2.0,14.0,4.0,17.0,23.0,4.0,9.0,6.0,6.0,2.0,3.0,5.0,2.0,2.0,9.0,4.0,6.0,14.0,1.0,4.5,12.0,9.0,7.0,11.0,11.0,3.0,18.0,8.0,9.0,5.0,13.0,7.0,5.0,2.0,10.0,24.0,9.0,3.0,3.0,9.0,3.0,7.0,9.0,4.0,15.0,1.0,3.0,9.0,12.0,8.0,7.0,3.0,3.0,8.0,21.0,5.0,8.0,4.0,6.0,8.0,1.0,6.0,8.0,4.0,2.0,7.0,14.0,4.0,0.0,6.0,13.0,12.0,8.0,8.0,3.0,6.0,10.0,7.0,11.0,0.0,1.0,6.0,5.0,7.0,11.0,8.0,2.0,2.0,20.0,7.0,11.0,0.0,1.0,1.0,8.0,11.0,9.0,7.0,11.0,6.0,5.0,2.0,5.0,3.0,2.0,4.0,1.0,0.0,6.0,3.0,0.0,3.0,6.0,5.0,2.0,3.0,3.0,4.0,1.0,4.0,0.0,3.0,5.0,1.0,6.0,1.0,1.0,2.0,0.0,1.0,3.0,2.0,1.0,4.0,1.0,4.0,1.0,0.0,0.0,0.0,0.0,1.0,0.0,0.0,1.0,3.0,3.0,1.0,2.0,2.0,1.0,0.0,0.0,1.0,0.0,2.0,5.0,0.0,2.0,0.0,6.0,1.0,1.0,2.0,4.0,3.0,4.0,1.0,0.0,4.0,1.0,8.0,5.0,2.0,5.0,0.0,1.0,2.0,2.0,0.0,5.0,3.0,8.0,1.0,0.0,0.0,0.0,3.0,8.0,7.0,9.0,4.0,15.0,2.0,5.0,5.0,2.0,1.0,6.0,4.0,0.0,3.0,10.0,1.0,3.0,1.0,6.0,0.0,14.0,3.0,6.0,6.0,2.0,0.0,0.0,5.0,1.0,4.0,2.0,5.0,0.0,7.0,5.0,0.0,8.0,6.0,2.0,1.0,4.0,3.0,1.0,6.0,8.0,1.0,2.0,8.0,12.0,1.0,9.0,2.0,7.0,4.0,2.0,8.0,11.0,0.0,1.0,3.0,1.0,2.0,5.0,2.0,3.0,9.0,2.0,6.0,2.0,2.0,1.0,1.0,0.0,4.0,3.0,3.0,6.0,15.0,5.0,0.0,2.0,8.0,4.0,3.0,1.0,7.0,2.0,2.0,10.0,0.0,9.0,4.0,12.0,3.0,5.0,2.0,18.0,4.0,3.0,3.0,4.0,15.0,0.0,6.0,13.0,4.0,3.0,2.0,4.0,10.0,7.0,2.0,1.0,7.0,6.0,0.0,14.0,8.0,9.0,2.0,6.0,8.0,11.0,7.0,7.0,7.0,4.0,7.0,4.0,3.0,4.0,2.0,3.0,6.0,3.0,6.0,1.0,6.0,8.0,4.0,10.0,3.0,5.0,4.0,1.0,0.0,1.0,0.0,0.0,0.0,0.0,0.0,0.0,0.0,0.0,0.0,,0.0,0.0,0.0,,0.0,,0.0,0.0,0.0,,0.0,0.0,,0.0,,0.0,,5.0,,0.0,,3.0,,,0.0,0.0,2.0,0.0,0.0,3.0,0.0,0.0,2.0,0.0,0.0,0.0,0.0,0.0,3.0,0.0,0.0,0.0,0.0,0.0,0.0,0.0,0.0,0.0,0.0,0.0,5.0,2.0,0.0,0.0,0.0,0.0,0.0,0.0,5.0,3.0,0.0,0.0,0.0,0.0,0.0,2.0,0.0,6.0,0.0,3.0,0.0,0.0,0.0,0.0,0.0,0.0,0.0,0.0,0.0,0.0,0.0,0.0,0.0,0.0,0.0,2.0,0.0,0.0,0.0,0.0,0.0,0.0,0.0,0.0,0.0,0.0,0.0,0.0,0.0,0.0,0.0,0.0,0.0,0.0,0.0,6.0,0.0,0.0,0.0,0.0,0.0,0.0,0.0,0.0,0.0,5.0,0.0,4.0,0.0,2.0,0.0,0.0,4.0,0.0,0.0,0.0,0.0,0.0,0.0,0.0,0.0,2.0,0.0,0.0,0.0,0.0,0.0,0.0,0.0,0.0,1.0,1.0,0.0,0.0,0.0,0.0,0.0,3.0,0.0,0.0,2.0,0.0,0.0,0.0,1.0,0.0,3.0,0.0,0.0,0.0,1.1666666666666667,0.0,0.0,0.0,0.0,0.0,0.0,0.0,1.3333333333333333,0.0,2.0,0.0,1.0,0.0,2.0,0.0,0.0,0.0,0.0,0.0,0.0,0.0,0.0,0.0,0.0,0.0,0.0,0.0,0.0,0.0,0.0,0.0,0.0,0.0,0.0,0.0,0.0,0.0,0.0,1.0,0.0,0.0,0.0,0.0,0.0,0.0,0.0,0.0,0.0,0.0,1.0,1.0,0.0,0.0,0.0,2.0,0.0,0.0,0.0,0.0,0.0,0.0,0.0,0.0,0.0,0.0,0.0,0.0,0.0,0.0,0.0,0.0,0.0,0.0,0.0,4.0,0.0,3.5,0.0,0.0,0.0,3.0,0.0,2.0,2.0,0.0,0.0,0.0,0.0,0.0,0.0,7.0,0.0,0.0,0.0,2.0,0.0,1.0,0.0,0.0,0.0,0.0,0.0,0.0,0.0,0.0,5.0,0.0,0.0,7.0,20.0,19.0,18.0,7.0,25.0,12.0,7.0,10.0,0.0,0.0,1.0,13.0,24.0,21.0,2.0,1.0,2.0,0.0,5.0,4.0,12.0,13.0,6.0,6.0,4.0,21.0,18.0,12.0,20.0,11.0,2.0,3.0,0.0,0.0,25.0,10.0,21.0,16.0,19.0,21.0,38.0,7.0,9.0,10.0,14.0,11.0,16.0,18.0,14.0,16.0,20.0,18.0,11.0,30.0,10.0,17.0,20.0,7.0,18.0,8.0,9.0,4.0,12.0,5.0,22.0,20.0,8.0,6.0,5.0,4.0,3.0,25.0,27.0,14.0,13.0,22.0,3.0,23.0,18.0,16.0,19.0,10.0,32.0,52.0,21.0,14.0,12.0,14.0,17.0,15.0,9.0,0.0,47.0,13.0,11.0,24.0,14.0,8.0,6.0,18.0,5.0,0.0,25.0,4.0,8.0,3.0,3.0,7.0,19.0,0.0,3.0,0.0,5.0,1.0,0.0,1.0,1.0,0.0,1.0,1.0,1.0,1.0,6.0,3.0,4.0,12.0,3.0,8.0,5.0,3.0,4.0,2.0,13.0,1.0,2.0,0.0,1.0,1.0,0.0,1.0,0.0,2.0,0.0,0.0,0.0,12.0,2.0,1.0,5.0,5.0,3.0,7.0,1.0,19.0,20.0,18.0,7.0,23.0,3.0,10.0,5.0,9.0,11.0,1.0,17.0,5.0,1.0,8.0,10.0,8.0,3.0,1.0,3.0,8.0,4.0,16.0,0.0,8.0,9.0,2.0,2.0,8.0,15.0,11.0,4.0,10.0,14.0,1.0,0.0,1.0,10.0,14.0,1.0,2.0,20.0,0.0,9.0,1.0,2.0,1.0,2.0,2.0,0.0,1.0,0.0,0.0,1.0,9.0,2.0,11.0,1.0,1.0,1.0,1.0,0.0,1.0,1.0,2.0,2.0,8.0,7.0,15.0,4.0,0.0,2.0,0.0,0.0,4.0,0.0,1.0,1.0,1.0,15.0,11.0,9.0,5.0,8.0,4.0,8.0,12.0,24.0,0.0,3.0,23.0,0.0,0.0,0.0,1.0,0.0,9.0,2.0,10.0,15.0,8.0,20.0,1.0,13.0,1.0,19.0,11.0,11.0,5.0,21.0,22.0,6.0,12.0,12.0,18.0,22.0,23.0,30.0,33.0,20.0,13.0,18.0,11.0,0.0,29.0,18.0,10.0,4.0,1.0,0.0,22.0,5.0,9.0,3.0,24.0,2.0,21.0,1.0,1.0,0.0,2.0,7.0,21.0,0.0,15.0,22.0,20.0,0.0,3.0,19.0,24.0,14.0,20.0,14.0,19.0,3.0,0.0,16.0,16.0,7.0,9.0,32.0,16.0,14.0,10.0,15.0,1.0,28.0,25.0,21.0,1.0,14.0,25.0,22.0,26.0,10.0,6.0,21.0,13.0,11.0,18.0,20.0,23.0,10.0,17.0,20.0,8.0,7.0,30.0,5.0,0.0,11.0,14.0,10.0,9.0,14.0,6.0,22.0,5.0,15.0,29.0,24.0,8.0,12.0,7.0,13.0,0.0,8.0,6.0,9.0,17.0,8.0,14.0,24.0,12.0,18.0,18.0,2.0,9.0,20.0,24.0,19.0,18.0,10.0,0.0,1.0,14.0,15.0,8.0,9.0,0.0,,0.0,13.0,5.0,3.0,1.0,3.0,6.0,0.0,16.0,18.0,7.0,6.0,0.0,0.0,0.0,1.0,0.0,0.0,0.0,0.0,0.0,3.0,0.0,0.0,,0.0,0.0,0.0,0.0,0.0,,0.0,0.0,,0.0,0.0,0.0,0.0,0.0,11.0,3.0,12.0,7.0,7.0,6.0,4.0,6.0,5.0,4.0,6.0,16.0,8.0,5.0,10.0,5.0,11.0,7.0,3.0,5.0,5.0,4.0,3.0,8.0,1.0,8.0,6.0,12.0,4.0,2.0,7.0,15.0,4.0,7.0,15.0,4.0,12.0,12.0,10.0,15.0,1.0,7.0,6.0,14.0,11.0,2.0,18.0,10.0,12.0,10.0,2.0,9.0,5.0,6.0,4.0,6.0,8.0,8.0,6.0,0.0,5.0,9.0,9.0,10.0,6.0,32.0,2.0,11.0,10.0,6.0,4.0,10.0,7.0,5.0,13.0,4.0,6.0,23.0,24.0,0.0,6.0,0.0,9.0,1.0,4.0,14.0,10.0,2.0,13.0,6.0,8.0,12.0,8.0,7.0,15.0,4.0,9.0,3.0,4.0,2.0,10.0,12.0,4.0,16.0,1.0,7.0,8.0,2.0,8.0,9.0,12.0,7.0,4.0,10.0,6.0,10.0,8.0,9.0,6.0,6.0,4.0,6.0,2.0,6.0,4.0,11.0,19.0,9.0,18.0,7.0,0.0,8.0,5.0,7.0,9.0,8.0,9.0,9.0,0.0,2.0,6.0,4.0,5.0,10.0,4.0,10.0,10.0,1.0,10.0,9.0,14.0,11.0,2.0,4.0,11.0,0.0,5.0,0.0,3.0,2.0,2.0,3.0,2.0,2.0,3.0,0.0,0.0,4.0,2.0,5.0,4.0,4.0,1.0,1.0,3.0,4.0,3.0,5.0,8.0,6.0,9.0,4.0,1.0,11.0,11.0,0.0,0.0,,11.0,2.0,11.0,15.0,19.0,15.0,0.0,4.0,18.0,13.0,13.0,3.0,13.0,6.0,,3.0,4.0,1.0,8.0,1.0,2.0,23.0,8.0,0.0,6.0,17.0,6.0,30.0,0.0,0.0,1.0,8.0,4.0,0.0,21.0,1.0,0.0,10.0,8.0,5.0,8.0,6.0,1.0,4.0,5.0,0.0,0.0,1.0,12.0,0.0,4.0,1.0,0.0,0.0,,5.0,21.0,0.0,16.0,15.0,1.0,14.0,2.0,1.0,3.0,11.0,6.0,1.0,3.0,3.0,4.0,0.0,0.0,0.0,12.0,2.0,8.0,4.0,1.0,0.0,0.0,0.0,0.0,7.0,0.0,8.0,0.0,20.0,11.0,,0.0,0.0,0.0,1.0,3.0,9.0,4.0,6.0,15.0,11.0,0.0,10.0,14.0,7.0,17.0,3.0,10.0,12.0,17.0,8.0,3.0,4.0,6.0,5.0,8.0,0.0,6.0,2.0,0.0,7.0,0.0,8.0,2.0,5.0,19.0,,20.0,2.0,6.0,8.0,11.0,8.0,2.0,14.0,0.0,0.0,1.0,26.0,9.0,0.0,7.0,19.0,15.0,0.0,2.0,3.0,14.0,14.0,17.0,6.0,17.0,3.0,9.0,12.0,1.0,9.0,2.0,11.0,7.0,34.0,0.0,5.0,0.0,21.0,9.0,3.0,10.0,12.0,11.0,10.0,0.0,9.0,8.0,6.0,22.0,5.0,17.0,16.0,14.0,14.0,14.0,3.0,20.0,6.0,3.0,9.0,9.0,2.0,15.0,10.0,1.0,6.0,0.0,2.0,12.0,1.0,11.0,1.0,5.0,18.0,8.0,4.0,14.0,6.0,4.0,0.0,,0.0,17.0,7.0,13.0,11.0,10.0,3.0,0.0,4.0,0.0,0.0,0.0,0.0,8.0,7.0,12.0,12.0,21.0,5.0,1.0,14.0,7.0,,4.0,14.0,0.0,17.0,13.0,5.0,20.0,6.0,4.0,10.0,7.0,11.0,15.0,18.0,10.0,7.0,4.0,12.0,13.0,7.0,14.0,15.0,7.0,6.0,1.0,13.0,7.0,4.0,3.0,0.0,0.0,6.0,17.0,3.0,5.0,2.0,0.0,0.0,,14.0,11.0,9.0,13.0,11.0,2.0,1.0,,11.0,8.0,1.0,14.0,0.0,10.0,0.0,2.0,6.0,19.0,15.0,15.0,9.0,5.0,5.0,1.0,4.0,30.0,4.0,2.0,17.0,2.0,17.0,15.0,15.0,2.0,5.0,6.0,8.0,6.0,6.0,4.0,5.0,1.0,1.0,6.0,0.0,31.0,13.0,0.0,1.0,0.0,17.0,11.0,7.0,9.0,3.0,17.0,15.0,1.0,6.0,,11.0,22.0,16.0,1.0,0.0,10.0,11.0,10.0,19.0,13.0,10.0,21.0,6.0,15.0,9.0,13.0,10.0,10.0,2.0,13.0,,0.0,9.0,3.0,3.0,5.0,16.0,7.0,0.0,1.0,0.0,0.0,3.0,0.0,2.0,1.0,6.0,0.0,4.0,0.0,0.0,9.0,3.0,12.0,0.0,8.0,2.0,0.0,10.0,14.0,6.0,27.0,5.0,24.0,14.0,5.0,5.0,14.0,0.0,0.0,21.0,0.0,3.0,1.0,0.0,3.0,3.0,5.0,12.0,15.0,4.0,8.0,14.0,0.0,7.0,9.0,3.0,8.0,17.0,1.0,8.0,8.0,0.0,19.0,16.0,6.0,8.0,11.0,14.0,8.0,3.0,10.0,0.0,11.0,11.0,9.0,10.0,11.0,13.0,8.0,1.0,0.0,13.0,12.0,5.0,15.0,10.0,7.0,0.0,26.0,4.0,14.0,15.0,17.0,0.0,7.0,6.0,12.0,2.0,21.0,4.0,0.0,0.0,1.0,0.0,1.0,2.0,0.0,13.0,0.0,11.0,0.0,2.0,33.0,11.0,3.0,7.0,0.5,1.0,2.0,1.0,2.0,1.0,7.0,1.5,6.0,1.0,1.5,1.5,2.0,8.0,1.0,0.5,0.0,0.5,1.5,0.5,0.5,5.5,0.5,3.5,1.5,1.5,0.0,7.0,3.0,0.5,9.5,4.0,11.0,8.0,1.0,0.0,1.0,0.0,1.5,0.5,1.0,1.0,1.0,10.5,1.0,0.5,0.5,11.0,0.5,1.0,1.0,3.0,5.0,4.0,0.0,2.0,0.0,0.0,0.0,5.0,5.0,0.0,5.0,2.0,5.0,0.0,0.0,5.0,5.0,0.0,3.0,18.0,5.0,10.0,15.0,8.0,6.0,18.0,2.0,6.0,8.0,0.0,21.0,13.0,15.0,10.0,8.0,4.0,8.0,9.0,26.0,10.0,6.0,11.0,8.0,7.0,13.0,7.0,20.0,7.0,8.0,11.0,14.0,20.0,16.0,8.0,17.0,4.0,8.0,20.0,7.0,4.0,10.0,11.0,1.0,15.0,12.0,10.0,4.0,17.0,21.0,15.0,3.0,26.0,9.0,17.0,3.0,2.0,9.0,12.0,16.0,16.0,14.0,7.0,8.0,10.0,2.0,19.0,10.0,6.0,12.0,21.0,20.0,22.0,11.0,18.0,14.0,16.0,7.0,22.0,22.0,7.0,14.0,16.0,10.0,1.0,24.0,4.0,11.0,15.0,10.0,2.0,26.0,10.0,17.0,18.0,6.0,15.0,15.0,17.0,10.0,18.0,2.0,5.0,15.0,11.0,10.0,10.0,5.0,13.0,24.0,19.0,11.0,11.0,9.0,0.0,1.0,11.0,11.0,10.0,11.0,9.0,22.0,10.0,4.0,10.0,19.0,3.0,10.0,10.0,7.0,15.0,2.0,1.0,13.0,20.0,4.0,3.0,18.0,26.0,30.0,15.0,10.0,8.0,9.0,8.0,11.0,9.0,15.0,11.0,9.0,8.0,21.0,7.0,18.0,5.0,3.0,3.0,8.0,11.0,11.0,10.0,9.0,19.0,9.0,9.0,18.0,5.0,5.0,23.0,10.0,16.0,15.0,17.0,4.0,3.0,21.0,16.0,15.0,9.0,4.0,20.0,9.0,14.0,19.0,4.0,18.0,13.0,11.0,4.0,11.0,8.0,35.0,6.0,11.0,15.0,13.0,8.0,20.0,8.0,11.0,7.0,13.0,6.0,10.0,18.0,12.0,3.0,19.0,27.0,15.0,14.0,18.0,8.0,12.0,11.0,20.0,13.0,13.0,6.0,20.0,3.0,11.0,7.0,10.0,3.0,12.0,17.0,13.0,16.0,8.0,4.0,9.0,15.0,4.0,11.0,8.0,1.0,5.0,7.0,20.0,20.0,13.0,14.0,10.0,8.0,10.0,10.0,11.0,10.0,10.0,12.0,12.0,14.0,12.0,16.0,10.0,12.0,14.0,9.0,14.0,12.0,2.0,9.0,5.0,5.0,8.0,10.0,10.0,6.0,17.0,6.0,19.0,20.0,11.0,14.0,6.0,10.0,9.0,9.0,10.0,12.0,8.0,5.0,16.0,9.0,20.0,15.0,9.0,4.0,7.0,9.0,11.0,0.0,13.0,9.0,13.0,15.0,15.0,8.0,6.0,10.0,3.0,0.0,1.0,14.0,8.0,4.0,5.0,0.0,4.0,11.0,9.0,26.0,11.0,17.0,1.0,1.0,6.0,9.0,4.0,15.0,4.0,15.0,12.0,2.0,6.0,4.0,12.0,8.0,2.0,0.0,3.0,0.0,0.0,0.0,3.0,9.0,5.0,14.0,19.0,15.0,3.0,9.0,9.0,8.0,8.0,9.0,13.0,9.0,8.0,10.0,15.0,7.0,9.0,6.0,13.0,4.0,9.0,16.0,10.0,7.0,8.0,6.0,9.0,5.0,18.0,8.0,4.0,11.0,23.0,1.0,12.0,15.0,1.0,6.0,13.0,4.0,17.0,14.0,10.0,16.0,2.0,3.0,7.0,6.0,12.0,15.0,9.0,7.0,0.0,5.0,6.0,27.0,1.0,6.0,10.0,8.0,12.0,2.0,0.0,8.0,3.0,17.0,2.0,0.0,10.0,3.0,14.0,5.0,13.0,14.0,1.0,14.0,19.0,19.0,8.0,0.0,10.0,0.0,1.0,4.0,0.0,2.0,2.0,15.0,1.0,5.0,1.0,0.0,0.0,0.0,0.0,7.0,0.0,19.0,7.0,1.0,4.0,3.0,0.0,0.0,0.0,0.0,0.0,0.0,0.0,0.0,3.0,0.0,10.0,11.0,1.0,0.0,0.0,1.0,0.0,0.0,4.0,0.0,0.0,0.0,13.0,0.0,3.0,4.0,0.0,0.0,0.0,1.0,0.0,1.0,3.0,1.0,8.0,4.0,6.0,16.0,1.0,1.0,0.0,0.0,23.0,11.0,0.0,1.0,7.0,7.0,3.0,12.0,0.0,3.0,1.0,0.0,4.0,3.0,0.0,11.0,14.0,7.0,3.0,1.0,7.0,7.0,2.0,1.0,4.0,4.0,9.0,1.0,0.0,2.0,2.0,3.0,1.0,8.0,0.0,0.0,6.0,12.0,4.0,15.0,13.0,5.0,5.0,8.0,0.0,10.0,3.0,30.0,2.0,10.0,19.0,10.0,0.0,0.0,1.0,0.0,2.0,0.0,0.0,4.0,1.0,1.0,0.0,0.0,2.0,0.0,7.0,11.0,13.0,4.0,5.0,7.0,8.0,7.0,5.0,10.0,7.0,3.0,1.0,1.0,3.0,1.0,5.0,5.0,4.0,3.0,3.0,2.0,7.0,1.0,1.0,5.0,3.0,0.0,15.0,1.0,1.0,19.0,15.0,3.0,2.0,1.0,0.0,0.0,6.0,1.0,3.0,0.0,10.0,3.0,7.0,0.0,2.0,0.0,0.0,3.0,2.0,7.0,2.0,6.0,0.0,0.0,0.0,4.0,16.0,3.0,5.0,9.0,6.0,6.0,16.0,2.0,1.0,0.0,0.0,0.0,21.0,8.0,4.0,11.0,7.0,16.0,3.0,9.0,0.0,0.0,1.0,20.0,1.0,2.0,0.0,5.0,4.0,0.0,0.0,2.0,3.0,0.0,3.0,1.0,0.0,2.0,17.0,1.0,0.0,0.0,1.0,2.0,1.0,3.0,1.0,3.0,1.0,22.0,4.0,3.0,1.0,15.0,3.0,5.0,11.0,4.0,8.0,0.0,0.0,8.0,4.0,2.0,2.0,0.0,1.0,1.0,0.0,0.0,0.0,8.0,6.0,9.0,5.0,16.0,5.0,2.0,4.0,7.0,2.0,4.0,0.0,11.0,10.0,5.0,3.0,4.0,9.0,4.0,21.0,17.0,5.0,5.0,2.0,3.0,3.0,0.0,4.0,3.0,4.0,4.0,6.0,1.0,10.0,3.0,7.0,1.0,14.0,17.0,8.0,8.0,9.0,17.0,10.0,3.0,25.0,5.0,5.0,13.0,0.0,14.0,3.0,11.0,15.0,6.0,6.0,2.0,4.0,0.0,0.0,0.0,1.0,1.0,1.0,17.0,0.0,1.0,0.0,0.0,0.0,1.0,0.0,1.0,4.0,1.0,10.0,3.0,5.0,2.0,0.0,4.0,6.0,5.0,1.0,4.0,9.0,1.0,7.0,2.0,0.0,5.0,6.0,6.0,7.0,3.0,14.0,9.0,5.0,15.0,6.0,4.0,6.0,8.0,3.0,6.0,2.0,2.0,34.0,6.0,9.0,0.0,4.0,3.0,5.0,2.0,2.0,3.0,6.0,8.0,3.0,7.0,1.0,6.0,7.0,3.0,2.0,3.0,8.0,14.0,4.0,3.0,17.0,0.0,11.0,4.0,9.0,8.0,7.0,0.0,5.0,2.0,7.0,1.0,2.0,0.0,2.0,2.0,3.0,1.0,5.0,4.0,9.0,7.0,0.0,0.0,3.0,2.0,4.0,1.0,9.0,4.0,5.0,1.0,1.0,1.0,5.0,4.0,8.0,0.0,5.0,7.0,6.0,12.0,10.0,0.0,6.0,11.0,4.0,7.0,14.0,9.0,10.0,2.0,2.0,2.0,13.0,9.0,5.0,5.0,1.0,5.0,12.0,9.0,10.0,6.0,8.0,9.0,4.0,2.0,3.0,6.0,0.0,13.0,2.0,2.0,3.0,6.0,0.0,4.0,4.0,6.0,7.0,4.0,2.0,3.0,2.0,2.0,7.0,4.0,8.0,5.0,6.0,1.0,1.0,1.0,1.0,20.0,6.0,2.0,6.0,6.0,6.0,11.0,6.0,14.0,13.0,0.0,3.0,9.0,16.0,7.0,3.0,1.0,10.0,7.0,7.0,1.0,7.0,3.0,4.0,4.0,4.0,5.0,5.0,6.0,6.0,8.0,7.0,8.0,6.0,7.0,5.0,3.0,12.0,13.0,6.0,16.0,8.0,4.0,8.0,9.0,11.0,6.0,5.0,13.0,6.0,12.0,9.0,10.0,12.0,12.0,4.0,5.0,4.0,8.0,6.0,7.0,14.0,5.0,7.0,10.0,7.0,4.0,5.0,8.0,8.0,5.0,9.0,10.0,12.0,9.0,8.0,5.0,12.0,2.0,3.0,9.0,23.0,6.0,4.0,5.0,15.0,3.0,11.0,18.0,12.0,16.0,11.0,7.0,14.0,18.0,7.0,1.0,13.0,18.0,7.0,7.0,4.0,6.0,7.0,18.0,8.0,7.0,4.0,5.0,9.0,14.0,10.0,5.0,12.0,0.0,8.0,5.0,1.0,15.0,9.0,9.0,4.0,5.0,8.0,7.0,11.0,7.0,11.0,7.0,11.0,2.0,2.0,9.0,3.0,11.0,17.0,9.0,0.0,0.0,10.0,16.0,7.0,4.0,4.0,5.0,4.0,21.0,8.0,8.0,7.0,0.0,5.0,6.0,7.0,8.0,9.0,6.0,7.0,12.0,12.0,14.0,5.0,6.0,14.0,17.0,11.0,4.0,8.0,9.0,14.0,10.0,12.0,4.0,7.0,5.0,20.0,15.0,6.0,2.0,4.0,7.0,8.0,10.0,4.0,8.0,11.0,10.0,11.0,7.0,10.0,5.0,5.0,8.0,10.0,1.0,5.0,9.0,5.0,5.0,5.0,9.0,7.0,1.0,2.0,6.0,6.0,7.0,6.0,13.0,4.0,3.0,8.0,10.0,10.0,12.0,6.0,21.0,9.0,9.0,10.0,8.0,3.0,8.0,4.0,5.0,8.0,7.0,6.0,8.0,6.0,4.0,3.0,7.0,11.0,3.0,3.0,0.0,9.0,2.0,5.0,12.0,2.0,3.0,5.0,0.0,1.0,1.0,2.0,16.0,12.0,0.0,1.0,11.0,3.0,0.0,1.0,12.0,5.0,0.0,0.0,1.0,5.0,8.0,0.0,4.0,11.0,0.0,7.0,5.0,3.0,5.0,2.0,2.0,3.0,4.0,3.0,5.0,1.0,4.0,5.0,5.0,1.0,1.0,5.0,4.0,5.0,2.0,0.0,5.0,5.0,5.0,5.0,4.0,2.0,3.0,4.0,2.0,5.0,2.0,1.0,2.0,2.0,5.0,4.0,5.0,2.0,0.0,5.0,5.0,5.0,5.0,4.0,4.0,1.0,1.0,4.0,4.0,2.0,0.0,5.0,0.0,5.0,1.0,4.0,5.0,4.0,5.0,5.0,5.0,5.0,5.0,4.0,5.0,5.0,5.0,1.0,5.0,3.0,5.0,3.0,5.0,5.0,5.0,5.0,1.0,0.0,5.0,5.0,1.0,2.0,2.0,5.0,5.0,5.0,5.0,1.0,1.0,5.0,0.0,2.0,0.0,1.0,0.0,8.0,1.0,0.0,1.0,0.0,4.0,8.0,1.0,1.0,8.0,0.0,0.0,4.0,1.0,8.0,0.0,4.0,1.0,1.0,0.0,1.0,1.0,0.0,0.0,1.0,0.0,2.0,0.0,2.0,2.0,0.0,5.0,0.0,13.0,4.0,0.0,5.0,11.0,15.0,14.0,3.0,0.0,0.0,0.0,15.0,5.0,12.0,1.0,5.0,6.0,5.0,0.0,0.0,3.0,1.0,3.0,12.0,2.0,13.0,10.0,1.0,0.0,6.0,8.0,3.0,0.0,5.0,6.0,3.0,6.0,22.0,2.0,2.0,8.0,4.0,0.0,0.0,0.0,5.0,8.0,9.0,14.0,5.0,4.0,1.0,22.0,1.0,0.0,0.0,1.0,3.0,1.0,10.0,2.0,0.0,25.0,4.0,4.0,7.0,2.0,0.0,2.0,0.0,3.0,2.0,0.0,10.0,4.0,9.0,12.0,5.0,22.0,0.0,7.0,1.0,8.0,0.0,3.0,0.0,1.0,0.0,12.0,15.0,14.0,14.0,7.0,4.0,7.0,15.0,25.0,6.0,1.0,1.0,0.0,6.0,0.0,4.0,2.0,23.0,26.0,9.0,10.0,14.0,4.0,21.0,13.0,10.0,19.0,1.0,22.0,6.0,22.0,10.0,0.0,9.0,3.0,10.0,0.0,4.0,12.0,8.0,2.0,15.0,2.0,1.0,3.0,5.0,1.0,9.0,13.0,29.0,6.0,3.0,0.0,14.0,2.0,8.0,3.0,6.0,4.0,12.0,7.0,6.0,0.0,2.0,20.0,13.0,18.0,6.0,16.0,1.0,1.0,2.0,20.0,4.0,0.0,17.0,8.0,17.0,9.0,0.0,2.0,7.0,0.0,0.0,2.0,10.0,0.0,6.0,1.0,14.0,0.0,2.0,4.0,1.0,10.0,18.0,1.0,2.0,0.0,3.0,26.0,1.0,16.0,1.0,0.0,1.0,10.0,10.0,10.0,1.0,10.0,27.0,9.0,15.0,1.0,1.0,17.0,10.0,13.0,16.0,9.0,35.0,15.0,2.0,14.0,0.0,10.0,7.0,14.0,4.0,7.0,8.0,0.0,14.0,1.0,0.0,0.0,10.0,0.0,2.0,2.0,10.0,12.0,6.0,0.0,11.0,18.0,9.0,4.0,1.0,0.0,7.0,0.0,0.0,16.0,4.0,6.0,17.0,0.0,15.0,19.0,23.0,,16.0,9.0,5.0,8.0,2.0,7.0,7.0,2.0,6.0,5.0,5.0,9.0,0.0,1.0,2.0,6.0,23.0,16.0,13.0,16.0,0.0,24.0,17.0,23.0,2.0,14.0,2.0,15.0,35.0,6.0,8.0,1.0,4.0,11.0,8.0,6.0,18.0,7.0,18.0,31.0,11.0,25.0,2.0,13.0,1.0,2.0,8.0,8.0,15.0,11.0,15.0,25.0,3.0,14.0,2.0,8.0,1.0,17.0,16.0,0.0,14.0,13.0,13.0,10.0,5.0,29.0,29.0,28.0,13.0,8.0,17.0,2.0,0.0,14.0,8.0,4.0,13.0,10.0,6.0,38.0,7.0,45.0,1.0,7.0,10.0,10.0,2.0,0.0,9.0,6.0,19.0,24.0,26.0,13.0,3.0,8.0,1.0,7.0,2.0,2.0,7.0,18.0,2.0,5.0,2.0,7.0,22.0,9.0,3.0,20.0,16.0,0.0,9.0,8.0,8.0,0.0,16.0,11.0,16.0,7.0,0.0,1.0,2.0,4.0,1.0,9.0,18.0,4.0,23.0,9.0,16.0,12.0,0.0,13.0,10.0,14.0,23.0,3.0,1.0,13.0,1.0,7.0,8.0,45.0,1.0,0.0,13.0,0.0,4.0,11.0,30.0,4.0,0.0,4.0,11.0,18.0,11.0,5.0,1.0,3.0,2.0,4.0,10.0,9.0,16.0,0.0,1.0,18.0,14.0,4.0,8.0,29.0,0.0,3.0,1.0,16.0,3.0,9.0,11.0,5.0,8.0,14.0,4.0,4.0,10.0,19.0,1.0,6.0,7.0,2.0,19.0,29.0,31.0,4.0,0.0,4.0,30.0,12.0,15.0,17.0,7.0,4.0,12.0,9.0,3.0,1.0,8.0,21.0,11.0,17.0,15.0,7.0,20.0,15.0,17.0,9.0,0.0,3.0,14.0,8.0,2.0,2.0,9.0,5.0,0.0,5.0,22.0,2.0,0.0,29.0,5.0,7.0,18.0,3.0,33.0,14.0,13.0,8.0,5.0,1.0,1.0,11.0,7.0,10.0,3.0,22.0,0.0,0.0,0.0,0.0,12.0,9.0,17.0,0.0,5.0,1.0,5.0,11.0,24.0,0.0,5.0,2.0,5.0,9.0,0.0,0.0,14.0,7.0,1.0,1.0,1.0,7.0,0.0,7.0,13.0,18.0,3.0,8.0,6.0,15.0,11.0,0.0,6.0,24.0,2.0,3.0,6.0,21.0,20.0,1.0,13.0,21.0,5.0,1.0,0.0,14.0,15.0,10.0,36.0,14.0,19.0,23.0,12.0,,1.0,4.0,8.0,13.0,2.0,0.0,1.0,9.0,14.0,0.0,4.0,8.0,1.0,5.0,0.0,1.0,1.0,4.0,6.0,1.0,5.0,37.0,30.0,76.0,29.0,37.0,0.0,0.0,14.0,0.0,13.0,0.0,5.0,1.0,0.0,14.0,10.0,0.0,10.0,1.0,7.0,23.0,0.0,8.0,2.0,13.0,6.0,2.0,3.0,15.0,23.0,4.0,6.0,11.0,8.0,11.0,4.0,13.0,17.0,11.0,4.0,0.0,10.0,8.0,9.0,11.0,13.0,14.0,8.0,4.0,4.0,5.0,13.0,12.0,14.0,8.0,11.0,5.0,11.0,19.0,17.0,3.0,4.0,11.0,7.0,11.0,12.0,8.0,9.0,8.0,4.0,14.0,16.0,13.0,14.0,5.0,4.0,11.0,12.0,5.0,9.0,14.0,9.0,15.0,11.0,5.0,5.0,14.0,15.0,9.0,12.0,6.0,11.0,2.0,17.0,6.0,10.0,5.0,16.0,0.0,7.0,12.0,6.0,10.0,6.0,2.0,7.0,9.0,11.0,14.0,5.0,2.0,7.0,21.0,14.0,10.0,12.0,9.0,6.0,11.0,15.0,4.0,18.0,4.0,11.0,5.0,20.0,10.0,14.0,17.0,14.0,10.0,5.0,3.0,6.0,7.0,13.0,9.0,5.0,3.0,4.0,15.0,6.0,7.0,11.0,16.0,7.0,16.0,1.0,10.0,0.0,7.0,11.0,14.0,9.0,13.0,13.0,14.0,10.0,4.0,5.0,9.0,6.0,14.0,13.0,14.0,5.0,16.0,12.0,1.0,12.0,0.0,17.0,9.0,19.0,8.0,10.0,5.0,12.0,1.0,13.0,0.0,15.0,3.0,0.0,3.0,13.0,6.0,8.0,10.0,2.0,10.0,0.0,0.0,0.0,4.0,3.0,0.0,4.0,3.0,11.0,0.0,14.0,15.0,11.0,3.0,1.0,0.0,16.0,2.0,8.0,14.0,2.0,13.0,10.0,16.0,1.0,2.0,10.0,0.0,1.0,5.0,0.0,9.0,4.0,9.0,0.0,10.0,7.0,4.0,1.0,8.0,5.0,7.0,0.0,11.0,0.0,0.0,9.0,0.0,17.0,4.0,4.0,0.0,8.0,7.0,4.0,1.0,16.0,3.0,5.0,0.0,6.0,5.0,0.0,0.0,1.0,10.0,0.0,0.0,2.0,16.0,5.0,8.0,13.0,6.0,11.0,6.0,0.0,7.0,12.0,9.0,0.0,0.0,9.0,9.0,1.0,14.0,2.0,7.0,8.0,7.0,1.0,6.0,7.0,2.0,3.0,13.0,6.0,8.0,11.0,4.0,25.0,5.0,1.0,2.0,0.0,9.0,12.0,3.0,18.0,3.0,10.0,0.0,5.0,1.0,1.0,0.0,0.0,21.0,4.0,12.0,19.0,9.0,15.0,11.0,1.0,0.0,6.0,3.0,6.0,1.0,6.0,0.0,2.0,13.0,14.0,3.0,5.0,12.0,0.0,6.0,6.0,13.0,19.0,0.0,1.0,15.0,0.0,8.0,3.0,3.0,3.0,0.0,30.0,2.0,15.0,1.0,1.0,3.0,7.0,9.0,3.0,2.0,0.0,0.0,11.0,0.0,12.0,11.0,5.0,5.0,9.0,5.0,1.0,2.0,3.0,1.0,0.0,10.0,0.0,5.0,5.0,1.0,8.0,0.0,13.0,19.0,16.0,2.0,8.0,11.0,0.0,10.0,7.0,7.0,12.0,5.0,11.0,4.0,15.0,8.0,1.0,8.0,15.0,6.0,6.0,12.0,10.0,9.0,4.0,0.0,2.0,12.0,14.0,11.0,12.0,3.0,3.0,0.0,5.0,13.0,0.0,0.0,0.0,1.0,7.0,6.0,29.0,16.0,0.0,7.0,10.0,11.0,7.0,9.0,12.0,11.0,6.0,4.0,0.0,8.0,9.0,8.0,15.0,4.0,0.0,2.0,0.0,1.0,8.0,15.0,16.0,11.0,8.0,3.0,4.0,3.0,6.0,10.0,4.0,0.0,9.0,10.0,5.0,10.0,13.0,6.0,1.0,14.0,0.0,6.0,15.0,2.0,7.0,11.0,7.0,1.0,0.0,0.0,0.0,0.0,0.0,3.0,5.0,3.0,3.0,1.0,0.0,3.0,0.0,0.0,1.0,10.0,0.0,4.0,0.0,1.0,6.0,0.0,4.0,0.0,0.0,0.0,0.0,0.0,0.0,6.0,1.0,0.0,0.0,0.0,0.0,0.0,4.0,1.0,1.0,1.0,0.0,1.0,2.0,0.0,0.0,0.0,1.0,0.0,1.0,1.0,4.0,4.0,0.0,1.0,0.0,3.0,2.0,0.0,0.0,0.0,0.0,1.0,0.0,0.0,3.0,2.0,0.0,2.0,0.0,0.0,2.0,0.0,2.0,2.0,0.0,0.0,0.0,0.0,0.0,1.0,0.0,2.0,0.0,0.0,5.0,4.0,0.0,0.0,0.0,0.0,0.0,0.0,3.0,0.0,1.0,1.0,0.0,2.0,3.0,9.0,5.0,0.0,3.0,3.0,9.0,1.0,5.0,5.0,5.0,3.0,7.0,12.0,4.0,11.0,4.0,3.0,7.0,4.0,15.0,9.0,8.0,6.0,7.0,3.0,2.0,4.0,2.0,4.0,2.0,3.0,9.0,2.0,11.0,1.0,8.0,11.0,8.0,5.0,6.0,7.0,5.0,7.0,0.0,1.0,4.0,3.0,2.0,2.0,4.0,3.0,4.0,6.0,5.0,2.0,2.0,8.0,3.0,5.0,3.0,5.0,2.0,1.0,5.0,3.0,2.0,5.0,4.0,2.0,5.0,3.0,2.0,2.0,8.0,6.0,3.0,4.0,6.0,1.0,3.0,9.0,3.0,4.0,5.0,4.0,0.0,3.0,5.0,5.0,4.0,0.0,1.0,8.0,0.0,0.0,3.0,2.0,4.0,5.0,2.0,0.0,3.0,1.0,3.0,6.0,7.0,1.0,2.0,4.0,5.0,0.0,2.0,2.0,4.0,0.0,0.0,2.0,7.0,6.0,9.0,5.0,2.0,2.0,3.0,10.0,3.0,4.0,3.0,2.0,2.0,5.0,6.0,6.0,6.0,4.0,0.0,5.0,3.0,5.0,4.0,4.0,4.0,0.0,3.0,2.0,11.0,3.0,7.0,14.0,5.0,10.0,7.0,6.0,3.0,3.0,3.0,4.0,4.0,2.0,12.0,7.0,4.0,6.0,0.0,1.0,8.0,3.0,4.0,0.0,2.0,7.0,0.0,1.0,1.0,1.0,3.0,2.0,0.0,0.0,2.0,0.0,2.0,6.0,1.0,1.0,6.0,0.0,0.0,0.0,0.0,0.0,2.0,8.0,9.0,6.0,5.0,4.0,5.0,4.0,6.0,8.0,4.0,5.0,5.0,6.0,3.0,4.0,9.0,5.0,4.0,6.0,4.0,6.0,4.0,7.0,8.0,6.0,8.0,3.0,12.0,1.0,7.0,5.0,13.0,5.0,2.0,4.0,5.0,2.0,9.0,2.0,6.0,4.0,5.0,10.0,6.0,2.0,2.0,9.0,5.0,5.0,9.0,4.0,2.0,3.0,7.0,4.0,2.0,8.0,7.0,5.0,5.0,6.0,2.0,6.0,7.0,2.0,6.0,5.0,1.0,3.0,10.0,2.0,2.0,8.0,14.0,8.0,10.0,1.0,6.0,2.0,1.0,11.0,8.0,2.0,6.0,3.0,4.0,7.0,6.0,2.0,7.0,5.0,10.0,11.0,11.0,6.0,6.0,8.0,5.0,3.0,3.0,2.0,4.0,2.0,6.0,6.0,8.0,6.0,5.0,7.0,4.0,3.0,5.0,2.0,4.0,4.0,0.0,0.0,4.0,4.0,5.0,5.0,5.0,5.0,5.0,5.0,4.0,4.0,5.0,5.0,5.0,4.0,4.0,3.0,3.0,5.0,5.0,5.0,5.0,0.0,2.0,4.0,5.0,3.0,4.0,3.0,4.0,5.0,0.0,4.0,2.0,1.0,1.0,0.0,1.0,5.0,8.0,0.0,8.0,1.0,3.0,0.0,15.0,1.0,2.0,0.0,1.0,1.0,0.0,4.0,1.0,1.0,4.0,0.0,5.0,0.0,10.0,2.0,9.0,12.0,0.0,4.0,9.0,5.0,3.0,0.0,0.0,11.0,1.0,0.0,15.0,4.0,2.0,14.0,1.0,1.0,2.0,0.0,0.0,1.0,10.0,0.0,3.0,1.0,2.0,0.0,11.0,0.0,11.0,0.0,12.0,0.0,4.0,6.0,0.0,0.0,0.0,3.0,1.0,0.0,5.0,0.0,0.0,4.0,2.0,0.0,0.0,0.0,4.0,18.0,1.0,14.0,0.0,14.0,1.0,1.0,0.0,2.0,2.0,0.0,0.0,0.0,0.0,4.0,6.0,2.0,5.0,0.0,2.0,7.0,5.0,11.0,13.0,4.0,8.0,4.0,0.0,7.0,1.0,4.0,21.0,1.0,4.0,7.0,10.0,0.0,3.0,2.0,3.0,4.0,4.0,0.0,0.0,12.0,13.0,3.0,0.0,3.0,0.0,5.0,15.0,3.0,0.0,7.0,1.0,3.0,8.0,3.0,11.0,1.0,1.0,2.0,4.0,10.0,6.0,5.0,3.0,6.0,10.0,4.0,8.0,0.0,0.0,8.0,8.0,2.0,9.0,5.0,0.0,10.0,0.0,6.0,15.0,2.0,11.0,4.0,10.0,1.0,2.0,11.0,9.0,14.0,15.0,3.0,8.0,9.0,3.0,13.0,6.0,12.0,10.0,9.0,1.0,13.0,11.0,10.0,4.0,1.0,3.0,11.0,14.0,0.0,6.0,9.0,6.0,3.0,9.0,3.0,0.0,8.0,3.0,5.0,14.0,8.0,9.0,13.0,7.0,2.0,6.0,12.0,15.0,6.0,12.0,1.0,9.0,8.0,7.0,1.0,6.0,9.0,4.0,19.0,11.0,2.0,2.0,1.0,5.0,15.0,4.0,2.0,5.0,14.0,7.0,0.0,38.0,15.0,1.0,0.0,2.0,0.0,8.0,22.0,13.0,20.0,3.0,1.0,5.0,25.0,3.0,12.0,18.0,12.0,1.0,3.0,0.0,16.0,0.0,11.0,23.0,16.0,2.0,1.0,15.0,0.0,13.0,23.0,14.0,5.0,16.0,3.0,11.0,6.0,13.0,12.0,2.0,0.0,1.0,4.0,4.0,10.0,5.0,3.0,0.0,23.0,0.0,8.0,4.0,8.0,1.0,4.0,0.0,16.0,11.0,9.0,0.0,18.0,8.0,9.0,16.0,6.0,3.0,18.0,1.0,9.0,1.0,4.0,0.0,25.0,13.0,6.0,2.0,11.0,30.0,0.0,4.0,19.0,1.0,8.0,7.0,0.0,6.0,9.0,26.0,5.0,14.0,19.0,6.0,0.0,0.0,15.0,5.0,1.0,0.0,1.0,1.0,20.0,5.0,0.0,24.0,2.0,0.0,0.0,15.0,4.0,14.0,3.0,8.0,0.0,7.0,3.0,1.0,10.0,4.0,1.0,8.0,0.0,0.0,7.0,2.0,12.0,10.0,22.0,14.0,5.0,2.0,17.0,12.0,12.0,5.0,8.0,28.0,6.0,13.0,9.0,1.0,11.0,0.0,5.0,5.0,4.0,6.0,1.0,6.0,8.0,1.0,0.0,15.0,15.0,6.0,8.0,15.0,4.0,14.0,0.0,2.0,7.0,20.0,0.0,21.0,1.0,23.0,0.0,3.0,0.0,5.0,11.0,19.0,3.0,0.0,14.0,4.0,1.0,11.0,1.0,10.0,11.0,0.0,5.0,10.0,5.0,2.0,10.0,10.0,7.0,2.0,2.0,18.0,2.0,3.0,15.0,16.0,0.0,5.0,5.0,2.0,0.0,2.0,14.0,0.0,1.0,1.0,20.0,0.0,0.0,0.0,10.0,3.0,0.0,4.0,9.0,0.0,2.0,14.0,24.0,1.0,1.0,16.0,1.0,23.0,22.0,6.0,2.0,12.0,12.0,20.5,10.0,0.0,0.0,3.0,14.0,16.0,2.0,24.0,23.0,11.0,22.0,10.0,6.0,10.0,40.0,1.0,4.0,1.0,7.0,4.0,17.0,0.0,10.0,0.0,8.0,3.0,17.0,8.0,18.0,17.0,6.0,0.0,14.0,13.0,8.0,9.0,7.0,2.0,10.0,2.0,13.0,18.0,23.0,7.0,0.0,0.0,7.0,30.0,20.0,18.0,19.0,10.0,28.0,2.0,19.0,9.0,5.0,24.0,5.0,16.0,31.0,16.0,4.0,11.0,2.0,10.0,0.0,2.0,0.0,1.0,1.0,,21.0,20.0,10.0,0.0,0.0,0.0,1.0,0.0,20.0,9.0,4.0,2.0,0.0,11.0,0.0,10.0,13.0,1.0,15.0,15.0,3.0,5.0,7.0,5.0,26.0,11.0,0.0,11.0,29.0,4.0,0.0,7.0,1.0,1.0,11.0,7.0,1.0,21.0,17.0,21.0,23.0,28.0,0.0,2.0,7.0,12.0,24.0,21.0,3.0,0.0,4.0,3.0,0.0,2.0,7.0,7.0,22.0,7.0,1.0,0.0,1.0,4.0,7.0,0.0,40.0,12.0,10.0,12.0,13.0,10.0,0.0,3.0,15.0,11.0,4.0,0.0,7.0,16.0,6.0,4.0,1.0,0.0,2.0,1.0,0.0,1.0,0.0,2.0,0.0,1.0,0.0,2.0,0.0,0.0,0.0,0.0,1.0,0.0,0.0,1.0,3.0,4.0,0.0,0.0,0.0,0.0,1.0,1.0,0.0,0.0,1.0,0.0,1.0,0.0,0.0,0.0,0.0,0.0,0.0,0.0,0.0,1.0,1.0,0.0,0.0,5.0,1.0,1.0,1.0,0.0,0.0,0.0,1.0,1.0,2.0,1.0,2.0,1.0,0.0,0.0,0.0,0.0,1.0,1.0,1.0,2.0,2.0,1.0,3.0,15.0,15.0,5.0,4.0,2.0,3.0,3.0,12.0,12.0,25.0,6.0,7.0,14.0,14.0,12.0,13.0,11.0,4.0,2.0,13.0,6.0,14.0,8.0,7.0,4.0,6.0,6.0,6.0,3.0,5.0,9.0,13.0,18.0,7.0,15.0,16.0,17.0,10.0,8.0,6.0,15.0,20.0,12.0,10.0,5.0,5.0,3.0,9.0,9.0,5.0,0.0,0.0,0.0,3.0,0.0,0.0,0.0,0.0,4.0,4.0,15.0,0.0,14.0,9.0,11.0,1.0,16.0,17.0,1.0,13.0,8.0,1.0,1.0,2.0,0.0,2.0,1.0,2.0,0.0,6.0,0.0,2.0,5.0,2.0,5.0,2.0,8.0,14.0,6.0,15.0,13.0,0.0,4.0,18.0,19.0,11.0,0.0,0.0,3.0,10.0,1.0,9.0,18.0,0.0,4.0,0.0,3.0,1.0,24.0,22.0,15.0,0.0,1.0,9.0,2.0,8.0,10.0,23.0,1.0,8.0,1.0,6.0,20.0,21.0,25.0,12.0,3.0,9.0,13.0,12.0,16.0,12.0,1.0,1.0,23.0,4.0,2.0,0.0,10.0,11.0,16.0,17.0,6.0,8.0,12.0,12.0,9.0,0.0,9.0,11.0,1.0,0.0,2.0,8.0,11.0,9.0,13.0,11.0,2.0,15.0,19.0,15.0,13.0,3.0,14.0,6.0,3.0,5.0,8.0,11.0,13.0,11.0,13.0,2.0,3.0,6.0,5.0,0.0,0.0,8.0,5.0,11.0,0.0,10.0,9.0,14.0,10.0,9.0,0.0,11.0,0.0,2.0,8.0,21.0,8.0,9.0,2.0,7.0,10.0,11.0,34.0,13.0,4.0,1.0,16.0,1.0,1.0,13.0,15.0,6.0,2.0,7.0,2.0,6.0,1.0,0.0,13.0,6.0,8.0,10.0,0.0,,1.0,0.0,6.0,0.0,1.0,9.0,14.0,0.0,3.0,1.0,5.0,3.0,2.0,11.0,9.0,6.0,6.0,6.0,10.0,2.0,5.0,12.0,9.0,4.0,4.0,7.0,11.0,22.0,13.0,14.0,9.0,3.0,4.0,5.0,6.0,9.0,9.0,2.0,5.0,2.0,5.0,6.0,8.0,8.0,2.0,10.0,7.0,8.0,0.0,8.0,6.0,10.0,6.0,2.0,1.0,0.0,11.0,0.0,6.0,3.0,3.0,2.0,0.0,0.0,0.0,4.0,4.0,15.0,5.0,0.0,0.0,2.0,4.0,17.0,10.0,6.0,1.0,9.0,2.0,12.0,14.0,4.0,4.0,3.0,13.0,9.0,3.0,11.0,3.0,14.0,15.0,6.0,8.0,0.0,2.0,6.0,6.0,12.0,9.0,5.0,8.0,14.0,3.0,1.0,4.0,10.0,2.0,2.0,0.0,5.0,9.0,10.0,3.0,3.0,2.0,6.0,8.0,2.0,4.0,6.0,8.0,13.0,13.0,6.0,10.0,0.0,11.0,1.0,0.0,9.0,5.0,5.0,13.0,5.0,2.0,6.0,9.0,5.0,10.0,12.0,1.0,4.0,9.0,5.0,8.0,3.0,0.0,3.0,3.0,4.0,5.0,6.0,0.0,4.0,7.0,0.0,5.0,5.0,2.0,4.0,14.0,13.0,10.0,11.0,5.0,7.0,6.0,7.0,5.0,8.0,5.0,10.0,3.0,17.0,7.0,5.0,4.0,11.0,10.0,4.0,12.0,9.0,14.0,10.0,6.0,2.0,11.0,3.0,7.0,3.0,0.0,7.0,7.0,1.0,6.0,3.0,15.0,9.0,0.0,11.0,3.0,13.0,10.0,13.0,8.0,11.0,0.0,10.0,10.0,6.0,11.0,16.0,0.0,0.0,15.0,9.0,7.0,2.0,8.0,4.0,32.0,7.0,12.0,6.0,8.0,1.0,7.0,9.0,9.0,10.0,4.0,0.0,8.0,13.0,1.0,7.0,2.0,3.0,1.0,1.0,6.0,8.0,0.0,4.0,4.0,13.0,7.0,11.0,13.0,8.0,11.0,4.0,0.0,0.0,16.0,19.0,6.0,6.0,1.0,17.0,5.0,9.0,6.0,9.0,6.0,10.0,6.0,7.0,6.0,6.0,0.0,7.0,5.0,7.0,13.0,12.0,0.0,3.0,13.0,6.0,9.0,8.0,6.0,5.0,12.0,7.0,8.0,9.0,9.0,9.0,5.0,6.0,6.0,7.0,6.0,7.0,6.0,4.0,7.0,20.0,7.0,16.0,2.0,15.0,4.0,12.0,12.0,8.0,4.0,3.0,3.0,11.0,7.0,6.0,4.0,12.0,6.0,14.0,5.0,6.0,6.0,9.0,3.0,4.0,18.0,11.0,7.0,13.0,6.0,2.0,7.0,8.0,9.0,4.0,5.0,9.0,0.0,13.0,6.0,2.0,8.0,17.0,11.0,1.0,5.0,10.0,6.0,5.0,9.0,11.0,5.0,0.0,2.0,4.0,2.0,6.0,5.0,14.0,9.0,2.0,5.0,3.0,13.0,25.0,7.0,13.0,0.0,7.0,5.0,6.0,1.0,11.0,9.0,28.0,12.0,2.0,3.0,12.0,7.0,7.0,6.0,4.0,9.0,6.0,3.0,2.0,5.0,12.0,3.0,5.0,4.0,13.0,10.0,12.0,11.0,16.0,4.0,4.0,10.0,0.0,2.0,5.0,0.0,0.0,0.0,0.0,0.0,0.0,0.0,0.0,1.0,0.0,3.0,4.0,0.0,4.0,2.0,2.0,3.0,8.0,5.0,9.0,3.0,2.0,7.0,4.0,16.0,8.0,6.0,3.0,3.0,4.0,2.0,5.0,2.0,4.0,7.0,2.0,2.0,5.0,6.0,3.0,4.0,8.0,2.0,2.0,2.0,2.0,2.0,0.0,1.0,2.0,2.0,3.0,2.0,2.0,3.0,2.0,3.0,2.0,2.0,2.0,1.0,3.0,2.0,3.0,5.0,4.0,2.0,4.0,2.0,2.0,2.0,2.0,4.0,3.0,0.0,0.0,4.0,3.0,2.0,4.0,4.0,3.0,4.0,3.0,2.0,1.0,0.0,3.0,1.0,2.0,4.0,5.0,2.0,2.0,3.0,2.0,4.0,2.0,3.0,0.0,4.0,3.0,3.0,2.0,0.0,2.0,3.0,2.0,1.0,2.0,2.0,1.0,2.0,3.0,3.0,2.0,0.0,3.0,2.0,2.0,3.0,2.0,3.0,3.0,2.0,3.0,5.0,5.0,3.0,1.0,3.0,0.0,2.0,0.0,1.0,3.0,5.0,2.0,6.0,4.0,2.0,1.0,9.0,4.0,7.0,6.0,3.0,3.0,4.0,6.0,4.0,3.0,5.0,7.0,11.0,6.0,6.0,5.0,4.0,4.0,7.0,5.0,6.0,0.0,0.0,0.0,10.0,0.0,0.0,6.0,5.0,0.0,0.0,0.0,0.0,0.0,0.0,0.0,0.0,0.0,4.0,0.0,5.0,0.0,8.0,0.0,0.0,1.0,0.0,0.0,0.0,0.0,0.0,0.0,0.0,0.0,14.0,0.0,0.0,0.0,0.0,5.0,5.0,5.0,5.0,5.0,4.0,5.0,5.0,5.0,1.0,9.0,6.0,5.0,10.0,7.0,4.0,6.0,6.0,6.0,4.0,9.0,3.0,7.0,6.0,7.0,7.0,6.0,5.0,5.0,7.0,1.0,2.0,9.0,10.0,5.0,7.0,6.0,7.0,4.0,7.0,2.0,5.0,6.0,7.0,7.0,4.0,9.0,0.0,9.0,5.0,10.0,6.0,5.0,8.0,4.0,8.0,4.0,5.0,5.0,7.0,4.0,6.0,12.0,10.0,7.0,4.0,,,,,,,,,,,,,,,,,,,,,,,,,,,,,,,,,,,,,,,,,,,,,,,,,,,,,,,,,,,,,,,,,,,,,,,,,,,,,,,,,,,,,,,,,,,,,,,,,,,,,,,,,,,,,,,,,,,,,,,,,,,,,,,,,,,,,,,,,,,,,,,,,,,,13.0,1.0,0.0,28.0,58.0,3.0,41.0,0.0,11.0,2.0,35.0,17.0,13.0,0.0,21.0,0.0,4.0,17.0,16.0,9.0,18.0,0.0,0.0,6.0,40.0,22.0,16.0,0.0,3.0,38.0,24.0,15.0,16.0,7.0,14.0,14.0,19.0,21.0,15.0,17.0,5.0,17.0,15.0,23.0,8.0,0.0,0.0,2.0,17.0,22.0,26.0,23.0,18.0,29.0,0.0,1.0,0.0,13.0,27.0,0.0,19.0,0.0,11.0,17.0,18.0,5.0,7.0,9.0,27.0,13.0,27.0,31.0,32.0,13.0,7.0,14.0,12.0,33.0,8.0,12.0,16.0,4.0,3.0,13.0,4.0,24.0,6.0,32.0,27.0,11.0,4.0,17.0,24.0,6.0,6.0,15.0,19.0,22.0,18.0,0.0,0.0,36.0,18.0,54.0,5.0,12.0,2.0,6.0,4.0,1.0,19.0,0.0,15.0,0.0,2.0,46.0,19.0,7.0,1.0,1.0,30.0,4.0,24.0,21.0,1.0,2.0,2.0,26.0,2.0,1.0,27.0,15.0,22.0,22.0,10.0,1.0,7.0,1.0,1.0,1.0,2.0,37.0,0.0,0.0,0.0,15.0,5.0,20.0,20.0,29.0,0.0,0.0,1.0,0.0,1.0,16.0,0.0,1.0,23.0,15.0,0.0,7.0,2.0,1.0,38.0,0.0,1.0,10.0,34.0,0.0,2.0,1.0,9.0,0.0,5.0,15.0,17.0,33.0,18.0,7.0,1.0,16.0,2.0,11.0,2.0,7.0,46.0,36.0,6.0,15.0,19.0,11.0,23.0,45.0,28.0,7.0,7.0,9.0,29.0,2.0,4.0,41.0,9.0,7.0,4.0,17.0,13.0,19.0,22.0,0.0,1.0,0.0,21.0,14.0,6.0,14.0,3.0,7.0,16.0,3.0,22.0,1.0,1.0,0.0,16.0,4.0,14.0,20.0,10.0,23.0,47.0,2.0,8.0,6.0,5.0,0.0,2.0,0.0,25.0,23.0,1.0,0.0,0.0,6.0,2.0,0.0,1.0,17.0,12.0,9.0,20.0,18.0,20.0,0.0,23.0,0.0,18.0,3.0,18.0,16.0,21.0,0.0,15.0,0.0,2.0,0.0,20.0,5.0,18.0,10.0,0.0,12.0,2.0,19.0,14.0,8.0,5.0,3.0,8.0,15.0,1.0,0.0,45.0,0.0,0.0,20.0,2.0,28.0,10.0,7.0,7.0,3.0,13.0,19.0,0.0,0.0,1.0,4.0,22.0,16.0,18.0,1.0,28.0,0.0,17.0,30.0,23.0,1.0,0.0,5.0,18.0,34.0,22.0,27.0,19.0,23.0,3.0,0.0,0.0,3.0,25.0,22.0,26.0,25.0,11.0,31.0,13.0,27.0,0.0,6.0,26.0,7.0,0.0,0.0,42.0,8.0,49.0,2.0,1.0,0.0,1.0,0.0,0.0,0.0,29.0,2.0,2.0,0.0,2.0,19.0,22.0,2.0,43.0,9.0,27.0,8.0,29.0,1.0,20.0,31.0,49.0,31.0,31.0,46.0,26.0,53.0,11.0,0.0,28.0,50.0,9.0,35.0,21.0,29.0,3.0,32.0,33.0,0.0,1.0,3.0,1.0,10.0,5.0,0.0,11.0,4.0,2.0,4.0,3.0,0.0,2.0,3.0,1.0,0.0,0.0,0.0,0.0,7.0,5.0,2.0,0.0,0.0,1.0,1.0,0.0,0.0,3.0,0.0,38.0,5.0,3.0,4.0,1.0,0.0,1.0,1.0,3.0,13.0,1.0,0.0,25.0,0.0,1.0,19.0,6.0,0.0,14.0,22.0,25.0,27.0,23.0,12.0,18.0,39.0,28.0,2.0,41.0,21.0,0.0,0.0,25.0,7.0,1.0,22.0,28.0,0.0,16.0,0.0,12.0,1.0,0.0,1.0,28.0,0.0,1.0,2.0,2.0,2.0,1.0,24.0,0.0,0.0,1.0,8.0,3.0,5.0,18.0,0.0,11.0,0.0,10.0,13.0,24.0,9.0,1.0,1.0,11.0,3.0,0.0,4.0,17.0,1.0,3.0,20.0,1.0,24.0,19.0,36.0,14.0,39.0,18.0,17.0,19.0,2.0,2.0,2.0,0.0,35.0,5.0,3.0,0.0,32.0,11.0,15.0,6.0,40.0,0.0,19.0,20.0,4.0,13.0,0.0,12.0,0.0,4.0,7.0,1.0,17.0,35.0,22.0,34.0,3.0,22.0,9.0,28.0,30.0,3.0,0.0,18.0,14.0,2.0,21.0,8.0,14.0,0.0,0.0,28.0,24.0,19.0,2.0,2.0,1.0,10.0,3.0,34.0,12.0,0.0,37.0,16.0,26.0,27.0,4.0,13.0,28.0,5.0,35.0,0.0,0.0,26.0,10.0,7.0,7.0,6.0,0.0,5.0,10.0,24.0,6.0,38.0,62.0,2.0,0.0,6.0,31.0,4.0,3.0,1.0,1.0,1.0,9.0,3.0,12.0,4.0,6.0,2.0,18.0,15.0,38.0,12.0,20.0,5.0,16.0,5.0,9.0,28.0,7.0,1.0,8.0,1.0,12.0,5.0,11.0,0.0,0.0,1.0,18.0,0.0,36.0,4.0,1.0,5.0,1.0,10.0,10.0,11.0,0.0,0.0,13.0,29.0,15.0,0.0,2.0,14.0,16.0,23.0,19.0,1.0,0.0,1.0,22.0,19.0,0.0,1.0,18.0,12.0,5.0,10.0,0.0,0.0,0.0,1.0,0.0,0.0,15.0,11.0,18.0,18.0,3.0,22.0,0.0,0.0,1.0,1.0,0.0,4.0,0.0,0.0,0.0,9.0,1.0,0.0,1.0,1.0,0.0,27.0,16.0,9.0,2.0,21.0,25.0,11.0,17.0,22.0,22.0,22.0,36.0,17.0,2.0,0.0,1.0,1.0,1.0,10.0,26.0,3.0,0.0,1.0,2.0,0.0,28.0,13.0,1.0,0.0,15.0,14.0,0.0,14.0,7.0,20.0,5.0,18.0,0.0,1.0,3.0,5.0,11.0,15.0,25.0,0.0,23.0,23.0,10.0,23.0,20.0,1.0,18.0,13.0,11.0,24.0,23.0,43.0,2.0,38.0,1.0,1.0,0.0,0.0,36.0,0.0,2.0,1.0,1.0,2.0,3.0,5.0,10.0,27.0,1.0,37.0,31.0,31.0,22.0,20.0,45.0,2.0,0.0,25.0,11.0,14.0,8.0,18.0,3.0,3.0,21.0,1.0,2.0,53.0,5.0,5.0,31.0,2.0,0.0,32.0,2.0,0.0,0.0,4.0,16.0,34.0,1.0,0.0,4.0,1.0,0.0,8.0,2.0,0.0,4.0,3.0,17.0,0.0,2.0,3.0,2.0,0.0,0.0,0.0,0.0,2.0,20.0,0.0,1.0,1.0,0.0,0.0,0.0,0.0,13.0,10.0,17.0,1.0,19.0,0.0,3.0,26.0,4.0,13.0,14.0,6.0,19.0,1.0,0.0,1.0,10.0,23.0,8.0,17.0,23.0,0.0,4.0,10.0,17.0,29.0,20.0,15.0,5.0,20.0,7.0,30.0,4.0,2.0,10.0,27.0,4.0,1.0,8.0,15.0,0.0,8.0,8.0,18.0,2.0,7.0,8.0,5.0,32.0,15.0,5.0,2.0,2.0,8.0,12.0,7.0,2.0,6.0,9.0,9.0,12.0,4.0,2.0,2.0,2.0,2.0,1.0,7.0,4.0,2.0,0.0,13.0,0.0,5.0,6.0,6.0,13.0,1.0,1.0,9.0,16.0,14.0,6.0,0.0,10.0,19.0,9.0,11.0,0.0,0.0,14.0,14.0,6.0,12.0,1.0,4.0,4.0,24.0,11.5,16.0,10.0,3.0,7.0,5.0,2.0,3.0,3.0,8.0,11.0,9.0,13.0,4.0,39.0,0.0,20.0,10.0,1.0,16.0,6.0,17.0,4.0,6.0,0.0,7.0,3.0,18.0,10.0,4.0,2.0,6.0,0.0,0.0,8.0,5.0,5.0,13.0,17.0,3.0,29.0,7.0,3.0,42.0,15.0,29.0,25.0,0.0,2.0,2.0,4.0,2.0,18.0,5.0,2.0,4.0,13.0,1.0,10.0,2.0,10.0,1.0,2.0,8.0,1.0,2.0,6.0,6.0,6.0,35.0,7.0,36.0,1.0,8.0,0.0,13.0,9.0,15.0,7.0,5.0,10.0,12.0,13.0,13.0,11.0,4.0,11.0,4.0,9.0,13.0,4.0,12.0,0.0,0.0,11.0,16.0,2.0,15.0,4.0,0.0,8.0,1.0,22.0,16.0,12.0,2.0,10.0,1.0,11.0,1.0,16.0,12.0,2.0,5.0,0.0,6.0,8.0,12.0,1.0,14.0,7.0,26.0,35.0,14.0,8.0,13.0,11.0,9.0,3.0,4.0,0.0,23.0,6.0,3.0,10.0,13.0,8.0,5.0,8.0,10.0,11.0,33.0,6.0,14.0,0.0,2.0,11.0,13.0,15.0,8.0,3.0,11.0,11.0,40.0,6.0,2.0,8.0,1.0,7.0,18.0,14.0,6.0,11.0,32.0,14.0,3.0,48.0,2.0,1.0,9.0,9.0,13.0,4.0,9.0,11.0,3.0,10.0,1.0,12.0,26.0,20.0,2.0,25.0,0.0,9.0,24.0,13.0,0.0,6.0,2.0,20.0,12.0,2.0,5.0,3.0,27.0,13.0,4.0,9.0,31.0,18.0,2.0,2.0,12.0,8.0,15.0,14.0,11.0,0.0,3.0,0.0,3.0,3.0,41.0,2.0,4.0,10.0,4.0,3.0,13.0,8.0,7.0,16.0,10.0,1.0,1.0,9.0,5.0,6.0,1.0,2.0,14.0,13.0,3.0,6.0,9.0,6.0,0.0,2.0,12.0,1.0,5.0,13.0,11.0,13.0,3.0,3.0,6.0,5.0,14.0,9.0,11.0,0.0,0.0,7.0,0.0,15.0,3.0,26.0,36.0,2.0,19.0,1.0,6.0,5.0,8.0,2.0,11.0,5.0,11.0,7.0,4.0,6.0,6.0,9.0,2.0,12.0,10.0,7.0,0.0,17.0,3.0,10.0,22.0,7.0,0.0,6.0,16.0,0.0,13.0,6.0,6.0,7.0,5.0,0.0,10.0,25.0,13.0,25.0,0.0,0.0,1.0,5.0,4.0,9.0,7.0,9.0,6.0,10.0,16.0,6.0,8.0,16.0,4.0,15.0,17.0,4.0,1.0,8.0,10.0,3.0,0.0,4.0,7.0,0.0,0.0,4.0,19.0,19.0,13.0,17.0,6.0,0.0,1.0,6.0,0.0,22.0,8.0,7.0,5.0,4.0,8.0,2.0,4.0,0.0,1.0,52.0,6.0,2.0,21.0,3.0,64.0,11.0,19.0,7.0,1.0,8.0,2.0,2.0,40.0,3.0,11.0,6.0,13.0,9.0,3.0,14.0,2.0,2.0,3.0,5.0,3.0,0.0,7.0,18.0,9.0,2.0,0.0,12.0,2.0,6.0,10.0,7.0,12.0,6.0,12.0,1.0,15.0,4.0,1.0,3.0,4.0,5.0,8.0,15.0,11.0,19.0,22.0,6.0,10.0,3.0,9.0,14.0,13.0,12.0,14.0,9.0,8.0,12.0,17.0,0.0,3.0,5.0,11.0,12.0,1.0,7.0,5.0,8.0,4.0,15.0,18.0,6.0,18.0,16.0,17.0,31.0,11.0,10.0,30.0,0.0,15.0,17.0,19.0,23.0,17.0,25.0,18.0,14.0,7.0,32.0,9.0,16.0,8.0,21.0,20.0,23.0,17.0,12.0,12.0,13.0,4.0,3.0,4.0,0.0,15.0,0.0,0.0,11.0,11.0,0.0,8.0,20.0,0.0,0.0,0.0,2.0,6.0,1.0,5.0,16.0,15.0,14.0,24.0,0.0,12.0,0.0,13.0,1.0,2.0,0.0,1.0,18.0,2.0,6.0,0.0,10.0,10.0,17.0,7.0,1.0,5.0,2.0,5.0,9.0,14.0,12.0,6.0,4.0,8.0,13.0,15.0,20.0,0.0,18.0,0.0,1.0,8.0,2.0,11.0,13.0,16.0,6.0,3.0,19.0,9.0,0.0,9.0,6.0,17.0,26.0,0.0,15.0,23.0,12.0,13.0,13.0,15.0,17.0,11.0,12.0,17.0,27.0,16.0,15.0,5.0,19.0,10.0,3.0,16.0,5.0,4.0,14.0,3.0,0.0,11.0,11.0,17.0,19.0,11.0,12.0,28.0,2.0,6.0,20.0,4.0,21.0,0.0,1.0,9.0,3.0,3.0,20.0,4.0,10.0,11.0,2.0,6.0,10.0,4.0,1.0,17.0,25.0,16.0,12.0,19.0,4.0,2.0,18.0,17.0,19.0,19.0,15.0,16.0,5.0,9.0,10.0,4.0,16.0,4.0,4.0,4.0,18.0,11.0,5.0,3.0,22.0,2.0,18.0,20.0,1.0,35.0,9.0,24.0,15.0,10.0,17.0,7.0,0.0,13.0,17.0,21.0,22.0,25.0,0.0,7.0,0.0,1.0,0.0,4.0,16.0,1.0,10.0,2.0,14.0,1.0,15.0,5.0,21.0,14.0,38.0,5.0,4.0,8.0,3.0,5.0,11.0,14.0,25.0,10.0,6.0,6.0,26.0,3.0,14.0,12.0,0.0,18.0,4.0,9.0,9.0,4.0,23.0,2.0,3.0,13.0,4.0,29.0,20.0,19.0,15.0,12.0,0.0,0.0,0.0,0.0,12.0,10.0,1.0,7.0,11.0,9.0,3.0,8.0,9.0,17.0,2.0,10.0,6.0,5.0,12.0,9.0,4.0,3.0,4.0,13.0,0.0,4.0,10.0,3.0,3.0,0.0,9.0,4.0,9.0,13.0,5.0,1.0,13.0,3.0,10.0,2.0,16.0,15.0,15.0,16.0,7.0,11.0,2.0,14.0,5.0,17.0,6.0,14.0,2.0,7.0,0.0,0.0,0.0,0.0,0.0,0.0,0.0,7.0,8.0,9.0,5.0,6.0,9.0,12.0,7.0,3.0,5.0,5.0,4.0,4.0,5.0,12.0,9.0,6.0,7.0,12.0,5.0,5.0,4.0,4.0,4.0,11.0,9.0,12.0,9.0,6.0,4.0,8.0,6.0,8.0,6.0,4.0,8.0,5.0,4.0,6.0,7.0,6.0,4.0,6.0,7.0,3.0,5.0,7.0,8.0,7.0,9.0,8.0,8.0,5.0,6.0,6.0,5.0,4.0,3.0,5.0,10.0,10.0,6.0,5.0,4.0,4.0,7.0,6.0,4.0,8.0,4.0,6.0,8.0,11.0,10.0,3.0,9.0,2.0,10.0,13.0,3.0,13.0,6.0,7.0,13.0,4.0,8.0,5.0,3.0,8.0,6.0,12.0,9.0,5.0,5.0,4.0,7.0,5.0,5.0,9.0,7.0,5.0,0.0,0.0,1.0,1.0,2.0,2.0,2.0,0.0,1.0,0.0,0.0,0.0,3.0,0.0,0.0,2.0,0.0,0.0,4.0,5.0,11.0,8.0,20.0,16.0,4.0,8.0,7.0,5.0,2.0,7.0,3.0,0.0,12.0,5.0,3.0,16.0,0.0,15.0,8.0,6.0,10.0,0.0,9.0,10.0,2.0,4.0,16.0,8.0,5.0,0.0,6.0,6.0,4.0,5.0,3.0,9.0,7.0,8.0,9.0,3.0,0.0,15.0,17.0,9.0,9.0,10.0,12.0,7.0,6.0,6.0,8.0,17.0,9.0,10.0,7.0,6.0,7.0,5.0,5.0,2.0,11.0,5.0,8.0,12.0,9.0,1.0,4.0,10.0,4.0,6.0,14.0,4.0,10.0,9.0,9.0,0.0,9.0,13.0,6.0,0.0,6.0,0.0,0.0,0.0,0.0,,,,,,,,,,,0.0,0.0,0.0,0.0,0.0,0.0,0.0,0.0,0.0,5.0,9.0,13.0,9.0,6.0,8.0,11.0,6.0,9.0,18.0,4.0,15.0,2.0,9.0,9.0,3.0,9.0,10.0,15.0,4.0,4.0,7.0,9.0,12.0,13.0,4.0,1.0,4.0,10.0,6.0,9.0,5.0,9.0,1.0,2.0,9.0,12.0,0.0,0.0,0.0,0.0,0.0,0.0,0.0,0.0,0.0,0.0,0.0,0.0,0.0,0.0,0.0,0.0,0.0,0.0,0.0,0.0,0.0,20.0,16.0,1.0,2.0,0.0,0.0,0.0,1.0,4.0,0.0,0.0,0.0,0.0,0.0,1.0,0.0,4.0,0.0,0.0,1.0,2.0,0.0,2.0,2.0,0.0,0.0,0.0,0.0,0.0,17.0,4.0,1.0,3.0,9.0,8.0,11.0,6.0,8.0,14.0,13.0,4.0,3.0,8.0,9.0,8.0,9.0,4.0,9.0,4.0,8.0,7.0,7.0,1.0,3.0,8.0,6.0,4.0,8.0,1.0,6.0,5.0,11.0,7.0,6.0,3.0,7.0,6.0,5.0,4.0,6.0,7.0,3.0,6.0,1.0,5.0,8.0,6.0,4.0,8.0,11.0,8.0,6.0,3.0,8.0,6.0,6.0,0.0,13.0,2.0,8.0,5.0,7.0,4.0,6.0,6.0,4.0,5.0,7.0,0.0,2.0,4.0,10.0,4.0,2.0,14.0,8.0,2.0,6.0,12.0,6.0,8.0,3.0,8.0,13.0,11.0,7.0,4.0,12.0,12.0,7.0,5.0,17.0,16.0,8.0,5.0,4.0,10.0,5.0,6.0,16.0,8.0,8.0,13.0,11.0,3.0,10.0,5.0,14.0,7.0,2.0,3.0,8.0,10.0,5.0,1.0,5.0,7.0,9.0,7.0,1.0,3.0,2.0,4.0,11.0,2.0,7.0,4.0,7.0,4.0,2.0,0.0,10.0,11.0,1.0,5.0,3.0,6.0,5.0,3.0,4.0,10.0,2.0,5.0,2.0,8.0,3.0,4.0,5.0,10.0,19.0,4.0,,,,,,,,,,,,,,,,,,,,,,,6.0,9.0,5.0,2.0,1.0,11.0,9.0,8.0,8.0,1.0,5.0,6.0,11.0,0.0,5.0,6.0,6.0,1.0,4.0,6.0,0.0,6.0,0.0,1.0,0.0,4.0,4.0,0.0,10.0,11.0,5.0,5.0,2.0,5.0,2.0,3.0,11.0,6.0,6.0,0.0,5.0,3.0,0.0,0.0,3.0,3.0,0.0,4.0,8.0,5.0,10.0,4.0,2.0,18.0,4.0,22.0,0.0,7.0,10.0,18.0,3.0,1.0,10.0,7.0,5.0,1.0,4.0,15.0,7.0,1.0,12.0,7.0,7.0,0.0,6.0,5.0,8.0,5.0,8.0,6.0,5.0,8.0,23.0,0.0,11.0,4.0,21.0,2.0,7.0,1.0,0.0,3.0,2.0,0.0,3.0,11.0,0.0,7.0,6.0,2.0,3.0,0.0,1.0,0.0,4.0,11.0,2.0,4.0,6.0,4.0,14.0,1.0,1.0,20.0,14.0,1.0,9.0,7.0,0.0,1.0,3.0,12.0,1.0,5.0,13.0,0.0,10.0,26.0,13.0,0.0,16.0,11.0,1.0,0.0,38.0,0.0,14.0,6.0,1.0,8.0,1.0,1.0,4.0,15.0,12.0,31.0,0.0,3.0,1.0,7.0,0.0,32.0,9.0,5.0,8.0,0.0,3.0,8.0,10.0,8.0,2.0,4.0,4.0,0.0,10.0,11.0,5.0,7.0,1.0,5.0,4.0,0.0,5.0,6.0,0.0,0.0,7.0,15.0,10.0,11.0,6.0,10.0,13.0,4.0,11.0,8.0,8.0,2.0,19.0,21.0,33.0,0.0,0.0,1.0,0.0,2.0,4.0,3.0,4.0,3.0,0.0,7.0,11.0,6.0,2.0,2.0,3.0,1.0,3.0,13.0,4.0,4.0,0.0,6.0,19.0,12.0,6.0,12.0,16.0,1.0,0.0,4.0,14.0,8.0,4.0,9.0,6.0,0.0,6.0,4.0,0.0,14.0,0.0,5.0,35.0,23.0,10.0,22.0,6.0,2.0,0.0,12.0,8.0,6.0,6.0,0.0,4.0,5.0,3.0,1.0,0.0,6.0,5.0,4.0,5.0,9.0,1.0,2.0,10.0,5.0,2.0,4.0,5.0,8.0,1.0,1.0,2.0,0.0,15.0,8.0,6.0,0.0,10.0,8.0,3.0,5.0,0.0,6.0,0.0,4.0,8.0,6.0,2.0,2.0,3.0,7.0,5.0,6.0,4.0,10.0,14.0,2.0,5.0,4.0,7.0,3.0,7.0,9.0,4.0,8.0,13.0,0.0,20.0,3.0,0.0,3.0,2.0,0.0,15.0,30.0,30.0,13.0,12.0,6.0,0.0,10.0,1.0,9.0,13.0,9.0,1.0,3.0,13.0,14.0,1.0,0.0,2.0,3.0,0.0,1.0,32.0,1.0,1.0,2.0,6.0,2.0,5.0,13.0,0.0,14.0,0.0,2.0,3.0,6.0,15.0,7.0,4.0,6.0,10.0,12.0,10.0,5.0,5.0,5.0,21.0,7.0,0.0,0.0,6.0,9.0,0.0,5.0,5.0,10.0,0.0,8.0,7.0,15.0,6.0,5.0,10.0,3.0,0.0,0.0,28.0,0.0,7.0,0.0,1.0,1.0,2.0,3.0,5.0,34.0,18.0,12.0,18.0,25.0,12.0,9.0,6.0,30.0,6.0,0.0,15.0,7.0,9.0,14.0,0.0,0.0,7.0,22.0,2.0,4.0,1.0,0.0,1.0,10.0,3.0,0.0,1.0,0.0,6.0,2.0,0.0,10.0,18.0,5.0,7.0,19.0,8.0,4.0,2.0,1.0,4.0,5.0,1.0,11.0,5.0,5.0,2.0,6.0,5.0,8.0,7.0,0.0,0.0,0.0,8.0,3.0,3.0,9.0,0.0,3.0,3.0,5.0,2.0,0.0,7.0,7.0,19.0,47.0,4.0,1.0,6.0,0.0,6.0,0.0,7.0,1.0,2.0,6.0,6.0,5.0,8.0,6.0,1.0,1.0,1.0,4.0,2.0,6.0,22.0,8.0,26.0,12.0,12.0,1.0,19.0,8.0,5.0,4.0,26.0,2.0,14.0,20.0,15.0,2.0,0.0,5.0,14.0,10.0,2.0,6.0,12.0,6.0,2.0,12.0,7.0,0.0,0.0,16.0,16.0,1.0,6.0,7.0,7.0,14.0,12.0,3.0,1.0,8.0,12.0,1.0,3.0,3.0,0.0,29.0,10.0,0.0,20.0,6.0,0.0,10.0,1.0,1.0,2.0,9.0,5.0,3.0,5.0,1.0,7.0,9.0,16.0,0.0,4.0,12.0,11.0,6.0,12.0,4.0,10.0,8.0,2.0,2.0,8.0,3.0,4.0,3.0,23.0,3.0,20.0,1.0,19.0,19.0,9.0,5.0,2.0,7.0,2.0,7.0,8.0,0.0,0.0,0.0,30.0,4.0,0.0,2.0,7.0,3.0,2.0,4.0,12.0,10.0,6.0,3.0,7.0,11.0,8.0,1.0,5.0,18.0,12.0,10.0,9.0,9.0,2.0,0.0,16.0,20.0,1.0,5.0,9.0,15.0,7.0,23.0,10.0,0.0,6.0,10.0,8.0,22.0,4.0,5.0,3.0,1.0,0.0,3.0,0.0,4.0,3.0,0.0,,,0.0,0.0,2.0,1.0,,5.0,9.0,1.0,7.0,0.0,0.0,2.0,2.0,1.0,1.0,,1.0,1.0,1.0,2.0,4.0,6.0,2.0,0.0,2.0,0.0,,2.0,0.0,0.0,3.0,0.0,1.0,4.0,1.0,0.0,3.0,4.0,,50.0,50.0,30.0,30.0,40.0,17.0,8.0,10.0,3.0,9.0,0.0,3.0,14.0,7.0,15.0,7.0,15.0,3.0,0.0,9.0,2.0,16.0,23.0,15.0,13.0,19.0,10.0,3.0,8.0,12.0,6.0,5.0,0.0,0.0,22.0,7.0,10.0,12.0,14.0,15.0,8.0,5.0,3.0,8.0,0.0,7.0,3.0,3.0,35.0,0.0,6.0,21.0,0.0,9.0,1.0,1.0,0.0,4.0,12.0,13.0,22.0,13.0,9.0,3.0,1.0,0.0,18.0,0.0,3.0,34.0,7.0,1.0,12.0,5.0,0.0,0.0,3.0,1.0,0.0,26.0,4.0,1.0,2.0,0.0,1.0,0.0,3.0,0.0,1.0,21.0,1.0,1.0,10.0,0.0,9.0,5.0,0.0,0.0,1.0,0.0,14.0,7.0,8.0,0.0,10.0,2.0,15.0,28.0,26.0,15.0,10.0,5.0,11.0,6.0,20.0,9.0,0.0,20.0,22.0,24.0,1.0,22.0,5.0,6.0,17.0,13.0,6.0,20.0,7.0,4.0,35.0,15.0,30.0,27.0,13.0,6.0,15.0,20.0,24.0,27.0,15.0,8.0,10.0,29.0,9.0,14.0,30.0,0.0,13.0,27.0,25.0,1.0,2.0,20.0,15.0,9.0,30.0,22.0,4.0,16.0,9.0,10.0,8.0,24.0,25.0,4.0,7.0,8.0,0.0,19.0,0.0,0.0,5.0,9.0,29.0,6.0,0.0,4.0,12.0,8.0,0.0,0.0,1.0,20.0,13.0,0.0,1.0,0.0,10.0,14.0,7.0,7.0,2.0,13.0,27.0,29.0,4.0,3.0,10.0,8.0,10.0,2.0,3.0,7.0,2.0,36.0,18.0,19.0,18.0,10.0,3.0,19.0,9.0,3.0,0.0,0.0,25.0,8.0,26.0,17.0,19.0,10.0,13.0,10.0,7.0,4.0,15.0,4.0,0.0,10.0,5.0,10.0,14.0,24.0,17.0,10.0,9.0,12.0,2.0,0.0,0.0,9.0,0.0,6.0,19.0,1.0,2.0,7.0,2.0,3.0,2.0,18.0,17.0,2.0,0.0,0.0,8.0,12.0,0.0,0.0,15.0,11.0,5.0,12.0,12.0,4.0,0.0,1.0,0.0,5.0,1.0,0.0,6.0,11.0,15.0,4.0,8.0,1.0,0.0,14.0,14.0,1.0,4.0,0.0,3.0,3.0,6.0,7.0,23.0,18.0,10.0,0.0,2.0,2.0,2.0,10.0,10.0,1.0,10.0,10.0,26.0,17.0,9.0,0.0,1.0,2.0,6.0,0.0,0.0,5.0,2.0,20.0,1.0,8.0,4.0,0.0,16.0,12.0,10.0,0.0,5.0,14.0,6.0,13.0,6.0,0.0,7.0,15.0,1.0,1.0,6.0,9.0,9.0,7.0,8.0,2.0,14.0,11.0,9.0,15.0,10.0,7.0,4.0,10.0,15.0,20.0,11.0,10.0,6.0,8.0,16.0,8.0,0.0,11.0,12.0,23.0,2.0,9.0,7.0,4.0,14.0,20.0,11.0,12.0,5.0,1.0,11.0,8.0,0.0,14.0,1.0,21.0,2.0,2.0,21.0,8.0,7.0,17.0,5.0,23.0,12.0,21.0,25.0,16.0,6.0,8.0,15.0,2.0,0.0,16.0,24.0,14.0,16.0,4.0,3.0,24.0,10.0,9.0,0.0,0.0,7.0,3.0,11.0,0.0,16.0,6.0,2.0,15.0,15.0,16.0,1.0,23.0,22.0,8.0,0.0,29.0,3.0,22.0,0.0,9.0,6.0,16.0,14.0,4.0,23.0,5.0,24.0,4.0,8.0,25.0,1.0,6.0,0.0,0.0,15.0,11.0,2.0,13.0,11.0,0.0,6.0,0.0,0.0,12.0,14.0,12.0,23.0,16.0,4.0,11.0,7.0,7.0,14.0,4.0,5.0,13.0,6.0,5.0,7.0,3.0,0.0,3.0,10.0,10.0,6.0,13.0,0.0,0.0,5.0,5.0,12.0,18.0,12.0,20.0,21.0,13.0,7.0,16.0,6.0,21.0,8.0,5.0,5.0,2.0,4.0,1.0,2.0,9.0,13.0,1.0,4.0,0.0,1.0,0.0,7.0,1.0,0.0,0.0,2.0,9.0,0.0,0.0,0.0,3.0,3.0,0.0,1.0,3.0,0.0,0.0,13.0,2.0,0.0,0.0,1.0,1.0,1.0,0.0,4.0,10.0,12.0,2.0,3.0,1.0,1.0,1.0,1.0,1.0,1.0,2.0,0.0,5.0,1.0,15.0,0.0,1.0,8.0,0.0,0.0,0.0,1.0,2.0,2.0,14.0,1.0,0.0,5.0,0.0,2.0,1.0,2.0,0.0,0.0,1.0,0.0,0.0,2.0,0.0,1.0,3.0,0.0,3.0,17.0,0.0,8.0,0.0,1.0,0.0,0.0,0.0,3.0,0.0,1.0,0.0,1.0,1.0,0.0,2.0,5.0,0.0,1.0,12.0,0.0,1.0,5.0,1.0,3.0,0.0,0.0,0.0,0.0,16.0,0.0,0.0,22.0,1.0,2.0,23.0,3.0,1.0,1.0,0.0,1.0,0.0,0.0,0.0,0.0,2.0,3.0,0.0,1.0,1.0,0.0,7.0,1.0,6.0,3.0,1.0,2.0,2.0,15.0,3.0,0.0,0.0,1.0,4.0,0.0,0.0,0.0,0.0,0.0,0.0,0.0,26.0,16.0,11.0,2.0,0.0,0.0,0.0,0.0,11.0,3.0,3.0,2.0,0.0,8.0,19.0,0.0,0.0,0.0,1.0,1.0,0.0,0.0,1.0,1.0,1.0,9.0,1.0,1.0,1.0,2.0,1.0,0.0,1.0,0.0,3.0,1.0,0.0,3.0,1.0,0.0,1.0,0.0,1.0,0.0,0.0,0.0,6.0,1.0,2.0,1.0,0.0,1.0,0.0,0.0,0.0,0.0,1.0,4.0,2.0,0.0,1.0,1.0,0.0,8.0,1.0,3.0,2.0,2.0,0.0,1.0,0.0,4.0,0.0,1.0,2.0,2.0,11.0,11.0,0.0,0.0,1.0,0.0,0.0,2.0,1.0,2.0,0.0,18.0,0.0,0.0,0.0,0.0,1.0,4.0,1.0,0.0,0.0,0.0,2.0,1.0,8.0,0.0,2.0,2.0,0.0,0.0,0.0,4.0,2.0,0.0,3.0,1.0,1.0,2.0,2.0,3.0,0.0,0.0,2.0,4.0,0.0,0.0,0.0,3.0,0.0,0.0,0.0,1.0,0.0,2.0,0.0,0.0,10.0,0.0,2.0,1.0,1.0,0.0,3.0,4.0,4.0,1.0,2.0,0.0,0.0,0.0,0.0,0.0,2.0,0.0,1.0,8.0,4.0,1.0,2.0,0.0,3.0,0.0,6.0,1.0,10.0,0.0,0.0,5.0,1.0,2.0,0.0,0.0,7.0,8.0,0.0,4.0,4.0,0.0,15.0,1.0,0.0,1.0,7.0,1.0,0.0,2.0,0.0,6.0,1.0,7.0,6.0,3.0,0.0,2.0,1.0,1.0,5.0,0.0,1.0,6.0,0.0,0.0,1.0,1.0,6.0,3.0,14.0,1.0,3.0,0.0,6.0,1.0,0.0,2.0,2.0,6.0,1.0,17.0,2.0,1.0,1.0,3.0,5.0,5.0,3.0,0.0,4.0,8.0,5.0,2.0,0.0,1.0,0.0,0.0,5.0,1.0,0.0,2.0,1.0,2.0,19.0,2.0,1.0,1.0,0.0,5.0,0.0,0.0,3.0,3.0,0.0,1.0,7.0,0.0,9.0,5.0,7.0,2.0,3.0,7.0,10.0,9.0,7.0,11.0,8.0,11.0,10.0,6.0,10.0,0.0,0.0,0.0,0.0,0.0,0.0,0.0,0.0,0.0,0.0,0.0,2.0,0.0,19.0,0.0,14.0,2.0,5.0,4.0,0.0,11.0,10.0,3.0,7.0,10.0,2.0,8.0,0.0,4.0,14.0,0.0,7.0,1.0,17.0,2.0,6.0,0.0,8.0,0.0,10.0,3.0,2.0,5.0,1.0,3.0,3.0,0.0,15.0,1.0,0.0,3.0,13.0,5.0,0.0,4.0,9.0,1.0,0.0,16.0,3.0,12.0,5.0,2.0,2.0,21.0,0.0,2.0,16.0,0.0,18.0,15.0,1.0,8.0,0.0,18.0,1.0,2.0,3.0,10.0,0.0,6.0,5.0,18.0,9.0,2.0,5.0,1.0,1.0,17.0,6.0,1.0,3.0,5.0,4.0,3.0,13.0,7.0,0.0,1.0,6.0,6.0,0.0,1.0,19.0,15.0,7.0,4.0,9.0,16.0,0.0,1.0,2.0,1.0,3.0,1.0,0.0,4.0,0.0,0.0,4.0,4.0,12.0,6.0,8.0,12.0,0.0,0.0,0.0,16.0,0.0,1.0,1.0,8.0,7.0,0.0,2.0,1.0,0.0,7.0,0.0,7.0,6.0,0.0,3.0,2.0,11.0,4.0,6.0,3.0,14.0,0.0,18.0,1.0,5.0,5.0,5.0,0.0,2.0,0.0,0.0,0.0,0.0,1.0,13.0,7.0,11.0,7.0,3.0,6.0,6.0,10.0,0.0,1.0,5.0,7.0,6.0,6.0,3.0,1.0,0.0,10.0,0.0,8.0,0.0,0.0,20.0,5.0,4.0,0.0,6.0,17.0,14.0,0.0,7.0,1.0,3.0,2.0,11.0,5.0,3.0,0.0,0.0,0.0,17.0,4.0,8.0,3.0,1.0,16.0,0.0,3.0,14.0,15.0,5.0,17.0,20.0,10.0,4.0,3.0,6.0,0.0,0.0,0.0,0.0,1.0,0.0,2.0,0.0,3.0,7.0,10.0,10.0,3.0,0.0,3.0,13.0,7.0,1.0,21.0,6.0,12.0,9.0,4.0,2.0,3.0,9.0,0.0,13.0,0.0,8.0,0.0,0.0,4.0,4.0,12.0,1.0,0.0,6.0,10.0,19.0,8.0,1.0,18.0,9.0,5.0,2.0,1.0,5.0,9.0,9.0,5.0,9.0,1.0,0.0,1.0,0.0,3.0,1.0,0.0,8.0,5.0,1.0,3.0,0.0,13.0,0.0,2.0,6.0,0.0,8.0,0.0,3.0,2.0,12.0,16.0,7.0,0.0,3.0,2.0,3.0,1.0,0.0,5.0,2.0,0.0,3.0,3.0,1.0,0.0,9.0,15.0,3.0,11.0,0.0,1.0,8.0,14.0,15.0,17.0,1.0,0.0,0.0,1.0,0.0,2.0,1.0,0.0,2.0,0.0,0.0,3.0,3.0,28.0,0.0,2.0,10.0,13.0,13.0,0.0,1.0,0.0,14.0,9.0,5.0,0.0,0.0,2.0,3.0,0.0,0.0,15.0,2.0,4.0,10.0,15.0,5.0,0.0,0.0,1.0,8.0,3.0,8.0,1.0,4.0,9.0,0.0,0.0,1.0,24.0,2.0,21.0,17.0,0.0,3.0,6.0,0.0,14.0,3.0,16.0,2.0,1.0,3.0,1.0,4.0,9.0,6.0,6.0,11.0,4.0,6.0,7.0,6.0,5.0,5.0,5.0,3.0,12.0,11.0,6.0,6.0,6.0,5.0,9.0,4.0,5.0,11.0,6.0,5.0,6.0,6.0,5.0,8.0,4.0,4.0,12.0,9.0,6.0,9.0,5.0,8.0,15.0,10.0,10.0,8.0,3.0,6.0,5.0,4.0,5.0,5.0,5.0,0.0,5.0,0.0,5.0,1.0,5.0,4.0,5.0,3.0,3.0,5.0,1.0,5.0,0.0,1.0,3.0,5.0,5.0,5.0,3.0,5.0,5.0,1.0,5.0,1.0,2.0,0.0,0.0,0.0,5.0,1.0,5.0,5.0,5.0,0.0,5.0,2.0,2.0,5.0,3.0,1.0,1.0,3.0,5.0,2.0,5.0,0.0,1.0,1.0,0.0,0.0,0.0,1.0,0.0,0.0,3.0,0.0,5.0,1.0,0.0,1.0,5.0,0.0,0.0,1.0,0.0,2.0,0.0,0.0,1.0,0.0,0.0,5.0,0.0,3.0,1.0,0.0,1.0,0.0,1.0,3.0,0.0,0.0,2.0,4.0,0.0,2.0,1.0,0.0,7.0,4.0,2.0,0.0,11.0,0.0,0.0,3.0,5.0,0.0,0.0,0.0,0.0,0.0,11.0,12.0,19.0,0.0,0.0,0.0,2.0,0.0,0.0,12.0,15.0,11.0,0.0,0.0,0.0,0.0,8.0,4.0,1.0,4.0,1.0,1.0,0.0,0.0,1.5,5.0,0.0,0.0,0.0,7.0,0.0,0.0,0.0,0.0,4.0,0.0,0.0,0.0,0.0,0.0,5.0,0.0,0.0,0.0,0.0,2.0,0.0,1.0,3.0,7.0,2.0,0.0,4.0,5.0,0.0,5.0,0.0,0.0,0.0,0.0,0.0,5.0,2.0,6.0,6.0,0.0,0.0,0.0,0.0,0.0,7.0,0.0,4.0,4.0,0.0,0.0,4.0,8.0,0.0,12.0,0.0,0.0,6.0,0.0,5.0,12.0,15.0,9.0,6.0,14.0,9.0,10.0,13.0,9.0,5.0,12.0,16.0,5.0,0.0,9.0,10.0,12.0,13.0,3.0,17.0,12.0,9.0,8.0,10.0,9.0,11.0,2.0,12.0,11.0,13.0,5.0,14.0,5.0,0.0,5.0,5.0,5.0,5.0,5.0,5.0,3.0,4.0,5.0,4.0,0.0,0.0,0.0,0.0,0.0,0.0,0.0,0.0,0.0,0.0,0.0,0.0,0.0,0.0,8.0,4.0,13.0,6.0,18.0,2.0,0.0,0.0,2.0,1.0,6.0,2.0,7.0,2.0,1.0,5.0,0.0,6.0,1.0,0.0,4.0,6.0,6.0,12.0,17.0,7.0,2.0,6.0,0.0,1.0,2.0,2.0,2.0,4.0,13.0,6.0,2.0,6.0,9.0,7.0,15.0,7.0,9.0,10.0,11.0,5.0,2.0,3.0,9.0,6.0,15.0,2.0,1.0,4.0,4.0,0.0,11.0,3.0,11.0,5.0,7.0,6.0,4.0,2.0,7.0,7.0,11.0,7.0,6.0,4.0,2.0,1.0,1.0,1.0,18.0,10.0,4.0,3.0,9.0,10.0,19.0,6.0,2.0,10.0,2.0,4.0,11.0,2.0,15.0,11.0,0.0,6.0,7.0,6.0,0.0,0.0,0.0,2.0,0.0,2.0,0.0,7.0,1.0,0.0,0.0,2.0,3.0,0.0,0.0,0.0,0.0,0.0,0.0,0.0,10.0,0.0,0.0,3.0,0.0,0.0,5.0,5.0,4.0,4.0,5.0,0.0,0.0,4.0,5.0,4.0,5.0,3.0,5.0,4.0,4.0,5.0,4.0,4.0,5.0,2.0,0.0,3.0,5.0,1.0,4.0,4.0,1.0,4.0,5.0,1.0,0.0,10.0,5.0,9.0,9.0,8.0,18.0,14.0,5.0,5.0,0.0,1.0,1.0,0.0,0.0,0.0,0.0,3.0,1.0,4.0,2.0,0.0,2.0,3.0,4.0,1.0,4.0,4.0,2.0,6.0,7.0,3.0,2.0,0.0,1.0,0.0,0.0,0.0,2.0,0.0,1.0,2.0,2.0,3.0,1.0,1.0,2.0,5.0,2.0,4.0,0.0,1.0,4.0,5.0,0.0,0.0,1.0,4.0,0.0,1.0,7.0,0.0,6.0,5.0,6.0,1.0,2.0,8.0,4.0,0.0,1.0,0.0,6.0,1.0,2.0,3.0,5.0,5.0,2.0,10.0,9.0,3.0,0.0,1.0,5.0,0.0,2.0,0.0,0.0,4.0,1.0,2.0,1.0,5.0,5.0,0.0,0.0,6.0,3.0,5.0,10.0,6.0,2.0,3.0,6.0,5.0,3.0,11.0,3.0,4.0,8.0,7.0,5.0,10.0,6.0,5.0,5.0,8.0,5.0,4.0,5.0,11.0,8.0,7.0,3.0,5.0,6.0,0.0,6.0,6.0,9.0,10.0,3.0,14.0,5.0,8.0,6.0,8.0,4.0,9.0,7.0,7.0,4.0,0.0,6.0,9.0,6.0,4.0,10.0,11.0,5.0,4.0,4.0,5.0,4.0,3.0,1.0,4.0,7.0,2.0,0.0,0.0,0.0,3.0,2.0,0.0,3.0,7.0,0.0,7.0,3.0,1.0,0.0,1.0,4.0,3.0,3.0,0.0,6.0,1.0,9.0,4.0,4.0,5.0,0.0,9.0,0.0,2.0,5.0,1.0,2.0,5.0,3.0,2.0,4.0,2.0,1.0,4.0,4.0,3.0,4.0,5.0,0.0,8.0,1.0,2.0,0.0,6.0,7.0,5.0,3.0,5.0,1.0,3.0,3.0,4.0,3.0,2.0,0.0,4.0,3.0,0.0,4.0,5.0,1.0,3.0,0.0,10.0,1.0,5.0,5.0,8.0,0.0,1.0,0.0,1.0,1.0,2.0,2.0,0.0,1.0,2.0,0.0,2.0,1.0,7.0,1.0,3.0,4.0,4.0,1.0,3.0,3.0,6.0,4.0,1.0,2.0,2.0,8.0,2.0,6.0,5.0,4.0,6.0,8.0,4.0,3.0,5.0,4.0,7.0,8.0,5.0,2.0,5.0,6.0,6.0,4.0,5.0,4.0,3.0,3.0,5.0,2.0,4.0,4.0,4.0,2.0,5.0,3.0,4.0,6.0,1.0,2.0,0.0,5.0,2.0,1.0,3.0,3.0,5.0,3.0,3.0,3.0,2.0,5.0,6.0,4.0,3.0,4.0,0.0,6.0,4.0,3.0,2.0,12.0,2.0,8.0,3.0,7.0,7.0,4.0,3.0,4.0,4.0,4.0,4.0,6.0,2.0,5.0,6.0,4.0,4.0,4.0,7.0,6.0,7.0,2.0,7.0,3.0,7.0,5.0,5.0,3.0,8.0,1.0,3.0,4.0,6.0,3.0,4.0,10.0,7.0,5.0,3.0,8.0,9.0,3.0,5.0,7.0,5.0,3.0,7.0,10.0,8.0,0.0,10.0,1.0,3.0,3.0,3.0,8.0,6.0,7.0,3.0,3.0,6.0,6.0,10.0,4.0,6.0,4.0,2.0,0.0,4.0,6.0,5.0,9.0,6.0,2.0,12.0,9.0,3.0,6.0,6.0,10.0,8.0,7.0,8.0,7.0,0.0,5.0,5.0,8.0,4.0,5.0,4.0,4.0,7.0,3.0,8.0,3.0,5.0,9.0,6.0,4.0,5.0,2.0,6.0,15.0,8.0,10.0,4.0,4.0,8.0,5.0,12.0,6.0,9.0,13.0,10.0,7.0,6.0,5.0,8.0,5.0,11.0,9.0,3.0,7.0,10.0,15.0,9.0,21.0,12.0,13.0,9.0,17.0,7.0,11.0,7.0,7.0,23.0,20.0,12.0,11.0,3.0,16.0,2.0,11.0,10.0,23.0,12.0,3.0,3.0,8.0,8.0,13.0,10.0,2.0,3.0,12.0,2.0,1.0,16.0,3.0,16.0,8.0,12.0,9.0,18.0,3.0,3.0,0.0,3.0,11.0,6.0,1.0,10.0,1.0,1.0,8.0,5.0,14.0,3.0,1.0,1.0,1.0,9.0,8.0,3.0,9.0,12.0,3.0,8.0,13.0,3.0,2.0,3.0,9.0,10.0,4.0,8.0,15.0,5.0,10.0,10.0,1.0,13.0,7.0,10.0,9.0,11.0,23.0,20.0,14.0,2.0,12.0,7.0,3.0,8.0,16.0,17.0,13.0,12.0,12.0,1.0,7.0,12.0,24.0,20.0,9.0,9.0,5.0,7.0,5.0,9.0,5.0,2.0,4.0,7.0,8.0,5.0,14.0,6.0,11.0,9.0,33.0,6.0,1.0,8.0,4.0,3.0,2.0,5.0,19.0,5.0,3.0,0.0,4.0,9.0,5.0,5.0,2.0,2.0,4.0,5.0,5.0,3.0,11.0,4.0,5.0,0.0,8.0,12.0,2.0,7.0,6.0,1.0,0.0,3.0,7.0,1.0,3.0,0.0,0.0,2.0,2.0,2.0,3.0,2.0,4.0,0.0,4.0,4.0,0.0,0.0,5.0,3.0,1.0,0.0,0.0,1.0,0.0,6.0,4.0,3.0,0.0,0.0,4.0,0.0,0.0,0.0,2.0,1.0,3.0,0.0,1.0,1.0,0.0,3.0,1.0,0.0,2.0,0.0,0.0,1.0,50.0,0.0,12.0,6.0,3.0,4.0,2.0,0.0,4.0,0.0,1.0,1.0,1.0,0.0,0.0,3.0,0.0,3.0,0.0,3.0,0.0,1.0,0.0,17.0,3.0,0.0,1.0,1.0,1.0,0.0,0.0,3.0,1.0,3.0,1.0,2.0,0.0,0.0,1.0,0.0,2.0,0.0,7.0,0.0,0.0,0.0,0.0,1.0,0.0,0.0,1.0,5.0,5.0,5.0,5.0,5.0,5.0,1.0,5.0,5.0,0.0,0.0,1.0,0.0,0.0,0.0,1.0,1.0,0.0,1.0,0.0,2.0,0.0,1.0,1.0,0.0,3.0,11.0,4.0,8.0,5.0,34.0,8.0,23.0,5.0,12.0,6.0,11.0,14.0,8.0,4.0,8.0,3.0,0.0,7.0,3.0,11.0,16.0,9.0,9.0,8.0,2.0,15.0,1.0,5.0,4.0,7.0,1.0,0.0,1.0,11.0,13.0,11.0,5.0,7.0,7.0,7.0,18.0,5.0,14.0,2.0,5.0,5.0,2.0,5.0,5.0,5.0,4.0,5.0,4.0,5.0,4.0,5.0,5.0,5.0,5.0,5.0,5.0,5.0,5.0,4.0,5.0,5.0,1.0,5.0,5.0,3.0,5.0,5.0,5.0,5.0,5.0,2.0,3.0,0.0,5.0,5.0,2.0,0.0,2.0,4.0,5.0,2.0,5.0,1.0,3.0,4.0,2.0,5.0,5.0,2.0,5.0,5.0,2.0,1.0,1.0,5.0,5.0,3.0,5.0,5.0,5.0,5.0,0.0,5.0,1.0,1.0,0.0,0.0,5.0,5.0,5.0,3.0,5.0,5.0,1.0,0.0,5.0,3.0,5.0,0.0,1.0,5.0,5.0,5.0,0.0,5.0,3.0,2.0,5.0,1.0,5.0,5.0,2.0,0.0,3.0,3.0,5.0,4.0,5.0,2.0,5.0,1.0,2.0,0.0,5.0,0.0,5.0,5.0,1.0,4.0,5.0,1.0,5.0,5.0,1.0,5.0,2.0,11.0,16.0,10.0,7.0,16.0,10.0,5.0,1.0,12.0,5.0,16.0,17.0,15.0,16.0,12.0,1.0,4.0,5.0,0.0,0.0,5.0,5.0,3.0,1.0,3.0,5.0,1.0,5.0,4.0,3.0,5.0,2.0,5.0,5.0,5.0,5.0,3.0,5.0,5.0,1.0,5.0,0.0,0.0,2.0,5.0,5.0,1.0,2.0,0.0,0.0,5.0,2.0,5.0,5.0,5.0,0.0,5.0,4.0,5.0,5.0,3.0,5.0,1.0,5.0,0.0,4.0,1.0,0.0,0.0,5.0,5.0,1.0,5.0,5.0,5.0,0.0,1.0,3.0,0.0,5.0,5.0,1.0,2.0,0.0,5.0,1.0,4.0,5.0,5.0,5.0,5.0,5.0,5.0,5.0,5.0,5.0,5.0,5.0,5.0,3.0,5.0,4.0,5.0,5.0,1.0,5.0,5.0,5.0,5.0,4.0,2.0,5.0,5.0,5.0,5.0,5.0,5.0,2.0,5.0,5.0,1.0,5.0,5.0,1.0,5.0,5.0,12.0,11.0,6.0,6.0,8.0,2.0,10.0,4.0,5.0,6.0,9.0,8.0,0.0,3.0,11.0,7.0,1.0,14.0,11.0,12.0,13.0,9.0,5.0,14.0,1.0,4.0,6.0,5.0,4.0,3.0,7.0,6.0,7.0,12.0,2.0,2.0,2.0,14.0,9.0,0.0,6.0,7.0,4.0,8.0,11.0,5.0,5.0,9.0,8.0,1.0,5.0,0.0,1.0,10.0,8.0,1.0,2.0,2.0,4.0,3.0,8.0,4.0,4.0,5.0,7.0,7.0,3.0,7.0,5.0,8.0,2.0,2.0,8.0,4.0,7.0,12.0,8.0,8.0,10.0,10.0,5.0,5.0,7.0,2.0,3.0,4.0,7.0,8.0,9.0,15.0,6.0,7.0,1.0,3.0,2.0,7.0,9.0,6.0,15.0,9.0,12.0,7.0,2.0,0.0,7.0,7.0,6.0,3.0,5.0,7.0,10.0,7.0,6.0,7.0,5.0,6.0,5.0,7.0,10.0,0.0,3.0,11.0,6.0,6.0,7.0,2.0,17.0,10.0,8.0,6.0,6.0,12.0,8.0,9.0,13.0,10.0,2.0,7.0,9.0,6.0,9.0,6.0,6.0,7.0,9.0,6.0,8.0,9.0,11.0,7.0,10.0,2.0,3.0,5.0,15.0,10.0,2.0,7.0,6.0,4.0,5.0,3.0,10.0,6.0,5.0,7.0,3.0,3.0,8.0,1.0,2.0,4.0,12.0,4.0,11.0,8.0,1.0,11.0,11.0,7.0,9.0,8.0,4.0,7.0,7.0,6.0,4.0,6.0,6.0,6.0,12.0,5.0,8.0,9.0,12.0,8.0,8.0,2.0,6.0,8.0,8.0,4.0,4.0,7.0,4.0,0.0,0.0,0.0,0.0,0.0,13.0,17.0,8.0,2.0,4.0,6.0,10.0,37.0,24.0,14.0,3.0,4.0,11.0,20.0,10.0,8.0,6.0,19.0,3.0,3.0,0.0,6.0,0.0,9.0,0.0,1.0,0.0,6.0,6.0,8.0,6.0,12.0,6.0,2.0,6.0,1.0,0.0,0.0,0.0,2.0,2.0,1.0,1.0,2.0,2.0,2.0,3.0,13.0,8.0,1.0,2.0,2.0,5.0,6.0,3.0,13.0,11.0,8.0,18.0,19.0,5.0,0.0,6.0,2.0,7.0,10.0,3.0,13.0,9.0,13.0,0.0,3.0,2.0,2.0,0.0,19.0,1.0,4.0,16.0,7.0,14.0,1.0,13.0,8.0,5.0,3.0,7.0,4.0,5.0,1.0,2.0,2.0,6.0,10.0,12.0,2.0,9.0,0.0,14.0,12.0,11.0,12.0,15.0,0.0,0.0,16.0,2.0,11.0,12.0,2.0,4.0,0.0,2.0,1.0,5.0,11.0,6.0,1.0,4.0,1.0,2.0,0.0,1.0,7.0,2.0,15.0,3.0,1.0,2.0,1.0,5.0,11.0,14.0,7.0,11.0,11.0,15.0,11.0,14.0,10.0,10.0,13.0,9.0,23.0,13.0,11.0,10.0,13.0,11.0,9.0,17.0,5.0,7.0,9.0,5.0,15.0,5.0,1.0,0.0,0.0,1.0,9.0,8.0,4.0,4.0,4.0,8.0,3.0,0.0,7.0,8.0,1.0,10.0,5.0,4.0,6.0,5.0,5.0,7.0,15.0,9.0,6.0,12.0,9.0,7.0,10.0,3.0,6.0,1.0,4.0,3.0,13.0,3.0,6.0,10.0,8.0,0.0,2.0,16.0,10.0,15.0,1.0,8.0,2.0,17.0,21.0,8.0,6.0,4.0,23.0,8.0,7.0,5.0,0.0,8.0,12.0,12.0,1.0,4.0,11.0,15.0,3.0,3.0,7.0,2.0,3.0,4.0,6.0,4.0,5.0,2.0,7.0,5.0,1.0,6.0,5.0,3.0,2.0,6.0,4.0,4.0,3.0,2.0,7.0,0.0,6.0,5.0,12.0,3.0,4.0,4.0,5.0,11.0,3.0,1.0,5.0,14.0,1.0,5.0,5.0,6.0,6.0,10.0,2.0,6.0,6.0,7.0,7.0,1.0,7.0,1.0,7.0,7.0,9.0,7.0,7.0,4.0,6.0,6.0,7.0,10.0,9.0,2.0,7.0,6.0,13.0,22.0,3.0,7.0,14.0,9.0,16.0,21.0,12.0,12.0,10.0,10.0,10.0,10.0,12.0,12.0,11.0,13.0,0.0,0.0,6.0,9.0,15.0,13.0,13.0,12.0,7.0,12.0,13.0,15.0,16.0,8.0,25.0,0.0,12.0,7.0,12.0,8.0,0.0,15.0,11.0,26.0,0.0,13.0,15.0,8.0,13.0,4.0,12.0,10.0,9.0,18.0,11.0,12.0,8.0,17.0,10.0,16.0,16.0,18.0,18.0,12.0,5.0,9.0,8.0,10.0,6.0,15.0,11.0,9.0,16.0,15.0,16.0,10.0,15.0,11.0,10.0,8.0,18.0,11.0,17.0,17.0,16.0,14.0,24.0,18.0,24.0,11.0,11.0,13.0,21.0,14.0,18.0,17.0,9.0,14.0,14.0,9.0,11.0,11.0,7.0,11.0,18.0,16.0,19.0,21.0,12.0,10.0,16.0,11.0,11.0,11.0,11.0,9.0,13.0,15.0,17.0,15.0,9.0,13.0,13.0,10.0,7.0,16.0,14.0,9.0,11.0,13.0,6.0,21.0,12.0,10.0,17.0,12.0,14.0,5.0,15.0,9.0,11.0,13.0,12.0,16.0,12.0,13.0,8.0,12.0,4.0,8.0,12.0,4.0,7.0,0.0,5.0,1.0,8.0,6.0,8.0,5.0,6.0,6.0,7.0,7.0,12.0,13.0,2.0,5.0,8.0,5.0,20.0,5.0,12.0,1.0,10.0,8.0,6.0,9.0,8.0,12.0,5.0,9.0,12.0,22.0,11.0,8.0,10.0,8.0,17.0,3.0,8.0,15.0,3.0,11.0,5.0,0.0,5.0,6.0,14.0,9.0,4.0,0.0,0.0,4.0,0.0,3.0,1.0,0.0,0.0,0.0,0.0,0.0,0.0,1.0,0.0,0.0,0.0,0.0,18.0,4.0,10.0,9.0,5.0,10.0,24.0,9.0,12.0,3.0,7.0,4.0,25.0,7.0,1.0,5.0,10.0,2.0,15.0,23.0,14.0,3.0,12.0,12.0,9.0,3.0,18.0,12.0,4.0,7.0,7.0,6.0,2.0,9.0,8.0,0.0,12.0,11.0,24.0,1.0,7.0,3.0,1.0,1.0,3.0,10.0,2.0,3.0,6.0,6.0,6.0,9.0,10.0,13.0,9.0,13.0,10.0,6.0,7.0,12.0,10.0,11.0,9.0,6.0,14.0,11.0,9.0,3.0,6.0,11.0,12.0,11.0,12.0,7.0,8.0,8.0,7.0,12.0,14.0,13.0,10.0,7.0,0.0,4.0,6.0,9.0,16.0,12.0,9.0,9.0,9.0,11.0,10.0,7.0,11.0,1.0,2.0,10.0,3.0,13.0,10.0,8.0,7.0,10.0,11.0,3.0,10.0,8.0,7.0,8.0,8.0,8.0,8.0,7.0,11.0,13.0,8.0,11.0,4.0,12.0,16.0,4.0,11.0,6.0,6.0,8.0,11.0,19.0,18.0,8.0,8.0,2.0,14.0,6.0,3.0,11.0,8.0,13.0,14.0,5.0,18.0,9.0,13.0,11.0,7.0,4.0,5.0,4.0,9.0,23.0,15.0,1.0,5.0,5.0,8.0,11.0,10.0,9.0,7.0,7.0,3.0,6.0,7.0,5.0,9.0,15.0,9.0,8.0,4.0,13.0,5.0,7.0,7.0,14.0,6.0,2.0,2.0,7.0,7.0,6.0,8.0,1.0,8.0,7.0,5.0,3.0,13.0,4.0,8.0,6.0,2.0,5.0,14.0,4.0,5.0,11.0,6.0,4.0,0.0,0.5,9.0,0.0,0.0,0.0,0.0,6.0,0.0,0.0,2.0,0.0,5.0,0.0,0.0,0.0,0.0,12.0,0.0,8.0,12.0,6.0,0.0,0.0,0.0,0.0,0.0,1.0,1.0,2.0,2.0,0.0,0.0,3.0,0.0,2.0,0.0,0.0,0.0,2.0,0.0,2.0,1.0,0.0,0.0,0.0,4.0,0.0,2.0,0.0,0.0,4.0,0.0,0.0,2.0,0.0,3.0,2.0,6.0,7.0,0.0,0.0,0.0,2.0,0.0,3.0,0.0,0.0,0.0,0.0,0.0,0.0,0.0,0.0,0.0,0.0,0.0,0.0,0.0,0.0,0.0,0.0,0.0,0.0,0.0,0.0,0.0,0.0,0.0,3.0,0.0,4.0,0.0,0.0,0.0,4.0,3.0,0.0,0.0,0.0,0.0,0.0,0.0,0.0,5.0,1.0,0.0,0.0,1.0,0.0,0.0,0.0,0.0,0.0,0.0,0.0,0.0,0.0,0.0,0.0,0.0,0.0,26.0,14.0,15.0,15.0,21.0,6.0,13.0,11.0,3.0,16.0,3.0,14.0,3.0,5.0,22.0,5.0,5.0,7.0,6.0,5.0,6.0,12.0,9.0,22.0,5.0,7.0,4.0,2.0,0.0,11.0,14.0,12.0,12.0,8.0,18.0,23.0,13.0,13.0,12.0,18.0,2.0,53.0,8.0,5.0,18.0,5.0,2.0,7.0,0.0,3.0,7.0,8.0,8.0,11.0,14.0,18.0,3.0,6.0,9.0,10.0,20.0,0.0,10.0,15.0,13.0,10.0,17.0,6.0,16.0,7.0,4.0,10.0,12.0,15.0,4.0,7.0,2.0,7.0,1.0,2.0,10.0,12.0,3.0,5.0,3.0,2.0,8.0,1.0,1.0,10.0,5.0,3.0,8.0,16.0,2.0,3.0,6.0,5.0,10.0,1.0,17.0,16.0,3.0,16.0,5.0,1.0,13.0,3.0,3.0,7.0,5.0,14.0,3.0,7.0,18.0,9.0,8.0,5.0,10.0,0.0,3.0,14.0,5.0,15.0,2.0,9.0,0.0,12.0,6.0,4.0,1.0,10.0,6.0,0.0,0.0,0.0,15.0,2.0,6.0,14.0,9.0,11.0,7.0,13.0,8.0,13.0,11.0,2.0,1.0,9.0,7.0,12.0,4.0,26.0,11.0,6.0,0.0,4.0,5.0,2.0,11.0,0.0,3.0,2.0,2.0,9.0,3.0,9.0,5.0,12.0,7.0,6.0,1.0,8.0,3.0,8.0,1.0,6.0,10.0,15.0,9.0,10.0,11.0,8.0,10.0,9.0,7.0,2.0,4.0,1.0,0.0,0.0,0.0,0.0,0.0,0.0,0.0,0.0,0.0,0.0,0.0,0.0,0.0,0.0,0.0,0.0,0.0,0.0,0.0,0.0,0.0,0.0,0.0,0.0,0.0,0.0,0.0,0.0,0.0,0.0,0.0,0.0,0.0,0.0,0.0,0.0,0.0,0.0,0.0,0.0,0.0,0.0,0.0,0.0,0.0,0.0,0.0,0.0,0.0,0.0,0.0,0.0,0.0,0.0,0.0,0.0,0.0,0.0,0.0,0.0,0.0,3.0,0.0,0.0,0.0,2.0,0.0,1.0,0.0,0.0,0.0,4.0,0.0,0.0,0.0,0.0,0.0,0.0,0.0,0.0,0.0,0.0,0.0,0.0,0.0,0.0,0.0,0.0,0.0,0.0,0.0,0.0,0.0,0.0,0.0,0.0,0.0,0.0,0.0,0.0,0.0,0.0,0.0,0.0,0.0,0.0,0.0,0.0,1.0,5.0,0.0,0.0,2.0,0.0,0.0,5.0,5.0,3.0,5.0,5.0,2.0,4.0,5.0,0.0,3.0,5.0,0.0,0.0,3.0,,,2.0,1.0,0.0,7.0,6.0,1.0,1.0,0.0,0.0,0.0,4.0,1.0,5.0,5.0,1.0,2.0,5.0,0.0,2.0,3.0,0.0,2.0,4.0,1.0,0.0,5.0,5.0,4.0,1.0,5.0,4.0,2.0,4.0,0.0,2.0,0.0,3.0,1.0,3.0,1.0,1.0,3.0,5.0,5.0,5.0,1.0,5.0,2.0,21.0,5.0,1.0,5.0,4.0,5.0,5.0,4.0,3.0,5.0,0.0,2.0,0.0,0.0,2.0,5.0,4.0,0.0,5.0,2.0,0.0,0.0,5.0,3.0,5.0,3.0,5.0,5.0,5.0,5.0,3.0,5.0,4.0,2.0,5.0,4.25,4.0,5.0,0.0,5.0,2.0,4.0,0.0,0.0,0.0,3.0,4.0,5.0,0.0,1.0,1.0,0.0,5.0,5.0,2.0,2.0,4.0,4.0,1.0,4.0,2.0,1.0,4.0,4.0,5.0,5.0,5.0,5.0,5.0,2.0,0.0,5.0,5.0,3.0,0.0,3.0,5.0,4.0,1.0,2.0,10.0,4.0,3.0,4.0,5.0,0.0,5.0,2.0,0.0,5.0,3.0,1.0,4.0,1.0,1.0,1.0,0.0,2.0,5.0,2.0,1.0,2.0,4.0,1.0,0.0,1.0,2.0,0.0,1.0,2.0,0.0,0.0,5.0,5.0,4.0,3.0,3.0,5.0,0.0,24.0,2.0,0.0,5.0,1.0,2.0,10.0,3.0,5.0,1.0,2.0,1.0,4.0,6.0,0.0,1.0,4.0,3.0,0.0,2.0,5.0,5.0,4.0,1.0,,2.0,1.0,6.0,1.0,5.0,1.0,0.0,1.0,0.0,0.0,4.0,0.0,0.0,0.0,0.0,1.0,2.0,0.0,4.0,1.0,2.0,0.0,0.0,0.0,2.0,3.0,3.0,2.0,9.0,5.0,0.0,1.0,5.0,0.0,1.0,5.0,5.0,15.0,25.0,5.0,10.0,3.0,4.0,5.0,2.0,4.0,1.0,5.0,0.0,1.0,2.0,1.0,4.0,0.0,1.0,2.0,2.0,6.0,6.0,1.0,3.0,5.0,3.0,4.0,5.0,13.0,5.0,9.0,15.0,3.0,4.0,1.0,1.0,5.0,0.0,2.0,5.0,5.0,4.0,1.0,1.0,4.0,1.0,3.0,3.5,2.0,4.0,0.0,2.0,0.0,5.0,2.0,15.0,0.0,0.0,5.0,3.0,2.0,,,,1.0,3.0,0.0,3.0,1.0,1.0,2.0,0.0,2.0,0.0,0.0,5.0,1.0,1.0,10.0,2.0,3.0,5.0,1.0,,3.0,5.0,1.0,5.0,5.0,3.0,5.0,2.0,0.0,1.0,4.0,5.0,4.0,6.0,2.0,5.0,5.0,0.0,3.0,4.0,0.0,6.0,3.0,2.0,4.0,0.0,5.0,2.0,5.0,5.0,7.0,5.0,,0.0,5.0,3.0,4.0,5.0,3.0,2.0,4.0,0.0,4.0,2.0,1.0,1.0,0.0,0.0,4.0,4.0,1.0,0.0,2.0,0.0,0.0,0.0,4.0,1.0,3.0,5.0,0.0,0.0,3.0,5.0,16.0,0.0,3.0,2.0,5.0,3.0,3.0,5.0,0.0,4.0,3.0,3.0,0.0,2.0,5.0,2.0,1.0,5.0,10.0,13.0,5.0,5.0,6.0,5.0,0.0,7.0,6.0,6.0,2.0,35.0,5.0,5.0,2.0,3.0,3.0,0.0,3.0,5.0,5.0,11.0,3.0,5.0,0.0,0.0,5.0,0.0,0.0,1.0,1.0,5.0,5.0,3.0,0.0,5.0,5.0,5.0,5.0,3.0,0.0,1.0,4.0,0.0,3.0,5.0,4.0,8.0,2.0,1.0,5.0,0.0,5.0,5.0,0.0,0.0,0.0,5.0,3.0,2.0,2.0,2.6666666666666665,5.0,0.0,4.0,0.0,0.0,0.0,0.0,0.0,5.0,5.0,3.0,0.0,2.0,1.0,5.0,2.0,0.0,2.0,5.0,5.0,0.0,1.0,5.0,1.0,5.0,3.0,5.0,5.0,5.0,5.0,0.0,5.0,5.0,3.0,5.0,1.0,4.0,5.0,5.0,5.0,5.0,5.0,4.0,1.0,5.0,4.0,3.0,1.0,5.0,3.0,5.0,1.0,3.0,4.0,5.0,3.0,5.0,2.0,3.0,5.0,4.0,1.0,1.0,5.0,1.0,4.0,0.0,5.0,5.0,0.0,0.0,5.0,9.0,5.0,5.0,5.0,0.0,5.0,5.0,5.0,5.0,5.0,5.0,5.0,5.0,5.0,3.0,5.0,3.0,5.0,5.0,0.0,0.0,5.0,0.0,2.0,0.0,1.0,0.0,2.0,5.0,5.0,1.0,3.0,5.0,5.0,4.0,0.0,4.0,1.0,1.0,1.0,1.0,5.0,2.0,0.0,2.0,3.0,1.0,0.0,2.0,2.0,5.0,0.0,5.0,5.0,3.0,5.0,3.0,0.0,5.0,7.0,1.0,2.0,5.0,0.0,2.0,3.0,0.0,5.0,2.0,5.0,4.0,2.0,5.0,1.0,0.0,5.0,3.0,5.0,4.0,0.0,0.0,0.0,1.0,2.0,0.0,5.0,3.0,5.0,5.0,1.0,2.0,2.0,1.0,5.0,5.0,5.0,4.0,5.0,2.0,3.0,5.0,2.0,3.0,2.0,2.0,,,,,,,,2.0,0.0,1.0,5.0,1.0,0.0,1.0,2.0,5.0,5.0,5.0,4.0,5.0,4.0,1.0,1.0,3.0,5.0,4.0,4.0,2.0,5.0,5.0,,,3.0,4.0,1.0,5.0,1.0,0.0,0.0,4.0,4.0,1.0,3.0,4.0,5.0,5.0,5.0,4.0,2.0,4.0,4.0,5.0,,,,4.0,2.0,2.0,3.0,3.0,2.0,12.0,5.0,4.0,1.0,3.0,0.0,3.0,0.0,0.0,3.0,0.0,4.0,1.0,1.0,4.0,3.0,0.0,5.0,4.0,5.0,3.0,4.0,3.0,3.0,5.0,2.0,5.0,5.0,5.0,0.0,3.0,5.0,5.0,2.0,0.0,5.0,5.0,5.0,5.0,5.0,0.0,6.0,2.0,5.0,0.0,1.0,0.0,5.0,0.0,0.0,4.0,5.0,5.0,2.0,0.0,5.0,4.0,1.0,1.0,5.0,3.0,5.0,4.0,0.0,2.0,0.0,0.0,2.0,4.0,3.0,2.0,5.0,5.0,0.0,,5.0,0.0,3.0,0.0,,,,,,,,5.0,3.0,6.0,0.0,3.0,0.0,5.0,0.0,4.0,4.0,5.0,,5.0,4.0,0.0,4.0,5.0,0.0,1.0,5.0,5.0,0.0,2.0,0.0,2.0,2.0,0.0,7.0,5.0,4.0,1.0,0.0,1.0,1.0,0.0,0.0,5.0,5.0,3.0,4.0,5.0,1.0,0.0,3.0,3.0,4.0,5.0,2.0,0.0,,5.0,0.0,4.0,3.0,2.0,2.0,1.0,4.0,3.0,2.0,1.0,5.0,0.0,5.0,2.0,4.0,0.0,3.0,5.0,0.0,1.0,3.0,5.0,0.0,5.0,3.0,0.0,1.0,0.0,0.0,2.0,0.0,1.0,2.0,,0.0,0.0,5.0,0.0,1.0,0.0,0.0,0.0,0.0,0.0,0.0,0.0,0.0,4.0,2.0,5.0,5.0,4.0,0.0,6.0,1.0,5.0,5.0,2.0,0.0,1.0,1.0,5.0,6.0,4.0,5.0,5.0,1.0,4.0,0.0,2.0,2.0,2.0,5.0,5.0,1.0,4.0,3.0,2.0,2.0,1.0,3.0,2.0,2.0,5.0,2.0,4.0,3.0,1.0,5.0,3.0,3.0,0.0,5.0,3.0,4.0,0.0,5.0,4.0,2.0,2.0,0.0,0.0,1.0,4.0,3.0,2.0,3.0,4.0,2.0,5.0,2.0,2.0,1.0,5.0,2.0,4.0,1.0,5.0,0.0,0.0,5.0,4.0,9.0,2.0,0.0,2.0,5.0,0.0,5.0,5.0,5.0,4.0,3.0,5.0,5.0,4.0,5.0,2.0,0.0,5.0,3.0,5.0,5.0,5.0,3.0,4.0,5.0,2.0,1.0,2.0,3.0,5.0,0.0,5.0,1.0,5.0,3.0,0.0,0.0,0.0,6.0,3.0,2.0,0.0,5.0,2.0,1.0,4.0,1.0,5.0,1.0,2.0,2.0,0.0,1.0,0.0,2.0,0.0,4.0,2.0,5.0,5.0,1.0,2.0,0.0,5.0,0.0,1.0,0.0,8.0,0.0,0.0,1.0,3.0,5.0,0.0,,,,3.0,5.0,4.0,0.0,1.0,1.0,0.0,0.0,4.0,4.0,1.0,0.0,5.0,3.0,1.0,0.0,3.0,5.0,2.0,5.0,2.0,2.0,2.0,5.0,1.0,3.0,0.0,0.0,0.0,5.0,0.0,3.0,5.0,4.0,5.0,1.0,5.0,0.0,3.0,5.0,5.0,2.0,9.0,12.0,0.0,0.0,0.0,2.0,0.0,5.0,1.0,1.0,2.0,5.0,5.0,5.0,0.0,3.0,0.0,3.0,5.0,5.0,3.0,5.0,1.0,1.0,5.0,5.0,1.0,3.0,3.0,2.0,5.0,2.0,11.0,6.0,1.0,5.0,2.0,2.0,3.0,3.0,5.0,3.0,3.0,0.0,2.0,2.0,4.0,2.0,1.0,5.0,2.0,0.0,3.0,3.0,2.0,2.0,5.0,1.0,3.0,1.0,0.0,0.0,0.0,5.0,5.0,3.0,2.0,1.0,4.0,5.0,0.0,5.0,4.0,1.0,5.0,1.0,11.0,4.0,1.0,4.0,5.0,5.0,8.0,4.0,5.0,0.0,6.0,3.0,5.0,0.0,0.0,4.0,5.0,6.0,5.0,5.0,3.0,1.0,2.0,2.0,2.0,4.0,5.0,0.0,4.0,0.0,1.0,5.0,1.0,5.0,6.0,4.0,4.0,5.0,4.0,4.0,,,1.0,5.0,6.0,12.0,2.0,0.0,7.0,17.0,8.0,4.0,4.0,0.0,3.0,2.0,2.0,4.0,0.0,2.0,3.0,5.0,5.0,5.0,5.0,1.0,1.0,5.0,5.0,1.0,0.0,1.0,1.0,2.0,5.0,5.0,4.0,4.0,1.0,5.0,5.0,5.0,2.0,5.0,2.0,0.0,0.0,5.0,0.0,0.0,1.0,0.0,1.0,0.0,5.0,4.0,2.0,5.0,1.0,3.0,5.0,0.0,2.0,3.0,2.0,4.0,3.0,4.0,4.0,5.0,5.0,4.0,3.5,7.0,6.0,3.0,3.0,0.0,2.0,0.0,4.0,3.0,3.0,4.0,4.0,5.0,1.0,1.0,5.0,0.0,4.0,5.0,2.0,1.0,0.0,2.0,10.0,4.0,5.0,5.0,5.0,5.0,5.0,5.0,5.0,4.0,3.0,4.0,5.0,5.0,1.0,3.0,3.0,4.0,4.0,4.0,4.0,1.0,0.0,3.0,0.0,2.0,3.0,0.0,2.0,1.0,0.0,4.0,5.0,3.0,4.0,0.0,3.0,5.0,5.0,0.0,0.0,3.0,5.0,,,,,,,,,,5.0,3.0,,0.0,5.0,1.0,5.0,1.0,2.0,0.0,5.0,2.0,5.0,3.0,5.0,1.0,2.0,0.0,4.0,1.0,5.0,5.0,5.0,5.0,5.0,5.0,5.0,5.0,5.0,1.0,2.0,0.0,5.0,5.0,5.0,0.0,0.0,4.0,1.0,3.0,0.0,0.0,0.0,0.0,0.0,0.0,0.0,0.0,3.0,0.0,5.0,0.0,0.0,3.0,0.0,5.0,3.0,5.0,5.0,0.0,1.0,5.0,4.0,1.0,9.0,4.0,4.0,5.0,6.0,0.0,12.0,7.0,0.0,0.0,0.0,5.0,,5.0,1.0,0.0,1.0,0.0,2.0,2.0,5.0,1.0,2.0,5.0,2.0,0.0,5.0,1.0,5.0,3.0,5.0,1.0,4.0,1.0,2.0,4.0,1.0,4.0,5.0,2.0,0.0,5.0,5.0,5.0,4.0,4.0,,4.0,14.0,5.0,1.0,2.0,5.0,,,2.0,2.0,2.0,5.0,5.0,0.0,3.0,3.0,6.0,0.0,0.0,3.0,5.0,5.0,3.0,1.0,0.0,3.0,1.0,0.0,0.0,0.0,1.0,0.0,4.0,10.0,,0.0,2.0,3.0,1.0,5.0,2.0,3.0,5.0,5.0,5.0,3.0,2.0,2.0,5.0,2.0,5.0,5.0,5.0,2.0,0.0,1.0,1.0,1.0,1.0,5.0,2.0,5.0,4.0,,3.0,2.0,2.0,1.0,2.0,2.0,5.0,0.0,2.0,0.0,0.0,0.0,2.0,0.0,0.0,0.0,0.0,2.0,0.0,0.0,1.0,0.0,3.0,0.0,0.0,3.0,5.0,2.0,2.0,5.0,1.0,5.0,5.0,4.0,5.0,2.0,5.0,5.0,5.0,0.0,5.0,2.0,4.0,5.0,3.0,2.0,5.0,5.0,5.0,4.0,2.0,5.0,5.0,5.0,4.0,3.0,4.0,4.0,4.0,3.0,0.0,0.0,0.0,0.0,0.0,0.0,0.0,0.0,0.0,0.0,0.0,0.0,0.0,0.0,1.0,0.0,0.0,0.0,5.0,5.0,3.0,5.0,3.0,5.0,4.0,5.0,5.0,5.0,3.0,5.0,5.0,3.0,3.0,5.0,6.0,1.0,0.0,3.0,0.0,5.0,4.0,0.0,0.0,0.0,0.0,0.0,0.0,0.0,0.0,0.0,0.0,0.0,0.0,0.0,8.0,0.0,0.0,0.0,0.0,0.0,0.0,0.0,5.0,9.0,6.0,0.0,0.0,0.0,0.0,0.0,0.0,2.0,1.0,2.5714285714285716,0.0,0.0,3.0,0.0,1.5,7.0,3.0,6.0,6.0,0.0,1.0,1.0,1.0,8.0,8.0,5.0,4.0,0.0,0.0,0.0,0.0,0.0,4.0,0.0,2.0,0.0,3.0,0.0,0.0,5.0,0.0,7.0,5.0,1.0,7.0,0.0,1.5,0.0,0.0,0.0,0.0,7.0,0.0,6.0,4.0,4.0,0.0,3.0,0.0,0.0,2.0,3.0,3.0,4.0,0.0,1.0,3.0,2.5,2.0,0.0,9.0,2.0,0.0,0.0,4.0,0.0,1.0,0.0,3.0,10.0,0.0,5.0,7.0,10.0,0.0,0.0,0.0,4.0,0.0,5.0,5.0,7.0,0.0,6.0,7.0,0.0,4.0,0.0,1.0,0.0,0.0,5.0,2.0,0.0,0.0,12.0,0.0,1.0,5.0,0.0,0.0,5.0,0.0,0.0,2.0,5.0,0.0,6.0,0.0,0.0,1.0,1.0,0.0,0.0,2.5,1.0,0.0,1.0,2.0,0.0,4.0,0.0,4.0,0.0,2.0,0.0,0.0,0.0,1.0,0.0,5.0,0.0,2.0,0.0,0.0,2.0,2.0,7.0,4.0,7.0,5.0,0.0,3.0,6.0,6.0,3.0,0.0,4.0,0.0,0.0,2.0,1.0,0.0,0.0,6.0,3.0,7.0,1.0,5.0,0.0,3.0,3.0,6.0,0.0,0.0,0.0,7.0,4.0,0.0,2.0,0.0,0.0,1.0,5.0,6.0,2.0,0.0,2.0,9.0,5.0,0.0,0.0,2.0,0.0,0.0,1.5,5.0,0.0,0.0,2.0,3.0,0.0,0.0,3.0,3.0,0.0,0.0,5.0,2.0,4.0,0.0,5.0,1.5,7.0,0.0,6.0,2.0,2.0,4.0,2.0,10.0,0.0,4.0,0.0,6.0,5.0,0.0,2.0,0.0,0.0,3.0,3.0,4.0,1.0,0.0,4.0,6.0,0.0,0.0,2.0,0.0,0.0,0.0,0.0,6.0,3.0,0.0,0.0,2.0,3.0,1.5,0.0,0.0,0.0,3.0,1.0,1.0,3.0,4.0,4.0,3.0,1.0,0.0,5.0,1.0,1.0,5.0,1.0,5.0,0.0,0.0,5.0,5.0,0.0,5.0,5.0,2.0,2.0,5.0,15.0,1.0,14.0,4.0,2.0,4.0,9.0,9.0,5.0,6.0,4.0,5.0,5.0,6.0,1.0,3.0,4.0,12.0,7.0,12.0,4.0,12.0,8.0,11.0,6.0,13.0,7.0,4.0,6.0,5.0,7.0,10.0,5.0,9.0,11.0,9.0,8.0,2.0,9.0,1.0,10.0,6.0,8.0,6.0,4.0,11.0,3.0,7.0,24.0,10.0,3.0,16.0,7.0,14.0,1.0,5.0,5.0,0.0,2.0,4.0,5.0,3.0,1.0,4.0,2.0,3.0,3.0,6.0,9.0,6.0,15.0,8.0,13.0,11.0,6.0,6.0,4.0,9.0,7.0,10.0,3.0,4.0,12.0,4.0,26.0,6.0,8.0,4.0,3.0,5.0,2.0,5.0,3.0,8.0,9.0,7.0,2.0,7.0,5.0,11.0,14.0,3.0,11.0,8.0,11.0,3.0,10.0,17.0,5.0,6.0,7.0,4.0,0.0,4.0,7.0,11.0,4.0,3.0,3.0,13.0,8.0,4.0,8.0,6.0,7.0,4.0,8.0,3.0,3.0,2.0,6.0,6.0,3.0,4.0,8.0,8.0,4.0,3.0,0.0,0.0,0.0,0.0,3.0,0.0,4.0,0.0,0.0,1.0,0.0,0.0,5.0,0.0,0.0,0.0,8.0,11.0,17.0,7.0,0.0,0.0,0.0,0.0,0.0,0.0,0.0,0.0,0.0,0.0,0.0,0.0,0.0,0.0,0.0,0.0,0.0,0.0,4.0,9.0,3.0,3.0,1.0,5.0,5.0,5.0,5.0,5.0,5.0,0.0,0.0,0.0,0.0,0.0,0.0,2.0,0.0,5.0,5.0,5.0,4.0,5.0,3.0,5.0,3.0,5.0,2.0,3.0,5.0,5.0,8.0,18.0,16.0,13.0,1.0,9.0,10.0,19.0,7.0,13.0,17.0,8.0,15.0,1.0,2.0,4.0,6.0,10.0,1.0,2.0,11.0,3.0,8.0,0.0,3.0,18.0,12.0,,2.0,10.0,5.0,5.0,5.0,5.0,5.0,5.0,5.0,5.0,5.0,5.0,5.0,5.0,5.0,5.0,5.0,5.0,5.0,1.0,5.0,5.0,5.0,5.0,5.0,5.0,1.0,,,4.0,6.0,5.0,0.0,3.0,4.0,4.0,9.0,2.0,3.0,2.0,4.0,7.0,2.0,5.0,4.0,1.0,0.0,0.0,1.0,2.0,6.0,5.0,5.0,2.0,2.0,2.0,3.0,0.0,2.0,1.0,1.0,4.0,5.0,2.0,3.0,3.0,2.0,4.0,5.0,3.0,2.0,0.0,3.0,2.0,2.0,5.0,8.0,0.0,3.0,2.0,4.0,1.0,12.0,8.0,2.0,1.0,2.0,1.0,2.0,1.0,0.0,1.0,4.0,1.0,1.0,2.0,0.0,1.0,0.0,1.0,3.0,0.0,0.0,1.0,2.0,1.0,1.0,5.0,1.0,0.0,5.0,5.0,4.0,7.0,1.0,2.0,2.0,2.0,0.0,2.0,3.0,2.0,5.0,4.0,3.0,4.0,2.0,4.0,2.0,1.0,0.0,5.0,0.0,2.0,2.0,0.0,1.0,0.0,4.0,3.0,0.0,0.0,2.0,3.0,9.0,6.0,4.0,0.0,3.0,7.0,3.0,3.0,3.0,1.0,4.0,3.0,0.0,1.0,1.0,0.0,0.0,0.0,0.0,0.0,0.0,0.0,0.0,0.0,0.0,0.0,0.0,0.0,0.0,0.0,0.0,0.0,0.0,0.0,0.0,0.0,0.0,0.0,0.0,0.0,0.0,0.0,0.0,0.0,0.0,1.0,0.0,0.0,0.0,0.0,0.0,0.0,0.0,1.0,5.0,2.0,0.0,0.0,0.0,0.0,0.0,5.0,5.0,5.0,5.0,5.0,5.0,5.0,5.0,5.0,2.0,5.0,4.0,5.0,2.0,2.0,5.0,5.0,5.0,2.0,1.0,5.0,5.0,3.0,5.0,5.0,5.0,7.0,3.0,13.0,7.0,3.0,7.0,3.0,4.0,8.5,10.0,7.0,9.0,7.0,4.0,9.0,6.0,7.0,8.0,10.0,6.0,9.0,7.0,6.0,6.0,6.0,6.0,7.0,3.0,6.0,6.0,6.0,8.0,8.0,6.0,6.0,2.0,3.0,8.0,10.5,2.0,6.0,6.0,6.0,8.0,8.0,8.0,7.0,6.0,3.0,4.0,6.0,11.0,9.0,8.0,8.0,10.0,9.0,8.0,7.0,9.0,9.0,9.0,6.0,4.0,6.0,2.0,7.0,6.0,7.0,10.0,8.0,6.0,6.0,6.0,7.0,9.0,6.0,12.0,6.0,6.0,13.0,8.0,7.0,7.0,12.0,7.0,0.0,11.0,9.0,6.0,10.0,6.0,2.0,7.0,7.0,6.0,7.0,7.0,6.0,8.0,5.0,8.0,10.0,8.0,7.0,7.0,8.0,10.0,8.0,8.0,10.0,9.0,7.0,10.0,7.0,9.0,11.0,4.0,7.0,8.0,7.0,3.0,5.0,5.0,2.0,2.0,6.0,4.0,3.0,2.0,6.0,6.0,1.0,4.0,4.0,2.0,3.0,2.0,6.0,8.0,2.0,8.0,3.0,4.0,4.0,4.0,4.0,7.0,3.0,4.0,0.0,3.0,7.0,2.0,2.0,3.0,7.0,9.0,8.0,7.0,7.0,15.0,7.0,7.0,10.0,4.0,8.0,6.0,7.0,9.0,5.0,15.0,17.0,5.0,7.0,9.0,8.0,15.0,13.0,13.0,12.0,7.0,16.0,10.0,6.0,6.0,12.0,4.0,17.0,5.0,11.0,7.0,4.0,11.0,15.0,5.0,12.0,13.0,8.0,11.0,14.0,12.0,7.0,5.0,4.0,9.0,6.0,10.0,13.0,12.0,8.0,7.0,7.0,5.0,9.0,8.0,6.0,12.0,10.0,6.0,0.0,0.0,0.0,0.0,0.0,0.0,0.0,0.0,0.0,0.0,1.0,2.0,2.0,6.0,2.0,2.0,0.0,7.0,7.0,11.0,3.0,0.0,0.0,2.0,1.0,1.0,0.0,0.0,0.0,2.0,3.0,1.0,3.0,2.0,1.0,1.0,5.0,3.0,0.0,3.0,0.0,0.0,0.0,1.0,4.0,1.0,0.0,1.0,3.0,8.0,0.0,27.0,29.0,1.0,2.0,59.0,1.0,12.0,14.0,16.0,3.0,8.0,25.0,17.0,13.0,24.0,6.0,4.0,3.0,4.0,47.0,30.0,11.0,2.0,23.0,17.0,7.0,16.0,6.0,0.0,25.0,8.0,5.0,3.0,13.0,6.0,42.0,4.0,14.0,12.0,7.0,23.0,28.0,6.0,4.0,24.0,23.0,22.0,1.0,6.0,18.0,28.0,0.0,11.0,1.0,5.0,21.0,2.0,20.0,32.0,13.0,2.0,5.0,4.0,5.0,0.0,22.0,5.0,10.0,13.0,1.0,2.0,17.0,10.0,0.0,8.0,20.0,16.0,9.0,0.0,21.0,41.0,11.0,11.0,0.0,9.0,30.0,2.0,0.0,8.0,39.0,14.0,1.0,0.0,31.0,5.0,18.0,9.0,2.0,19.0,15.0,33.0,5.0,8.0,21.0,7.0,8.0,11.0,20.0,3.0,28.0,0.0,1.0,0.0,4.0,0.0,17.0,3.0,0.0,8.0,21.0,5.0,7.0,17.0,17.0,3.0,2.0,0.0,47.0,10.0,16.0,3.0,9.0,28.0,6.0,26.0,1.0,28.0,21.0,7.0,8.0,1.0,4.0,9.0,8.0,2.0,17.0,7.0,7.0,21.0,2.0,7.0,1.0,0.0,8.0,3.0,17.0,14.0,14.0,26.0,17.0,2.0,9.0,20.0,1.0,3.0,0.0,2.0,15.0,4.0,0.0,31.0,14.0,5.0,8.0,3.0,2.0,14.0,9.0,13.0,4.0,18.0,23.0,17.0,8.0,2.0,9.0,0.0,17.0,33.0,20.0,13.0,3.0,11.0,15.0,2.0,3.0,3.0,4.0,11.0,2.0,6.0,1.0,5.0,0.0,4.0,6.0,1.0,8.0,8.0,9.0,1.0,11.0,21.0,9.0,8.0,2.0,5.0,11.0,0.0,8.0,8.0,6.0,14.0,1.0,0.0,16.0,4.0,8.0,0.0,10.0,12.0,24.0,10.0,1.0,0.0,24.0,2.0,3.0,0.0,0.0,2.0,1.0,11.0,10.0,17.0,3.0,0.0,5.0,23.0,0.0,0.0,11.0,18.0,25.0,3.0,1.0,0.0,14.0,2.0,1.0,4.0,3.0,7.0,7.0,2.0,3.0,23.0,18.0,5.0,1.0,26.0,13.0,1.0,15.0,12.0,8.0,22.0,5.0,21.0,3.0,7.0,4.0,1.0,11.0,18.0,8.0,12.0,13.0,5.0,3.0,9.0,0.0,4.0,24.0,14.0,0.0,9.0,16.0,13.0,5.0,6.0,1.0,16.0,5.0,9.0,14.0,6.0,2.0,0.0,10.0,5.0,4.0,3.0,6.0,0.0,8.0,0.0,22.0,0.0,9.0,20.0,19.0,11.0,15.0,12.0,14.0,21.0,18.0,11.0,5.0,1.0,1.0,24.0,3.0,8.0,19.0,11.0,15.0,1.0,29.0,5.0,12.0,7.0,2.0,,6.0,2.0,3.0,2.0,7.0,12.0,8.0,7.0,4.0,13.0,2.0,18.0,17.0,1.0,1.0,3.0,14.0,24.0,33.0,8.0,12.0,1.0,16.0,5.0,0.0,3.0,9.0,4.0,17.0,30.0,7.0,1.0,19.0,10.0,13.0,0.0,18.0,8.0,0.0,8.0,18.0,13.0,1.0,10.0,12.0,2.0,25.0,23.0,3.0,16.0,7.0,1.0,18.0,23.0,3.0,5.0,0.0,7.0,2.0,15.0,8.0,35.0,7.0,5.0,3.0,8.0,5.0,8.0,3.0,15.0,5.0,5.0,7.0,7.0,1.0,21.0,1.0,2.0,2.0,9.0,1.0,1.0,11.0,3.0,9.0,5.0,5.0,10.0,5.0,30.0,9.0,3.0,0.0,2.0,2.0,17.0,14.0,18.0,12.0,3.0,15.0,0.0,1.0,4.0,11.0,0.0,5.0,18.0,11.0,8.0,8.0,3.0,15.0,9.0,15.0,3.0,1.0,1.0,0.0,4.0,2.0,16.0,6.0,18.0,14.0,3.0,5.0,11.0,34.0,2.0,0.0,5.0,2.0,17.0,0.0,8.0,4.0,3.0,4.0,8.0,0.0,2.0,18.0,6.0,6.0,2.0,16.0,14.0,24.0,9.0,14.0,5.0,4.0,24.0,12.0,1.0,28.0,15.0,0.0,18.0,1.0,1.0,4.0,0.0,10.0,1.0,8.0,0.0,4.0,3.0,4.0,10.0,7.0,6.0,5.0,0.0,3.0,18.0,2.0,18.0,34.0,1.0,12.0,9.0,1.0,17.0,2.0,22.0,3.0,24.0,9.0,12.0,0.0,26.0,5.0,13.0,10.0,1.0,1.0,13.0,0.0,11.0,3.0,16.0,8.0,12.0,15.0,1.0,23.0,22.0,2.0,14.0,5.0,4.0,7.0,14.0,22.0,21.0,3.0,13.0,2.0,8.0,14.0,15.0,11.0,5.0,4.0,6.0,2.0,0.0,14.0,4.0,8.0,4.0,0.0,24.0,0.0,3.0,16.0,2.0,1.0,1.0,20.0,4.0,0.0,1.0,0.0,15.0,16.0,4.0,16.0,5.0,1.0,23.0,2.0,0.0,5.0,16.0,4.0,0.0,8.0,4.0,9.0,7.0,3.0,1.0,1.0,23.0,1.0,5.0,2.0,17.0,0.0,34.0,0.0,25.0,0.0,3.0,1.0,0.0,1.0,4.0,17.0,0.0,9.0,9.0,4.0,7.0,1.0,6.0,8.0,2.0,16.0,22.0,14.0,0.0,5.0,6.0,0.0,13.0,1.0,9.0,0.0,10.0,1.0,2.0,11.0,0.0,5.0,7.0,5.0,9.0,1.0,4.0,4.0,22.0,6.0,0.0,0.0,5.0,3.0,6.0,30.0,6.0,8.0,19.0,2.0,22.0,1.0,0.0,7.0,1.0,1.0,2.0,8.0,0.0,3.0,1.0,3.0,5.0,3.0,1.0,40.0,20.0,8.0,2.0,1.0,1.0,13.0,3.0,6.0,1.0,7.0,11.0,3.0,0.0,0.0,24.0,18.0,7.0,5.0,14.0,0.0,13.0,8.0,5.0,20.0,14.0,5.0,19.0,6.0,7.0,0.0,5.0,0.0,14.0,4.0,2.0,12.0,22.0,2.0,8.0,0.0,1.0,31.0,10.0,3.0,4.0,2.0,4.0,5.0,23.0,5.0,27.0,7.0,3.0,1.0,3.0,5.0,33.0,5.0,25.0,24.0,1.0,22.0,9.0,0.0,16.0,18.0,2.0,9.0,13.0,4.0,36.0,15.0,2.0,25.0,18.0,9.0,26.0,3.0,26.0,1.0,0.0,0.0,5.0,2.0,13.0,2.0,5.0,8.0,1.0,2.0,9.0,1.0,3.0,4.0,5.0,3.0,5.0,5.0,5.0,1.0,3.0,5.0,5.0,3.0,5.0,5.0,5.0,5.0,5.0,4.0,5.0,3.0,5.0,3.0,3.0,0.0,5.0,2.0,5.0,4.0,5.0,1.0,4.0,3.0,3.0,1.0,3.0,0.0,0.0,0.0,5.0,0.0,0.0,1.0,2.0,0.5,0.0,0.0,0.0,0.0,0.0,0.0,0.0,0.0,0.0,0.0,1.0,0.0,0.0,3.0,0.0,0.0,0.0,0.0,0.0,9.0,6.0,11.0,0.0,17.0,0.0,0.0,0.0,6.0,4.0,10.0,11.0,6.0,9.0,3.0,6.0,10.0,5.0,15.0,0.0,16.0,16.0,5.0,4.0,19.0,9.0,11.0,15.0,14.0,0.0,1.0,8.0,7.0,8.0,11.0,3.0,4.0,0.0,3.0,30.0,3.0,2.0,1.0,3.0,3.0,2.0,3.0,4.0,12.0,4.0,11.0,13.0,15.0,2.0,3.0,11.0,5.0,2.0,8.0,8.0,17.0,13.0,18.0,3.0,3.0,1.0,6.0,3.0,6.0,36.0,10.0,7.0,8.0,3.0,18.0,10.0,13.0,1.0,1.0,12.0,10.0,13.0,2.0,14.0,13.0,1.0,24.0,0.0,2.0,0.0,7.0,4.0,8.0,7.0,4.0,6.0,6.0,3.0,26.0,6.0,34.0,14.0,20.0,5.0,19.0,5.0,5.0,12.0,2.0,16.0,17.0,9.0,14.0,20.0,16.0,0.0,5.0,17.0,5.0,15.0,14.0,16.0,16.0,10.0,12.0,22.0,13.0,16.0,9.0,13.0,14.0,17.0,14.0,9.0,15.0,16.0,13.0,13.0,9.0,11.0,17.0,13.0,12.0,9.0,7.0,18.0,11.0,3.0,4.0,7.0,8.0,6.0,17.0,10.0,17.0,15.0,11.0,9.0,16.0,2.0,17.0,3.0,0.0,14.0,12.0,16.0,15.0,14.0,8.0,9.0,13.0,10.0,5.0,16.0,6.0,2.0,13.0,3.0,19.0,7.0,12.0,13.0,20.0,19.0,16.0,20.0,20.0,5.0,4.0,8.0,7.0,5.0,15.0,14.0,12.0,13.0,20.0,15.0,7.0,17.0,11.0,11.0,13.0,4.0,9.0,12.0,10.0,2.0,6.0,2.0,11.0,12.0,9.0,10.0,13.0,4.0,14.0,13.0,3.0,4.0,7.0,2.0,7.0,4.0,1.0,7.0,14.0,15.0,11.0,9.0,6.0,0.0,1.0,5.0,0.0,14.0,3.0,20.0,7.0,15.0,12.0,12.0,25.0,14.0,11.0,12.0,9.0,1.0,8.0,6.0,8.0,1.0,8.0,13.0,25.0,18.0,0.0,0.0,0.0,0.0,0.0,0.0,0.0,0.0,0.0,0.0,0.0,0.0,0.0,0.0,0.0,0.0,0.0,0.0,0.0,0.0,0.0,0.0,0.0,0.0,0.0,0.0,0.0,0.0,0.0,0.0,0.0,0.0,0.0,0.0,0.0,0.0,0.0,0.0,0.0,0.0,0.0,0.0,0.0,0.0,0.0,0.0,0.0,0.0,0.0,0.0,0.0,0.0,0.0,0.0,0.0,0.0,0.0,5.0,1.0,5.0,1.0,0.0,0.0,1.0,1.0,5.0,4.0,4.0,5.0,3.0,3.0,0.0,1.0,5.0,1.0,1.0,1.0,1.0,1.0,1.0,2.0,4.0,2.0,2.0,5.0,5.0,1.0,4.0,5.0,5.0,5.0,5.0,3.0,5.0,5.0,4.0,5.0,2.0,5.0,5.0,5.0,5.0,5.0,0.0,4.0,5.0,4.0,5.0,5.0,5.0,5.0,4.0,5.0,4.0,5.0,5.0,1.0,1.0,5.0,5.0,4.0,5.0,5.0,5.0,5.0,5.0,0.0,4.0,5.0,5.0,4.0,5.0,1.0,3.0,5.0,7.0,6.0,3.0,7.0,3.0,1.0,7.0,4.0,3.0,5.0,3.0,1.0,3.0,5.0,6.0,1.0,3.0,5.0,2.0,0.0,5.0,5.0,5.0,5.0,5.0,5.0,0.0,5.0,1.0,5.0,5.0,0.0,5.0,0.0,5.0,5.0,5.0,5.0,3.0,5.0,4.0,5.0,0.0,5.0,5.0,5.0,5.0,5.0,0.0,5.0,2.0,4.0,5.0,5.0,5.0,5.0,5.0,5.0,0.0,0.0,5.0,5.0,5.0,2.0,5.0,5.0,3.0,5.0,10.0,0.0,3.0,11.0,0.0,1.0,2.0,3.0,0.0,3.0,0.0,3.0,2.0,3.0,12.0,5.0,1.0,8.0,0.0,6.0,8.0,16.0,4.0,0.0,13.0,0.0,0.0,2.0,1.0,1.0,7.0,1.0,4.0,4.0,2.0,3.0,2.0,7.0,3.0,3.0,2.0,2.0,1.0,1.0,3.0,4.0,6.0,6.0,6.0,7.0,3.0,10.0,5.0,4.0,1.0,0.0,9.0,1.0,5.0,2.0,2.0,3.0,10.0,0.0,0.0,1.0,6.0,4.0,1.0,3.0,9.0,5.0,0.0,0.0,6.0,0.0,1.0,1.0,7.0,7.0,4.0,9.0,0.0,3.0,3.0,0.0,4.0,0.0,3.0,4.0,4.0,1.0,8.0,5.0,5.0,4.0,4.0,2.0,1.0,13.0,6.0,16.0,7.0,9.0,4.0,11.0,4.0,2.0,3.0,0.0,0.0,1.0,5.0,3.0,0.0,3.0,6.0,3.0,0.0,3.0,0.0,1.0,1.0,3.0,0.0,2.0,0.0,1.0,4.0,4.0,4.0,9.0,7.0,7.0,1.0,2.0,2.0,5.0,4.0,4.0,3.0,3.0,4.0,7.0,7.0,0.0,0.0,1.0,0.0,9.0,10.0,14.0,12.0,3.0,13.0,5.0,7.0,18.0,5.0,6.0,7.0,5.0,4.0,0.0,0.0,0.0,4.0,0.0,0.0,0.0,8.0,4.0,8.0,9.0,0.0,0.0,1.0,4.0,1.0,4.0,0.0,0.0,6.0,8.0,7.0,5.0,0.0,8.0,14.0,26.0,39.0,11.0,4.0,10.0,19.0,14.0,15.0,5.0,9.0,21.0,9.0,3.0,14.0,11.0,9.0,8.0,8.0,28.0,8.0,2.0,18.0,12.0,9.0,5.0,13.0,1.0,11.0,6.0,48.0,13.0,22.0,16.0,4.0,5.0,4.0,1.0,5.0,3.0,5.0,5.0,5.0,5.0,5.0,5.0,5.0,5.0,1.0,5.0,5.0,5.0,5.0,5.0,5.0,4.0,1.0,5.0,5.0,5.0,5.0,5.0,5.0,3.0,2.0,5.0,5.0,5.0,5.0,5.0,5.0,5.0,4.0,5.0,5.0,5.0,4.0,5.0,2.0,18.0,2.0,0.0,11.0,0.0,0.0,0.0,17.0,12.0,5.0,0.0,2.0,3.0,8.0,5.0,2.0,0.0,7.0,0.0,28.0,34.0,27.0,13.0,12.0,6.0,2.0,0.0,3.0,1.0,0.0,5.0,3.0,24.0,0.0,8.0,8.0,15.0,12.0,13.0,5.0,3.0,20.0,19.0,0.0,23.0,19.0,9.0,23.0,17.0,5.0,9.0,12.0,14.0,1.0,1.0,21.0,19.0,24.0,40.0,4.0,1.0,4.0,2.0,1.0,1.0,1.0,1.0,30.0,27.0,10.0,1.0,6.0,8.0,4.0,14.0,5.0,4.0,4.0,3.0,6.0,7.0,4.0,2.0,10.0,11.0,5.0,5.0,5.0,5.0,5.0,5.0,5.0,3.0,2.0,15.0,7.0,11.0,5.0,13.0,11.0,10.0,16.0,9.0,10.0,0.0,0.0,3.0,3.0,2.0,3.0,0.0,0.0,0.0,4.0,3.0,2.0,2.0,2.0,2.0,3.0,2.0,0.0,7.0,2.0,4.0,5.0,2.0,16.0,2.0,46.0,0.0,2.0,2.0,2.0,0.0,5.0,0.0,0.0,0.0,0.0,0.0,1.0,2.0,2.0,1.0,3.0,1.0,0.0,1.0,0.0,0.0,1.0,0.0,0.0,0.0,1.0,1.0,1.0,0.0,1.0,1.0,1.0,0.0,0.0,1.0,1.0,1.0,1.0,2.0,1.0,0.0,0.0,1.0,0.0,2.0,2.0,0.0,1.0,5.0,1.0,1.0,1.0,1.0,1.0,2.0,1.0,0.0,1.0,1.0,0.0,1.0,2.0,1.0,1.0,1.0,0.0,3.0,1.0,0.0,0.0,1.0,1.0,1.0,1.0,0.0,1.0,0.0,0.0,1.0,0.0,1.0,0.0,0.0,1.0,0.0,1.0,0.0,1.0,1.0,1.0,2.0,0.0,4.0,3.0,2.0,3.0,0.0,7.0,0.0,4.0,1.0,9.0,0.0,2.0,1.0,0.0,0.0,0.0,0.0,1.0,0.0,1.0,1.0,0.0,0.0,0.0,2.0,1.0,1.0,4.0,1.0,1.0,2.0,2.0,7.0,0.0,2.0,0.0,0.0,2.0,4.0,0.0,2.0,1.0,1.0,1.0,0.0,1.0,2.0,0.0,7.0,2.0,0.0,0.0,1.0,1.0,0.0,2.0,2.0,0.0,1.0,4.0,3.0,0.0,0.0,9.0,7.0,1.0,0.0,0.0,0.0,0.0,1.0,1.0,1.0,4.0,0.0,0.0,0.0,2.0,0.0,1.0,0.0,0.0,1.0,0.0,0.0,0.0,0.0,4.0,0.0,2.0,1.0,1.0,2.0,1.0,11.0,1.0,0.0,0.0,0.0,0.0,0.0,2.0,2.0,2.0,4.0,0.0,0.0,4.0,0.0,10.0,0.0,0.0,0.0,0.0,0.0,0.0,2.0,1.0,0.0,7.0,0.0,0.0,5.0,0.0,2.0,0.0,0.0,0.0,1.0,0.0,0.0,0.0,0.0,0.0,0.0,0.0,6.0,4.0,3.0,3.0,7.0,4.0,4.0,2.0,8.0,2.0,1.0,3.0,3.0,3.0,4.0,6.0,5.0,5.0,2.0,4.0,2.0,2.0,3.0,3.0,4.0,5.0,4.0,0.0,4.0,3.0,2.0,11.0,12.0,9.0,9.0,9.0,10.0,12.0,7.0,7.0,7.0,13.0,8.0,12.0,7.0,9.0,9.0,8.0,5.0,5.0,5.0,5.0,4.0,5.0,5.0,2.0,5.0,1.0,2.0,2.0,3.0,0.0,3.0,3.0,0.0,9.0,1.0,4.0,6.0,0.0,7.0,2.0,1.0,1.0,4.0,5.0,0.0,5.0,3.0,2.0,5.0,4.0,6.0,1.0,3.0,5.0,9.0,2.0,1.0,4.0,7.0,1.0,2.0,6.0,3.0,2.0,11.0,2.0,5.0,0.0,0.0,2.0,9.0,0.0,0.0,1.0,0.0,7.0,0.0,5.0,2.0,5.0,5.0,5.0,5.0,3.0,0.0,5.0,5.0,2.0,5.0,0.0,5.0,5.0,5.0,5.0,5.0,5.0,5.0,3.0,5.0,4.0,3.0,0.0,4.0,4.0,5.0,5.0,5.0,3.0,5.0,5.0,5.0,5.0,1.0,5.0,5.0,5.0,4.0,5.0,4.0,4.0,2.0,4.0,5.0,5.0,5.0,5.0,4.0,5.0,5.0,4.0,5.0,2.0,4.0,3.0,4.0,5.0,5.0,5.0,5.0,5.0,2.0,5.0,4.0,5.0,4.0,5.0,4.0,5.0,5.0,4.0,5.0,4.0,4.0,5.0,5.0,5.0,5.0,4.0,5.0,4.0,5.0,5.0,4.0,5.0,5.0,4.0,4.0,5.0,3.0,3.0,3.0,5.0,5.0,5.0,5.0,5.0,5.0,5.0,5.0,4.0,5.0,5.0,4.0,5.0,2.0,5.0,4.0,3.0,5.0,2.0,5.0,5.0,5.0,5.0,4.0,0.0,5.0,0.0,0.0,0.0,0.0,2.0,2.0,10.0,10.0,25.0,28.0,11.0,7.0,19.0,15.0,5.0,6.0,4.0,4.0,10.0,4.0,9.0,14.0,18.0,11.0,4.0,12.0,19.0,28.0,13.0,15.0,11.0,20.0,19.0,27.0,14.0,8.0,17.0,5.0,23.0,6.0,4.0,16.0,24.0,16.0,14.0,2.0,19.0,15.0,5.0,7.0,23.0,16.0,4.0,15.0,10.0,6.0,4.0,5.0,10.0,2.0,9.0,9.0,7.0,6.0,6.0,4.0,8.0,1.0,4.0,12.0,12.0,1.0,19.0,17.0,19.0,14.0,16.0,0.0,13.0,11.0,12.0,13.0,3.0,1.0,11.0,5.0,2.0,15.0,6.0,14.0,2.0,3.0,13.0,8.0,18.0,6.0,12.0,6.0,15.0,10.0,13.0,7.0,16.0,6.0,6.0,13.0,9.0,4.0,10.0,14.0,14.0,14.0,18.0,15.0,11.0,24.0,1.0,14.0,16.0,12.0,19.0,3.0,17.0,7.0,12.0,6.0,9.0,32.0,27.0,5.0,11.0,20.0,18.0,20.0,18.0,6.0,12.0,3.0,9.0,13.0,21.0,23.0,20.0,12.0,5.0,19.0,8.0,2.0,15.0,8.0,2.0,22.0,30.0,5.0,2.0,13.0,10.0,13.0,14.0,1.0,15.0,1.0,13.0,9.0,12.0,5.0,8.0,9.0,14.0,7.0,10.0,11.0,8.0,10.0,9.0,6.0,12.0,8.0,22.0,4.0,5.0,8.0,1.0,20.0,2.0,8.0,6.0,22.0,14.0,10.0,3.0,12.0,2.0,14.0,9.0,5.0,18.0,12.0,12.0,1.0,18.0,20.0,12.0,4.0,12.0,10.0,8.0,15.0,3.0,16.0,17.0,1.0,15.0,7.0,11.0,6.0,12.0,1.0,18.0,13.0,10.0,3.0,2.0,12.0,11.0,9.0,17.0,14.0,10.0,2.0,11.0,3.0,9.0,10.0,22.0,12.0,18.0,5.0,11.0,13.0,9.0,12.0,7.0,19.0,8.0,15.0,15.0,10.0,2.0,19.0,2.0,2.0,25.0,3.0,1.0,16.0,28.0,9.0,3.0,10.0,5.0,11.0,10.0,14.0,21.0,18.0,15.0,14.0,5.0,2.0,1.0,36.0,18.0,16.0,14.0,13.0,29.0,7.0,9.0,7.0,12.0,1.0,0.0,13.0,5.0,16.0,3.0,14.0,15.0,28.0,11.0,9.0,10.0,13.0,5.0,7.0,11.0,11.0,2.0,18.0,13.0,15.0,6.0,6.0,4.0,9.0,8.0,3.0,14.0,3.0,14.0,10.0,12.0,2.0,8.0,22.0,6.0,2.0,2.0,2.0,8.0,7.0,15.0,3.0,9.0,16.0,12.0,17.0,2.0,8.0,15.0,31.0,5.0,20.0,12.0,5.0,13.0,17.0,13.0,5.0,13.0,9.0,16.0,14.0,13.0,7.0,2.0,8.0,15.0,8.0,10.0,23.0,10.0,12.0,0.0,7.0,2.0,6.0,1.0,1.0,3.0,2.0,1.0,5.0,1.0,0.0,0.0,0.0,0.0,1.0,3.0,1.0,2.0,4.0,0.0,0.0,0.0,1.0,0.0,1.0,1.0,0.0,0.0,5.0,1.0,0.0,1.0,5.0,1.0,,3.0,5.0,5.0,0.0,0.0,0.0,1.0,0.0,2.0,0.0,4.0,2.0,0.0,2.0,0.0,1.0,1.0,0.0,0.0,0.0,1.0,1.0,0.0,1.0,0.0,3.0,0.0,1.0,1.0,5.0,5.0,1.0,1.0,0.0,1.0,1.0,5.0,1.0,0.0,0.0,3.0,0.0,2.0,0.0,1.0,1.0,0.0,2.0,1.0,4.0,0.0,0.0,0.0,0.0,0.0,0.0,5.0,1.0,0.0,0.0,0.0,1.0,2.0,4.0,1.0,0.0,3.0,1.0,3.0,2.0,1.0,0.0,1.0,2.0,0.0,5.0,0.0,3.0,2.0,0.0,1.0,4.0,6.0,1.0,4.0,2.0,0.0,3.0,0.0,2.0,3.0,2.0,9.0,1.0,1.0,0.0,5.0,4.0,2.0,5.8,1.0,0.0,0.0,1.0,8.0,1.0,2.0,1.0,5.0,6.0,3.0,8.0,1.0,5.0,14.0,0.0,5.0,1.0,6.0,0.0,0.0,4.0,0.0,3.0,2.0,4.0,10.0,2.0,7.0,8.0,1.0,5.0,0.0,3.0,3.0,3.0,2.0,5.0,0.0,7.0,6.0,10.0,3.0,3.6666666666666665,3.0,14.0,8.0,2.0,0.0,8.0,4.0,1.0,2.0,2.0,6.0,5.0,3.0,2.0,5.0,4.0,5.0,5.0,3.0,2.0,0.0,10.0,1.0,0.0,4.0,5.0,5.0,0.0,2.0,1.0,4.0,6.0,0.0,1.0,2.0,6.0,4.0,0.0,3.0,0.0,3.0,2.0,2.0,2.0,8.0,3.0,3.0,2.0,3.0,5.0,2.0,6.0,13.0,3.0,1.0,5.0,4.0,3.0,3.0,4.0,2.0,12.0,7.0,8.0,11.0,4.0,0.0,1.0,4.0,7.0,9.0,4.0,1.0,2.0,2.0,2.0,5.0,4.0,0.0,6.0,4.0,2.0,5.0,6.0,0.0,2.0,1.0,3.0,4.0,1.0,1.0,6.0,5.0,5.0,3.0,8.0,4.0,10.0,0.0,4.0,7.0,2.0,4.0,12.0,15.0,0.0,0.0,1.0,3.0,3.0,7.0,3.0,0.0,1.0,2.0,4.0,4.0,6.0,1.0,1.0,2.0,0.0,9.0,3.0,7.0,5.0,4.0,5.0,2.0,1.0,4.0,5.0,3.0,5.0,3.0,0.0,8.0,3.0,9.0,7.0,2.0,15.0,3.0,10.0,19.0,9.0,8.0,9.0,10.0,13.0,18.0,2.0,11.0,5.0,0.0,15.0,2.0,6.0,9.0,15.0,15.0,11.0,4.0,5.0,1.0,1.0,5.0,1.0,11.0,14.0,0.0,4.0,4.0,3.0,3.0,0.0,13.0,11.0,7.0,17.0,20.0,15.0,15.0,4.0,15.0,17.0,5.0,13.0,0.0,12.0,4.0,5.0,13.0,5.0,0.0,9.0,2.0,11.0,7.0,8.0,17.0,17.0,18.0,5.0,5.0,27.0,4.0,7.0,5.0,15.0,25.0,27.0,18.0,7.0,4.0,3.0,8.0,8.0,13.0,14.0,7.0,5.0,2.0,20.0,15.0,2.0,4.0,13.0,11.0,3.0,3.0,3.0,5.0,10.0,11.0,5.0,8.0,0.0,8.0,15.0,16.0,4.0,13.0,10.0,0.0,15.0,9.0,1.0,6.0,1.0,19.0,15.0,4.0,1.0,13.0,7.0,4.0,15.0,15.0,17.0,3.0,15.0,19.0,20.0,17.0,20.0,15.0,18.0,14.0,10.0,16.0,10.0,13.0,7.0,1.0,8.0,8.0,6.0,8.0,2.0,15.0,6.0,8.0,11.0,13.0,3.0,13.0,6.0,12.0,1.0,17.0,8.0,19.0,14.0,11.0,6.0,6.0,2.0,19.0,9.0,7.0,4.0,0.0,6.0,9.0,10.0,1.0,1.0,9.0,7.0,10.0,14.0,12.0,13.0,8.0,13.0,17.0,2.0,3.0,3.0,7.0,14.0,12.0,13.0,16.0,5.0,0.0,19.0,8.0,9.0,11.0,9.0,5.0,11.0,8.0,8.0,4.0,4.0,0.0,11.0,15.0,4.0,5.0,16.0,14.0,0.0,8.0,1.0,7.0,14.0,13.0,8.0,14.0,13.0,12.0,9.0,5.0,13.0,7.0,12.0,16.0,6.0,16.0,11.0,17.0,2.0,5.0,7.0,4.0,1.0,1.0,1.0,13.0,10.0,2.0,3.0,20.0,0.0,14.0,6.0,4.0,4.0,4.0,8.0,7.0,5.0,12.0,10.0,10.0,17.0,7.0,8.0,20.0,0.0,3.0,13.0,4.0,6.0,6.0,10.0,6.0,9.0,15.0,14.0,19.0,2.0,6.0,10.0,13.0,7.0,11.0,5.0,10.0,12.0,24.0,9.0,5.0,13.0,7.0,8.0,13.0,6.0,10.0,7.0,9.0,7.0,17.0,11.0,12.0,11.0,12.0,8.0,9.0,6.0,9.0,0.0,0.0,0.0,0.0,0.0,0.0,16.0,6.0,0.0,2.0,0.0,2.0,16.0,25.0,7.0,2.0,2.0,1.0,7.0,7.0,17.0,14.0,8.0,12.0,0.0,0.0,1.0,11.0,9.0,8.0,14.0,12.0,12.0,3.0,3.0,10.0,2.0,0.0,0.0,2.0,9.0,14.0,4.0,16.0,2.0,13.0,2.0,5.0,6.0,5.0,0.0,1.0,8.0,15.0,8.0,4.0,3.0,3.0,6.0,2.0,2.0,10.0,1.0,3.0,17.0,7.0,10.0,27.0,0.0,2.0,6.0,11.0,0.0,11.0,5.0,1.0,15.0,3.0,2.0,13.0,9.0,16.0,6.0,4.0,2.0,10.0,4.0,1.0,1.0,6.0,3.0,0.0,5.0,8.0,4.0,4.0,2.0,3.0,6.0,9.0,42.0,18.0,21.0,9.0,20.0,3.0,0.0,18.0,8.0,7.0,14.0,0.0,16.0,15.0,9.0,26.0,8.0,14.0,10.0,1.0,3.0,3.0,9.0,7.0,10.0,11.0,3.0,1.0,12.0,6.0,2.0,9.0,12.0,3.0,3.0,4.0,9.0,39.0,8.0,11.0,1.0,19.0,0.0,2.0,23.0,0.0,0.0,7.0,4.0,1.0,13.0,38.0,7.0,14.0,2.0,1.0,5.0,8.0,1.0,8.0,16.0,3.0,6.0,4.0,24.0,16.0,3.0,6.0,2.0,9.0,1.0,10.0,3.0,4.0,8.0,3.0,0.0,4.0,18.0,2.0,13.0,7.0,3.0,3.0,8.0,5.0,23.0,13.0,7.0,7.0,10.0,17.0,7.0,2.0,0.0,4.0,1.0,4.0,8.0,2.0,10.0,2.0,2.0,5.0,15.0,6.0,1.0,4.0,3.0,3.0,4.0,1.0,18.0,4.0,5.0,5.0,4.0,6.0,2.0,8.0,1.0,6.0,2.0,2.0,3.0,0.0,23.0,5.0,6.0,5.0,9.0,0.0,2.0,17.0,3.0,6.0,25.0,7.0,3.0,4.0,13.0,2.0,4.5,18.0,6.0,3.0,24.0,1.0,1.0,3.0,5.0,0.0,8.0,2.0,6.0,18.0,6.0,2.0,4.0,4.0,0.0,2.0,18.0,20.0,11.0,14.0,0.0,7.0,12.0,22.0,1.0,6.0,4.0,3.0,8.0,39.0,0.0,9.0,4.0,15.0,6.0,5.0,12.0,2.0,0.0,0.0,23.0,6.0,13.0,9.0,2.0,6.0,17.0,1.0,1.0,0.0,10.0,16.0,34.0,1.0,4.0,0.0,6.0,2.0,5.0,9.0,2.0,12.0,6.0,6.0,10.0,8.0,4.0,2.0,5.0,13.0,0.0,2.0,8.0,8.0,4.0,6.0,2.0,4.0,3.0,0.0,0.0,6.0,5.0,2.0,2.0,1.0,0.0,7.0,8.0,6.0,5.0,7.0,9.0,1.0,5.0,3.0,2.0,14.0,12.0,2.0,15.0,13.0,1.0,8.0,9.0,34.0,0.0,6.0,8.0,17.0,5.0,6.0,2.0,0.0,8.0,7.0,4.0,5.0,3.0,0.0,5.0,6.0,13.0,7.0,4.0,12.0,9.0,2.0,3.0,2.0,3.0,5.0,4.0,31.0,2.0,12.0,20.0,6.0,38.0,4.0,5.0,3.0,7.0,4.0,11.0,6.0,1.0,11.0,10.0,0.0,1.0,1.0,12.0,22.0,28.0,5.0,2.0,10.0,3.0,17.0,3.0,5.0,23.0,10.0,8.0,1.0,18.0,7.0,1.0,6.0,18.0,10.0,3.0,7.0,1.0,0.0,5.0,9.0,8.0,13.0,6.0,6.0,9.0,9.0,0.0,12.0,20.0,3.0,6.0,0.0,7.0,9.0,6.0,13.0,8.0,16.0,6.0,11.0,2.0,23.0,11.0,9.0,15.0,5.0,0.0,10.0,13.0,2.0,15.0,9.0,8.0,17.0,20.0,31.0,39.0,8.0,25.0,5.0,10.0,15.0,4.0,5.0,9.0,10.0,2.0,1.0,5.0,3.0,5.0,5.0,4.0,6.0,1.0,9.0,12.0,8.0,6.0,4.0,1.0,16.0,1.0,6.0,23.0,6.0,10.0,3.0,3.0,13.0,20.0,17.0,5.0,0.0,5.0,11.0,8.0,8.0,20.0,5.0,0.0,4.0,26.0,11.0,19.0,5.0,2.0,1.0,2.0,9.0,0.0,6.0,0.0,6.0,3.0,11.0,5.0,8.0,9.0,13.0,11.0,13.0,1.0,2.0,18.0,4.0,18.0,0.0,7.0,6.0,2.0,3.0,8.0,8.0,1.0,4.0,0.0,12.0,4.0,0.0,8.0,9.0,2.0,3.0,10.0,53.0,6.0,9.0,8.0,9.25,13.0,1.0,5.0,3.0,8.0,3.0,4.0,13.0,15.0,5.0,3.0,10.0,0.0,5.0,16.0,15.0,2.0,7.0,9.0,2.0,4.0,18.0,5.0,2.0,4.0,5.0,4.0,3.0,2.0,4.0,12.0,4.0,4.0,2.0,7.0,26.0,6.0,2.0,8.0,7.0,7.0,3.0,5.0,4.0,21.0,4.0,3.0,3.0,3.0,0.0,2.0,5.0,6.0,0.0,1.0,4.0,8.0,2.0,4.0,9.0,1.0,5.0,5.0,4.0,4.0,16.0,3.0,11.0,6.0,0.0,4.0,6.0,9.0,0.0,9.0,3.0,0.0,2.0,2.0,0.0,6.0,3.0,11.0,2.0,6.0,26.0,21.0,19.0,23.0,3.0,4.0,0.0,12.0,11.0,6.0,7.0,1.0,10.0,1.0,4.0,7.0,8.0,11.0,4.0,5.0,30.0,6.0,9.0,4.0,8.0,7.0,10.0,6.0,8.0,6.0,2.0,4.0,8.0,3.0,16.0,13.0,7.0,14.0,9.0,5.0,5.0,5.0,27.0,4.0,19.0,9.0,14.0,24.0,3.0,3.0,4.0,6.0,2.0,14.0,8.0,4.0,6.0,6.0,7.0,27.0,2.0,12.0,3.0,10.0,18.0,5.0,3.0,1.0,0.0,33.0,9.0,0.0,10.0,15.0,8.0,0.0,5.0,9.0,2.0,3.0,9.0,1.0,21.0,5.0,3.0,2.0,8.0,11.0,0.0,15.0,7.0,4.0,2.0,11.0,7.0,4.0,6.0,13.0,3.0,1.0,4.0,4.0,17.0,12.0,16.0,15.0,4.0,12.0,8.0,17.0,21.0,57.0,6.0,4.0,3.0,2.0,12.0,10.0,6.0,3.0,2.0,17.0,12.0,7.0,6.0,7.0,3.0,8.0,3.0,5.0,3.0,2.0,4.0,18.0,8.0,10.0,11.0,2.0,8.0,23.0,30.0,2.0,7.0,6.0,12.0,11.0,8.0,3.0,11.0,14.0,9.0,9.0,12.0,2.0,31.0,2.0,7.0,2.0,4.0,2.0,4.0,6.0,0.0,6.0,10.0,4.0,8.0,5.0,14.0,17.0,12.0,2.0,8.0,3.0,5.0,25.0,8.0,5.0,4.0,0.0,4.0,8.0,3.0,2.0,18.0,7.0,5.0,11.0,9.0,7.0,1.0,7.0,10.0,1.0,11.0,7.0,16.0,14.0,3.0,6.0,2.0,15.0,1.0,4.0,7.0,2.0,7.0,2.0,5.0,17.0,11.0,12.0,5.0,7.0,0.0,5.0,7.0,6.0,7.0,27.0,1.0,5.0,22.0,5.0,8.0,6.0,5.0,11.0,7.0,1.0,4.0,3.0,0.0,8.0,1.0,11.0,41.0,5.0,4.0,5.0,24.0,35.0,1.0,31.0,16.0,16.0,5.0,3.0,7.0,13.0,4.0,4.0,6.0,10.0,5.0,12.0,16.0,4.0,19.0,9.0,22.0,1.0,7.0,3.0,4.0,15.0,8.0,19.0,11.0,2.0,4.0,15.0,9.0,2.0,12.0,2.0,2.0,9.0,16.0,13.0,9.0,2.0,4.0,13.0,13.0,1.0,9.0,5.0,3.0,3.0,15.0,6.0,8.0,17.0,2.0,15.0,16.0,6.0,2.0,13.0,0.0,8.0,6.0,10.0,11.0,13.0,6.0,9.0,3.0,8.0,4.0,11.0,11.0,29.0,15.0,9.0,8.0,19.0,12.0,2.0,24.0,1.0,8.5,5.0,0.0,5.0,4.0,12.0,8.0,6.0,11.0,5.0,8.0,12.0,7.0,16.0,5.0,4.0,23.0,11.0,2.0,6.0,3.0,0.0,0.0,5.0,10.0,10.0,10.0,0.0,4.0,3.0,29.0,25.0,16.0,8.0,3.0,8.0,0.0,4.0,0.0,11.0,34.0,15.0,5.0,4.0,15.0,1.0,7.0,14.0,3.0,4.0,14.0,2.0,0.0,22.0,0.0,19.0,8.0,8.0,7.5,26.0,6.0,7.0,5.0,32.0,54.0,7.0,6.0,2.0,7.0,3.0,2.0,3.0,10.0,13.0,23.0,2.0,22.0,19.0,6.0,3.0,3.0,5.0,22.0,17.0,18.0,7.0,13.0,25.0,7.0,3.0,3.0,3.0,5.0,5.0,1.0,14.0,0.0,5.0,0.0,19.0,13.0,8.0,3.0,17.0,5.0,0.0,28.0,1.0,,8.0,2.0,9.0,0.0,18.0,17.0,0.0,24.0,3.0,13.0,7.0,19.0,16.0,8.0,4.0,0.0,3.0,3.0,0.0,2.0,1.0,8.0,0.0,23.0,40.0,24.0,2.0,2.0,0.0,4.0,12.0,9.0,3.0,8.0,5.0,7.0,9.0,5.0,9.0,6.0,4.0,11.0,3.0,6.0,14.0,26.0,6.0,4.0,9.0,10.0,0.0,6.0,4.0,9.0,21.0,7.0,5.0,10.0,1.0,3.0,6.0,2.0,1.0,9.0,5.0,5.0,14.0,1.0,21.0,12.0,6.0,7.0,6.0,13.0,1.0,28.0,34.0,4.0,15.0,5.0,7.0,3.0,29.0,24.0,4.0,9.0,0.0,13.0,5.0,4.0,0.0,5.0,6.0,3.0,0.0,2.0,4.0,6.0,1.0,12.0,4.0,5.0,0.0,4.0,5.0,10.0,15.0,7.0,1.0,15.0,34.0,12.0,6.0,2.0,12.0,21.0,11.0,12.0,12.0,9.0,7.0,21.0,9.0,4.0,14.0,17.0,1.0,2.0,8.0,8.0,2.0,6.0,0.0,15.0,7.0,11.0,5.0,5.0,12.0,3.0,4.0,4.0,4.0,11.0,4.0,7.0,3.0,2.0,0.0,10.0,16.0,1.0,3.0,15.0,3.0,4.0,5.0,7.0,8.0,41.0,0.0,25.0,8.0,6.0,2.0,22.0,1.0,7.0,0.0,7.0,3.0,2.0,4.0,15.0,1.0,6.0,4.0,3.0,0.0,2.0,1.0,3.0,2.0,0.0,1.0,2.0,1.0,8.0,8.0,5.0,0.0,18.0,3.0,0.0,5.0,3.0,7.0,5.0,4.0,15.0,0.0,0.0,0.0,15.0,18.0,16.0,16.0,4.0,1.0,7.0,7.0,3.0,23.0,2.0,4.0,12.0,6.0,19.0,0.0,8.0,9.0,3.0,3.0,2.0,1.0,5.0,2.0,6.0,11.0,18.0,24.0,6.0,10.0,0.0,16.0,24.0,33.0,10.0,4.0,15.0,17.0,3.0,5.0,18.0,1.0,12.0,16.0,8.0,15.0,8.0,6.0,14.0,8.0,0.0,4.0,0.0,13.0,1.0,0.0,20.0,20.0,15.0,2.0,11.0,3.0,6.0,5.0,2.0,7.0,4.0,14.0,4.0,1.0,6.0,30.0,0.0,10.0,2.0,9.0,3.0,24.0,8.0,9.0,3.0,0.0,6.0,1.0,23.0,15.0,12.0,16.0,20.0,25.0,2.0,0.0,4.0,14.0,3.0,12.0,16.0,18.0,8.0,5.0,6.0,32.0,12.0,22.0,0.0,24.0,17.0,22.0,31.0,27.0,7.0,0.0,5.0,1.0,23.0,18.0,5.0,4.0,23.0,5.0,14.0,10.0,15.0,9.0,6.0,7.0,11.0,26.0,21.0,29.0,31.0,17.0,14.0,21.0,25.0,14.0,17.0,14.0,4.0,5.0,16.0,23.0,26.0,13.0,10.0,14.0,15.0,10.0,10.0,25.0,6.0,12.0,4.0,7.0,9.0,17.0,8.0,0.0,4.0,24.0,8.0,23.0,13.0,15.0,6.0,6.0,2.0,3.0,21.0,12.0,0.0,11.0,0.0,2.0,4.0,15.0,2.0,19.0,16.0,3.0,10.0,13.0,18.0,2.0,20.0,2.0,2.0,6.0,9.0,11.0,9.0,27.0,25.0,1.0,5.0,10.0,5.0,16.0,10.0,17.0,13.0,3.0,11.0,5.0,7.0,1.0,0.0,0.0,10.0,14.0,13.0,10.0,19.0,20.0,20.0,9.0,28.0,0.0,13.0,9.0,12.0,14.0,15.0,18.0,4.0,6.0,6.0,26.0,17.0,18.0,3.0,22.0,22.0,1.0,14.0,10.0,20.0,5.0,11.0,14.0,6.0,9.0,12.0,27.0,1.0,11.0,10.0,25.0,12.0,12.0,4.0,6.0,26.0,14.0,2.0,19.0,7.0,13.0,21.0,10.0,12.0,4.0,16.0,21.0,8.0,8.0,6.0,18.0,5.0,6.0,7.0,18.0,22.0,21.0,20.0,0.0,11.0,1.0,23.0,16.0,11.0,14.0,6.0,5.0,30.0,21.0,22.0,21.0,9.0,7.0,6.0,7.0,12.0,2.0,6.0,15.0,17.0,12.0,9.0,7.0,22.0,19.0,12.0,11.0,13.0,7.0,18.0,5.0,6.0,10.0,18.0,7.0,8.0,9.0,13.0,10.0,20.0,9.0,4.0,3.0,15.0,5.0,9.0,9.0,12.0,6.0,13.0,8.0,16.0,16.0,10.0,17.0,7.0,21.0,14.0,10.0,24.0,4.0,6.0,12.0,1.0,12.0,10.0,17.0,5.0,26.0,24.0,8.0,8.0,14.0,6.0,7.0,5.0,16.0,7.0,12.0,19.0,12.0,22.0,11.0,11.0,4.0,3.0,8.0,5.0,1.0,23.0,8.0,19.0,20.0,9.0,16.0,25.0,17.0,20.0,19.0,8.0,10.0,8.0,4.0,19.0,4.0,25.0,7.0,3.0,7.0,2.0,8.0,7.0,5.0,10.0,2.0,6.0,6.0,7.0,9.0,11.0,4.0,4.0,7.0,5.0,16.0,25.0,5.0,7.0,7.0,15.0,5.0,8.0,8.0,7.0,6.0,6.0,7.0,6.0,6.0,5.0,5.0,7.0,5.0,6.0,6.0,5.0,,0.0,6.0,1.0,2.0,0.0,7.0,0.0,1.0,2.0,1.0,14.0,7.0,4.0,11.0,1.0,8.0,19.0,8.0,9.0,8.0,10.0,18.0,6.0,3.0,9.0,1.0,4.0,6.0,9.0,7.0,2.0,6.0,5.0,0.0,0.0,8.0,11.0,4.0,7.0,5.0,4.0,1.0,0.0,2.0,16.0,13.0,9.0,3.0,4.0,10.0,8.0,3.0,7.0,18.0,4.0,5.0,7.0,12.0,13.0,14.0,1.0,3.0,4.0,5.0,5.0,4.0,7.0,5.0,7.0,4.0,4.0,2.0,1.0,8.0,2.0,7.0,2.0,10.0,8.0,11.0,11.0,5.0,2.0,8.0,1.0,8.0,7.0,0.0,4.0,3.0,0.0,0.0,0.0,0.0,5.0,0.0,3.0,0.0,3.0,0.0,0.0,1.0,2.0,0.0,0.0,0.0,7.0,0.0,7.0,0.0,0.0,2.0,3.0,6.0,9.0,26.0,11.0,3.0,7.0,0.0,8.0,11.0,14.0,7.0,0.0,,4.0,9.0,11.0,9.0,12.0,8.0,11.0,,5.0,11.0,1.0,3.0,5.0,2.0,8.0,18.0,9.0,17.0,11.0,11.0,13.0,5.0,2.0,5.0,5.0,6.0,19.0,13.0,8.0,1.0,9.0,5.0,7.0,1.0,8.0,8.0,26.0,4.0,4.0,3.0,2.0,11.0,2.0,1.0,4.0,8.0,14.0,5.0,4.0,3.0,5.0,0.0,6.0,9.0,7.0,22.0,4.0,3.0,1.0,21.0,6.0,11.0,11.0,10.0,7.0,6.0,16.0,14.0,8.0,2.0,8.0,10.0,8.0,13.0,2.0,14.0,4.0,9.0,10.0,13.0,1.0,13.0,7.0,14.0,26.0,10.0,15.0,11.0,3.0,19.0,5.0,16.0,11.0,10.0,,0.0,0.0,10.0,3.0,,2.0,3.0,9.0,6.0,14.0,4.0,18.0,5.0,9.0,17.0,13.0,1.0,8.0,9.0,7.0,12.0,1.0,4.0,5.0,,1.0,7.0,8.0,4.0,1.0,7.0,17.0,9.0,2.0,1.0,32.0,13.0,20.0,5.0,6.0,1.0,0.0,0.0,1.0,8.0,8.0,9.0,12.0,9.0,9.0,5.0,7.0,3.0,4.0,14.0,0.0,11.0,4.0,9.0,11.0,8.0,4.0,3.0,10.0,3.0,3.0,2.0,10.0,3.0,6.0,4.0,5.0,2.0,2.0,8.0,6.0,4.0,6.0,0.0,5.0,7.0,6.0,6.0,4.0,0.0,5.0,6.0,4.0,1.0,0.0,3.0,4.0,8.0,3.0,5.0,5.0,3.0,2.0,4.0,3.0,9.0,10.0,0.0,2.0,11.0,8.0,7.0,13.0,4.0,1.0,0.0,6.0,4.0,1.0,10.0,10.0,4.0,11.0,13.0,17.0,2.0,22.0,9.0,8.0,4.0,18.0,7.0,11.0,0.0,3.0,23.0,8.0,9.0,1.0,3.0,1.0,8.0,0.0,0.0,12.0,4.0,0.0,0.0,4.0,4.0,14.0,3.0,8.0,7.0,5.0,4.0,3.0,0.0,1.0,4.0,6.0,0.0,2.0,2.0,8.0,0.0,1.0,4.0,2.0,2.0,3.0,10.0,3.0,5.0,3.0,0.0,6.0,10.0,11.0,9.0,4.0,4.0,10.0,0.0,7.0,5.0,7.0,4.0,22.0,12.0,9.0,1.0,2.0,3.0,5.0,8.0,3.0,10.0,8.0,6.0,1.0,8.0,8.0,5.0,6.0,16.0,13.0,4.0,14.0,6.0,14.0,9.0,9.0,11.0,10.0,18.0,2.0,2.0,8.0,6.0,1.0,6.0,0.0,8.0,6.0,6.0,8.0,3.0,10.0,16.0,4.0,13.0,8.0,7.0,2.0,8.0,9.0,10.0,9.0,11.0,5.0,13.0,14.0,12.0,10.0,26.0,2.0,8.0,12.0,4.0,8.0,2.0,10.0,6.0,0.0,9.0,14.0,9.0,10.0,13.0,6.0,8.0,2.0,2.0,0.0,5.0,13.0,2.0,2.0,0.0,6.0,7.0,5.0,3.0,9.0,11.0,9.0,9.0,0.0,4.0,11.0,0.0,1.0,1.0,4.0,4.0,0.0,10.0,30.0,1.0,5.0,2.0,4.0,2.0,0.0,18.0,1.0,2.0,0.0,5.0,1.0,11.0,22.0,11.0,1.0,3.0,14.0,7.0,4.0,0.0,6.0,2.0,0.0,2.0,3.0,10.0,1.0,11.0,1.0,3.0,15.0,4.0,6.0,12.0,3.0,2.0,4.0,2.0,2.0,0.0,0.0,6.0,1.0,1.0,4.0,0.0,0.0,1.0,3.0,3.0,2.0,4.0,0.0,3.0,2.0,0.0,0.0,1.0,12.0,3.0,0.0,5.0,3.0,0.0,10.0,1.0,0.0,20.0,1.0,3.0,1.0,6.0,4.0,0.0,8.0,8.0,0.0,0.0,6.0,20.0,0.0,9.0,1.0,7.0,6.0,3.0,0.0,0.0,3.0,0.0,16.0,17.0,10.0,7.0,12.0,3.0,20.0,39.0,16.0,13.0,12.0,16.0,19.0,8.0,26.0,12.0,13.0,5.0,22.0,14.0,9.0,27.0,3.0,11.0,21.0,12.0,7.0,16.0,5.0,8.0,14.0,1.0,5.0,2.0,19.0,0.0,1.0,46.0,0.0,0.0,8.0,11.0,4.0,3.0,0.0,0.0,5.0,3.0,9.0,30.0,2.0,12.0,15.0,0.0,0.0,0.0,12.0,1.0,0.0,0.0,2.0,23.0,11.0,4.0,5.0,25.0,3.0,1.0,14.0,10.0,0.0,0.0,1.0,6.0,2.0,6.0,1.0,4.0,3.0,1.0,1.0,7.0,5.0,0.0,0.0,12.0,0.0,1.0,1.0,10.0,15.0,4.0,10.0,7.0,7.0,15.0,9.0,0.0,8.0,12.0,15.0,37.0,0.0,14.0,12.0,10.0,11.0,16.0,7.0,14.0,4.0,15.0,8.0,0.0,6.0,10.0,3.0,5.0,9.0,8.0,6.0,5.0,3.0,1.0,10.0,16.0,8.0,12.0,16.0,3.0,8.0,20.0,19.0,0.0,2.0,10.0,8.0,12.0,9.0,2.0,5.0,12.0,9.0,10.0,13.0,5.0,3.0,9.0,11.0,23.0,31.0,0.0,6.0,8.0,3.0,7.0,2.0,6.0,4.0,7.0,3.0,5.0,10.0,2.0,12.0,10.0,4.0,9.0,2.0,7.0,3.0,3.0,14.0,1.0,5.0,8.0,9.0,8.0,20.0,1.0,0.0,4.0,3.0,7.0,16.0,9.0,19.0,4.0,22.0,3.0,3.0,7.0,9.0,5.0,5.0,3.0,7.0,1.0,5.0,1.0,3.0,0.0,11.0,11.0,1.0,4.0,0.0,2.0,0.0,0.0,8.0,13.0,11.0,0.0,2.0,3.0,0.0,11.0,1.0,4.0,1.0,5.0,0.0,5.0,1.0,5.0,1.0,3.0,1.0,0.0,1.0,5.0,11.0,9.0,11.0,10.0,1.0,17.0,1.0,13.0,10.0,0.0,13.0,4.0,7.0,4.0,0.0,10.0,10.0,11.0,3.0,9.0,0.0,0.0,0.0,20.0,11.0,6.0,6.0,10.0,8.0,1.0,4.0,5.0,7.0,6.0,13.0,7.0,7.0,4.0,3.0,11.0,11.0,0.0,6.0,4.0,8.0,12.0,5.0,7.0,1.0,4.0,11.0,5.0,0.0,8.0,2.0,3.0,10.0,3.0,10.0,5.0,2.0,3.0,6.0,6.0,2.0,7.0,5.0,3.0,7.0,2.0,2.0,6.0,4.0,3.0,4.0,4.0,6.0,7.0,5.0,9.0,5.0,5.0,4.0,9.0,6.0,3.0,11.0,12.0,5.0,4.0,4.0,5.0,4.0,13.0,10.0,3.0,7.0,12.0,14.0,8.0,8.0,0.0,9.0,5.0,5.0,12.0,4.0,4.0,5.0,4.0,0.0,11.0,24.0,7.0,5.0,17.0,6.0,17.0,4.0,13.0,15.0,12.0,4.0,1.0,8.0,5.0,21.0,22.0,20.0,14.0,15.0,17.0,0.0,7.0,14.0,15.0,4.0,4.0,12.0,1.0,2.0,6.0,5.0,2.0,12.0,11.0,5.0,17.0,9.0,2.0,8.0,7.0,11.0,3.0,11.0,7.0,9.0,17.0,6.0,18.0,14.0,10.0,11.0,5.0,11.0,4.0,10.0,13.0,13.0,1.0,9.0,12.0,21.0,5.0,9.0,13.0,2.0,2.0,9.0,13.0,5.0,8.0,11.0,14.0,8.0,11.0,9.0,5.0,17.0,11.0,22.0,25.0,9.0,10.0,13.0,6.0,8.0,4.0,1.0,17.0,15.0,13.0,13.0,4.0,25.0,11.0,22.0,17.0,10.0,2.0,6.0,9.0,5.0,7.0,13.0,10.0,10.0,8.0,10.0,12.0,4.0,15.0,13.0,16.0,14.0,5.0,3.0,11.0,0.0,1.0,9.0,7.0,0.0,9.0,16.0,23.0,8.0,15.0,6.0,9.0,4.0,4.0,6.0,7.0,1.0,10.0,5.0,8.0,6.0,6.0,16.0,16.0,8.0,13.0,3.0,10.0,6.0,7.0,18.0,7.0,8.0,2.0,6.0,6.0,14.0,7.0,19.0,3.0,9.0,5.0,10.0,11.0,14.0,12.0,6.0,3.0,9.0,6.0,6.0,2.0,9.0,11.0,12.0,7.0,10.0,2.0,10.0,8.0,4.0,7.0,2.0,3.0,4.0,4.0,4.0,17.0,7.0,15.0,14.0,4.0,12.0,5.0,6.0,2.0,0.0,1.0,7.0,6.0,12.0,1.0,8.0,13.0,9.0,1.0,2.0,0.0,1.0,0.0,6.0,4.0,14.0,13.0,3.0,7.0,7.0,6.0,7.0,7.0,1.0,10.0,16.0,11.0,8.0,0.0,7.0,7.0,6.0,2.0,2.0,0.0,11.0,2.0,8.0,12.0,15.0,10.0,11.0,13.0,2.0,7.0,6.0,10.0,9.0,8.0,10.0,7.0,4.0,2.0,7.0,8.0,5.0,5.0,10.0,14.0,2.0,7.0,7.0,4.0,6.0,7.0,8.0,6.0,10.0,9.0,2.0,4.0,0.0,10.0,0.0,9.0,2.0,4.0,12.0,16.0,7.0,8.0,5.0,2.0,13.0,8.0,6.0,10.0,5.0,5.0,14.0,3.0,0.0,3.0,0.0,1.0,0.0,0.0,0.0,1.0,0.0,3.0,1.0,0.0,0.0,1.0,1.0,5.0,1.0,0.0,0.0,2.0,0.0,0.0,5.0,0.0,1.0,1.0,0.0,5.0,0.0,1.0,0.0,3.0,0.0,5.0,4.0,1.0,1.0,0.0,0.0,0.0,0.0,0.0,3.0,0.0,0.0,1.0,0.0,0.0,5.0,0.0,2.0,0.0,2.0,0.0,0.0,0.0,4.0,5.0,2.0,0.0,4.0,0.0,5.0,1.0,1.0,2.0,3.0,0.0,0.0,1.0,0.0,4.0,0.0,2.0,0.0,3.0,0.0,1.0,0.0,2.0,3.0,4.0,16.0,2.0,2.0,8.0,3.0,2.0,3.0,3.0,11.0,0.0,3.0,2.0,5.0,8.0,1.0,6.0,8.0,3.0,17.0,5.0,2.0,0.0,0.0,8.0,4.0,4.0,0.0,2.0,8.0,10.0,7.0,9.0,0.0,8.0,3.0,3.0,2.0,1.0,3.0,6.0,6.0,11.0,4.0,9.0,2.0,7.0,27.0,6.0,0.0,5.0,4.0,12.0,0.0,3.0,15.0,6.0,1.0,14.0,2.0,6.0,6.0,1.0,0.0,19.0,9.0,12.0,1.0,16.0,3.0,2.0,0.0,9.0,10.0,0.0,0.0,12.0,7.0,6.0,5.0,9.0,27.0,4.0,6.0,3.0,7.0,6.0,3.0,2.0,1.0,2.0,3.0,2.0,3.0,9.0,16.0,3.0,3.0,16.0,10.0,3.0,18.0,13.0,10.0,5.0,3.0,5.0,14.0,20.0,18.0,5.0,5.0,3.0,2.0,4.0,2.0,5.0,3.0,0.0,0.0,7.0,4.0,15.0,1.0,6.0,2.0,1.0,7.0,4.0,2.0,10.0,5.0,1.0,5.0,0.0,0.0,7.0,4.0,14.0,0.0,3.0,2.0,4.0,6.0,4.0,2.0,16.0,1.0,4.0,1.0,14.0,1.0,0.0,1.0,5.0,8.0,5.0,2.0,3.0,1.0,28.0,1.0,12.0,16.0,18.0,8.0,0.0,23.0,4.0,0.0,2.0,14.0,6.0,1.0,9.0,3.0,1.0,2.0,4.0,5.0,3.0,4.0,0.0,5.0,7.0,4.0,2.0,1.0,4.0,9.0,1.0,1.0,2.0,5.0,0.0,4.0,10.0,2.0,9.0,0.0,3.0,2.0,4.0,3.0,11.0,12.0,9.0,3.0,2.0,15.0,9.0,1.0,1.0,4.0,8.0,13.0,0.0,3.0,2.0,6.0,3.0,16.0,9.0,8.0,5.0,4.0,0.0,0.0,15.0,0.0,33.0,2.0,5.0,3.0,1.0,5.0,6.0,0.0,2.0,2.0,2.0,12.0,3.0,8.0,5.0,1.0,0.0,0.0,10.0,3.0,2.0,8.0,9.0,4.0,0.0,14.0,11.0,3.0,0.0,1.0,2.0,16.0,10.0,2.0,12.0,2.0,7.0,5.0,7.0,2.0,0.0,6.0,5.0,4.0,10.0,0.0,13.0,8.0,12.0,1.0,3.0,1.0,1.0,2.0,5.0,1.0,13.0,4.0,4.0,1.0,6.0,2.0,0.0,3.0,0.0,0.0,8.0,6.0,4.0,6.0,0.0,4.0,5.0,4.0,0.0,7.0,1.0,2.0,16.0,3.0,8.0,2.0,12.0,2.0,0.0,8.0,0.0,9.0,1.0,1.0,0.0,3.0,0.0,7.0,4.0,2.0,15.0,8.0,4.0,9.0,0.0,0.0,0.0,6.0,0.0,1.0,16.0,5.0,0.0,3.0,11.0,7.0,13.0,3.0,2.0,1.0,6.0,5.0,4.0,1.0,1.0,0.0,0.0,1.0,0.0,8.0,12.0,2.0,5.0,0.0,3.0,13.0,8.0,1.0,0.0,0.0,6.0,3.0,0.0,0.0,3.0,1.0,2.0,0.0,0.0,12.0,0.0,2.0,0.0,0.0,1.0,2.0,0.0,0.0,2.0,0.0,2.0,8.0,5.0,0.0,1.0,2.0,0.0,1.0,1.0,1.0,0.0,0.0,0.0,2.0,1.0,3.0,1.0,0.0,2.0,0.0,0.0,0.0,1.0,4.0,0.0,0.0,2.0,0.0,1.0,0.0,0.0,1.0,0.0,2.0,2.0,1.0,1.0,0.0,1.0,0.0,0.0,1.0,0.0,0.0,0.0,1.0,2.0,0.0,3.0,4.0,2.0,0.0,0.0,2.0,1.0,3.0,0.0,2.0,0.0,1.0,1.0,0.0,0.0,1.0,5.0,0.0,0.0,0.0,2.0,5.0,6.0,9.0,3.0,12.0,6.0,6.0,10.0,5.0,5.0,5.0,5.0,5.0,5.0,5.0,5.0,1.0,5.0,5.0,3.0,4.0,4.0,5.0,1.0,2.0,5.0,5.0,5.0,5.0,5.0,5.0,5.0,5.0,1.0,5.0,5.0,4.0,5.0,5.0,5.0,5.0,3.0,1.0,5.0,5.0,3.0,5.0,5.0,0.0,0.0,0.0,0.0,0.0,2.0,0.0,0.0,0.0,0.0,0.0,2.0,0.0,0.0,0.0,0.0,0.0,0.0,0.0,1.0,0.0,0.0,0.0,0.0,0.0,0.0,0.0,0.0,0.0,0.0,0.0,2.0,0.0,0.0,0.0,4.0,1.0,5.0,1.0,0.0,2.0,0.0,0.0,0.0,0.0,0.0,3.0,1.0,0.0,0.0,0.0,0.0,0.0,0.0,0.0,5.0,0.0,1.0,0.0,0.0,0.0,1.0,0.0,1.0,0.0,0.0,0.0,0.0,0.0,1.0,0.0,0.0,0.0,0.0,0.0,0.0,0.0,0.0,1.0,1.0,0.0,0.0,0.0,0.0,0.0,0.0,0.0,0.0,0.0,0.0,0.0,0.0,0.0,2.0,0.0,0.0,0.0,2.0,0.0,0.0,0.0,1.0,0.0,0.0,0.0,0.0,0.0,0.0,0.0,0.0,0.0,0.0,0.0,2.0,8.0,0.0,0.0,0.0,0.0,0.0,0.0,1.0,2.0,0.0,0.0,0.0,0.0,0.0,0.0,0.0,0.0,0.0,0.0,0.0,0.0,1.0,0.0,5.0,0.0,2.0,0.0,0.0,0.0,0.0,0.0,7.0,0.0,0.0,3.0,0.0,3.0,3.0,2.0,1.0,0.0,1.0,3.0,0.0,4.0,0.0,0.0,0.0,2.0,0.0,3.0,1.0,0.0,0.0,0.0,0.0,0.0,0.0,2.0,0.0,0.0,1.0,0.0,0.0,0.0,0.0,0.0,0.0,0.0,0.0,0.0,5.0,0.0,0.0,0.0,2.0,0.0,0.0,0.0,0.0,1.0,1.0,0.0,0.0,0.0,4.0,0.0,5.0,5.0,0.0,5.0,16.0,10.0,4.0,13.0,6.0,10.0,7.0,11.0,14.0,7.0,9.0,7.0,7.0,10.0,18.0,10.0,4.0,11.0,4.0,4.0,5.0,11.0,6.0,15.0,2.0,3.0,9.0,17.0,9.0,8.0,14.0,12.0,15.0,11.0,12.0,14.0,8.0,0.0,16.0,7.0,9.0,9.0,9.0,6.0,4.0,1.0,5.0,7.0,2.0,24.0,11.0,4.0,3.0,0.0,3.0,6.0,3.0,3.0,2.0,18.0,26.0,2.0,35.0,5.0,9.0,5.0,3.0,4.0,23.0,0.0,11.0,6.0,17.0,27.0,34.0,29.0,30.0,26.0,3.0,12.0,0.0,1.0,2.0,27.0,4.0,5.0,7.0,0.0,21.0,0.0,39.0,23.0,10.0,3.0,2.0,16.0,24.0,36.0,0.0,11.0,1.0,0.0,1.0,0.0,11.0,21.0,4.0,5.0,0.0,1.0,1.0,18.0,32.0,7.0,7.0,29.0,38.0,20.0,5.0,2.0,39.0,3.0,14.0,25.0,27.0,5.0,3.0,9.0,17.0,2.0,1.0,2.0,10.0,9.0,2.0,0.0,23.0,0.0,0.0,0.0,20.0,36.0,0.0,9.0,19.0,2.0,0.0,28.0,14.0,5.0,39.0,8.0,0.0,0.0,9.0,15.0,2.0,16.0,6.0,1.0,5.0,3.0,2.0,4.0,2.0,3.0,3.0,0.0,1.0,2.0,4.0,3.0,1.0,0.0,3.0,4.0,1.0,0.0,3.0,0.0,2.0,3.0,1.0,3.0,2.0,1.0,1.0,7.0,1.0,3.0,1.0,0.0,0.0,2.0,1.0,1.0,7.0,1.0,2.0,2.0,4.0,1.0,5.0,2.0,4.0,3.0,0.0,1.0,3.0,0.0,5.0,0.0,0.0,0.0,0.0,0.0,0.0,1.0,1.0,3.0,0.0,0.0,0.0,0.0,0.0,0.0,1.0,1.0,5.0,2.0,0.0,3.0,5.0,2.0,4.0,1.0,2.0,3.0,1.0,4.0,1.0,2.0,4.0,1.0,5.0,1.0,,1.0,5.0,4.0,2.0,0.0,2.0,1.0,3.0,4.0,4.0,0.0,1.0,2.0,2.0,3.0,2.0,1.0,2.0,0.0,5.0,,3.0,0.0,1.0,2.0,3.0,4.0,0.0,3.0,1.0,5.0,2.0,0.0,1.0,5.0,3.0,0.0,2.0,5.0,3.0,1.0,0.0,3.0,2.0,1.0,0.0,3.0,2.0,1.0,2.0,5.0,0.0,3.0,2.0,0.0,2.0,1.0,2.0,1.0,2.0,1.0,0.0,1.0,1.0,1.0,4.0,5.0,3.0,,2.0,2.0,1.0,3.0,3.5,1.0,5.0,2.5,5.0,1.0,5.0,3.5,5.0,5.0,0.0,0.0,1.0,0.0,0.0,0.0,,0.0,5.0,1.0,0.0,3.0,0.0,0.0,2.0,0.0,1.0,1.0,1.0,2.0,2.0,0.0,2.0,3.0,4.0,5.0,2.0,5.0,1.0,1.0,3.0,2.0,1.0,5.0,1.0,2.0,2.0,0.0,2.0,1.0,1.0,0.0,0.0,0.0,3.0,3.0,0.0,0.0,2.0,0.0,1.0,2.0,5.0,1.0,1.0,2.0,1.0,0.0,2.0,0.0,0.0,0.0,4.0,3.0,2.0,0.0,0.0,4.0,2.0,1.0,1.0,2.0,1.0,,5.0,0.0,0.0,3.0,5.0,0.0,0.0,1.0,0.0,2.0,3.0,1.0,0.0,1.0,2.0,0.0,,0.0,0.0,0.0,1.0,5.0,5.0,1.0,1.0,0.0,1.0,5.0,5.0,2.0,0.0,1.0,5.0,1.0,0.0,2.0,1.0,0.0,0.0,2.0,0.0,0.0,1.0,0.0,0.0,0.0,0.0,0.0,5.0,0.0,0.0,1.0,1.0,2.0,0.0,3.0,5.0,4.0,2.0,0.0,3.0,0.0,2.0,1.0,1.0,1.0,1.0,2.0,2.0,4.0,1.0,2.0,0.0,1.0,0.0,3.0,5.0,0.0,2.0,0.0,2.0,0.0,1.0,4.0,3.0,0.0,3.0,0.0,1.0,2.0,0.0,1.0,2.0,1.0,0.0,5.0,1.0,5.0,0.0,0.0,5.0,2.0,0.0,0.0,0.0,5.0,1.0,0.0,1.0,0.0,4.0,3.0,2.0,5.0,1.0,1.0,2.0,1.0,5.0,5.0,4.0,0.0,5.0,1.0,0.0,1.0,5.0,1.0,0.0,1.0,5.0,0.0,3.0,4.0,1.0,1.0,5.0,5.0,2.0,2.0,5.0,4.0,1.0,1.0,3.0,1.0,0.0,0.0,1.0,5.0,4.0,3.0,0.0,5.0,5.0,2.0,1.0,0.0,0.0,0.0,0.0,0.0,0.0,2.0,0.0,2.0,3.0,2.0,2.0,1.0,5.0,0.0,0.0,0.0,0.0,3.0,1.0,0.0,1.0,3.0,2.0,0.0,5.0,5.0,1.0,2.0,1.0,0.0,2.0,5.0,0.0,2.0,0.0,0.0,0.0,1.0,1.0,1.0,0.0,0.0,0.0,0.0,5.0,4.0,2.0,5.0,1.0,0.0,1.0,0.0,1.0,2.0,2.0,2.0,3.0,2.0,1.0,5.0,4.0,1.0,2.0,5.0,5.0,0.0,2.0,1.0,0.0,5.0,0.0,0.0,4.0,5.0,4.0,1.0,2.0,0.0,0.0,0.0,0.0,0.0,2.0,2.0,0.0,0.0,1.0,4.0,2.0,0.0,0.0,0.0,1.0,4.0,1.0,0.0,2.0,2.0,0.0,1.0,2.0,0.0,0.0,3.0,4.0,5.0,0.0,3.0,1.0,0.0,0.0,0.0,4.0,0.0,5.0,0.0,0.0,4.0,0.0,1.0,2.0,1.0,1.0,1.0,3.0,3.0,0.0,0.0,2.0,3.0,0.0,1.0,2.0,1.0,2.0,0.0,3.0,1.0,0.0,3.0,3.0,0.0,0.0,0.0,0.0,0.0,1.0,0.0,0.0,5.0,1.0,0.0,0.0,0.0,1.0,0.0,0.0,0.0,1.0,1.0,5.0,9.0,13.0,15.0,2.0,0.0,25.0,11.0,0.0,10.0,8.0,3.0,3.0,13.0,17.0,8.0,16.0,7.0,5.0,10.0,37.0,20.0,12.0,6.0,0.0,16.0,19.0,7.0,19.0,8.0,15.0,15.0,24.0,7.0,28.0,12.0,11.0,5.0,0.0,7.0,1.0,5.0,12.0,4.0,11.0,7.0,13.0,15.0,17.0,7.0,2.0,34.0,13.0,17.0,15.0,18.0,30.0,15.0,3.0,7.0,18.0,1.0,12.0,22.0,15.0,2.0,18.0,18.0,12.0,5.0,9.0,12.0,11.0,4.0,18.0,9.0,7.0,7.0,4.0,8.0,6.0,6.0,11.0,18.0,8.0,8.0,22.0,5.0,10.0,12.0,16.0,6.0,7.0,7.0,6.0,1.0,5.0,8.0,4.0,11.0,10.0,14.0,15.0,9.0,16.0,9.0,10.0,14.0,10.0,7.0,20.0,8.0,14.0,14.0,13.0,15.0,6.0,17.0,0.0,14.0,12.0,18.0,15.0,0.0,3.0,4.0,0.0,4.0,21.0,17.0,19.0,16.0,6.0,8.0,18.0,8.0,26.0,21.0,14.0,13.0,13.0,12.0,13.0,17.0,17.0,12.0,6.0,19.0,9.0,5.0,1.0,17.0,6.0,8.0,12.0,16.0,12.0,16.0,17.0,10.0,19.0,7.0,7.0,13.0,12.0,8.0,12.0,4.0,5.0,15.0,15.0,18.0,10.0,16.0,14.0,6.0,15.0,0.0,9.0,9.0,14.0,0.0,15.0,0.0,13.0,12.0,20.0,2.0,13.0,13.0,17.0,10.0,7.0,3.0,10.0,20.0,6.0,7.0,18.0,4.0,14.0,9.0,7.0,22.0,8.0,0.0,9.0,8.0,18.0,12.0,16.0,8.0,11.0,8.0,13.0,13.0,17.0,5.0,11.0,8.0,13.0,15.0,12.0,13.0,8.0,8.0,14.0,6.0,7.0,4.0,14.0,14.0,4.0,22.0,2.0,17.0,14.0,9.0,7.0,13.0,9.0,3.0,13.0,6.0,19.0,9.0,9.0,13.0,16.0,0.0,14.0,18.0,6.0,12.0,11.0,9.0,12.0,4.0,10.0,13.0,2.0,17.0,10.0,11.0,9.0,23.0,14.0,11.0,8.0,13.0,15.0,5.0,11.0,8.0,7.0,18.0,2.0,9.0,9.0,10.0,5.0,1.0,14.0,13.0,12.0,8.0,11.0,14.0,2.0,10.0,20.0,10.0,4.0,0.0,0.0,17.0,15.0,11.0,15.0,7.0,7.0,2.0,16.0,9.0,6.0,11.0,13.0,12.0,16.0,10.0,14.0,4.0,10.0,8.0,12.0,4.0,19.0,10.0,12.0,4.0,4.0,7.0,9.0,13.0,19.0,7.0,1.0,7.0,13.0,14.0,10.0,2.0,13.0,4.0,5.0,4.0,3.0,19.0,17.0,4.0,12.0,14.0,10.0,10.0,13.0,11.0,8.0,7.0,5.0,8.0,6.0,13.0,8.0,5.0,1.0,24.0,7.0,2.0,4.0,5.0,4.0,29.0,24.0,5.0,4.0,3.0,7.0,4.0,14.0,13.0,7.0,12.0,2.0,3.0,5.0,8.0,12.0,5.0,14.0,5.0,5.0,5.0,2.0,5.0,5.0,2.0,5.0,4.0,5.0,2.0,2.0,5.0,5.0,5.0,1.0,5.0,5.0,0.0,5.0,1.0,4.0,0.0,2.0,5.0,5.0,0.0,5.0,3.0,1.0,5.0,1.0,5.0,5.0,2.0,5.0,3.0,3.0,5.0,5.0,3.0,5.0,5.0,5.0,5.0,5.0,5.0,4.0,5.0,4.0,5.0,0.0,5.0,1.0,3.0,0.0,5.0,2.0,3.0,5.0,5.0,5.0,5.0,5.0,0.0,4.0,5.0,1.0,1.0,4.0,5.0,5.0,3.0,2.0,5.0,,5.0,3.0,3.0,0.0,5.0,2.0,0.0,5.0,5.0,5.0,5.0,1.0,1.0,2.0,5.0,3.0,5.0,5.0,2.0,4.0,5.0,3.0,5.0,1.0,5.0,5.0,5.0,3.0,3.0,5.0,5.0,5.0,5.0,5.0,4.0,2.0,5.0,5.0,5.0,5.0,3.0,0.0,0.0,1.0,3.0,5.0,1.0,5.0,5.0,5.0,5.0,1.0,1.0,5.0,5.0,5.0,5.0,5.0,1.0,5.0,5.0,4.0,5.0,5.0,5.0,5.0,5.0,5.0,5.0,5.0,5.0,1.0,5.0,0.0,5.0,5.0,5.0,4.0,3.0,2.0,18.0,13.0,14.0,1.0,3.0,2.0
15,4.0,5.0,5.0,5.0,3.0,7.0,3.0,5.0,5.0,4.0,4.0,2.0,2.0,5.0,5.0,19.0,6.0,5.0,5.0,5.0,7.0,2.0,7.0,0.0,2.0,7.0,5.0,4.0,6.0,0.0,4.0,5.0,3.0,11.0,5.0,5.0,5.0,2.0,6.0,6.0,4.0,5.0,4.0,4.0,3.0,4.0,10.0,6.0,2.0,0.0,0.0,0.0,0.0,0.0,0.0,0.0,0.0,0.0,0.0,0.0,0.0,0.0,0.0,0.0,0.0,0.0,0.0,0.0,0.0,0.0,0.0,0.0,0.0,0.0,0.0,0.0,0.0,0.0,0.0,,5.0,4.0,5.0,5.0,5.0,5.0,5.0,0.0,0.0,0.0,0.0,0.0,10.0,0.0,0.0,0.0,0.0,0.0,0.0,0.0,0.0,0.0,0.0,0.0,0.0,0.0,0.0,0.0,0.0,0.0,0.0,0.0,0.0,1.0,6.0,5.0,4.0,5.0,2.0,5.0,3.0,14.0,6.0,2.0,4.0,16.0,1.0,2.0,7.0,5.0,6.0,4.0,11.0,7.0,10.0,1.0,11.0,4.0,7.0,3.0,2.0,3.0,3.0,4.0,4.0,8.0,11.0,8.0,10.0,5.0,5.0,10.0,2.0,4.0,2.0,7.0,3.0,3.0,5.0,1.0,4.0,3.0,13.0,1.0,5.0,5.0,5.0,5.0,3.0,3.0,3.0,10.0,11.0,0.0,8.0,7.0,4.0,8.0,5.0,2.0,5.0,3.0,2.0,10.0,5.0,6.0,4.0,4.0,2.0,3.0,5.0,4.0,7.0,7.0,3.0,4.0,1.0,7.0,12.0,5.0,5.0,1.0,7.0,3.0,5.0,2.0,4.0,2.0,3.0,4.0,3.0,4.0,2.0,3.0,0.0,3.0,6.0,8.0,0.0,0.0,4.0,10.0,4.0,6.0,0.0,6.0,8.0,1.0,6.0,2.0,7.0,9.0,4.0,5.0,1.0,3.0,3.0,0.0,3.0,15.0,2.0,8.0,0.0,3.0,2.0,0.0,2.0,13.0,2.0,5.0,2.0,8.0,8.0,18.0,4.0,0.0,20.0,4.0,8.0,0.0,0.0,5.0,8.0,4.0,7.0,2.0,5.0,4.0,0.0,4.0,3.0,8.0,7.0,10.0,8.0,7.0,6.0,4.0,10.0,7.0,4.0,6.0,7.0,11.0,4.0,4.0,6.0,7.0,8.0,9.0,7.0,8.0,11.0,2.0,1.0,2.0,0.0,0.0,3.0,0.0,0.0,0.0,0.0,1.0,0.0,0.0,0.0,4.0,0.0,8.0,15.0,14.0,7.0,4.0,6.0,5.0,1.0,11.0,17.0,5.0,11.0,10.0,3.0,9.0,8.0,6.0,10.0,5.0,11.0,6.0,9.0,11.0,9.0,4.0,10.0,11.0,9.0,2.0,6.0,17.0,1.0,12.0,8.0,8.0,20.0,8.0,6.0,5.0,5.0,10.0,9.0,14.0,10.0,12.0,4.0,23.0,3.0,13.0,5.0,12.0,5.0,7.0,2.0,11.0,2.0,0.0,6.0,6.0,11.0,11.0,4.0,12.0,4.0,8.0,2.0,1.0,2.0,2.0,1.0,3.0,0.0,1.0,2.0,1.0,2.0,2.0,8.0,0.0,4.0,1.0,0.0,9.0,0.0,0.0,1.0,3.0,1.0,0.0,0.0,2.0,0.0,0.0,1.0,1.0,0.0,3.0,0.0,0.0,0.0,0.0,1.0,0.0,0.0,1.0,1.0,2.0,4.0,1.0,5.0,0.0,2.0,1.0,8.0,3.0,3.0,0.0,0.0,1.0,6.0,6.0,5.0,2.0,7.0,8.0,8.0,1.0,6.0,8.0,6.0,2.0,2.0,0.0,6.0,9.0,14.0,6.0,6.0,3.0,2.0,5.0,15.0,4.0,7.0,5.0,1.0,10.0,0.0,2.0,4.0,2.0,1.0,1.0,1.0,0.0,3.0,2.0,5.0,0.0,3.0,1.0,0.0,1.0,2.0,1.0,0.0,0.0,3.0,5.0,1.0,5.0,2.0,3.0,3.0,0.0,9.0,7.0,5.0,2.0,2.0,4.0,5.0,1.0,2.0,5.0,0.0,2.0,5.0,5.0,6.0,9.0,12.0,6.0,0.0,2.0,14.0,10.0,8.0,3.0,3.0,1.0,5.0,5.0,1.0,11.0,5.0,3.0,4.0,2.0,2.0,7.0,14.0,2.0,10.0,5.0,5.0,5.0,5.0,5.0,5.0,2.0,0.0,2.0,6.0,6.0,1.0,4.0,0.0,7.0,1.0,6.0,2.0,6.0,1.0,2.0,2.0,2.0,,,,,,,,,,,,,,,,,,,,,,,,,,,,,,,,,,19.0,12.0,8.0,9.0,11.0,,,8.0,14.0,15.0,22.0,8.0,12.0,,,,19.0,,,,,,,,,12.0,,,,,,,,5.0,7.0,,,12.0,9.0,19.0,33.0,,16.0,12.0,,5.0,12.0,7.0,,12.0,,,16.0,23.0,24.0,,,7.0,,12.0,8.0,17.0,31.0,19.0,6.0,,0.0,0.0,0.0,18.0,0.0,0.0,0.0,0.0,0.0,1.0,0.0,2.0,6.0,0.0,3.0,0.0,2.0,3.0,0.0,0.0,2.0,4.0,5.0,1.0,1.0,5.0,2.0,0.0,1.0,0.0,5.0,0.0,0.0,0.0,1.0,5.0,5.0,3.0,1.0,5.0,3.0,5.0,4.0,1.0,5.0,5.0,0.0,5.0,1.0,5.0,0.0,0.0,5.0,3.0,3.0,0.0,0.0,2.0,0.0,1.0,2.0,5.0,0.0,4.0,5.0,5.0,5.0,5.0,2.0,5.0,4.0,5.0,0.0,0.0,0.0,0.0,0.0,0.0,0.0,0.0,0.0,0.0,5.0,0.0,0.0,0.0,0.0,0.0,0.0,0.0,0.0,0.0,0.0,0.0,4.0,0.0,0.0,0.0,4.0,0.0,3.0,5.0,3.0,0.0,0.0,4.0,4.0,4.0,1.0,3.0,6.0,1.0,4.0,17.0,6.0,7.0,9.0,16.0,9.0,8.0,10.0,11.0,9.0,10.0,10.0,10.0,6.0,8.0,8.0,8.0,2.0,7.0,0.0,10.0,11.0,6.0,12.0,6.0,4.0,7.0,5.0,3.0,4.0,6.0,7.0,6.0,8.0,0.0,5.0,5.0,6.0,5.0,6.0,5.0,6.0,4.0,2.0,5.0,9.0,6.0,7.0,6.0,6.0,6.0,9.0,7.0,6.0,7.0,14.0,4.0,8.0,8.0,4.0,0.0,2.0,4.0,6.0,7.0,4.0,4.0,5.0,5.0,5.0,4.0,5.0,7.0,4.0,4.0,6.0,7.0,17.0,7.0,5.0,13.0,5.0,5.0,10.0,5.0,6.0,6.0,6.0,7.0,5.0,4.0,2.0,10.0,5.0,4.0,5.0,8.0,4.0,,,,,,,,,,,,,,,,,,,,,,,,,,,,,,,,,,,,,,,,,,,,,,,,,,,,,,,,,,,,,,,,,,,,,,,,,,,,,,,,,,,,,,,,,,,,,,,,,,,,,,,,,,,,,,,,,,,,,,,,,,,,,,,,,,,,,,,,,,,,,,,,,,,,,,,,,,,,,,,,,,,,,,,,,,,,,,,,,,,,,,,,,,,,,,,,2.0,5.0,5.0,3.0,4.0,0.0,0.0,8.0,3.0,1.0,4.0,4.0,4.0,4.0,5.0,2.0,0.0,4.0,3.0,0.0,2.0,9.0,0.0,0.0,1.0,2.0,2.0,0.0,1.0,0.0,0.0,1.0,3.0,1.0,3.0,1.0,0.0,0.0,1.0,1.0,3.0,0.0,0.0,1.0,3.0,3.0,0.0,3.0,2.0,1.0,1.0,1.0,2.0,0.0,0.0,1.0,0.0,0.0,1.0,2.0,0.0,1.0,2.0,4.0,4.0,4.0,1.0,0.0,9.0,1.0,11.0,5.0,0.0,4.0,1.0,0.0,2.0,1.0,1.0,1.0,3.0,7.0,1.0,0.0,0.0,0.0,4.0,9.0,8.0,9.0,5.0,12.0,2.0,4.0,3.0,2.0,1.0,6.0,3.0,0.0,2.0,9.0,2.0,3.0,0.0,7.0,0.0,15.0,3.0,8.0,8.0,2.0,0.0,2.0,5.0,2.0,3.0,1.0,4.0,0.0,7.0,4.0,0.0,5.0,6.0,3.0,1.0,6.0,2.0,2.0,4.0,8.0,0.0,1.0,6.0,11.0,1.0,12.0,1.0,7.0,4.0,1.0,7.0,11.0,0.0,1.0,3.0,1.0,0.0,5.0,2.0,5.0,9.0,2.0,6.0,2.0,3.0,1.0,1.0,1.0,4.0,4.0,3.0,7.0,15.0,6.0,0.0,1.0,8.0,4.0,3.0,6.0,3.0,8.0,3.0,9.0,6.0,9.0,4.0,10.0,4.0,0.0,3.0,14.0,5.0,1.0,3.0,5.0,12.0,2.0,7.0,1.0,2.0,5.0,6.0,6.0,8.0,4.0,3.0,3.0,9.0,7.0,0.0,12.0,11.0,11.0,0.0,8.0,7.0,14.0,8.0,6.0,9.0,6.0,8.0,12.0,2.0,0.0,0.0,6.0,10.0,2.0,6.0,0.0,6.0,6.0,6.0,4.0,3.0,5.0,4.0,1.0,0.0,1.0,0.0,0.0,0.0,0.0,0.0,0.0,0.0,0.0,0.0,0.0,0.0,0.0,0.0,0.0,0.0,0.0,0.0,0.0,0.0,0.0,0.0,0.0,0.0,0.0,0.0,0.0,0.0,5.0,0.0,0.0,0.0,3.0,0.0,0.0,0.0,0.0,0.0,0.0,0.0,0.0,0.0,0.0,2.0,0.0,0.0,0.0,0.0,0.0,0.0,0.0,0.0,0.0,0.0,0.0,0.0,0.0,0.0,0.0,0.0,0.0,5.0,2.0,0.0,0.0,0.0,0.0,0.0,0.0,5.0,3.0,0.0,0.0,0.0,0.0,0.0,2.0,0.0,6.0,0.0,3.0,0.0,0.0,0.0,0.0,0.0,0.0,0.0,0.0,0.0,0.0,0.0,0.0,0.0,0.0,0.0,0.0,0.0,0.0,0.0,0.0,0.0,0.0,0.0,0.0,0.0,0.0,0.0,0.0,0.0,0.0,0.0,0.0,0.0,0.0,0.0,6.0,0.0,0.0,0.0,0.0,0.0,0.0,0.0,0.0,0.0,0.0,0.0,4.0,0.0,2.0,0.0,0.0,4.0,0.0,0.0,0.0,0.0,0.0,0.0,0.0,0.0,0.0,0.0,0.0,0.0,,0.0,0.0,0.0,0.0,1.0,1.0,0.0,1.0,0.0,0.0,0.0,3.0,0.0,0.0,2.0,0.0,0.0,0.0,1.0,0.0,3.0,0.0,0.0,0.0,0.3333333333333333,0.0,0.0,0.0,0.0,0.0,0.0,0.0,1.0,0.0,0.0,0.0,1.0,0.0,2.0,0.0,0.0,0.0,0.0,0.0,0.0,0.0,0.0,0.0,0.0,0.0,0.0,0.0,0.0,0.0,0.0,,,0.0,0.0,0.0,0.0,0.0,0.0,1.0,0.0,0.0,0.0,0.0,0.0,0.0,0.0,0.0,0.0,0.0,0.0,0.0,0.0,0.0,0.0,0.0,0.0,0.0,0.0,0.0,0.0,0.0,0.0,0.0,0.0,0.0,0.0,0.0,0.0,0.0,0.0,0.0,0.0,0.0,0.0,0.0,0.0,3.0,0.0,0.0,0.0,3.0,0.0,2.0,2.0,0.0,0.0,0.0,0.0,0.0,0.0,7.0,0.0,0.0,0.0,2.0,0.0,1.0,0.0,0.0,0.0,0.0,0.0,0.0,0.0,0.0,4.0,0.0,0.0,1.0,19.0,21.0,20.0,8.0,31.0,17.0,14.0,14.0,1.0,2.0,12.0,20.0,0.0,20.0,1.0,2.0,1.0,2.0,4.0,3.0,10.0,13.0,15.0,8.0,8.0,22.0,15.0,8.0,20.0,8.0,1.0,3.0,9.0,0.0,26.0,5.0,20.0,21.0,21.0,15.0,29.0,5.0,10.0,7.0,15.0,13.0,17.0,23.0,11.0,4.0,18.0,17.0,12.0,29.0,22.0,18.0,8.0,6.0,18.0,11.0,3.0,3.0,11.0,0.0,15.0,3.0,6.0,3.0,6.0,4.0,3.0,24.0,24.0,8.0,12.0,23.0,2.0,21.0,7.0,16.0,19.0,7.0,41.0,53.0,24.0,14.0,12.0,17.0,18.0,12.0,11.0,0.0,47.0,15.0,13.0,20.0,15.0,9.0,8.0,16.0,3.0,0.0,26.0,8.0,7.0,1.0,1.0,6.0,19.0,0.0,1.0,1.0,4.0,2.0,0.0,0.0,0.0,0.0,0.0,2.0,1.0,0.0,9.0,0.0,4.0,9.0,3.0,8.0,4.0,3.0,2.0,0.0,12.0,1.0,1.0,0.0,0.0,4.0,0.0,0.0,0.0,1.0,2.0,3.0,13.0,14.0,1.0,4.0,12.0,8.0,1.0,13.0,0.0,21.0,20.0,22.0,3.0,22.0,5.0,7.0,4.0,8.0,10.0,3.0,16.0,6.0,0.0,10.0,11.0,6.0,4.0,1.0,1.0,8.0,4.0,16.0,1.0,14.0,10.0,1.0,6.0,10.0,15.0,8.0,3.0,10.0,13.0,1.0,0.0,1.0,10.0,12.0,13.0,1.0,20.0,3.0,10.0,2.0,2.0,1.0,2.0,2.0,,1.0,0.0,0.0,0.0,7.0,3.0,10.0,1.0,1.0,2.0,1.0,0.0,1.0,0.0,2.0,1.0,8.0,6.0,11.0,3.0,0.0,0.0,0.0,0.0,0.0,1.0,1.0,1.0,1.0,14.0,7.0,6.0,4.0,9.0,3.0,6.0,14.0,21.0,0.0,6.0,25.0,0.0,0.0,0.0,1.0,0.0,7.0,2.0,9.0,14.0,5.0,14.0,2.0,10.0,1.0,19.0,11.0,11.0,5.0,21.0,23.0,11.0,13.0,13.0,13.0,19.0,23.0,31.0,33.0,20.0,12.0,19.0,10.0,1.0,27.0,17.0,8.0,5.0,3.0,0.0,21.0,4.0,13.0,2.0,24.0,1.0,23.0,1.0,2.0,0.0,3.0,1.0,20.0,4.0,16.0,21.0,14.0,0.0,0.0,1.0,23.0,11.0,20.0,13.0,24.0,0.0,4.0,13.0,14.0,17.0,11.0,40.0,23.0,14.0,11.0,9.0,2.0,30.0,25.0,23.0,1.0,16.0,28.0,14.0,26.0,14.0,3.0,23.0,12.0,7.0,15.0,21.0,22.0,4.0,23.0,21.0,10.0,8.0,30.0,0.0,1.0,10.0,15.0,13.0,9.0,13.0,8.0,25.0,2.0,14.0,28.0,22.0,10.0,14.0,6.0,13.0,3.0,6.0,7.0,12.0,18.0,11.0,13.0,24.0,8.0,18.0,19.0,0.0,1.0,23.0,21.0,19.0,20.0,7.0,0.0,3.0,13.0,20.0,8.0,14.0,0.0,3.0,0.0,0.0,3.0,2.0,3.0,3.0,3.0,2.0,10.0,2.0,6.0,5.0,0.0,0.0,0.0,6.0,1.0,0.0,2.0,3.0,0.0,0.0,1.0,0.0,,0.0,0.0,0.0,0.0,0.0,0.0,0.0,,,0.0,0.0,0.0,0.0,0.0,11.0,4.0,12.0,8.0,9.0,5.0,5.0,5.0,3.0,4.0,8.0,10.0,9.0,9.0,13.0,3.0,5.0,5.0,5.0,4.0,6.0,5.0,5.0,10.0,4.0,8.0,3.0,9.0,14.0,5.0,4.0,5.0,2.0,6.0,12.0,0.0,10.0,11.0,8.0,15.0,2.0,6.0,6.0,28.0,12.0,1.0,2.0,13.0,9.0,7.0,10.0,9.0,4.0,5.0,2.0,3.0,9.0,8.0,7.0,0.0,4.0,12.0,9.0,10.0,7.0,24.0,5.0,7.0,15.0,4.0,4.0,7.0,3.0,3.0,8.0,4.0,9.0,24.0,14.0,1.0,6.0,8.0,4.0,4.0,1.0,14.0,11.0,1.0,1.0,6.0,10.0,12.0,6.0,1.0,9.0,5.0,9.0,9.0,2.0,6.0,11.0,9.0,3.0,30.0,2.0,4.0,8.0,1.0,9.0,8.0,6.0,4.0,0.0,7.0,9.0,5.0,11.0,10.0,7.0,5.0,0.0,8.0,0.0,2.0,4.0,10.0,18.0,9.0,12.0,10.0,0.0,6.0,8.0,7.0,11.0,9.0,11.0,4.0,0.0,1.0,3.0,8.0,6.0,10.0,6.0,10.0,13.0,0.0,10.0,9.0,13.0,12.0,4.0,4.0,14.0,0.0,5.0,0.0,3.0,2.0,2.0,0.0,2.0,2.0,3.0,0.0,0.0,4.0,2.0,4.0,4.0,4.0,1.0,1.0,3.0,7.0,3.0,5.0,6.0,5.0,9.0,5.0,0.0,8.0,11.0,1.0,1.0,,10.0,0.0,11.0,15.0,19.0,15.0,0.0,1.0,19.0,13.0,12.0,2.0,14.0,5.0,,3.0,5.0,1.0,10.0,1.0,2.0,22.0,8.0,0.0,4.0,16.0,8.0,26.0,1.0,5.0,0.0,7.0,8.0,2.0,18.0,2.0,1.0,10.0,6.0,6.0,8.0,6.0,7.0,4.0,2.0,0.0,1.0,2.0,11.0,0.0,1.0,0.0,1.0,0.0,,5.0,22.0,0.0,17.0,13.0,1.0,15.0,0.0,3.0,1.0,10.0,6.0,0.0,3.0,1.0,4.0,0.0,0.0,1.0,12.0,2.0,8.0,4.0,1.0,0.0,0.0,1.0,0.0,3.0,0.0,9.0,0.0,22.0,11.0,,1.0,1.0,2.0,1.0,4.0,8.0,0.0,6.0,16.0,11.0,0.0,11.0,15.0,7.0,17.0,3.0,9.0,11.0,16.0,4.0,3.0,4.0,6.0,5.0,7.0,0.0,6.0,3.0,0.0,7.0,1.0,8.0,0.0,5.0,19.0,,15.0,1.0,6.0,8.0,10.0,6.0,2.0,10.0,1.0,0.0,1.0,23.0,8.0,1.0,7.0,14.0,15.0,7.0,3.0,4.0,15.0,14.0,17.0,6.0,17.0,3.0,11.0,12.0,1.0,8.0,0.0,10.0,8.0,33.0,0.0,0.0,0.0,20.0,9.0,3.0,9.0,12.0,10.0,11.0,2.0,6.0,11.0,8.0,20.0,5.0,15.0,16.0,15.0,12.0,14.0,3.0,20.0,6.0,9.0,9.0,9.0,1.0,14.0,10.0,2.0,7.0,1.0,1.0,8.0,1.0,11.0,0.0,5.0,17.0,9.0,4.0,13.0,6.0,3.0,0.0,,1.0,17.0,7.0,14.0,10.0,10.0,5.0,0.0,5.0,0.0,0.0,0.0,0.0,7.0,5.0,11.0,12.0,21.0,4.0,2.0,13.0,8.0,,3.0,14.0,3.0,16.0,13.0,9.0,21.0,11.0,4.0,10.0,7.0,9.0,15.0,17.0,10.0,7.0,8.0,12.0,13.0,7.0,14.0,16.0,9.0,6.0,1.0,13.0,6.0,5.0,1.0,0.0,0.0,6.0,17.0,0.0,5.0,2.0,0.0,0.0,,14.0,14.0,9.0,9.0,9.0,2.0,0.0,,11.0,8.0,1.0,14.0,0.0,10.0,1.0,2.0,6.0,20.0,14.0,3.0,9.0,4.0,5.0,1.0,4.0,29.0,6.0,2.0,17.0,3.0,14.0,15.0,16.0,1.0,5.0,6.0,8.0,4.0,7.0,3.0,5.0,1.0,1.0,10.0,0.0,30.0,13.0,0.0,0.0,1.0,18.0,12.0,6.0,7.0,3.0,17.0,15.0,2.0,6.0,,11.0,20.0,16.0,3.0,0.0,11.0,14.0,9.0,19.0,13.0,7.0,22.0,6.0,15.0,9.0,13.0,10.0,12.0,2.0,2.0,,0.0,11.0,10.0,3.0,5.0,12.0,5.0,0.0,3.0,0.0,0.0,3.0,0.0,2.0,1.0,6.0,0.0,4.0,0.0,0.0,10.0,3.0,19.0,0.0,7.0,1.0,0.0,4.0,16.0,8.0,27.0,8.0,21.0,16.0,5.0,5.0,14.0,0.0,0.0,21.0,2.0,3.0,1.0,0.0,3.0,2.0,3.0,12.0,15.0,4.0,6.0,13.0,0.0,6.0,8.0,2.0,9.0,17.0,0.0,6.0,6.0,0.0,19.0,15.0,4.0,8.0,11.0,14.0,8.0,2.0,11.0,0.0,17.0,12.0,10.0,10.0,11.0,13.0,7.0,1.0,1.0,13.0,11.0,4.0,17.0,9.0,8.0,0.0,24.0,4.0,14.0,14.0,16.0,0.0,6.0,4.0,16.0,2.0,21.0,4.0,0.0,0.0,3.0,1.0,1.0,0.0,0.0,15.0,0.0,7.0,2.0,1.0,33.0,13.0,4.0,6.0,1.0,1.0,2.0,1.0,2.0,1.0,8.0,1.0,7.0,1.0,2.0,2.0,2.0,8.0,1.0,1.0,1.0,1.0,1.0,1.0,1.0,7.0,0.0,0.0,1.0,3.0,1.0,5.0,3.0,0.0,11.0,5.0,11.0,8.0,2.0,0.0,1.0,0.0,0.0,1.0,1.0,2.0,1.0,7.0,1.0,1.0,0.0,11.0,1.0,2.0,3.0,2.0,2.0,5.0,0.0,2.0,4.0,0.0,0.0,0.0,4.0,3.0,4.0,3.0,4.0,5.0,0.0,5.0,5.0,1.0,3.0,13.0,2.0,9.0,15.0,5.0,6.0,23.0,0.0,3.0,7.0,1.0,24.0,14.0,17.0,9.0,11.0,4.0,9.0,10.0,27.0,10.0,6.0,11.0,9.0,10.0,17.0,7.0,17.0,8.0,8.0,11.0,15.0,19.0,14.0,8.0,15.0,8.0,10.0,13.0,7.0,3.0,8.0,11.0,0.0,16.0,12.0,12.0,2.0,7.0,26.0,13.0,3.0,21.0,10.0,18.0,3.0,4.0,7.0,13.0,15.0,16.0,16.0,8.0,9.0,8.0,9.0,6.0,11.0,4.0,10.0,21.0,18.0,21.0,11.0,20.0,12.0,19.0,8.0,20.0,17.0,5.0,13.0,17.0,9.0,0.0,24.0,4.0,13.0,13.0,9.0,5.0,21.0,13.0,13.0,13.0,3.0,12.0,18.0,18.0,8.0,19.0,5.0,4.0,15.0,9.0,10.0,8.0,8.0,16.0,24.0,19.0,13.0,8.0,11.0,6.0,11.0,14.0,7.0,9.0,9.0,13.0,21.0,9.0,4.0,11.0,20.0,4.0,10.0,11.0,5.0,14.0,2.0,4.0,12.0,17.0,3.0,4.0,20.0,26.0,29.0,11.0,12.0,5.0,8.0,7.0,5.0,10.0,16.0,7.0,8.0,6.0,22.0,17.0,19.0,6.0,1.0,5.0,9.0,13.0,14.0,11.0,9.0,21.0,10.0,12.0,16.0,6.0,3.0,23.0,9.0,11.0,17.0,17.0,6.0,3.0,21.0,16.0,14.0,13.0,3.0,15.0,10.0,14.0,17.0,6.0,17.0,13.0,6.0,5.0,11.0,0.0,35.0,14.0,11.0,18.0,16.0,8.0,12.0,11.0,10.0,14.0,13.0,8.0,9.0,16.0,12.0,1.0,16.0,30.0,13.0,15.0,9.0,7.0,11.0,14.0,17.0,6.0,6.0,7.0,13.0,1.0,9.0,14.0,10.0,1.0,8.0,11.0,14.0,16.0,5.0,16.0,9.0,15.0,5.0,7.0,8.0,0.0,6.0,10.0,21.0,19.0,12.0,13.0,3.0,4.0,11.0,11.0,12.0,10.0,9.0,12.0,11.0,17.0,13.0,11.0,7.0,12.0,15.0,10.0,14.0,12.0,12.0,9.0,8.0,1.0,5.0,9.0,12.0,4.0,11.0,5.0,16.0,16.0,11.0,15.0,2.0,12.0,8.0,10.0,8.0,11.0,9.0,11.0,9.0,10.0,7.0,12.0,8.0,1.0,5.0,5.0,14.0,3.0,11.0,9.0,14.0,14.0,15.0,14.0,5.0,14.0,10.0,1.0,1.0,8.0,9.0,7.0,2.0,2.0,4.0,9.0,6.0,24.0,9.0,12.0,9.0,2.0,2.0,6.0,3.0,16.0,3.0,15.0,10.0,4.0,7.0,10.0,13.0,10.0,2.0,0.0,3.0,0.0,0.0,0.0,3.0,10.0,7.0,15.0,19.0,12.0,6.0,11.0,10.0,6.0,6.0,10.0,14.0,7.0,10.0,9.0,12.0,2.0,3.0,5.0,10.0,4.0,6.0,18.0,8.0,7.0,9.0,6.0,9.0,7.0,17.0,6.0,2.0,13.0,23.0,5.0,10.0,10.0,2.0,6.0,13.0,6.0,15.0,12.0,11.0,14.0,4.0,6.0,7.0,5.0,11.0,9.0,9.0,7.0,4.0,5.0,7.0,25.0,4.0,7.0,10.0,10.0,13.0,2.0,0.0,8.0,4.0,17.0,3.0,0.0,6.0,3.0,15.0,5.0,15.0,13.0,5.0,14.0,18.0,12.0,11.0,0.0,12.0,1.0,1.0,4.0,2.0,0.0,0.0,12.0,3.0,2.0,2.0,1.0,1.0,1.0,3.0,7.0,0.0,11.0,5.0,1.0,7.0,3.0,3.0,0.0,3.0,0.0,0.0,0.0,2.0,0.0,1.0,2.0,6.0,6.0,1.0,0.0,0.0,1.0,0.0,1.0,8.0,2.0,0.0,0.0,10.0,0.0,0.0,7.0,0.0,1.0,4.0,0.0,4.0,1.0,0.0,0.0,1.0,0.0,7.0,2.0,2.0,2.0,1.0,3.0,19.0,0.0,7.0,2.0,5.0,2.0,2.0,13.0,1.0,3.0,0.0,2.0,1.0,6.0,0.0,10.0,7.0,10.0,3.0,1.0,4.0,4.0,0.0,1.0,1.0,0.0,4.0,0.0,0.0,0.0,0.0,1.0,4.0,6.0,2.0,2.0,3.0,7.0,14.0,14.0,15.0,7.0,13.0,9.0,0.0,4.0,3.0,37.0,1.0,8.0,16.0,6.0,1.0,0.0,0.0,1.0,1.0,3.0,2.0,1.0,1.0,0.0,3.0,3.0,1.0,4.0,8.0,14.0,11.0,4.0,4.0,4.0,6.0,4.0,9.0,14.0,8.0,4.0,4.0,1.0,0.0,3.0,6.0,6.0,3.0,6.0,4.0,4.0,6.0,2.0,1.0,3.0,2.0,1.0,14.0,1.0,5.0,18.0,17.0,3.0,0.0,0.0,0.0,5.0,5.0,0.0,4.0,1.0,8.0,5.0,6.0,2.0,5.0,3.0,3.0,2.0,0.0,3.0,0.0,2.0,1.0,0.0,8.0,0.0,10.0,3.0,6.0,16.0,9.0,5.0,15.0,2.0,1.0,0.0,0.0,0.0,13.0,7.0,1.0,9.0,2.0,12.0,0.0,6.0,0.0,0.0,3.0,19.0,2.0,6.0,0.0,6.0,3.0,1.0,0.0,0.0,5.0,0.0,2.0,6.0,0.0,0.0,17.0,0.0,1.0,0.0,1.0,1.0,0.0,3.0,1.0,0.0,3.0,22.0,2.0,5.0,2.0,18.0,3.0,7.0,13.0,7.0,6.0,0.0,2.0,4.0,2.0,2.0,3.0,2.0,4.0,7.0,3.0,0.0,0.0,23.0,7.0,6.0,4.0,17.0,6.0,2.0,0.0,9.0,0.0,0.0,0.0,9.0,9.0,8.0,0.0,4.0,6.0,4.0,9.0,4.0,6.0,8.0,7.0,3.0,3.0,10.0,4.0,3.0,4.0,3.0,7.0,2.0,14.0,5.0,6.0,1.0,14.0,20.0,5.0,8.0,9.0,18.0,15.0,5.0,25.0,4.0,1.0,13.0,0.0,13.0,3.0,12.0,17.0,4.0,0.0,2.0,3.0,1.0,0.0,0.0,0.0,1.0,1.0,19.0,0.0,0.0,0.0,0.0,0.0,0.0,1.0,1.0,5.0,0.0,10.0,2.0,6.0,3.0,4.0,7.0,7.0,2.0,0.0,6.0,1.0,1.0,7.0,4.0,0.0,6.0,7.0,2.0,7.0,3.0,15.0,9.0,5.0,15.0,10.0,4.0,6.0,8.0,2.0,2.0,2.0,2.0,32.0,7.0,10.0,0.0,4.0,3.0,5.0,2.0,2.0,3.0,7.0,5.0,4.0,7.0,2.0,7.0,5.0,1.0,1.0,4.0,6.0,14.0,3.0,1.0,16.0,0.0,11.0,4.0,9.0,8.0,8.0,0.0,5.0,2.0,7.0,2.0,4.0,0.0,1.0,3.0,4.0,1.0,5.0,3.0,8.0,7.0,7.0,8.0,2.0,2.0,4.0,0.0,12.0,4.0,4.0,0.0,1.0,1.0,5.0,5.0,8.0,3.0,5.0,5.0,6.0,12.0,10.0,0.0,6.0,10.0,4.0,8.0,17.0,15.0,14.0,7.0,2.0,2.0,12.0,9.0,8.0,6.0,1.0,6.0,12.0,9.0,12.0,5.0,8.0,8.0,5.0,1.0,2.0,5.0,2.0,13.0,2.0,1.0,3.0,6.0,0.0,4.0,4.0,7.0,7.0,2.0,1.0,2.0,2.0,2.0,7.0,5.0,6.0,5.0,5.0,1.0,0.0,2.0,2.0,22.0,5.0,10.0,5.0,6.0,6.0,14.0,6.0,14.0,13.0,6.0,3.0,9.0,16.0,7.0,3.0,1.0,11.0,7.0,7.0,1.0,7.0,3.0,4.0,4.0,4.0,5.0,5.0,6.0,6.0,8.0,7.0,8.0,6.0,7.0,5.0,3.0,12.0,13.0,6.0,16.0,8.0,4.0,8.0,9.0,11.0,7.0,4.0,13.0,6.0,12.0,9.0,10.0,12.0,12.0,4.0,5.0,4.0,8.0,6.0,7.0,14.0,5.0,7.0,10.0,7.0,2.0,5.0,8.0,9.0,5.0,8.0,10.0,12.0,9.0,8.0,6.0,12.0,2.0,3.0,8.0,26.0,6.0,4.0,5.0,15.0,2.0,12.0,16.0,12.0,15.0,10.0,8.0,13.0,17.0,6.0,3.0,10.0,19.0,7.0,7.0,4.0,6.0,7.0,18.0,9.0,9.0,5.0,4.0,9.0,14.0,11.0,4.0,13.0,1.0,8.0,5.0,1.0,16.0,9.0,9.0,4.0,5.0,8.0,7.0,11.0,6.0,11.0,7.0,10.0,1.0,0.0,9.0,3.0,10.0,20.0,9.0,0.0,6.0,9.0,17.0,8.0,4.0,2.0,5.0,2.0,21.0,8.0,6.0,7.0,5.0,6.0,7.0,7.0,8.0,9.0,7.0,7.0,12.0,0.0,7.0,5.0,6.0,14.0,17.0,9.0,4.0,8.0,9.0,14.0,10.0,12.0,4.0,7.0,5.0,20.0,15.0,6.0,2.0,4.0,7.0,7.0,10.0,3.0,8.0,10.0,10.0,11.0,7.0,12.0,5.0,5.0,8.0,10.0,1.0,5.0,8.0,6.0,5.0,5.0,9.0,7.0,1.0,2.0,6.0,6.0,7.0,6.0,13.0,4.0,3.0,8.0,10.0,10.0,12.0,6.0,21.0,9.0,9.0,10.0,8.0,3.0,8.0,4.0,5.0,8.0,8.0,6.0,8.0,6.0,4.0,3.0,7.0,10.0,1.0,2.0,1.0,10.0,2.0,5.0,12.0,1.0,5.0,4.0,0.0,1.0,1.0,1.0,13.0,9.0,0.0,0.0,9.0,1.0,3.0,2.0,9.0,7.0,2.0,1.0,1.0,6.0,5.0,0.0,2.0,10.0,1.0,7.0,4.0,5.0,5.0,3.0,2.0,0.0,2.0,4.0,5.0,1.0,3.0,5.0,5.0,0.0,0.0,5.0,5.0,5.0,0.0,0.0,5.0,5.0,2.0,5.0,3.0,3.0,2.0,3.0,3.0,5.0,1.0,2.0,5.0,4.0,5.0,5.0,4.0,2.0,0.0,5.0,5.0,5.0,5.0,5.0,0.0,0.0,4.0,1.0,5.0,2.0,1.0,5.0,0.0,5.0,2.0,4.0,5.0,3.0,5.0,0.0,5.0,5.0,5.0,5.0,5.0,5.0,5.0,3.0,3.0,2.0,5.0,3.0,5.0,5.0,5.0,1.0,2.0,5.0,5.0,5.0,0.0,3.0,2.0,5.0,4.0,5.0,5.0,2.0,0.0,0.0,0.0,0.0,2.0,2.0,4.0,6.0,4.0,0.0,1.0,3.0,5.0,5.0,0.0,0.0,3.0,1.0,1.0,0.0,2.0,8.0,2.0,1.0,1.0,6.0,2.0,1.0,0.0,3.0,0.0,1.0,0.0,2.0,1.0,0.0,1.0,0.0,5.0,9.0,13.0,3.0,10.0,5.0,12.0,15.0,16.0,2.0,22.0,0.0,0.0,15.0,3.0,13.0,0.0,6.0,6.0,22.0,9.0,0.0,1.0,0.0,3.0,10.0,1.0,14.0,14.0,1.0,3.0,6.0,6.0,3.0,1.0,3.0,4.0,8.0,5.0,19.0,3.0,0.0,10.0,5.0,0.0,2.0,1.0,3.0,8.0,9.0,14.0,5.0,3.0,0.0,20.0,0.0,3.0,22.0,1.0,2.0,2.0,8.0,1.0,1.0,25.0,1.0,2.0,7.0,4.0,3.0,3.0,1.0,6.0,2.0,0.0,10.0,1.0,10.0,13.0,5.0,22.0,1.0,1.0,0.0,8.0,0.0,1.0,1.0,0.0,0.0,10.0,13.0,14.0,10.0,7.0,3.0,6.0,14.0,27.0,2.0,0.0,2.0,0.0,3.0,2.0,4.0,0.0,22.0,27.0,4.0,10.0,12.0,2.0,20.0,12.0,12.0,16.0,4.0,21.0,10.0,21.0,10.0,0.0,6.0,2.0,6.0,0.0,0.0,11.0,6.0,8.0,15.0,1.0,13.0,4.0,0.0,1.0,11.0,15.0,25.0,1.0,1.0,3.0,15.0,7.0,7.0,4.0,8.0,4.0,11.0,7.0,6.0,2.0,3.0,19.0,13.0,18.0,6.0,17.0,1.0,14.0,4.0,20.0,3.0,1.0,3.0,5.0,13.0,13.0,0.0,1.0,8.0,0.0,3.0,2.0,9.0,0.0,9.0,2.0,13.0,1.0,1.0,4.0,4.0,8.0,18.0,1.0,0.0,6.0,8.0,26.0,3.0,16.0,1.0,3.0,0.0,9.0,8.0,12.0,3.0,9.0,28.0,7.0,15.0,1.0,0.0,16.0,12.0,11.0,15.0,7.0,23.0,18.0,0.0,14.0,1.0,10.0,13.0,14.0,4.0,9.0,9.0,1.0,13.0,3.0,1.0,13.0,4.0,1.0,3.0,8.0,10.0,11.0,4.0,0.0,7.0,18.0,8.0,3.0,0.0,9.0,6.0,5.0,5.0,16.0,3.0,5.0,17.0,0.0,11.0,19.0,18.0,,19.0,9.0,1.0,13.0,7.0,2.0,6.0,0.0,2.0,7.0,2.0,7.0,0.0,0.0,0.0,3.0,21.0,19.0,10.0,12.0,1.0,25.0,22.0,25.0,0.0,13.0,1.0,13.0,32.0,4.0,3.0,1.0,10.0,16.0,6.0,6.0,16.0,11.0,23.0,32.0,13.0,23.0,4.0,15.0,2.0,0.0,11.0,7.0,16.0,9.0,11.0,23.0,3.0,17.0,2.0,8.0,5.0,15.0,19.0,0.0,12.0,18.0,14.0,10.0,14.0,28.0,30.0,29.0,15.0,13.0,13.0,2.0,1.0,14.0,0.0,3.0,16.0,8.0,9.0,36.0,6.0,34.0,16.0,5.0,8.0,12.0,2.0,0.0,9.0,5.0,17.0,24.0,21.0,8.0,1.0,8.0,1.0,6.0,1.0,2.0,10.0,15.0,1.0,6.0,0.0,6.0,23.0,9.0,2.0,16.0,16.0,0.0,13.0,0.0,4.0,0.0,16.0,12.0,16.0,6.0,2.0,2.0,1.0,4.0,0.0,9.0,16.0,4.0,25.0,9.0,18.0,13.0,3.0,10.0,10.0,16.0,17.0,2.0,1.0,7.0,1.0,6.0,7.0,33.0,2.0,0.0,10.0,0.0,3.0,5.0,27.0,9.0,0.0,0.0,10.0,17.0,11.0,3.0,2.0,1.0,0.0,1.0,10.0,13.0,17.0,7.0,1.0,19.0,9.0,5.0,12.0,31.0,1.0,5.0,2.0,12.0,5.0,10.0,11.0,5.0,8.0,14.0,4.0,7.0,12.0,21.0,1.0,6.0,6.0,4.0,21.0,29.0,29.0,6.0,0.0,5.0,31.0,7.0,16.0,17.0,7.0,4.0,13.0,7.0,3.0,1.0,9.0,22.0,13.0,17.0,18.0,10.0,20.0,13.0,22.0,12.0,4.0,6.0,8.0,2.0,2.0,4.0,8.0,4.0,4.0,5.0,22.0,3.0,2.0,29.0,4.0,7.0,16.0,0.0,27.0,15.0,9.0,8.0,3.0,1.0,0.0,11.0,7.0,8.0,2.0,7.0,1.0,0.0,1.0,0.0,8.0,11.0,12.0,0.0,5.0,2.0,5.0,9.0,26.0,1.0,2.0,7.0,6.0,16.0,0.0,0.0,11.0,7.0,1.0,0.0,1.0,6.0,0.0,6.0,12.0,16.0,11.0,5.0,4.0,11.0,10.0,11.0,6.0,26.0,3.0,5.0,6.0,22.0,20.0,3.0,13.0,20.0,6.0,3.0,2.0,14.0,14.0,13.0,40.0,8.0,19.0,23.0,17.0,,5.0,2.0,9.0,16.0,1.0,13.0,0.0,9.0,14.0,1.0,3.0,8.0,1.0,0.0,0.0,0.0,0.0,5.0,10.0,1.0,6.0,38.0,23.0,78.0,32.0,18.0,0.0,1.0,15.0,0.0,16.0,0.0,4.0,0.0,2.0,14.0,9.0,3.0,7.0,10.0,2.0,17.0,0.0,10.0,1.0,6.0,8.0,0.0,2.0,19.0,20.0,5.0,4.0,11.0,8.0,11.0,15.0,14.0,16.0,10.0,2.0,0.0,10.0,4.0,7.0,12.0,13.0,15.0,9.0,5.0,7.0,0.0,13.0,10.0,15.0,10.0,11.0,8.0,10.0,17.0,17.0,4.0,2.0,11.0,7.0,13.0,13.0,9.0,10.0,6.0,12.0,14.0,17.0,12.0,9.0,6.0,11.0,6.0,13.0,1.0,9.0,12.0,11.0,16.0,13.0,6.0,5.0,13.0,15.0,10.0,11.0,6.0,9.0,2.0,17.0,5.0,11.0,15.0,7.0,0.0,5.0,14.0,6.0,9.0,5.0,2.0,7.0,10.0,9.0,16.0,5.0,10.0,3.0,11.0,14.0,11.0,12.0,7.0,7.0,7.0,14.0,8.0,16.0,2.0,12.0,6.0,18.0,16.0,12.0,10.0,14.0,9.0,4.0,6.0,6.0,8.0,13.0,8.0,5.0,3.0,9.0,14.0,8.0,7.0,14.0,16.0,6.0,17.0,10.0,8.0,0.0,8.0,10.0,11.0,9.0,13.0,14.0,13.0,10.0,4.0,9.0,10.0,7.0,16.0,13.0,13.0,2.0,16.0,11.0,1.0,12.0,2.0,17.0,9.0,15.0,8.0,10.0,5.0,12.0,2.0,13.0,1.0,13.0,8.0,1.0,0.0,6.0,6.0,8.0,11.0,3.0,12.0,0.0,1.0,4.0,0.0,4.0,0.0,4.0,3.0,11.0,1.0,11.0,15.0,11.0,8.0,0.0,0.0,15.0,4.0,8.0,8.0,4.0,12.0,12.0,12.0,0.0,4.0,10.0,0.0,2.0,7.0,2.0,9.0,5.0,9.0,0.0,9.0,5.0,5.0,1.0,7.0,7.0,3.0,5.0,11.0,2.0,4.0,9.0,1.0,21.0,4.0,3.0,1.0,9.0,8.0,3.0,1.0,16.0,3.0,5.0,3.0,6.0,6.0,0.0,2.0,1.0,8.0,0.0,0.0,2.0,14.0,1.0,8.0,16.0,6.0,10.0,6.0,1.0,8.0,13.0,9.0,1.0,0.0,9.0,8.0,0.0,13.0,2.0,7.0,7.0,7.0,0.0,7.0,7.0,2.0,3.0,13.0,6.0,8.0,11.0,4.0,27.0,4.0,1.0,3.0,0.0,9.0,12.0,3.0,18.0,1.0,9.0,0.0,4.0,2.0,2.0,0.0,0.0,9.0,5.0,11.0,19.0,9.0,11.0,13.0,0.0,0.0,1.0,2.0,6.0,0.0,8.0,0.0,8.0,12.0,11.0,0.0,4.0,14.0,6.0,6.0,5.0,8.0,15.0,0.0,4.0,15.0,1.0,10.0,4.0,10.0,2.0,0.0,30.0,5.0,8.0,7.0,1.0,3.0,6.0,9.0,3.0,3.0,0.0,0.0,12.0,0.0,12.0,11.0,5.0,5.0,9.0,5.0,3.0,2.0,5.0,1.0,1.0,10.0,10.0,5.0,5.0,0.0,7.0,0.0,14.0,18.0,12.0,4.0,7.0,12.0,0.0,9.0,7.0,6.0,12.0,1.0,14.0,4.0,8.0,6.0,1.0,10.0,16.0,6.0,6.0,10.0,11.0,8.0,0.0,0.0,2.0,4.0,13.0,14.0,12.0,1.0,4.0,1.0,0.0,11.0,0.0,1.0,0.0,1.0,6.0,6.0,33.0,11.0,0.0,7.0,9.0,12.0,7.0,9.0,12.0,11.0,5.0,4.0,0.0,8.0,9.0,9.0,10.0,1.0,0.0,8.0,0.0,0.0,6.0,3.0,7.0,10.0,8.0,3.0,4.0,1.0,4.0,10.0,8.0,0.0,10.0,11.0,5.0,10.0,10.0,7.0,0.0,15.0,0.0,3.0,15.0,3.0,5.0,11.0,6.0,1.0,0.0,0.0,0.0,0.0,0.0,3.0,5.0,3.0,3.0,1.0,0.0,2.0,0.0,0.0,1.0,10.0,0.0,5.0,0.0,1.0,6.0,0.0,4.0,0.0,0.0,0.0,0.0,0.0,0.0,6.0,1.0,0.0,0.0,0.0,0.0,0.0,4.0,1.0,1.0,1.0,0.0,1.0,2.0,0.0,0.0,0.0,1.0,0.0,1.0,2.0,4.0,4.0,0.0,1.0,0.0,3.0,2.0,0.0,0.0,0.0,0.0,1.0,0.0,0.0,3.0,2.0,0.0,2.0,0.0,0.0,2.0,0.0,2.0,2.0,0.0,0.0,0.0,0.0,0.0,1.0,0.0,2.0,0.0,1.0,5.0,4.0,0.0,0.0,0.0,0.0,0.0,0.0,3.0,0.0,0.0,1.0,0.0,2.0,3.0,10.0,6.0,0.0,3.0,2.0,8.0,2.0,4.0,3.0,6.0,2.0,7.0,13.0,3.0,13.0,4.0,3.0,7.0,7.0,15.0,7.0,8.0,6.0,5.0,2.0,3.0,3.0,3.0,5.0,1.0,3.0,9.0,0.0,15.0,3.0,8.0,9.0,7.0,4.0,6.0,8.0,5.0,5.0,1.0,1.0,4.0,3.0,2.0,2.0,4.0,2.0,4.0,6.0,5.0,2.0,0.0,7.0,3.0,5.0,3.0,4.0,2.0,1.0,7.0,3.0,2.0,5.0,3.0,2.0,5.0,3.0,3.0,4.0,9.0,5.0,3.0,3.0,4.0,1.0,3.0,8.0,3.0,4.0,5.0,4.0,0.0,4.0,5.0,6.0,4.0,0.0,1.0,8.0,0.0,0.0,3.0,2.0,4.0,5.0,2.0,0.0,3.0,0.0,3.0,6.0,7.0,1.0,2.0,4.0,5.0,0.0,2.0,2.0,4.0,0.0,0.0,2.0,9.0,6.0,10.0,3.0,2.0,2.0,3.0,9.0,3.0,4.0,3.0,1.0,2.0,5.0,6.0,7.0,6.0,4.0,0.0,5.0,3.0,5.0,4.0,4.0,4.0,0.0,3.0,1.0,11.0,4.0,7.0,13.0,5.0,10.0,8.0,6.0,2.0,3.0,3.0,4.0,4.0,2.0,12.0,8.0,4.0,6.0,0.0,1.0,8.0,3.0,4.0,0.0,2.0,7.0,0.0,1.0,1.0,1.0,3.0,2.0,0.0,0.0,2.0,0.0,2.0,6.0,1.0,1.0,6.0,0.0,0.0,0.0,0.0,0.0,4.0,7.0,11.0,6.0,5.0,4.0,5.0,2.0,6.0,8.0,4.0,5.0,5.0,6.0,3.0,3.0,9.0,5.0,4.0,6.0,4.0,6.0,3.0,7.0,8.0,6.0,8.0,2.0,12.0,4.0,7.0,5.0,13.0,5.0,2.0,4.0,5.0,2.0,9.0,2.0,6.0,4.0,5.0,8.0,6.0,2.0,2.0,9.0,5.0,6.0,9.0,4.0,2.0,3.0,7.0,5.0,2.0,8.0,7.0,4.0,5.0,6.0,2.0,6.0,7.0,2.0,6.0,5.0,4.0,3.0,9.0,2.0,4.0,7.0,8.0,9.0,9.0,2.0,6.0,2.0,2.0,11.0,8.0,2.0,6.0,3.0,4.0,6.0,6.0,2.0,8.0,5.0,10.0,11.0,11.0,6.0,6.0,8.0,5.0,3.0,3.0,2.0,4.0,2.0,6.0,6.0,8.0,6.0,5.0,7.0,4.0,3.0,4.0,5.0,4.0,5.0,0.0,0.0,4.0,4.0,5.0,5.0,5.0,5.0,5.0,5.0,4.0,4.0,5.0,5.0,5.0,4.0,4.0,3.0,3.0,5.0,5.0,5.0,5.0,0.0,2.0,4.0,5.0,3.0,3.0,3.0,4.0,5.0,0.0,4.0,1.0,2.0,0.0,0.0,2.0,5.0,7.0,0.0,8.0,1.0,1.0,0.0,13.0,3.0,2.0,0.0,1.0,1.0,0.0,5.0,1.0,2.0,6.0,0.0,3.0,1.0,5.0,2.0,9.0,10.0,0.0,4.0,9.0,5.0,3.0,0.0,0.0,8.0,0.0,0.0,10.0,5.0,2.0,16.0,2.0,1.0,1.0,0.0,0.0,0.0,11.0,0.0,2.0,1.0,1.0,0.0,11.0,0.0,8.0,0.0,13.0,0.0,2.0,6.0,0.0,0.0,0.0,3.0,3.0,0.0,5.0,0.0,0.0,4.0,2.0,0.0,0.0,0.0,4.0,15.0,0.0,11.0,0.0,13.0,0.0,3.0,0.0,2.0,0.0,0.0,0.0,0.0,0.0,4.0,9.0,4.0,4.0,0.0,2.0,10.0,3.0,8.0,7.0,5.0,7.0,3.0,3.0,7.0,0.0,5.0,22.0,1.0,3.0,6.0,10.0,1.0,3.0,2.0,4.0,4.0,3.0,0.0,0.0,13.0,9.0,5.0,0.0,3.0,0.0,3.0,20.0,1.0,0.0,14.0,1.0,0.0,10.0,4.0,11.0,1.0,1.0,2.0,3.0,10.0,5.0,3.0,3.0,6.0,10.0,4.0,9.0,1.0,0.0,8.0,7.0,1.0,7.0,5.0,0.0,10.0,0.0,5.0,15.0,4.0,11.0,5.0,10.0,1.0,0.0,11.0,9.0,13.0,14.0,6.0,9.0,8.0,3.0,13.0,8.0,12.0,11.0,10.0,2.0,11.0,9.0,10.0,3.0,2.0,3.0,11.0,14.0,0.0,6.0,9.0,1.0,2.0,11.0,2.0,4.0,6.0,1.0,5.0,14.0,9.0,9.0,14.0,4.0,3.0,7.0,12.0,15.0,4.0,12.0,1.0,8.0,9.0,10.0,0.0,6.0,9.0,6.0,9.0,15.0,0.0,1.0,2.0,0.0,9.0,5.0,2.0,6.0,26.0,10.0,1.0,38.0,14.0,0.0,3.0,12.0,1.0,13.0,23.0,0.0,17.0,0.0,0.0,14.0,25.0,9.0,6.0,11.0,13.0,3.0,7.0,6.0,7.0,10.0,9.0,27.0,27.0,1.0,1.0,14.0,1.0,11.0,25.0,13.0,7.0,10.0,2.0,13.0,7.0,12.0,12.0,4.0,2.0,1.0,5.0,3.0,13.0,3.0,1.0,1.0,22.0,0.0,10.0,9.0,5.0,1.0,9.0,0.0,23.0,7.0,10.0,0.0,18.0,6.0,19.0,17.0,10.0,3.0,17.0,1.0,11.0,3.0,1.0,0.0,23.0,14.0,5.0,0.0,13.0,32.0,0.0,3.0,19.0,2.0,6.0,4.0,1.0,5.0,12.0,27.0,11.0,13.0,12.0,9.0,7.0,5.0,13.0,3.0,4.0,0.0,1.0,0.0,18.0,3.0,0.0,23.0,7.0,0.0,0.0,13.0,4.0,15.0,4.0,12.0,0.0,8.0,2.0,3.0,10.0,2.0,0.0,9.0,16.0,0.0,6.0,1.0,13.0,11.0,20.0,11.0,1.0,0.0,17.0,12.0,14.0,3.0,1.0,28.0,5.0,15.0,12.0,1.0,9.0,1.0,5.0,3.0,4.0,4.0,1.0,12.0,7.0,1.0,0.0,15.0,10.0,15.0,3.0,12.0,7.0,12.0,2.0,1.0,5.0,23.0,1.0,17.0,4.0,16.0,0.0,0.0,0.0,6.0,14.0,19.0,1.0,3.0,12.0,6.0,1.0,8.0,2.0,12.0,11.0,0.0,8.0,10.0,5.0,8.0,13.0,7.0,7.0,0.0,6.0,20.0,2.0,5.0,16.0,12.0,0.0,5.0,7.0,3.0,1.0,2.0,7.0,0.0,0.0,0.0,17.0,0.0,0.0,3.0,9.0,2.0,2.0,3.0,8.0,2.0,1.0,10.0,23.0,1.0,1.0,0.0,2.0,27.0,22.0,4.0,3.0,11.0,16.0,21.5,8.0,0.0,0.0,0.0,11.0,15.0,3.0,16.0,27.0,8.0,20.0,13.0,3.0,8.0,47.0,3.0,6.0,3.0,9.0,0.0,22.0,1.0,8.0,2.0,8.0,6.0,16.0,19.0,18.0,13.0,7.0,0.0,14.0,14.0,7.0,5.0,6.0,0.0,15.0,1.0,12.5,19.0,23.0,5.0,0.0,1.0,5.0,35.0,21.0,14.0,20.0,11.0,28.0,3.0,24.0,8.0,11.0,23.0,4.0,13.0,25.0,11.0,7.0,8.0,8.0,10.0,0.0,1.0,2.0,0.0,0.0,,3.0,14.0,14.0,1.0,0.0,1.0,0.0,0.0,15.0,0.0,6.0,5.0,1.0,11.0,1.0,14.0,11.0,1.0,5.0,14.0,6.0,7.0,27.0,0.0,34.0,18.0,0.0,11.0,30.0,4.0,0.0,6.0,1.0,2.0,12.0,9.0,0.0,25.0,17.0,19.0,16.0,30.0,0.0,2.0,0.0,15.0,16.0,22.0,4.0,11.0,2.0,0.0,0.0,7.0,11.0,6.0,23.0,0.0,1.0,0.0,0.0,2.0,4.0,1.0,26.0,14.0,9.0,14.0,13.0,11.0,2.0,1.0,18.0,11.0,0.0,0.0,7.0,15.0,6.0,0.0,3.0,1.0,0.0,0.0,0.0,1.0,0.0,2.0,0.0,1.0,1.0,2.0,0.0,0.0,0.0,0.0,1.0,0.0,0.0,0.0,2.0,5.0,0.0,1.0,0.0,0.0,0.0,1.0,0.0,0.0,1.0,0.0,2.0,0.0,0.0,0.0,0.0,0.0,1.0,0.0,1.0,1.0,1.0,0.0,0.0,2.0,1.0,1.0,0.0,1.0,0.0,0.0,0.0,1.0,1.0,3.0,2.0,2.0,0.0,2.0,0.0,0.0,1.0,1.0,1.0,2.0,0.0,1.0,2.0,32.0,19.0,6.0,5.0,1.0,1.0,3.0,7.0,5.0,32.0,11.0,6.0,14.0,16.0,11.0,8.0,11.0,3.0,4.0,6.0,7.0,19.0,4.0,9.0,0.0,6.0,5.0,13.0,4.0,6.0,6.0,13.0,14.0,8.0,17.0,14.0,18.0,10.0,7.0,9.0,14.0,12.0,12.0,11.0,5.0,4.0,7.0,10.0,9.0,2.0,0.0,0.0,0.0,3.0,0.0,0.0,0.0,0.0,0.0,0.0,15.0,10.0,15.0,5.0,10.0,1.0,15.0,13.0,2.0,3.0,6.0,0.0,0.0,0.0,1.0,0.0,3.0,2.0,1.0,7.0,0.0,2.0,5.0,1.0,2.0,3.0,8.0,1.0,5.0,10.0,18.0,0.0,4.0,15.0,16.0,11.0,0.0,1.0,4.0,10.0,1.0,9.0,14.0,10.0,4.0,0.0,2.0,1.0,20.0,21.0,17.0,2.0,0.0,6.0,0.0,7.0,17.0,19.0,1.0,8.0,0.0,4.0,19.0,18.0,25.0,12.0,0.0,7.0,10.0,12.0,16.0,13.0,4.0,1.0,25.0,4.0,2.0,11.0,10.0,11.0,15.0,13.0,6.0,8.0,12.0,11.0,9.0,3.0,6.0,9.0,2.0,1.0,0.0,8.0,11.0,8.0,13.0,13.0,5.0,15.0,20.0,0.0,14.0,3.0,14.0,8.0,4.0,3.0,9.0,13.0,18.0,10.0,13.0,3.0,3.0,5.0,6.0,10.0,4.0,6.0,5.0,11.0,0.0,9.0,9.0,16.0,7.0,9.0,0.0,9.0,0.0,1.0,2.0,20.0,6.0,9.0,3.0,7.0,10.0,10.0,31.0,14.0,1.0,1.0,15.0,0.0,1.0,12.0,15.0,9.0,2.0,7.0,3.0,6.0,3.0,1.0,15.0,5.0,9.0,11.0,2.0,1.0,0.0,0.0,7.0,0.0,0.0,11.0,18.0,1.0,3.0,7.0,5.0,3.0,2.0,11.0,9.0,5.0,5.0,6.0,10.0,2.0,5.0,12.0,7.0,4.0,4.0,6.0,14.0,22.0,13.0,14.0,9.0,3.0,3.0,5.0,6.0,9.0,9.0,1.0,5.0,1.0,5.0,6.0,11.0,6.0,0.0,10.0,7.0,8.0,0.0,8.0,6.0,10.0,6.0,2.0,1.0,12.0,9.0,0.0,6.0,2.0,4.0,2.0,0.0,0.0,0.0,4.0,4.0,5.0,4.0,0.0,0.0,2.0,4.0,17.0,10.0,6.0,1.0,9.0,2.0,12.0,13.0,4.0,5.0,3.0,14.0,9.0,3.0,11.0,3.0,14.0,15.0,6.0,8.0,2.0,2.0,6.0,6.0,12.0,9.0,5.0,8.0,14.0,3.0,1.0,4.0,10.0,2.0,2.0,4.0,3.0,7.0,10.0,5.0,3.0,2.0,6.0,8.0,2.0,3.0,6.0,7.0,13.0,13.0,6.0,10.0,0.0,11.0,1.0,0.0,9.0,5.0,5.0,13.0,5.0,1.0,6.0,8.0,5.0,10.0,12.0,12.0,4.0,9.0,4.0,8.0,3.0,1.0,2.0,3.0,4.0,4.0,6.0,0.0,4.0,7.0,0.0,3.0,8.0,2.0,5.0,14.0,12.0,12.0,16.0,2.0,8.0,6.0,7.0,5.0,8.0,4.0,10.0,3.0,17.0,7.0,5.0,4.0,11.0,10.0,4.0,12.0,9.0,14.0,9.0,10.0,11.0,11.0,3.0,8.0,3.0,12.0,7.0,7.0,0.0,5.0,3.0,11.0,7.0,1.0,11.0,3.0,14.0,10.0,12.0,8.0,12.0,0.0,9.0,12.0,6.0,10.0,16.0,1.0,0.0,16.0,9.0,7.0,2.0,8.0,4.0,30.0,7.0,12.0,6.0,8.0,1.0,8.0,9.0,9.0,9.0,4.0,0.0,8.0,14.0,1.0,7.0,2.0,3.0,1.0,1.0,6.0,8.0,1.0,4.0,4.0,13.0,7.0,11.0,13.0,0.0,15.0,4.0,0.0,1.0,17.0,19.0,6.0,6.0,2.0,18.0,6.0,9.0,6.0,9.0,6.0,10.0,2.0,7.0,6.0,6.0,0.0,7.0,5.0,7.0,12.0,12.0,0.0,3.0,13.0,6.0,9.0,8.0,4.0,4.0,12.0,7.0,8.0,9.0,9.0,9.0,5.0,7.0,6.0,7.0,6.0,7.0,6.0,3.0,7.0,20.0,7.0,17.0,11.0,14.0,4.0,12.0,12.0,8.0,4.0,3.0,3.0,11.0,7.0,6.0,4.0,10.0,6.0,14.0,5.0,7.0,6.0,9.0,3.0,4.0,18.0,11.0,8.0,13.0,6.0,4.0,7.0,8.0,9.0,4.0,5.0,9.0,13.0,13.0,7.0,2.0,8.0,17.0,11.0,1.0,5.0,10.0,5.0,5.0,9.0,11.0,5.0,0.0,2.0,4.0,2.0,6.0,5.0,10.0,9.0,2.0,5.0,4.0,11.0,25.0,7.0,13.0,0.0,7.0,5.0,6.0,1.0,11.0,9.0,23.0,11.0,2.0,3.0,12.0,7.0,7.0,6.0,4.0,9.0,6.0,3.0,2.0,5.0,12.0,3.0,4.0,5.0,13.0,10.0,12.0,11.0,16.0,4.0,6.0,10.0,2.0,2.0,4.0,0.0,0.0,0.0,0.0,0.0,0.0,0.0,0.0,1.0,0.0,0.0,4.0,0.0,4.0,2.0,2.0,3.0,8.0,5.0,9.0,2.0,2.0,7.0,4.0,14.0,9.0,6.0,3.0,3.0,4.0,3.0,5.0,2.0,4.0,7.0,2.0,2.0,4.0,6.0,2.0,4.0,8.0,2.0,2.0,2.0,1.0,2.0,0.0,1.0,2.0,2.0,3.0,2.0,2.0,2.0,2.0,3.0,2.0,2.0,2.0,1.0,3.0,2.0,3.0,5.0,4.0,2.0,4.0,2.0,2.0,2.0,2.0,4.0,4.0,0.0,0.0,4.0,2.0,2.0,4.0,4.0,3.0,5.0,3.0,2.0,1.0,0.0,3.0,1.0,2.0,4.0,5.0,2.0,2.0,3.0,2.0,4.0,2.0,3.0,0.0,4.0,3.0,3.0,2.0,0.0,2.0,3.0,2.0,1.0,2.0,2.0,1.0,3.0,3.0,3.0,2.0,0.0,3.0,2.0,2.0,3.0,2.0,3.0,3.0,2.0,3.0,5.0,5.0,3.0,2.0,3.0,0.0,2.0,1.0,1.0,3.0,6.0,2.0,6.0,4.0,2.0,1.0,7.0,4.0,7.0,6.0,3.0,3.0,4.0,3.0,4.0,3.0,5.0,7.0,11.0,6.0,6.0,5.0,4.0,4.0,7.0,5.0,0.0,0.0,0.0,0.0,10.0,0.0,0.0,3.0,0.0,0.0,0.0,0.0,0.0,0.0,0.0,0.0,0.0,0.0,3.0,0.0,0.0,0.0,8.0,0.0,0.0,0.0,0.0,0.0,0.0,0.0,0.0,0.0,0.0,0.0,8.0,0.0,0.0,0.0,0.0,5.0,5.0,5.0,5.0,5.0,5.0,5.0,5.0,5.0,2.0,10.0,6.0,5.0,10.0,7.0,4.0,5.0,6.0,6.0,4.0,9.0,1.0,7.0,6.0,8.0,7.0,6.0,4.0,6.0,7.0,1.0,4.0,9.0,10.0,7.0,7.0,6.0,7.0,4.0,5.0,2.0,5.0,3.0,7.0,7.0,4.0,11.0,12.0,9.0,6.0,5.0,5.0,4.0,7.0,5.0,7.0,5.0,5.0,5.0,7.0,4.0,6.0,9.0,10.0,7.0,4.0,6.0,13.0,8.0,8.0,12.0,4.0,6.0,2.0,8.0,10.0,6.0,8.0,17.0,3.0,13.0,10.0,8.0,6.0,10.0,13.0,10.0,4.0,15.0,7.0,14.0,8.0,1.0,5.0,8.0,11.0,8.0,5.0,6.0,0.0,1.0,9.0,5.0,13.0,7.0,16.0,10.0,9.0,4.0,8.0,15.0,9.0,7.0,11.0,6.0,8.0,2.0,7.0,12.0,5.0,6.0,9.0,7.0,4.0,10.0,13.0,8.0,6.0,15.0,0.0,11.0,3.0,2.0,6.0,10.0,3.0,3.0,5.0,4.0,6.0,15.0,10.0,7.0,8.0,5.0,5.0,0.0,9.0,4.0,7.0,9.0,10.0,6.0,4.0,3.0,3.0,4.0,3.0,8.0,13.0,9.0,9.0,,8.0,7.0,8.0,8.0,5.0,6.0,3.0,8.0,7.0,6.0,8.0,5.0,3.0,5.0,5.0,2.0,3.0,7.0,8.0,7.0,4.0,6.0,6.0,6.0,6.0,2.0,5.0,6.0,4.0,7.0,4.0,4.0,7.0,5.0,6.0,6.0,6.0,5.0,3.0,7.0,6.0,11.0,8.0,8.0,4.0,3.0,7.0,5.0,5.0,6.0,13.0,0.0,0.0,27.0,52.0,3.0,29.0,2.0,11.0,0.0,31.0,15.0,9.0,0.0,28.0,2.0,4.0,12.0,16.0,19.0,19.0,2.0,3.0,8.0,39.0,23.0,15.0,3.0,4.0,39.0,24.0,12.0,16.0,6.0,13.0,17.0,20.0,21.0,16.0,16.0,7.0,17.0,15.0,22.0,8.0,0.0,0.0,3.0,18.0,23.0,25.0,22.0,17.0,42.0,0.0,0.0,0.0,10.0,27.0,1.0,18.0,0.0,11.0,15.0,19.0,6.0,5.0,8.0,26.0,14.0,31.0,31.0,32.0,10.0,9.0,11.0,10.0,31.0,8.0,18.0,16.0,6.0,3.0,14.0,4.0,23.0,7.0,32.0,28.0,11.0,3.0,19.0,24.0,7.0,8.0,15.0,19.0,22.0,18.0,1.0,1.0,38.0,17.0,52.0,6.0,17.0,3.0,6.0,0.0,2.0,18.0,0.0,15.0,0.0,0.0,45.0,22.0,3.0,0.0,0.0,19.0,1.0,23.0,19.0,0.0,3.0,9.0,17.0,1.0,1.0,25.0,14.0,22.0,20.0,9.0,1.0,7.0,0.0,0.0,0.0,2.0,34.0,2.0,1.0,0.0,3.0,6.0,17.0,21.0,27.0,0.0,1.0,4.0,2.0,1.0,15.0,3.0,2.0,21.0,14.0,4.0,7.0,1.0,0.0,38.0,0.0,0.0,6.0,35.0,0.0,3.0,1.0,9.0,1.0,4.0,17.0,21.0,31.0,19.0,12.0,2.0,16.0,4.0,13.0,0.0,7.0,47.0,34.0,6.0,11.0,15.0,12.0,22.0,41.0,27.0,2.0,8.0,10.0,28.0,1.0,4.0,42.0,9.0,7.0,3.0,20.0,11.0,16.0,23.0,0.0,0.0,1.0,22.0,14.0,9.0,15.0,0.0,11.0,10.0,2.0,21.0,0.0,0.0,0.0,13.0,2.0,13.0,18.0,8.0,23.0,44.0,2.0,0.0,1.0,3.0,6.0,2.0,1.0,26.0,24.0,1.0,0.0,0.0,7.0,4.0,0.0,0.0,14.0,4.0,10.0,20.0,19.0,19.0,1.0,19.0,1.0,19.0,4.0,17.0,15.0,21.0,0.0,16.0,0.0,1.0,4.0,23.0,5.0,18.0,11.0,4.0,12.0,8.0,22.0,13.0,7.0,0.0,6.0,7.0,17.0,0.0,0.0,46.0,0.0,1.0,21.0,2.0,30.0,13.0,7.0,9.0,3.0,15.0,18.0,0.0,0.0,2.0,3.0,22.0,18.0,18.0,2.0,30.0,0.0,15.0,27.0,23.0,5.0,8.0,5.0,18.0,32.0,20.0,25.0,19.0,23.0,0.0,6.0,0.0,4.0,23.0,22.0,24.0,25.0,8.0,30.0,12.0,26.0,4.0,1.0,27.0,7.0,1.0,1.0,39.0,0.0,53.0,3.0,0.0,0.0,0.0,0.0,0.0,1.0,25.0,3.0,1.0,1.0,0.0,2.0,22.0,6.0,30.0,2.0,30.0,6.0,31.0,0.0,23.0,38.0,51.0,31.0,31.0,43.0,24.0,54.0,8.0,0.0,32.0,48.0,9.0,34.0,21.0,30.0,4.0,23.0,27.0,1.0,0.0,1.0,5.0,7.0,3.0,0.0,12.0,9.0,4.0,4.0,8.0,0.0,2.0,0.0,0.0,0.0,0.0,0.0,0.0,2.0,5.0,0.0,0.0,1.0,2.0,2.0,2.0,1.0,1.0,0.0,40.0,3.0,2.0,2.0,1.0,0.0,1.0,2.0,7.0,14.0,2.0,0.0,25.0,4.0,0.0,18.0,3.0,0.0,12.0,26.0,23.0,25.0,24.0,11.0,20.0,32.0,27.0,2.0,36.0,18.0,4.0,0.0,26.0,7.0,1.0,17.0,31.0,1.0,17.0,0.0,10.0,0.0,2.0,1.0,19.0,0.0,0.0,2.0,1.0,3.0,10.0,26.0,0.0,0.0,1.0,11.0,4.0,11.0,22.0,0.0,10.0,1.0,9.0,15.0,23.0,9.0,1.0,2.0,13.0,0.0,0.0,8.0,17.0,1.0,2.0,20.0,1.0,22.0,18.0,38.0,12.0,37.0,17.0,17.0,19.0,4.0,1.0,2.0,2.0,33.0,7.0,1.0,0.0,30.0,13.0,15.0,5.0,44.0,0.0,18.0,20.0,4.0,13.0,1.0,14.0,0.0,0.0,0.0,1.0,17.0,29.0,23.0,31.0,1.0,20.0,13.0,31.0,29.0,0.0,0.0,16.0,17.0,0.0,20.0,2.0,11.0,1.0,0.0,27.0,24.0,18.0,7.0,6.0,2.0,13.0,3.0,31.0,12.0,2.0,35.0,21.0,26.0,29.0,0.0,11.0,28.0,2.0,33.0,0.0,1.0,26.0,8.0,4.0,8.0,8.0,0.0,4.0,11.0,24.0,6.0,40.0,52.0,2.0,1.0,7.0,33.0,4.0,0.0,0.0,0.0,2.0,8.0,5.0,10.0,4.0,7.0,2.0,17.0,5.0,37.0,12.0,18.0,3.0,17.0,7.0,9.0,18.0,6.0,3.0,6.0,7.0,16.0,4.0,10.0,1.0,2.0,0.0,15.0,12.0,28.0,6.0,1.0,2.0,2.0,11.0,10.0,15.0,0.0,1.0,14.0,30.0,14.0,3.0,2.0,25.0,13.0,28.0,19.0,2.0,0.0,0.0,21.0,18.0,0.0,0.0,21.0,11.0,5.0,7.0,0.0,1.0,0.0,0.0,0.0,0.0,14.0,9.0,20.0,17.0,3.0,15.0,0.0,2.0,1.0,2.0,1.0,4.0,0.0,0.0,1.0,8.0,0.0,0.0,1.0,7.0,1.0,27.0,19.0,10.0,1.0,21.0,24.0,17.0,17.0,9.0,21.0,25.0,37.0,18.0,0.0,1.0,1.0,3.0,0.0,10.0,24.0,3.0,0.0,0.0,0.0,0.0,27.0,13.0,0.0,0.0,15.0,12.0,0.0,15.0,12.0,21.0,5.0,19.0,0.0,0.0,4.0,7.0,10.0,15.0,26.0,0.0,23.0,23.0,4.0,23.0,20.0,6.0,20.0,12.0,10.0,23.0,24.0,44.0,1.0,36.0,1.0,0.0,0.0,1.0,23.0,1.0,5.0,0.0,1.0,1.0,4.0,5.0,11.0,22.0,2.0,22.0,34.0,28.0,16.0,6.0,48.0,6.0,2.0,33.0,11.0,4.0,14.0,21.0,6.0,9.0,17.0,3.0,7.0,52.0,4.0,5.0,30.0,11.0,0.0,39.0,0.0,2.0,2.0,0.0,19.0,34.0,5.0,2.0,2.0,1.0,0.0,10.0,5.0,4.0,1.0,1.0,9.0,3.0,11.0,0.0,3.0,0.0,1.0,0.0,0.0,0.0,9.0,0.0,0.0,0.0,1.0,0.0,0.0,0.0,21.0,8.0,16.0,1.0,20.0,0.0,1.0,12.0,0.0,3.0,22.0,7.0,19.0,1.0,0.0,1.0,15.0,27.0,8.0,20.0,23.0,0.0,4.0,11.0,16.0,30.0,20.0,14.0,1.0,20.0,3.0,33.0,3.0,0.0,1.0,27.0,4.0,1.0,4.0,15.0,1.0,8.0,7.0,17.0,5.0,7.0,8.0,1.0,6.0,17.0,2.0,1.0,0.0,7.0,12.0,7.0,2.0,6.0,9.0,10.0,12.0,1.0,5.0,2.0,1.0,3.0,1.0,13.0,4.0,1.0,0.0,13.0,0.0,8.0,0.0,6.0,18.0,0.0,2.0,11.0,13.0,15.0,9.0,0.0,10.0,11.0,14.0,11.0,1.0,0.0,14.0,14.0,4.0,11.0,5.0,0.0,5.0,26.0,11.5,15.0,15.0,11.0,7.0,5.0,12.0,3.0,7.0,1.0,11.0,10.0,12.0,6.0,35.0,1.0,20.0,11.0,0.0,12.0,5.0,49.0,4.0,11.0,0.0,4.0,3.0,14.0,11.0,0.0,7.0,2.0,0.0,1.0,8.0,5.0,3.0,13.0,19.0,4.0,27.0,4.0,6.0,48.0,7.0,27.0,35.0,0.0,0.0,1.0,4.0,2.0,0.0,6.0,3.0,6.0,12.0,0.0,11.0,1.0,13.0,2.0,1.0,8.0,0.0,0.0,3.0,6.0,8.0,24.0,7.0,34.0,2.0,8.0,2.0,12.0,11.0,15.0,7.0,5.0,12.0,16.0,14.0,13.0,19.0,3.0,11.0,12.0,11.0,12.0,10.0,12.0,0.0,0.0,11.0,17.0,3.0,15.0,1.0,0.0,11.0,1.0,20.0,16.0,12.0,3.0,9.0,1.0,11.0,0.0,12.0,11.0,5.0,5.0,0.0,5.0,8.0,11.0,1.0,11.0,4.0,29.0,40.0,15.0,10.0,13.0,11.0,10.0,5.0,1.0,7.0,20.0,4.0,3.0,11.0,14.0,7.0,5.0,10.0,7.0,16.0,35.0,0.0,15.0,0.0,0.0,11.0,13.0,16.0,8.0,4.0,12.0,13.0,21.0,8.0,3.0,8.0,4.0,7.0,17.0,14.0,6.0,11.0,30.0,19.0,8.0,48.0,1.0,1.0,6.0,9.0,13.0,4.0,8.0,5.0,4.0,10.0,1.0,18.0,27.0,19.0,3.0,24.0,1.0,9.0,23.0,14.0,0.0,10.0,2.0,20.0,7.0,0.0,8.0,0.0,24.0,13.0,0.0,9.0,31.0,11.0,3.0,2.0,12.0,8.0,15.0,20.0,16.0,1.0,4.0,0.0,1.0,3.0,38.0,3.0,7.0,10.0,3.0,4.0,5.0,11.0,7.0,16.0,10.0,6.0,7.0,9.0,11.0,7.0,0.0,3.0,17.0,8.0,3.0,8.0,8.0,3.0,0.0,1.0,14.0,3.0,3.0,14.0,9.0,11.0,2.0,5.0,5.0,6.0,14.0,9.0,11.0,0.0,0.0,8.0,1.0,13.0,5.0,22.0,27.0,3.0,19.0,2.0,4.0,5.0,8.0,4.0,11.0,6.0,11.0,9.0,6.0,3.0,7.0,9.0,2.0,13.0,9.0,7.0,0.0,16.0,4.0,10.0,22.0,6.0,6.0,0.0,15.0,1.0,10.0,5.0,8.0,5.0,5.0,0.0,10.0,13.0,13.0,23.0,0.0,1.0,0.0,2.0,2.0,9.0,10.0,9.0,5.0,10.0,15.0,5.0,9.0,24.0,8.0,15.0,17.0,1.0,1.0,8.0,11.0,7.0,1.0,0.0,6.0,0.0,0.0,3.0,17.0,19.0,13.0,19.0,16.0,1.0,4.0,3.0,0.0,23.0,10.0,5.0,11.0,7.0,7.0,2.0,2.0,0.0,9.0,44.0,2.0,4.0,10.0,3.0,55.0,13.0,24.0,7.0,0.0,8.0,0.0,3.0,41.0,2.0,7.0,6.0,13.0,9.0,1.0,14.0,1.0,6.0,1.0,6.0,3.0,18.0,12.0,15.0,9.0,14.0,10.0,12.0,2.0,7.0,10.0,7.0,12.0,7.0,12.0,3.0,29.0,4.0,1.0,3.0,4.0,5.0,7.0,15.0,11.0,19.0,22.0,6.0,10.0,3.0,9.0,15.0,13.0,12.0,14.0,9.0,8.0,12.0,17.0,0.0,3.0,5.0,11.0,12.0,1.0,7.0,5.0,8.0,4.0,15.0,18.0,6.0,18.0,16.0,17.0,31.0,11.0,10.0,30.0,0.0,15.0,17.0,19.0,23.0,18.0,26.0,18.0,14.0,7.0,33.0,9.0,16.0,7.0,21.0,20.0,23.0,17.0,12.0,12.0,13.0,4.0,3.0,4.0,0.0,15.0,0.0,0.0,11.0,11.0,0.0,8.0,20.0,0.0,0.0,0.0,1.0,6.0,1.0,5.0,15.0,15.0,15.0,24.0,0.0,11.0,0.0,13.0,1.0,2.0,0.0,1.0,18.0,2.0,5.0,0.0,10.0,10.0,17.0,7.0,2.0,5.0,2.0,5.0,9.0,14.0,12.0,6.0,4.0,9.0,13.0,15.0,20.0,0.0,18.0,0.0,1.0,8.0,2.0,11.0,13.0,16.0,6.0,3.0,19.0,9.0,0.0,9.0,6.0,17.0,26.0,0.0,15.0,23.0,12.0,13.0,13.0,15.0,17.0,11.0,12.0,17.0,27.0,16.0,15.0,5.0,19.0,10.0,3.0,16.0,5.0,4.0,14.0,6.0,0.0,12.0,12.0,18.0,18.0,10.0,19.0,31.0,1.0,7.0,21.0,9.0,20.0,0.0,4.0,5.0,4.0,7.0,20.0,4.0,9.0,11.0,2.0,4.0,10.0,3.0,6.0,16.0,19.0,14.0,14.0,17.0,1.0,0.0,14.0,14.0,21.0,14.0,18.0,16.0,5.0,3.0,7.0,4.0,15.0,7.0,4.0,5.0,18.0,9.0,5.0,5.0,21.0,0.0,15.0,23.0,2.0,27.0,6.0,24.0,15.0,15.0,19.0,6.0,1.0,9.0,9.0,26.0,19.0,30.0,2.0,10.0,2.0,2.0,1.0,2.0,16.0,3.0,11.0,0.0,10.0,1.0,15.0,11.0,17.0,15.0,21.0,4.0,4.0,4.0,6.0,4.0,14.0,12.0,26.0,8.0,5.0,0.0,26.0,2.0,15.0,15.0,1.0,15.0,3.0,9.0,4.0,4.0,25.0,1.0,1.0,12.0,5.0,29.0,14.0,18.0,15.0,9.0,0.0,0.0,0.0,0.0,12.0,12.0,0.0,7.0,11.0,9.0,6.0,8.0,9.0,18.0,2.0,13.0,6.0,6.0,17.0,9.0,4.0,3.0,4.0,14.0,0.0,1.0,10.0,3.0,3.0,0.0,9.0,1.0,11.0,13.0,7.0,0.0,12.0,2.0,7.0,2.0,18.0,16.0,14.0,17.0,8.0,12.0,2.0,16.0,4.0,19.0,5.0,16.0,2.0,6.0,0.0,0.0,0.0,0.0,0.0,0.0,0.0,7.0,8.0,9.0,5.0,6.0,10.0,12.0,7.0,3.0,5.0,5.0,4.0,4.0,5.0,11.0,9.0,6.0,6.0,10.0,5.0,5.0,4.0,4.0,4.0,11.0,9.0,13.0,9.0,5.0,4.0,8.0,6.0,8.0,6.0,4.0,8.0,5.0,4.0,6.0,7.0,6.0,4.0,6.0,7.0,3.0,5.0,7.0,8.0,7.0,10.0,8.0,8.0,5.0,6.0,6.0,5.0,4.0,3.0,5.0,10.0,8.0,7.0,5.0,4.0,4.0,7.0,6.0,4.0,8.0,4.0,6.0,9.0,11.0,10.0,4.0,9.0,2.0,9.0,13.0,3.0,13.0,7.0,8.0,13.0,4.0,11.0,5.0,3.0,9.0,6.0,13.0,9.0,5.0,5.0,3.0,7.0,11.0,6.0,9.0,6.0,4.0,0.0,0.0,1.0,1.0,2.0,2.0,2.0,0.0,1.0,0.0,0.0,0.0,3.0,0.0,0.0,2.0,0.0,0.0,4.0,5.0,11.0,8.0,18.0,17.0,4.0,8.0,7.0,5.0,2.0,6.0,4.0,0.0,12.0,5.0,0.0,16.0,0.0,15.0,4.0,6.0,13.0,0.0,9.0,8.0,2.0,3.0,18.0,9.0,5.0,0.0,5.0,3.0,5.0,8.0,3.0,9.0,7.0,9.0,11.0,3.0,0.0,15.0,16.0,9.0,10.0,9.0,12.0,7.0,5.0,5.0,9.0,17.0,9.0,10.0,8.0,8.0,7.0,5.0,5.0,2.0,9.0,1.0,8.0,14.0,9.0,1.0,4.0,10.0,4.0,6.0,13.0,3.0,9.0,9.0,9.0,0.0,9.0,13.0,,0.0,6.0,0.0,0.0,0.0,0.0,13.0,2.0,3.0,10.0,8.0,9.0,4.0,12.0,3.0,11.0,0.0,0.0,0.0,0.0,0.0,0.0,0.0,0.0,0.0,6.0,8.0,14.0,6.0,5.0,9.0,0.0,5.0,9.0,18.0,3.0,14.0,5.0,7.0,9.0,11.0,8.0,11.0,13.0,5.0,4.0,8.0,11.0,19.0,14.0,2.0,0.0,4.0,10.0,6.0,7.0,5.0,9.0,3.0,1.0,12.0,12.0,0.0,0.0,0.0,0.0,0.0,0.0,0.0,0.0,0.0,0.0,0.0,0.0,0.0,0.0,0.0,0.0,0.0,0.0,0.0,0.0,0.0,20.0,16.0,1.0,2.0,0.0,0.0,0.0,1.0,4.0,0.0,0.0,0.0,0.0,0.0,1.0,0.0,5.0,0.0,0.0,1.0,2.0,0.0,1.0,2.0,0.0,0.0,0.0,0.0,0.0,11.0,7.0,6.0,6.0,9.0,5.0,10.0,6.0,9.0,15.0,9.0,4.0,1.0,6.0,5.0,10.0,9.0,6.0,11.0,4.0,8.0,7.0,9.0,1.0,3.0,8.0,7.0,9.0,7.0,5.0,5.0,6.0,11.0,9.0,4.0,3.0,9.0,10.0,8.0,5.0,6.0,5.0,3.0,6.0,3.0,5.0,8.0,8.0,4.0,8.0,9.0,8.0,5.0,3.0,8.0,4.0,6.0,0.0,13.0,4.0,4.0,4.0,2.0,4.0,6.0,6.0,3.0,5.0,3.0,4.0,0.0,4.0,13.0,3.0,2.0,15.0,8.0,1.0,6.0,10.0,6.0,8.0,3.0,3.0,11.0,13.0,7.0,2.0,13.0,12.0,7.0,6.0,21.0,18.0,8.0,4.0,4.0,10.0,6.0,5.0,15.0,9.0,8.0,10.0,12.0,1.0,9.0,5.0,13.0,8.0,6.0,1.0,5.0,9.0,4.0,6.0,5.0,7.0,9.0,7.0,1.0,1.0,2.0,4.0,11.0,2.0,7.0,4.0,7.0,6.0,1.0,5.0,10.0,11.0,0.0,4.0,5.0,6.0,5.0,4.0,4.0,10.0,2.0,5.0,2.0,10.0,3.0,4.0,6.0,9.0,20.0,3.0,4.0,3.0,5.0,6.0,6.0,3.0,4.0,5.0,5.0,1.0,3.0,5.0,8.0,8.0,5.0,6.0,5.0,1.0,6.0,6.0,6.0,4.0,5.0,9.0,5.0,0.0,2.0,6.0,9.0,6.0,8.0,2.0,5.0,6.0,10.0,0.0,5.0,6.0,6.0,1.0,4.0,6.0,0.0,5.0,1.0,0.0,12.0,4.0,4.0,0.0,10.0,11.0,5.0,3.0,3.0,5.0,0.0,3.0,11.0,6.0,6.0,1.0,5.0,2.0,1.0,1.0,3.0,3.0,2.0,3.0,9.0,4.0,10.0,3.0,1.0,16.0,5.0,22.0,0.0,7.0,10.0,14.0,3.0,1.0,10.0,7.0,5.0,0.0,2.0,17.0,7.0,6.0,11.0,7.0,7.0,1.0,5.0,4.0,8.0,5.0,8.0,6.0,4.0,8.0,22.0,0.0,9.0,9.0,19.0,0.0,6.0,1.0,0.0,3.0,0.0,0.0,3.0,11.0,0.0,7.0,6.0,2.0,3.0,0.0,1.0,0.0,2.0,8.0,2.0,4.0,6.0,4.0,6.0,1.0,0.0,19.0,5.0,2.0,14.0,6.0,1.0,0.0,2.0,10.0,3.0,5.0,12.0,0.0,10.0,26.0,13.0,1.0,17.0,13.0,0.0,4.0,38.0,6.0,14.0,6.0,1.0,5.0,1.0,2.0,6.0,16.0,14.0,30.0,7.0,2.0,0.0,9.0,0.0,38.0,9.0,5.0,6.0,0.0,3.0,8.0,10.0,8.0,2.0,4.0,4.0,0.0,10.0,20.0,5.0,7.0,0.0,1.0,2.0,1.0,5.0,6.0,2.0,0.0,7.0,13.0,10.0,11.0,6.0,4.0,13.0,2.0,12.0,8.0,12.0,1.0,18.0,22.0,36.0,2.0,0.0,0.0,16.0,2.0,3.0,3.0,5.0,2.0,1.0,6.0,10.0,6.0,0.0,2.0,3.0,2.0,3.0,13.0,4.0,4.0,0.0,7.0,19.0,13.0,6.0,12.0,13.0,1.0,2.0,4.0,12.0,8.0,3.0,9.0,6.0,2.0,2.0,3.0,0.0,14.0,0.0,5.0,35.0,25.0,7.0,22.0,5.0,2.0,11.0,14.0,8.0,9.0,6.0,0.0,4.0,4.0,3.0,1.0,0.0,6.0,5.0,4.0,5.0,9.0,1.0,2.0,10.0,5.0,1.0,1.0,5.0,6.0,3.0,2.0,1.0,0.0,15.0,4.0,6.0,0.0,9.0,7.0,3.0,2.0,0.0,7.0,0.0,4.0,8.0,6.0,3.0,2.0,4.0,7.0,6.0,6.0,4.0,8.0,13.0,2.0,5.0,4.0,7.0,3.0,7.0,9.0,4.0,8.0,10.0,1.0,22.0,3.0,0.0,3.0,2.0,3.0,11.0,28.0,31.0,14.0,11.0,1.0,2.0,6.0,4.0,10.0,4.0,2.0,1.0,1.0,13.0,14.0,3.0,4.0,2.0,3.0,1.0,3.0,37.0,0.0,1.0,0.0,7.0,2.0,5.0,13.0,2.0,13.0,1.0,3.0,2.0,4.0,15.0,9.0,4.0,5.0,9.0,2.0,9.0,9.0,5.0,5.0,22.0,7.0,1.0,1.0,2.0,9.0,0.0,5.0,5.0,10.0,0.0,7.0,7.0,3.0,6.0,5.0,8.0,3.0,0.0,0.0,25.0,3.0,6.0,0.0,0.0,1.0,1.0,5.0,9.0,34.0,18.0,4.0,18.0,11.0,8.0,9.0,6.0,29.0,6.0,0.0,15.0,5.0,9.0,15.0,2.0,0.0,7.0,23.0,2.0,3.0,0.0,0.0,1.0,10.0,4.0,1.0,2.0,0.0,5.0,0.0,0.0,11.0,17.0,6.0,6.0,20.0,7.0,4.0,8.0,1.0,4.0,5.0,4.0,13.0,5.0,5.0,2.0,6.0,5.0,8.0,7.0,0.0,0.0,0.0,9.0,3.0,3.0,8.0,0.0,1.0,3.0,6.0,2.0,0.0,5.0,7.0,19.0,46.0,4.0,1.0,6.0,0.0,7.0,0.0,7.0,3.0,9.0,6.0,6.0,5.0,8.0,7.0,0.0,1.0,1.0,4.0,3.0,13.0,23.0,12.0,24.0,13.0,12.0,1.0,18.0,6.0,5.0,3.0,25.0,2.0,17.0,23.0,15.0,2.0,0.0,5.0,13.0,10.0,2.0,6.0,12.0,6.0,2.0,3.0,6.0,9.0,1.0,16.0,8.0,4.0,1.0,6.0,7.0,14.0,12.0,3.0,1.0,14.0,13.0,1.0,3.0,3.0,0.0,28.0,7.0,0.0,19.0,5.0,0.0,11.0,1.0,3.0,2.0,9.0,5.0,3.0,5.0,1.0,9.0,9.0,21.0,0.0,4.0,12.0,11.0,6.0,17.0,7.0,10.0,8.0,2.0,2.0,6.0,3.0,4.0,3.0,23.0,1.0,14.0,1.0,19.0,18.0,10.0,2.0,2.0,7.0,2.0,9.0,8.0,0.0,0.0,0.0,30.0,16.0,0.0,0.0,7.0,3.0,2.0,4.0,12.0,10.0,5.0,3.0,7.0,11.0,6.0,1.0,5.0,18.0,12.0,10.0,9.0,8.0,1.0,0.0,14.0,20.0,11.0,6.0,9.0,15.0,7.0,21.0,10.0,0.0,4.0,10.0,5.0,22.0,4.0,6.0,2.0,1.0,0.0,3.0,0.0,4.0,3.0,0.0,0.0,0.0,0.0,0.0,2.0,1.0,0.0,4.25,9.0,1.0,7.0,0.0,0.0,2.0,2.0,1.0,1.0,3.0,1.0,1.0,1.0,2.0,4.0,6.0,2.0,0.0,2.0,0.0,0.0,2.0,0.0,0.0,3.0,0.0,1.0,4.0,1.0,0.0,3.0,4.0,5.0,50.0,50.0,30.0,30.0,40.0,19.0,16.0,8.0,11.0,8.0,6.0,13.0,15.0,2.0,15.0,6.0,13.0,5.0,1.0,13.0,0.0,21.0,25.0,17.0,18.0,21.0,0.0,4.0,13.0,11.0,6.0,4.0,3.0,2.0,25.0,3.0,14.0,23.0,19.0,16.0,10.0,4.0,0.0,14.0,0.0,9.0,0.0,1.0,10.0,0.0,12.0,19.0,9.0,10.0,4.0,1.0,9.0,5.0,10.0,22.0,24.0,13.0,9.0,1.0,0.0,0.0,15.0,2.0,3.0,33.0,6.0,0.0,5.0,4.0,1.0,6.0,0.0,3.0,5.0,16.0,0.0,0.0,12.0,0.0,6.0,0.0,5.0,9.0,1.0,13.0,7.0,3.0,15.0,0.0,11.0,1.0,2.0,1.0,5.0,4.0,20.0,7.0,4.0,0.0,10.0,4.0,15.0,35.0,26.0,18.0,2.0,18.0,10.0,8.0,21.0,9.0,10.0,21.0,24.0,23.0,8.0,23.0,5.0,14.0,15.0,17.0,5.0,23.0,8.0,6.0,31.0,16.0,31.0,34.0,16.0,7.0,14.0,21.0,14.0,23.0,17.0,4.0,15.0,34.0,9.0,15.0,18.0,5.0,15.0,27.0,30.0,26.0,21.0,21.0,25.0,10.0,30.0,22.0,5.0,20.0,13.0,14.0,9.0,25.0,24.0,7.0,9.0,11.0,5.0,18.0,8.0,6.0,6.0,15.0,30.0,6.0,4.0,3.0,9.0,0.0,10.0,0.0,0.0,25.0,11.0,0.0,0.0,0.0,7.0,12.0,8.0,5.0,1.0,14.0,6.0,28.0,8.0,0.0,11.0,5.0,9.0,2.0,5.0,6.0,1.0,36.0,21.0,25.0,21.0,9.0,1.0,19.0,8.0,3.0,8.0,8.0,6.0,11.0,31.0,9.0,11.0,1.0,12.0,8.0,8.0,8.0,9.0,4.0,1.0,1.0,3.0,10.0,16.0,23.0,14.0,4.0,12.0,7.0,7.0,5.0,8.0,8.0,2.0,5.0,21.0,1.0,0.0,3.0,0.0,0.0,2.0,11.0,20.0,2.0,1.0,2.0,3.0,8.0,0.0,1.0,13.0,11.0,3.0,11.0,11.0,3.0,1.0,0.0,0.0,3.0,0.0,0.0,5.0,11.0,14.0,1.0,3.0,1.0,0.0,19.0,14.0,0.0,5.0,0.0,2.0,3.0,6.0,7.0,25.0,18.0,16.0,9.0,10.0,1.0,0.0,8.0,9.0,0.0,12.0,9.0,33.0,17.0,9.0,8.0,1.0,2.0,1.0,1.0,1.0,4.0,3.0,20.0,2.0,10.0,5.0,0.0,19.0,11.0,9.0,4.0,6.0,14.0,8.0,15.0,6.0,0.0,8.0,11.0,2.0,0.0,9.0,8.0,7.0,5.0,7.0,2.0,14.0,10.0,9.0,15.0,13.0,4.0,12.0,11.0,19.0,12.0,11.0,10.0,3.0,6.0,16.0,8.0,1.0,10.0,11.0,18.0,3.0,9.0,3.0,5.0,14.0,7.0,9.0,12.0,7.0,1.0,12.0,8.0,0.0,17.0,1.0,18.0,1.0,2.0,25.0,6.0,11.0,16.0,8.0,21.0,13.0,21.0,29.0,19.0,4.0,8.0,23.0,9.0,6.0,16.0,24.0,12.0,18.0,3.0,1.0,11.0,15.0,9.0,6.0,0.0,8.0,8.0,9.0,5.0,21.0,9.0,3.0,12.0,15.0,17.0,0.0,26.0,6.0,11.0,3.0,22.0,7.0,27.0,1.0,9.0,10.0,16.0,24.0,4.0,20.0,4.0,13.0,3.0,6.0,19.0,0.0,9.0,0.0,0.0,18.0,9.0,6.0,13.0,8.0,4.0,1.0,1.0,1.0,19.0,15.0,12.0,4.0,17.0,2.0,17.0,10.0,10.0,15.0,6.0,15.0,12.0,5.0,5.0,8.0,0.0,1.0,2.0,9.0,10.0,11.0,14.0,1.0,3.0,6.0,8.0,9.0,18.0,13.0,21.0,20.0,15.0,11.0,17.0,6.0,21.0,10.0,5.0,4.0,0.0,4.0,1.0,0.0,12.0,7.0,2.0,2.0,0.0,1.0,1.0,8.0,0.0,1.0,0.0,2.0,2.0,0.0,2.0,0.0,0.0,5.0,0.0,0.0,1.0,2.0,1.0,12.0,0.0,2.0,0.0,0.0,1.0,1.0,1.0,2.0,1.0,6.0,5.0,0.0,2.0,1.0,0.0,0.0,0.0,3.0,3.0,2.0,0.0,1.0,15.0,1.0,1.0,10.0,1.0,0.0,0.0,4.0,0.0,0.0,3.0,1.0,0.0,1.0,0.0,1.0,1.0,2.0,0.0,1.0,1.0,0.0,0.0,5.0,0.0,2.0,0.0,0.0,1.0,17.0,0.0,5.0,0.0,1.0,0.0,1.0,0.0,0.0,2.0,0.0,0.0,0.0,0.0,0.0,2.0,0.0,1.0,4.0,11.0,2.0,1.0,0.0,0.0,1.0,2.0,0.0,0.0,0.0,15.0,2.0,0.0,18.0,0.0,0.0,25.0,0.0,2.0,2.0,0.0,0.0,0.0,0.0,0.0,2.0,2.0,1.0,1.0,1.0,1.0,0.0,0.0,0.0,4.0,0.0,3.0,2.0,3.0,12.0,3.0,3.0,0.0,0.0,3.0,0.0,1.0,0.0,0.0,4.0,0.0,0.0,20.0,15.0,11.0,3.0,0.0,1.0,0.0,0.0,0.0,2.0,2.0,3.0,0.0,0.0,18.0,1.0,0.0,0.0,0.0,0.0,1.0,0.0,1.0,2.0,3.0,2.0,1.0,1.0,2.0,5.0,2.0,1.0,0.0,1.0,0.0,2.0,0.0,0.0,3.0,0.0,0.0,4.0,4.0,1.0,0.0,2.0,0.0,0.0,1.0,2.0,1.0,2.0,0.0,0.0,0.0,1.0,3.0,5.0,1.0,0.0,0.0,0.0,2.0,5.0,0.0,2.0,2.0,0.0,0.0,0.0,0.0,7.0,0.0,0.0,1.0,0.0,12.0,5.0,0.0,0.0,1.0,0.0,1.0,1.0,1.0,0.0,2.0,14.0,0.0,1.0,1.0,0.0,1.0,0.0,0.0,4.0,1.0,1.0,0.0,0.0,1.0,0.0,1.0,1.0,2.0,0.0,2.0,1.0,0.0,0.0,1.0,0.0,0.0,0.0,2.0,5.0,1.0,0.0,1.0,1.0,2.0,1.0,0.0,1.0,0.0,0.0,0.0,0.0,2.0,0.0,0.0,0.0,1.0,2.0,0.0,0.0,1.0,2.0,0.0,0.0,0.0,1.0,0.0,0.0,0.0,0.0,0.0,4.0,4.0,0.0,1.0,6.0,3.0,0.0,2.0,0.0,2.0,0.0,3.0,2.0,11.0,0.0,1.0,5.0,1.0,2.0,1.0,1.0,3.0,9.0,1.0,2.0,5.0,0.0,11.0,1.0,6.0,0.0,9.0,1.0,0.0,2.0,0.0,5.0,2.0,8.0,5.0,2.0,1.0,0.0,0.0,1.0,4.0,1.0,0.0,4.0,0.0,1.0,1.0,2.0,8.0,2.0,15.0,0.0,0.0,1.0,1.0,5.0,0.0,2.0,2.0,9.0,0.0,16.0,4.0,0.0,1.0,1.0,4.0,3.0,1.0,0.0,1.0,6.0,7.0,0.0,0.0,2.0,1.0,1.0,5.0,1.0,2.0,1.0,0.0,0.0,19.0,5.0,1.0,0.0,0.0,2.0,1.0,0.0,2.0,3.0,0.0,0.0,9.0,0.0,9.0,5.0,6.0,5.0,3.0,7.0,10.0,9.0,7.0,11.0,8.0,8.0,10.0,6.0,10.0,0.0,0.0,0.0,0.0,0.0,0.0,0.0,0.0,0.0,0.0,0.0,1.0,0.0,21.0,0.0,15.0,6.0,3.0,7.0,0.0,7.0,2.0,7.0,6.0,4.0,0.0,9.0,0.0,4.0,1.0,0.0,5.0,3.0,32.0,2.0,5.0,0.0,2.0,0.0,13.0,3.0,2.0,3.0,0.0,2.0,3.0,0.0,11.0,1.0,0.0,4.0,12.0,6.0,0.0,0.0,1.0,1.0,0.0,22.0,1.0,9.0,4.0,2.0,2.0,20.0,0.0,1.0,15.0,0.0,17.0,27.0,3.0,15.0,0.0,17.0,0.0,5.0,7.0,0.0,0.0,6.0,16.0,18.0,8.0,4.0,7.0,0.0,1.0,16.0,4.0,0.0,1.0,5.0,6.0,3.0,21.0,7.0,0.0,1.0,5.0,6.0,0.0,0.0,18.0,11.0,2.0,6.0,21.0,11.0,0.0,1.0,2.0,2.0,0.0,9.0,0.0,0.0,0.0,4.0,10.0,10.0,12.0,5.0,12.0,11.0,0.0,0.0,0.0,15.0,0.0,4.0,0.0,9.0,13.0,0.0,0.0,0.0,0.0,12.0,0.0,14.0,4.0,0.0,3.0,0.0,15.0,0.0,5.0,5.0,14.0,0.0,16.0,0.0,1.0,6.0,4.0,1.0,2.0,0.0,0.0,0.0,0.0,0.0,14.0,6.0,12.0,8.0,7.0,6.0,6.0,10.0,0.0,4.0,12.0,3.0,8.0,6.0,5.0,0.0,1.0,8.0,0.0,4.0,0.0,0.0,20.0,5.0,1.0,0.0,1.0,7.0,11.0,0.0,7.0,0.0,0.0,0.0,13.0,6.0,4.0,0.0,0.0,1.0,17.0,6.0,1.0,0.0,0.0,10.0,0.0,0.0,14.0,14.0,16.0,17.0,23.0,5.0,4.0,3.0,0.0,0.0,0.0,0.0,0.0,0.0,0.0,2.0,0.0,1.0,15.0,8.0,11.0,2.0,0.0,2.0,4.0,8.0,1.0,30.0,6.0,9.0,7.0,4.0,2.0,3.0,8.0,0.0,2.0,3.0,5.0,0.0,0.0,0.0,11.0,11.0,1.0,0.0,5.0,1.0,16.0,8.0,1.0,15.0,33.0,2.0,3.0,0.0,5.0,9.0,10.0,4.0,5.0,1.0,0.0,0.0,0.0,3.0,1.0,0.0,1.0,5.0,3.0,3.0,0.0,27.0,0.0,1.0,12.0,0.0,7.0,0.0,1.0,2.0,0.0,13.0,7.0,0.0,2.0,9.0,8.0,1.0,0.0,8.0,2.0,0.0,3.0,3.0,1.0,0.0,12.0,19.0,0.0,0.0,0.0,2.0,7.0,12.0,15.0,17.0,1.0,0.0,0.0,0.0,0.0,2.0,2.0,0.0,0.0,0.0,0.0,3.0,3.0,30.0,0.0,2.0,3.0,13.0,1.0,0.0,0.0,0.0,20.0,10.0,0.0,0.0,0.0,0.0,0.0,0.0,1.0,20.0,2.0,11.0,18.0,23.0,0.0,1.0,0.0,4.0,4.0,1.0,0.0,0.0,2.0,1.0,0.0,0.0,0.0,24.0,2.0,27.0,15.0,0.0,0.0,15.0,1.0,14.0,2.0,16.0,2.0,1.0,0.0,1.0,4.0,9.0,6.0,5.0,11.0,4.0,6.0,8.0,6.0,5.0,6.0,5.0,3.0,12.0,11.0,6.0,6.0,6.0,5.0,9.0,4.0,5.0,11.0,6.0,5.0,6.0,6.0,5.0,8.0,4.0,4.0,12.0,9.0,6.0,9.0,5.0,8.0,15.0,10.0,10.0,7.0,3.0,6.0,5.0,4.0,5.0,5.0,5.0,0.0,1.0,0.0,5.0,1.0,5.0,5.0,5.0,3.0,5.0,5.0,0.0,5.0,0.0,1.0,4.0,5.0,5.0,5.0,4.0,5.0,5.0,0.0,5.0,1.0,2.0,0.0,1.0,0.0,5.0,0.0,5.0,5.0,5.0,0.0,5.0,1.0,1.0,5.0,0.0,0.0,2.0,1.0,5.0,0.0,5.0,0.0,1.0,1.0,1.0,0.0,0.0,1.0,0.0,0.0,3.0,0.0,5.0,1.0,0.0,3.0,5.0,0.0,0.0,1.0,0.0,2.0,0.0,0.0,1.0,0.0,0.0,5.0,0.0,3.0,1.0,0.0,1.0,1.0,1.0,4.0,0.0,0.0,2.0,3.0,0.0,1.0,1.0,0.0,7.0,3.0,8.0,0.0,11.0,0.0,0.0,1.0,7.0,0.0,0.0,0.0,0.0,0.0,11.0,10.0,16.0,0.0,0.0,0.0,5.0,0.0,0.0,9.0,13.0,10.0,0.0,0.0,0.0,0.0,10.0,1.0,1.0,9.0,1.0,1.0,0.0,0.0,1.5,3.0,0.0,0.0,0.0,5.0,0.0,0.0,0.0,0.0,2.0,0.0,0.0,0.0,0.0,0.0,6.0,0.0,0.0,0.0,0.0,2.0,0.0,3.0,3.0,5.0,2.0,0.0,7.0,5.0,0.0,4.0,0.0,0.0,0.0,0.0,0.0,5.0,2.0,3.0,6.0,0.0,0.0,0.0,0.0,0.0,4.0,0.0,2.0,5.0,0.0,0.0,3.0,8.0,0.0,12.0,0.0,0.0,6.0,0.0,3.0,12.0,15.0,9.0,6.0,13.0,9.0,10.0,13.0,9.0,5.0,12.0,16.0,5.0,0.0,10.0,11.0,13.0,13.0,3.0,20.0,12.0,9.0,7.0,11.0,11.0,11.0,5.0,12.0,11.0,9.0,5.0,14.0,5.0,3.0,5.0,5.0,3.0,5.0,5.0,5.0,3.0,4.0,5.0,4.0,0.0,0.0,0.0,0.0,0.0,0.0,0.0,0.0,0.0,0.0,0.0,0.0,0.0,0.0,8.0,3.0,12.0,1.0,18.0,4.0,0.0,0.0,0.0,2.0,4.0,2.0,0.0,1.0,1.0,0.0,1.0,0.0,4.0,3.0,5.0,4.0,5.0,7.0,12.0,8.0,5.0,6.0,1.0,0.0,1.0,3.0,3.0,3.0,12.0,8.0,0.0,4.0,7.0,8.0,14.0,8.0,9.0,12.0,10.0,8.0,5.0,6.0,7.0,4.0,17.0,2.0,2.0,4.0,6.0,0.0,11.0,3.0,13.0,4.0,7.0,6.0,4.0,1.0,8.0,8.0,10.0,8.0,9.0,3.0,2.0,1.0,0.0,1.0,18.0,11.0,2.0,3.0,9.0,10.0,20.0,4.0,1.0,5.0,6.0,4.0,14.0,2.0,16.0,11.0,0.0,6.0,0.0,6.0,0.0,0.0,0.0,0.0,0.0,0.0,0.0,6.0,1.0,0.0,0.0,0.0,2.0,0.0,0.0,0.0,0.0,0.0,0.0,8.0,0.0,0.0,0.0,0.0,0.0,0.0,5.0,5.0,4.0,4.0,5.0,0.0,0.0,4.0,5.0,4.0,5.0,3.0,5.0,4.0,4.0,5.0,4.0,4.0,5.0,2.0,0.0,3.0,5.0,2.0,4.0,4.0,1.0,4.0,5.0,1.0,0.0,10.0,5.0,9.0,8.0,8.0,18.0,12.0,5.0,5.0,0.0,1.0,1.0,0.0,1.0,0.0,0.0,3.0,1.0,4.0,2.0,0.0,2.0,3.0,4.0,1.0,4.0,4.0,2.0,6.0,7.0,3.0,2.0,0.0,0.0,0.0,0.0,0.0,2.0,0.0,1.0,2.0,0.0,3.0,1.0,1.0,2.0,5.0,2.0,4.0,0.0,1.0,4.0,5.0,0.0,1.0,1.0,4.0,0.0,1.0,7.0,0.0,5.0,5.0,6.0,1.0,2.0,8.0,4.0,0.0,1.0,0.0,6.0,1.0,2.0,3.0,5.0,5.0,2.0,10.0,9.0,3.0,0.0,1.0,6.0,0.0,2.0,0.0,0.0,4.0,1.0,2.0,1.0,5.0,5.0,1.0,0.0,6.0,3.0,5.0,10.0,6.0,2.0,3.0,6.0,5.0,3.0,11.0,3.0,4.0,9.0,7.0,5.0,10.0,6.0,5.0,5.0,6.0,5.0,4.0,5.0,11.0,8.0,7.0,3.0,5.0,6.0,0.0,6.0,4.0,9.0,11.0,1.0,6.0,6.0,8.0,5.0,9.0,4.0,9.0,7.0,6.0,4.0,0.0,6.0,9.0,6.0,6.0,9.0,11.0,5.0,4.0,4.0,6.0,4.0,1.0,3.0,3.0,8.0,2.0,0.0,0.0,0.0,3.0,2.0,0.0,1.0,7.0,0.0,7.0,3.0,0.0,0.0,1.0,4.0,3.0,1.0,4.0,7.0,1.0,10.0,4.0,4.0,5.0,0.0,5.0,0.0,3.0,6.0,1.0,2.0,5.0,3.0,2.0,4.0,2.0,1.0,4.0,4.0,3.0,4.0,4.0,0.0,8.0,1.0,2.0,0.0,5.0,7.0,5.0,3.0,5.0,1.0,3.0,3.0,4.0,3.0,1.0,0.0,5.0,5.0,0.0,4.0,4.0,1.0,3.0,0.0,8.0,1.0,5.0,4.0,8.0,0.0,1.0,0.0,1.0,1.0,2.0,1.0,0.0,1.0,2.0,2.0,2.0,1.0,8.0,1.0,3.0,4.0,4.0,0.0,3.0,4.0,6.0,4.0,1.0,2.0,1.0,8.0,1.0,6.0,5.0,4.0,8.0,8.0,4.0,3.0,5.0,4.0,5.0,7.0,3.0,4.0,5.0,6.0,6.0,4.0,4.0,4.0,4.0,3.0,5.0,3.0,4.0,4.0,4.0,3.0,5.0,3.0,2.0,6.0,3.0,2.0,0.0,5.0,2.0,3.0,3.0,3.0,5.0,3.0,3.0,3.0,2.0,5.0,6.0,4.0,3.0,4.0,0.0,6.0,4.0,3.0,2.0,11.0,2.0,8.0,3.0,7.0,7.0,4.0,3.0,3.0,4.0,4.0,4.0,6.0,2.0,5.0,6.0,4.0,4.0,4.0,7.0,5.0,5.0,2.0,7.0,3.0,8.0,5.0,5.0,2.0,8.0,1.0,2.0,4.0,7.0,3.0,4.0,10.0,7.0,5.0,3.0,8.0,11.0,5.0,5.0,7.0,5.0,3.0,7.0,13.0,8.0,1.0,10.0,6.0,3.0,3.0,3.0,8.0,6.0,7.0,3.0,3.0,6.0,6.0,9.0,4.0,6.0,4.0,2.0,0.0,4.0,6.0,5.0,9.0,5.0,2.0,12.0,9.0,3.0,6.0,6.0,10.0,9.0,7.0,8.0,7.0,0.0,5.0,5.0,8.0,4.0,5.0,4.0,6.0,7.0,3.0,8.0,3.0,6.0,9.0,6.0,4.0,5.0,2.0,6.0,15.0,8.0,10.0,4.0,4.0,9.0,5.0,14.0,6.0,9.0,13.0,9.0,6.0,7.0,4.0,10.0,3.0,11.0,9.0,5.0,7.0,12.0,15.0,9.0,21.0,11.0,15.0,8.0,17.0,9.0,10.0,7.0,5.0,24.0,22.0,11.0,11.0,1.0,17.0,1.0,9.0,9.0,24.0,12.0,3.0,3.0,6.0,7.0,15.0,9.0,2.0,2.0,12.0,2.0,1.0,18.0,3.0,16.0,8.0,13.0,9.0,18.0,0.0,4.0,1.0,4.0,13.0,5.0,1.0,11.0,3.0,3.0,8.0,5.0,13.0,2.0,1.0,0.0,2.0,9.0,8.0,3.0,9.0,12.0,3.0,7.0,13.0,3.0,3.0,4.0,10.0,7.0,4.0,8.0,13.0,5.0,11.0,10.0,1.0,12.0,9.0,11.0,9.0,10.0,23.0,20.0,14.0,2.0,12.0,6.0,2.0,8.0,16.0,15.0,14.0,13.0,12.0,4.0,7.0,12.0,24.0,21.0,8.0,9.0,3.0,6.0,4.0,9.0,4.0,1.0,4.0,3.0,7.0,5.0,14.0,8.0,11.0,9.0,33.0,6.0,4.0,8.0,3.0,3.0,2.0,6.0,19.0,5.0,2.0,2.0,4.0,9.0,5.0,6.0,1.0,3.0,3.0,5.0,5.0,3.0,10.0,4.0,5.0,4.0,8.0,12.0,3.0,7.0,6.0,1.0,0.0,3.0,6.0,1.0,4.0,0.0,0.0,3.0,2.0,2.0,3.0,4.0,4.0,0.0,2.0,3.0,0.0,0.0,4.0,3.0,1.0,0.0,0.0,1.0,0.0,3.0,4.0,3.0,0.0,0.0,4.0,0.0,0.0,0.0,1.0,1.0,3.0,0.0,1.0,1.0,0.0,3.0,2.0,0.0,2.0,0.0,0.0,1.0,50.0,0.0,12.0,6.0,3.0,3.0,2.0,0.0,2.0,0.0,1.0,1.0,1.0,0.0,0.0,2.0,0.0,3.0,0.0,3.0,0.0,1.0,0.0,19.0,3.0,0.0,1.0,1.0,1.0,0.0,0.0,3.0,2.0,3.0,1.0,3.0,0.0,0.0,2.0,0.0,2.0,0.0,5.0,0.0,0.0,0.0,0.0,1.0,0.0,0.0,1.0,5.0,5.0,5.0,5.0,5.0,5.0,0.0,5.0,4.0,0.0,0.0,1.0,0.0,0.0,5.0,0.0,1.0,0.0,1.0,0.0,1.0,0.0,1.0,0.0,0.0,1.0,10.0,16.0,8.0,5.0,35.0,7.0,15.0,1.0,12.0,11.0,12.0,16.0,8.0,4.0,4.0,11.0,0.0,7.0,0.0,9.0,18.0,7.0,6.0,13.0,7.0,13.0,3.0,6.0,3.0,7.0,2.0,0.0,1.0,10.0,13.0,17.0,2.0,7.0,5.0,9.0,20.0,2.0,19.0,1.0,5.0,4.0,5.0,5.0,4.0,5.0,5.0,5.0,2.0,0.0,1.0,5.0,5.0,5.0,5.0,5.0,5.0,5.0,5.0,4.0,5.0,4.0,2.0,5.0,5.0,3.0,5.0,5.0,4.0,5.0,5.0,3.0,3.0,1.0,5.0,2.0,2.0,2.0,0.0,0.0,5.0,1.0,5.0,0.0,3.0,0.0,2.0,5.0,5.0,1.0,2.0,5.0,2.0,1.0,0.0,5.0,5.0,3.0,5.0,5.0,5.0,5.0,1.0,5.0,1.0,2.0,1.0,2.0,5.0,3.0,5.0,3.0,5.0,5.0,1.0,1.0,5.0,5.0,5.0,0.0,1.0,5.0,5.0,5.0,0.0,4.0,1.0,3.0,5.0,0.0,5.0,5.0,1.0,0.0,3.0,3.0,3.0,5.0,5.0,1.0,5.0,0.0,5.0,0.0,5.0,1.0,5.0,5.0,1.0,2.0,5.0,1.0,5.0,5.0,1.0,5.0,2.0,10.0,14.0,10.0,7.0,16.0,9.0,6.0,1.0,12.0,6.0,15.0,18.0,14.0,16.0,11.0,1.0,5.0,5.0,1.0,3.0,5.0,5.0,3.0,0.0,1.0,2.0,3.0,5.0,3.0,2.0,5.0,2.0,5.0,5.0,5.0,5.0,2.0,5.0,5.0,1.0,5.0,0.0,1.0,4.0,5.0,5.0,1.0,0.0,5.0,5.0,5.0,2.0,5.0,5.0,5.0,1.0,5.0,1.0,5.0,5.0,2.0,5.0,1.0,5.0,1.0,4.0,0.0,0.0,0.0,5.0,5.0,1.0,5.0,4.0,5.0,2.0,4.0,5.0,0.0,5.0,5.0,1.0,2.0,0.0,5.0,3.0,4.0,5.0,5.0,5.0,5.0,5.0,5.0,5.0,5.0,5.0,5.0,5.0,5.0,2.0,2.0,3.0,5.0,5.0,3.0,5.0,5.0,5.0,3.0,2.0,2.0,5.0,2.0,5.0,5.0,5.0,5.0,3.0,5.0,4.0,1.0,4.0,5.0,1.0,5.0,5.0,6.0,11.0,5.0,10.0,8.0,1.0,11.0,6.0,4.0,1.0,9.0,6.0,0.0,4.0,11.0,7.0,1.0,12.0,12.0,13.0,10.0,7.0,0.0,10.0,3.0,3.0,6.0,3.0,5.0,3.0,2.0,8.0,6.0,12.0,2.0,2.0,1.0,12.0,10.0,0.0,6.0,8.0,0.0,9.0,10.0,2.0,6.0,7.0,8.0,3.0,6.0,0.0,1.0,10.0,8.0,1.0,8.0,2.0,4.0,2.0,9.0,11.0,4.0,3.0,6.0,6.0,5.0,9.0,5.0,7.0,8.0,4.0,7.0,4.0,5.0,11.0,8.0,12.0,11.0,8.0,5.0,3.0,9.0,2.0,5.0,2.0,12.0,12.0,8.0,10.0,2.0,7.0,3.0,3.0,6.0,9.0,11.0,8.0,11.0,4.0,12.0,6.0,5.0,0.0,6.0,9.0,10.0,5.0,7.0,6.0,10.0,2.0,7.0,7.0,6.0,4.0,6.0,8.0,10.0,1.0,3.0,11.0,6.0,6.0,5.0,2.0,21.0,10.0,8.0,6.0,7.0,12.0,8.0,9.0,12.0,10.0,2.0,7.0,9.0,7.0,8.0,6.0,6.0,7.0,8.0,6.0,6.0,10.0,11.0,7.0,10.0,2.0,3.0,6.0,15.0,9.0,3.0,6.0,6.0,4.0,8.0,3.0,9.0,3.0,6.0,9.0,0.0,3.0,5.0,1.0,4.0,3.0,12.0,4.0,10.0,9.0,1.0,10.0,11.0,6.0,9.0,8.0,4.0,7.0,7.0,6.0,4.0,6.0,6.0,6.0,12.0,5.0,7.0,9.0,11.0,8.0,8.0,2.0,6.0,8.0,9.0,4.0,4.0,7.0,4.0,0.0,0.0,0.0,0.0,0.0,13.0,16.0,8.0,2.0,4.0,6.0,10.0,37.0,25.0,14.0,2.0,5.0,11.0,20.0,10.0,7.0,5.0,19.0,2.0,2.0,1.0,6.0,1.0,5.0,3.0,1.0,3.0,5.0,11.0,7.0,8.0,9.0,6.0,0.0,7.0,0.0,1.0,0.0,0.0,3.0,1.0,0.0,0.0,3.0,5.0,1.0,7.0,9.0,12.0,0.0,2.0,2.0,8.0,6.0,4.0,15.0,10.0,6.0,17.0,12.0,6.0,5.0,4.0,2.0,2.0,11.0,9.0,14.0,15.0,12.0,2.0,1.0,0.0,1.0,4.0,10.0,10.0,9.0,18.0,7.0,12.0,9.0,17.0,8.0,3.0,2.0,4.0,8.0,3.0,1.0,3.0,1.0,1.0,3.0,15.0,1.0,11.0,5.0,19.0,12.0,10.0,14.0,15.0,0.0,9.0,13.0,0.0,13.0,15.0,3.0,3.0,0.0,2.0,0.0,6.0,12.0,4.0,0.0,1.0,1.0,0.0,0.0,2.0,7.0,0.0,15.0,2.0,2.0,2.0,0.0,10.0,0.0,14.0,8.0,7.0,16.0,9.0,4.0,13.0,10.0,10.0,12.0,14.0,23.0,13.0,15.0,8.0,13.0,9.0,9.0,17.0,8.0,7.0,8.0,0.0,11.0,4.0,1.0,0.0,0.0,1.0,7.0,8.0,3.0,4.0,4.0,8.0,3.0,0.0,4.0,12.0,4.0,10.0,5.0,2.0,7.0,4.0,4.0,7.0,12.0,10.0,7.0,9.0,9.0,6.0,9.0,3.0,6.0,8.0,3.0,5.0,11.0,1.0,7.0,10.0,6.0,1.0,11.0,17.0,10.0,15.0,2.0,7.0,2.0,16.0,22.0,7.0,6.0,8.0,12.0,6.0,7.0,2.0,0.0,8.0,4.0,12.0,1.0,5.0,11.0,12.0,1.0,5.0,6.0,5.0,3.0,3.0,8.0,3.0,5.0,2.0,7.0,5.0,1.0,5.0,4.0,3.0,2.0,4.0,4.0,4.0,3.0,2.0,6.0,2.0,4.0,5.0,13.0,4.0,4.0,4.0,4.0,11.0,2.0,3.0,5.0,14.0,2.0,5.0,2.0,5.0,6.0,11.0,2.0,6.0,4.0,7.0,7.0,1.0,8.0,1.0,7.0,6.0,8.0,7.0,6.0,3.0,7.0,6.0,5.0,10.0,8.0,2.0,7.0,6.0,13.0,22.0,3.0,11.0,14.0,9.0,11.0,16.0,11.0,12.0,10.0,11.0,10.0,11.0,12.0,12.0,11.0,12.0,0.0,0.0,12.0,8.0,15.0,13.0,13.0,13.0,7.0,12.0,12.0,15.0,13.0,10.0,26.0,0.0,9.0,7.0,9.0,8.0,0.0,14.0,11.0,26.0,0.0,11.0,15.0,8.0,11.0,4.0,11.0,11.0,9.0,19.0,11.0,16.0,8.0,17.0,8.0,17.0,14.0,18.0,18.0,12.0,5.0,9.0,8.0,10.0,5.0,14.0,14.0,9.0,16.0,16.0,16.0,9.0,18.0,11.0,11.0,8.0,17.0,13.0,18.0,17.0,14.0,13.0,23.0,18.0,24.0,10.0,12.0,11.0,22.0,15.0,18.0,17.0,9.0,18.0,13.0,10.0,12.0,12.0,2.0,12.0,18.0,15.0,19.0,21.0,12.0,10.0,14.0,10.0,11.0,11.0,10.0,9.0,11.0,16.0,15.0,15.0,9.0,13.0,13.0,10.0,8.0,16.0,14.0,10.0,11.0,13.0,6.0,23.0,10.0,8.0,17.0,12.0,13.0,4.0,15.0,9.0,11.0,11.0,12.0,16.0,12.0,13.0,9.0,11.0,4.0,8.0,9.0,1.0,7.0,0.0,3.0,2.0,10.0,6.0,8.0,7.0,5.0,4.0,4.0,9.0,7.0,16.0,4.0,6.0,6.0,7.0,19.0,5.0,8.0,1.0,12.0,10.0,1.0,18.0,6.0,9.0,6.0,8.0,13.0,13.0,9.0,8.0,11.0,10.0,15.0,6.0,9.0,14.0,1.0,8.0,4.0,8.0,7.0,4.0,15.0,9.0,6.0,0.0,0.0,4.0,0.0,3.0,0.0,0.0,0.0,0.0,0.0,0.0,0.0,0.0,0.0,0.0,0.0,0.0,18.0,4.0,10.0,9.0,5.0,10.0,24.0,9.0,12.0,3.0,7.0,4.0,25.0,7.0,2.0,5.0,10.0,2.0,16.0,23.0,14.0,3.0,12.0,12.0,9.0,3.0,18.0,12.0,4.0,7.0,6.0,6.0,2.0,9.0,8.0,5.0,12.0,11.0,24.0,1.0,3.0,3.0,1.0,1.0,3.0,9.0,2.0,3.0,6.0,6.0,6.0,10.0,10.0,13.0,10.0,12.0,10.0,6.0,7.0,12.0,10.0,12.0,10.0,6.0,14.0,12.0,9.0,10.0,7.0,11.0,11.0,11.0,14.0,6.0,6.0,8.0,7.0,12.0,15.0,15.0,10.0,7.0,1.0,4.0,6.0,8.0,16.0,11.0,6.0,10.0,9.0,12.0,8.0,7.0,11.0,1.0,2.0,10.0,3.0,13.0,10.0,8.0,7.0,9.0,11.0,4.0,10.0,9.0,7.0,8.0,8.0,8.0,9.0,6.0,11.0,13.0,8.0,9.0,4.0,12.0,15.0,5.0,11.0,6.0,6.0,7.0,11.0,23.0,28.0,7.0,5.0,2.0,13.0,6.0,3.0,11.0,8.0,13.0,14.0,5.0,17.0,9.0,14.0,10.0,8.0,4.0,3.0,4.0,7.0,22.0,15.0,1.0,5.0,5.0,8.0,10.0,12.0,9.0,7.0,7.0,3.0,6.0,7.0,6.0,10.0,14.0,10.0,8.0,4.0,14.0,5.0,7.0,7.0,2.0,6.0,2.0,2.0,7.0,8.0,6.0,10.0,1.0,8.0,7.0,5.0,3.0,13.0,4.0,8.0,6.0,2.0,5.0,14.0,4.0,6.0,11.0,6.0,0.0,0.0,0.5,10.0,0.0,0.0,0.0,0.0,6.0,0.0,0.0,0.0,0.0,6.0,0.0,0.0,0.0,0.0,12.0,0.0,5.0,0.0,7.0,0.0,0.0,0.0,0.0,0.0,1.0,0.0,2.0,2.0,0.0,0.0,2.0,0.0,2.0,0.0,0.0,0.0,3.0,0.0,3.0,0.0,0.0,0.0,0.0,0.0,0.0,1.0,0.0,0.0,0.0,0.0,0.0,1.0,0.0,0.0,2.0,6.0,0.0,0.0,0.0,0.0,0.0,0.0,0.0,0.0,0.0,0.0,0.0,0.0,0.0,0.0,0.0,0.0,0.0,0.0,0.0,,0.0,0.0,,,,,0.0,0.0,0.0,0.0,0.0,0.0,0.0,0.0,0.0,0.0,4.0,4.0,0.0,0.0,0.0,0.0,0.0,0.0,0.0,0.0,1.0,0.0,0.0,1.0,0.0,0.0,0.0,0.0,0.0,0.0,0.0,0.0,0.0,0.0,0.0,0.0,0.0,44.0,22.0,16.0,15.0,9.0,6.0,14.0,12.0,5.0,16.0,8.0,14.0,3.0,12.0,19.0,4.0,8.0,17.0,9.0,4.0,6.0,13.0,6.0,7.0,8.0,6.0,11.0,5.0,2.0,11.0,6.0,6.0,11.0,4.0,0.0,21.0,20.0,13.0,11.0,14.0,2.0,50.0,11.0,5.0,19.0,12.0,1.0,6.0,0.0,2.0,5.0,10.0,8.0,8.0,15.0,19.0,1.0,6.0,10.0,10.0,21.0,0.0,8.0,5.0,4.0,7.0,15.0,4.0,16.0,15.0,5.0,10.0,12.0,15.0,4.0,7.0,6.0,9.0,7.0,1.0,10.0,11.0,4.0,4.0,4.0,5.0,8.0,1.0,2.0,9.0,1.0,2.0,7.0,16.0,0.0,1.0,5.0,1.0,10.0,1.0,15.0,19.0,1.0,9.0,6.0,1.0,12.0,4.0,10.0,2.0,8.0,14.0,3.0,1.0,13.0,5.0,8.0,0.0,10.0,0.0,4.0,13.0,4.0,12.0,1.0,12.0,0.0,11.0,8.0,4.0,0.0,7.0,5.0,0.0,0.0,12.0,15.0,0.0,5.0,16.0,9.0,10.0,7.0,12.0,10.0,11.0,11.0,10.0,0.0,9.0,8.0,11.0,2.0,23.0,10.0,14.0,0.0,3.0,5.0,2.0,13.0,0.0,3.0,2.0,2.0,9.0,2.0,7.0,4.0,9.0,5.0,5.0,1.0,6.0,0.0,6.0,1.0,2.0,9.0,14.0,9.0,10.0,9.0,6.0,8.0,7.0,6.0,6.0,4.0,1.0,0.0,0.0,0.0,0.0,0.0,0.0,0.0,0.0,0.0,0.0,0.0,0.0,0.0,0.0,0.0,0.0,0.0,0.0,0.0,0.0,0.0,0.0,0.0,0.0,0.0,0.0,0.0,0.0,0.0,0.0,0.0,0.0,0.0,0.0,0.0,0.0,0.0,0.0,0.0,0.0,0.0,0.0,0.0,0.0,0.0,0.0,0.0,0.0,0.0,0.0,0.0,0.0,0.0,0.0,0.0,0.0,0.0,0.0,0.0,0.0,0.0,3.0,1.0,0.0,0.0,0.0,0.0,1.0,0.0,0.0,0.0,4.0,0.0,0.0,0.0,0.0,0.0,0.0,0.0,0.0,0.0,0.0,0.0,0.0,0.0,0.0,0.0,0.0,0.0,0.0,0.0,0.0,0.0,0.0,0.0,0.0,0.0,0.0,0.0,0.0,0.0,0.0,0.0,0.0,0.0,0.0,0.0,0.0,1.0,5.0,0.0,0.0,2.0,0.0,0.0,5.0,5.0,3.0,5.0,5.0,2.0,2.0,,0.0,3.0,5.0,0.0,0.0,3.0,1.0,4.0,2.0,1.0,0.0,7.0,6.0,1.0,1.0,0.0,0.0,0.0,4.0,1.0,5.0,5.0,0.0,2.0,5.0,1.0,2.0,3.0,0.0,1.0,4.0,2.0,0.0,5.0,5.0,4.0,2.0,5.0,4.0,2.0,4.0,0.0,1.0,0.0,3.0,1.0,3.0,1.0,1.0,3.0,5.0,5.0,5.0,1.0,5.0,0.0,20.0,5.0,1.0,5.0,4.0,5.0,5.0,4.0,3.0,5.0,0.0,2.0,0.0,1.0,3.0,5.0,3.0,1.0,5.0,2.0,0.0,0.0,2.0,3.0,5.0,3.0,5.0,,,,,,,,5.0,4.25,4.0,,1.0,,2.0,4.0,0.0,0.0,0.0,3.0,5.0,5.0,0.0,1.0,2.0,1.0,5.0,5.0,2.0,3.0,4.0,4.0,1.0,5.0,2.0,1.0,5.0,4.0,5.0,5.0,5.0,5.0,5.0,2.0,0.0,5.0,5.0,3.0,0.0,3.0,5.0,4.0,1.0,2.0,11.0,4.0,3.0,6.0,5.0,0.0,4.0,2.0,0.0,1.0,3.0,1.0,3.0,1.0,1.0,1.0,0.0,2.0,5.0,2.0,1.0,2.0,4.0,0.0,3.0,1.0,2.0,0.0,3.0,2.0,0.0,0.0,5.0,5.0,4.0,3.0,2.0,5.0,1.0,26.0,0.0,0.0,5.0,0.0,2.0,10.0,3.0,5.0,0.0,1.0,1.0,4.0,6.0,1.0,1.0,,3.0,0.0,2.0,5.0,5.0,3.0,1.0,1.0,2.0,2.0,6.0,1.0,5.0,1.0,0.0,2.0,1.0,10.0,4.0,0.0,0.0,0.0,0.0,1.0,2.0,0.0,1.0,0.0,0.0,0.0,2.0,0.0,0.0,3.0,3.0,1.0,10.0,5.0,0.0,0.0,4.0,0.0,1.0,5.0,5.0,15.0,25.0,5.0,10.0,3.0,4.0,5.0,2.0,3.0,2.0,5.0,2.0,0.0,4.0,0.0,4.0,0.0,0.0,1.0,1.0,3.0,6.0,1.0,3.0,5.0,3.0,4.0,5.0,8.0,5.0,9.0,15.0,3.0,5.0,1.0,0.0,5.0,0.0,5.0,5.0,4.0,4.0,1.0,1.0,4.0,2.0,3.0,2.5,2.0,5.0,0.0,2.0,0.0,5.0,2.0,15.0,0.0,0.0,5.0,3.0,2.0,2.0,5.0,1.0,,,0.0,,1.0,1.0,2.0,0.0,1.0,0.0,0.0,5.0,0.0,1.0,10.0,2.0,3.0,5.0,1.0,0.0,3.0,5.0,1.0,5.0,5.0,3.0,5.0,2.0,0.0,0.0,4.0,5.0,2.0,6.0,2.0,5.0,5.0,0.0,1.0,4.0,0.0,6.0,4.0,2.0,4.0,0.0,5.0,1.0,5.0,3.0,6.0,5.0,2.0,0.0,5.0,3.0,4.0,5.0,3.0,4.0,4.0,0.0,3.0,4.0,1.0,2.0,0.0,0.0,5.0,2.0,0.0,0.0,1.0,0.0,0.0,0.0,5.0,1.0,3.0,5.0,0.0,0.0,3.0,5.0,15.0,0.0,3.0,2.0,5.0,3.0,3.0,5.0,0.0,4.0,3.0,3.0,0.0,2.0,5.0,2.0,1.0,3.0,10.0,14.0,5.0,5.0,6.0,5.0,1.0,6.0,6.0,5.0,6.0,35.0,5.0,5.0,2.0,3.0,3.0,0.0,0.0,5.0,5.0,11.0,3.0,5.0,1.0,0.0,0.0,0.0,0.0,1.0,0.0,5.0,4.0,4.0,0.0,5.0,,5.0,,,0.0,,4.0,0.0,2.0,5.0,4.0,8.0,2.0,1.0,5.0,0.0,,5.0,1.0,0.0,0.0,5.0,3.0,2.0,2.0,2.75,5.0,0.0,4.0,0.0,0.0,0.0,0.0,0.0,5.0,5.0,2.0,5.0,3.0,0.0,5.0,2.0,0.0,2.0,5.0,5.0,0.0,1.0,5.0,3.0,5.0,3.0,5.0,5.0,5.0,5.0,1.0,5.0,2.0,3.0,5.0,1.0,5.0,5.0,5.0,5.0,5.0,5.0,4.0,1.0,5.0,4.0,3.0,1.0,5.0,0.0,5.0,1.0,3.0,4.0,5.0,3.0,5.0,5.0,3.0,5.0,4.0,1.0,2.0,5.0,1.0,4.0,0.0,5.0,5.0,0.0,0.0,5.0,9.0,5.0,5.0,5.0,0.0,5.0,5.0,5.0,5.0,5.0,5.0,5.0,5.0,5.0,3.0,5.0,3.0,5.0,5.0,0.0,0.0,5.0,0.0,2.0,0.0,2.0,0.0,1.0,5.0,5.0,1.0,3.0,5.0,5.0,4.0,0.0,4.0,1.0,1.0,1.0,1.0,4.0,2.0,0.0,2.0,3.0,1.0,1.0,1.0,2.0,5.0,0.0,5.0,5.0,3.0,5.0,5.0,0.0,4.0,8.0,0.0,2.0,5.0,0.0,2.0,3.0,0.0,5.0,2.0,5.0,4.0,2.0,5.0,1.0,0.0,5.0,3.0,5.0,3.0,0.0,0.0,0.0,1.0,2.0,0.0,5.0,2.0,5.0,5.0,1.0,0.0,2.0,1.0,5.0,5.0,5.0,4.0,5.0,2.0,3.0,5.0,2.0,,,,2.0,2.0,5.0,5.0,2.0,0.0,0.0,2.0,0.0,0.0,5.0,2.0,0.0,1.0,0.0,5.0,5.0,5.0,3.0,5.0,4.0,4.0,0.0,0.0,5.0,4.0,4.0,2.0,5.0,5.0,0.0,0.0,2.0,5.0,2.0,,1.0,0.0,0.0,4.0,3.0,1.0,4.0,4.0,5.0,5.0,5.0,4.0,2.0,4.0,4.0,5.0,4.0,3.0,5.0,4.0,2.0,2.0,3.0,2.0,3.0,13.0,5.0,4.0,1.0,3.0,0.0,3.0,0.0,0.0,1.0,0.0,5.0,1.0,1.0,4.0,3.0,0.0,5.0,3.0,5.0,3.0,5.0,3.0,2.0,5.0,2.0,5.0,5.0,5.0,0.0,3.0,5.0,5.0,2.0,0.0,5.0,5.0,5.0,5.0,5.0,0.0,6.0,2.0,4.0,0.0,1.0,0.0,5.0,0.0,0.0,4.0,5.0,5.0,2.0,0.0,5.0,4.0,1.0,0.0,5.0,3.0,5.0,4.0,2.0,2.0,0.0,0.0,2.0,4.0,3.0,2.0,5.0,5.0,0.0,5.0,5.0,0.0,2.0,0.0,0.0,1.0,0.0,0.0,0.0,1.0,1.0,5.0,5.0,1.0,0.0,3.0,0.0,,0.0,4.0,5.0,4.0,2.0,5.0,4.0,0.0,5.0,5.0,0.0,1.0,5.0,5.0,0.0,2.0,2.0,2.0,2.0,0.0,6.0,5.0,3.0,1.0,0.0,2.0,1.0,0.0,1.0,5.0,5.0,3.0,4.0,5.0,1.0,0.0,3.0,2.0,4.0,5.0,2.0,0.0,2.0,5.0,0.0,4.0,3.0,2.0,2.0,1.0,4.0,3.0,2.0,0.0,5.0,1.0,5.0,2.0,4.0,2.0,3.0,5.0,0.0,1.0,3.0,5.0,0.0,1.0,1.0,0.0,2.0,0.0,0.0,1.0,0.0,0.0,0.0,0.0,0.0,0.0,5.0,0.0,1.0,0.0,0.0,0.0,0.0,0.0,0.0,0.0,0.0,4.0,2.0,5.0,5.0,4.0,,6.0,1.0,4.0,5.0,,1.0,1.0,,5.0,6.0,3.0,5.0,5.0,1.0,4.0,0.0,2.0,2.0,2.0,7.0,5.0,1.0,4.0,3.0,2.0,2.0,3.0,1.0,1.0,2.0,5.0,2.0,4.0,3.0,1.0,5.0,3.0,3.0,0.0,5.0,3.0,4.0,0.0,5.0,3.0,2.0,1.0,,,3.0,,3.0,1.0,3.0,4.0,2.0,4.0,3.0,2.0,1.0,5.0,4.0,3.0,2.0,5.0,1.0,0.0,5.0,4.0,9.0,2.0,3.0,0.0,5.0,7.0,5.0,5.0,5.0,4.0,0.0,5.0,5.0,4.0,4.0,1.0,0.0,5.0,3.0,5.0,5.0,5.0,3.0,4.0,5.0,2.0,5.0,2.0,3.0,5.0,0.0,5.0,0.0,5.0,2.0,0.0,0.0,2.0,6.0,3.0,2.0,4.0,5.0,2.0,1.0,4.0,1.0,4.0,1.0,2.0,2.0,1.0,0.0,1.0,1.0,0.0,4.0,2.0,5.0,5.0,1.0,2.0,0.0,5.0,0.0,2.0,0.0,8.0,1.0,4.0,1.0,2.0,5.0,0.0,3.0,2.0,4.0,3.0,5.0,4.0,0.0,1.0,1.0,0.0,0.0,4.0,5.0,1.0,0.0,5.0,1.0,1.0,0.0,3.0,5.0,2.0,5.0,1.0,2.0,2.0,5.0,0.0,4.0,1.0,0.0,0.0,5.0,2.0,1.0,5.0,3.0,2.0,1.0,5.0,1.0,5.0,5.0,5.0,2.0,9.0,12.0,0.0,0.0,0.0,2.0,0.0,5.0,1.0,1.0,3.0,5.0,5.0,5.0,0.0,3.0,0.0,3.0,5.0,5.0,3.0,5.0,1.0,1.0,5.0,5.0,1.0,3.0,4.0,2.0,5.0,2.0,11.0,6.0,3.0,5.0,2.0,5.0,3.0,3.0,5.0,3.0,3.0,0.0,,3.0,4.0,3.0,0.0,5.0,2.0,0.0,4.0,3.0,4.0,2.0,5.0,1.0,2.0,1.0,0.0,0.0,0.0,5.0,5.0,2.0,2.0,1.0,5.0,5.0,0.0,5.0,4.0,1.0,5.0,1.0,13.0,4.0,0.0,4.0,5.0,5.0,8.0,3.0,5.0,0.0,6.0,3.0,5.0,0.0,0.0,4.0,4.0,6.0,5.0,5.0,3.0,2.0,1.0,2.0,2.0,4.0,5.0,1.0,5.0,0.0,2.0,5.0,1.0,5.0,6.0,4.0,4.0,5.0,5.0,2.0,4.0,5.0,1.0,4.0,6.0,12.0,2.0,0.0,7.0,15.0,8.0,4.0,4.0,0.0,3.0,2.0,2.0,,0.0,2.0,3.0,5.0,5.0,5.0,5.0,1.0,1.0,5.0,5.0,1.0,0.0,0.0,1.0,3.0,5.0,5.0,4.0,4.0,1.0,5.0,5.0,3.0,2.0,5.0,2.0,0.0,1.0,5.0,1.0,0.0,,0.0,1.0,0.0,5.0,4.0,2.0,5.0,2.0,3.0,5.0,1.0,2.0,4.0,2.0,4.0,3.0,4.0,4.0,5.0,5.0,3.0,3.5,7.0,5.0,3.0,3.0,2.0,3.0,0.0,4.0,3.0,4.0,4.0,5.0,5.0,1.0,1.0,3.0,0.0,4.0,5.0,2.0,0.0,0.0,4.0,10.0,2.0,5.0,5.0,5.0,5.0,5.0,5.0,5.0,4.0,3.0,4.0,5.0,5.0,1.0,3.0,3.0,2.0,2.0,4.0,4.0,1.0,0.0,3.0,0.0,2.0,3.0,0.0,2.0,1.0,0.0,4.0,5.0,3.0,4.0,0.0,3.0,1.0,5.0,1.0,4.0,3.0,5.0,4.0,5.0,2.0,5.0,3.0,3.0,4.0,5.0,0.0,5.0,3.0,3.0,0.0,5.0,1.0,5.0,1.0,1.0,0.0,5.0,3.0,5.0,3.0,5.0,1.0,2.0,2.0,4.0,0.0,5.0,5.0,5.0,5.0,5.0,5.0,5.0,3.0,5.0,1.0,2.0,2.0,5.0,5.0,5.0,1.0,0.0,4.0,1.0,3.0,0.0,0.0,0.0,0.0,0.0,0.0,0.0,0.0,3.0,1.0,5.0,0.0,3.0,3.0,1.0,5.0,3.0,5.0,5.0,0.0,0.0,5.0,4.0,1.0,9.0,4.0,4.0,4.0,6.0,0.0,10.0,7.0,1.0,0.0,0.0,5.0,2.0,5.0,1.0,0.0,1.0,0.0,2.0,2.0,5.0,1.0,2.0,5.0,2.0,0.0,5.0,2.0,5.0,3.0,5.0,1.0,5.0,1.0,1.0,4.0,1.0,3.0,5.0,2.0,0.0,5.0,5.0,3.0,4.0,4.0,4.0,4.0,13.0,5.0,1.0,2.0,4.0,5.0,5.0,3.0,2.0,2.0,5.0,5.0,0.0,3.0,3.0,6.0,0.0,0.0,2.0,5.0,5.0,3.0,1.0,1.0,2.0,1.0,0.0,0.0,0.0,1.0,0.0,4.0,10.0,5.0,0.0,2.0,3.0,0.0,5.0,4.0,3.0,5.0,5.0,5.0,3.0,2.0,2.0,5.0,1.0,5.0,5.0,5.0,2.0,4.0,0.0,3.0,1.0,1.0,5.0,2.0,5.0,3.0,5.0,,1.0,3.0,1.0,2.0,2.0,5.0,0.0,4.0,0.0,2.0,0.0,2.0,0.0,0.0,0.0,0.0,2.0,0.0,1.0,1.0,0.0,3.0,0.0,0.0,3.0,5.0,3.0,2.0,5.0,0.0,5.0,5.0,4.0,5.0,2.0,5.0,5.0,5.0,0.0,5.0,2.0,4.0,5.0,5.0,0.0,4.0,5.0,4.0,3.0,2.0,5.0,5.0,4.0,3.0,3.0,4.0,4.0,4.0,3.0,0.0,0.0,0.0,0.0,0.0,0.0,0.0,0.0,0.0,0.0,0.0,0.0,0.0,0.0,1.0,0.0,0.0,0.0,1.0,5.0,5.0,5.0,3.0,5.0,4.0,5.0,5.0,5.0,4.0,5.0,5.0,4.0,3.0,5.0,6.0,1.0,0.0,3.0,0.0,5.0,4.0,0.0,0.0,0.0,0.0,0.0,0.0,0.0,0.0,0.0,0.0,0.0,0.0,0.0,8.0,0.0,0.0,0.0,0.0,0.0,0.0,0.0,5.0,9.0,6.0,0.0,0.0,0.0,0.0,0.0,0.0,2.0,1.0,2.5714285714285716,0.0,0.0,3.0,0.0,1.5,7.0,3.0,6.0,6.0,0.0,1.0,1.0,1.0,8.0,8.0,5.0,4.0,0.0,0.0,0.0,0.0,0.0,4.0,0.0,2.0,0.0,3.0,0.0,0.0,5.0,0.0,7.0,5.0,1.0,7.0,0.0,1.5,0.0,0.0,0.0,0.0,7.0,0.0,6.0,4.0,4.0,0.0,3.0,0.0,0.0,2.0,3.0,3.0,4.0,0.0,1.0,3.0,2.5,2.0,0.0,9.0,1.6666666666666667,0.0,0.0,4.0,0.0,1.0,0.0,3.0,10.0,0.0,4.0,8.0,11.0,0.0,0.0,0.0,4.0,0.0,5.0,5.0,6.0,0.0,6.0,7.0,0.0,4.0,0.0,1.0,0.0,0.0,5.0,2.0,0.0,0.0,12.0,0.0,1.0,5.0,0.0,0.0,5.0,0.0,0.0,2.0,4.0,0.0,6.0,0.0,0.0,1.0,1.0,0.0,0.0,2.5,1.0,0.0,1.0,2.0,0.0,4.0,0.0,4.0,0.0,2.0,0.0,0.0,0.0,1.0,0.0,5.0,0.0,2.0,0.0,0.0,2.0,2.0,7.0,4.0,7.0,5.0,0.0,3.0,6.0,6.0,3.0,0.0,4.0,0.0,0.0,2.0,1.0,0.0,0.0,6.0,3.0,7.0,1.0,5.0,0.0,3.0,3.0,6.0,0.0,0.0,0.0,7.0,3.0,0.0,2.0,0.0,0.0,1.0,4.0,6.0,4.0,0.0,2.0,9.0,5.0,0.0,0.0,2.0,0.0,0.0,1.5,5.0,0.0,0.0,2.0,3.0,0.0,0.0,3.0,3.0,0.0,0.0,5.0,2.0,4.0,0.0,5.0,1.5,7.0,0.0,6.0,2.0,2.0,4.0,2.0,10.0,0.0,4.0,0.0,6.0,5.0,0.0,2.0,0.0,0.0,3.0,3.0,4.0,1.0,0.0,4.0,6.0,0.0,0.0,2.0,0.0,0.0,0.0,0.0,6.0,3.0,0.0,0.0,2.0,3.0,1.5,0.0,0.0,0.0,3.0,1.0,1.0,3.0,4.0,4.0,5.0,1.0,0.0,5.0,1.0,2.0,5.0,0.0,4.0,1.0,0.0,5.0,5.0,1.0,5.0,4.0,2.0,2.0,5.0,6.0,0.0,5.0,3.0,2.0,4.0,9.0,10.0,6.0,6.0,4.0,4.0,4.0,8.0,0.0,4.0,4.0,14.0,4.0,4.0,1.0,6.0,9.0,16.0,5.0,7.0,8.0,6.0,10.0,7.0,9.0,13.0,4.0,9.0,11.0,7.0,4.0,3.0,4.0,1.0,10.0,6.0,9.0,2.0,4.0,12.0,3.0,9.0,23.0,9.0,5.0,11.0,2.0,11.0,4.0,6.0,5.0,0.0,1.0,2.0,7.0,4.0,0.0,3.0,0.0,3.0,3.0,6.5,11.0,6.0,15.0,12.0,17.0,13.0,6.0,6.0,6.0,12.0,11.0,8.0,4.0,2.0,10.0,3.0,12.0,7.0,12.0,5.0,5.0,3.0,3.0,10.0,3.0,9.0,12.0,5.0,7.0,5.0,7.0,12.0,13.0,2.0,12.0,11.0,10.0,3.0,9.0,18.0,7.0,6.0,5.0,5.0,0.0,3.0,3.0,10.0,3.0,5.0,3.0,10.0,4.0,8.0,7.0,7.0,4.0,4.0,10.0,2.0,7.0,4.0,2.0,7.0,4.0,6.0,19.0,13.0,7.0,0.0,0.0,0.0,0.0,0.0,0.0,0.0,0.0,0.0,0.0,1.0,0.0,0.0,5.0,0.0,0.0,0.0,8.0,13.0,16.0,7.0,0.0,0.0,0.0,0.0,0.0,0.0,0.0,0.0,0.0,0.0,0.0,0.0,0.0,0.0,0.0,0.0,0.0,0.0,4.0,9.0,3.0,3.0,1.0,5.0,5.0,5.0,5.0,3.0,5.0,0.0,0.0,0.0,0.0,0.0,0.0,0.0,0.0,5.0,5.0,5.0,4.0,5.0,1.0,5.0,5.0,5.0,5.0,5.0,5.0,3.0,0.0,18.0,20.0,1.0,3.0,6.0,10.0,20.0,3.0,13.0,15.0,12.0,14.0,3.0,1.0,5.0,5.0,8.0,2.0,1.0,11.0,3.0,6.0,5.0,1.0,22.0,10.0,,2.0,12.0,5.0,5.0,5.0,5.0,5.0,4.0,5.0,5.0,5.0,5.0,5.0,5.0,5.0,5.0,5.0,5.0,5.0,4.0,5.0,5.0,3.0,5.0,5.0,5.0,4.0,,,4.0,6.0,5.0,0.0,3.0,5.0,4.0,9.0,2.0,3.0,4.0,4.0,7.0,2.0,5.0,4.0,1.0,0.0,0.0,1.0,2.0,6.0,3.0,4.0,3.0,1.0,2.0,3.0,0.0,2.0,1.0,1.0,3.0,5.0,4.0,3.0,3.0,2.0,4.0,4.0,3.0,2.0,0.0,3.0,3.0,2.0,5.0,5.0,0.0,3.0,2.0,4.0,1.0,12.0,8.0,2.0,1.0,2.0,1.0,2.0,1.0,0.0,1.0,4.0,1.0,1.0,2.0,0.0,1.0,0.0,1.0,3.0,0.0,0.0,1.0,2.0,1.0,1.0,5.0,1.0,0.0,5.0,4.0,4.0,8.0,1.0,2.0,2.0,2.0,0.0,2.0,3.0,2.0,5.0,4.0,3.0,4.0,2.0,4.0,2.0,1.0,0.0,5.0,0.0,2.0,2.0,0.0,1.0,0.0,4.0,3.0,0.0,0.0,2.0,3.0,5.0,6.0,4.0,0.0,3.0,7.0,3.0,3.0,3.0,1.0,4.0,3.0,0.0,1.0,1.0,0.0,0.0,0.0,0.0,0.0,0.0,0.0,0.0,0.0,0.0,0.0,0.0,0.0,0.0,0.0,0.0,0.0,0.0,0.0,0.0,0.0,0.0,0.0,0.0,0.0,0.0,0.0,0.0,0.0,0.0,1.0,0.0,0.0,0.0,0.0,0.0,0.0,0.0,1.0,5.0,1.0,0.0,0.0,0.0,0.0,0.0,5.0,5.0,5.0,5.0,5.0,5.0,5.0,5.0,3.0,2.0,5.0,5.0,5.0,1.0,1.0,2.0,5.0,5.0,4.0,2.0,5.0,5.0,2.0,5.0,5.0,5.0,7.0,3.0,13.0,8.5,2.0,9.0,4.0,5.0,8.0,7.0,7.0,9.0,6.0,4.0,9.0,6.0,7.0,8.0,10.0,6.0,10.0,7.0,6.0,6.0,6.0,6.0,3.0,3.0,11.0,6.0,5.0,6.0,6.0,5.0,6.0,2.0,3.0,8.0,10.5,3.0,6.0,3.0,6.0,8.0,7.0,4.0,7.0,5.0,2.0,4.0,7.0,11.0,9.0,8.0,8.0,10.0,10.0,8.0,7.0,11.0,6.0,8.0,6.0,4.0,6.0,2.0,7.0,6.0,7.0,10.0,7.0,6.0,6.0,7.0,8.0,11.0,7.0,12.0,6.0,6.0,10.0,6.0,7.0,9.0,10.0,7.0,2.0,9.0,9.0,10.0,11.0,5.0,1.0,5.0,7.0,6.0,7.0,10.0,6.0,8.0,5.0,8.0,9.0,8.0,7.0,6.0,9.0,10.0,9.0,8.0,10.0,10.0,9.0,10.0,8.0,9.0,11.0,7.0,7.0,8.0,7.0,3.0,5.0,5.0,2.0,1.0,6.0,4.0,4.0,2.0,6.0,6.0,1.0,4.0,4.0,2.0,3.0,2.0,6.0,8.0,2.0,8.0,3.0,3.0,4.0,4.0,4.0,7.0,5.0,4.0,0.0,3.0,5.0,2.0,2.0,3.0,7.0,9.0,8.0,7.0,7.0,15.0,7.0,7.0,10.0,4.0,8.0,6.0,7.0,9.0,5.0,15.0,17.0,5.0,7.0,9.0,8.0,15.0,13.0,13.0,12.0,7.0,16.0,10.0,6.0,6.0,12.0,4.0,17.0,5.0,11.0,7.0,4.0,14.0,15.0,6.0,12.0,13.0,8.0,11.0,14.0,12.0,7.0,5.0,4.0,10.0,6.0,10.0,13.0,12.0,8.0,7.0,7.0,5.0,9.0,8.0,6.0,12.0,10.0,6.0,0.0,0.0,0.0,0.0,0.0,0.0,0.0,0.0,0.0,0.0,1.0,2.0,2.0,6.0,2.0,2.0,0.0,6.0,7.0,13.0,3.0,0.0,0.0,2.0,1.0,1.0,0.0,0.0,0.0,2.0,4.0,1.0,3.0,2.0,2.0,1.0,4.0,3.0,0.0,2.0,0.0,0.0,0.0,1.0,4.0,1.0,0.0,1.0,2.0,8.0,0.0,29.0,18.0,1.0,6.0,57.0,1.0,9.0,13.0,19.0,2.0,8.0,12.0,17.0,16.0,21.0,4.0,5.0,0.0,0.0,39.0,29.0,18.0,9.0,13.0,19.0,6.0,14.0,6.0,1.0,28.0,6.0,6.0,6.0,15.0,6.0,35.0,5.0,11.0,10.0,10.0,22.0,23.0,9.0,8.0,21.0,19.0,23.0,1.0,2.0,14.0,22.0,3.0,5.0,2.0,5.0,24.0,4.0,12.0,28.0,12.0,5.0,6.0,1.0,1.0,2.0,25.0,5.0,8.0,14.0,0.0,3.0,15.0,18.0,4.0,2.0,20.0,16.0,2.0,1.0,21.0,42.0,11.0,6.0,2.0,10.0,20.0,3.0,8.0,5.0,43.0,14.0,3.0,0.0,27.0,6.0,8.0,7.0,1.0,14.0,8.0,29.0,13.0,7.0,19.0,12.0,7.0,12.0,8.0,3.0,32.0,36.0,0.0,3.0,7.0,8.0,16.0,4.0,2.0,6.0,19.0,7.0,4.0,20.0,6.0,3.0,2.0,3.0,43.0,9.0,14.0,3.0,7.0,19.0,5.0,22.0,0.0,36.0,24.0,5.0,11.0,6.0,0.0,6.0,1.0,0.0,17.0,7.0,6.0,15.0,0.0,7.0,4.0,1.0,1.0,1.0,15.0,9.0,12.0,24.0,17.0,0.0,9.0,19.0,7.0,4.0,3.0,6.0,11.0,4.0,8.0,27.0,12.0,4.0,15.0,12.0,0.0,14.0,5.0,7.0,1.0,16.0,18.0,15.0,9.0,4.0,4.0,2.0,17.0,31.0,11.0,21.0,7.0,5.0,18.0,1.0,2.0,3.0,1.0,0.0,0.0,10.0,1.0,7.0,0.0,6.0,0.0,2.0,11.0,7.0,8.0,4.0,12.0,6.0,6.0,5.0,0.0,7.0,6.0,2.0,4.0,11.0,4.0,8.0,2.0,3.0,12.0,1.0,4.0,0.0,9.0,11.0,21.0,10.0,5.0,0.0,16.0,7.0,4.0,0.0,0.0,0.0,2.0,10.0,4.0,17.0,0.0,0.0,4.0,23.0,0.0,1.0,10.0,16.0,26.0,1.0,0.0,0.0,14.0,2.0,1.0,8.0,4.0,9.0,8.0,1.0,3.0,17.0,17.0,7.0,4.0,24.0,13.0,0.0,16.0,11.0,9.0,23.0,2.0,13.0,3.0,5.0,4.0,2.0,5.0,0.0,10.0,11.0,15.0,3.0,3.0,6.0,2.0,3.0,25.0,10.0,0.0,11.0,6.0,10.0,4.0,4.0,1.0,11.0,6.0,13.0,13.0,4.0,5.0,0.0,13.0,5.0,4.0,0.0,5.0,1.0,8.0,1.0,26.0,1.0,7.0,18.0,8.0,9.0,15.0,16.0,12.0,22.0,15.0,11.0,10.0,1.0,3.0,25.0,4.0,3.0,11.0,18.0,14.0,1.0,29.0,6.0,8.0,7.0,5.0,,6.0,3.0,4.0,10.0,7.0,10.0,5.0,7.0,3.0,9.0,1.0,20.0,15.0,1.0,1.0,2.0,13.0,18.0,30.0,13.0,9.0,1.0,15.0,0.0,7.0,4.0,11.0,5.0,15.0,27.0,16.0,1.0,19.0,11.0,13.0,0.0,13.0,7.0,0.0,7.0,12.0,9.0,1.0,9.0,9.0,0.0,24.0,20.0,1.0,16.0,4.0,1.0,18.0,23.0,4.0,5.0,0.0,7.0,3.0,15.0,5.0,31.0,7.0,5.0,2.0,5.0,7.0,8.0,2.0,13.0,4.0,6.0,7.0,7.0,0.0,21.0,2.0,0.0,3.0,8.0,7.0,0.0,11.0,4.0,8.0,6.0,4.0,10.0,3.0,31.0,1.0,1.0,5.0,6.0,4.0,13.0,13.0,17.0,19.0,5.0,21.0,0.0,1.0,6.0,12.0,1.0,6.0,17.0,18.0,8.0,8.0,0.0,5.0,9.0,14.0,0.0,1.0,1.0,0.0,4.0,1.0,19.0,6.0,20.0,9.0,1.0,2.0,8.0,32.0,2.0,3.0,4.0,2.0,10.0,1.0,4.0,4.0,5.0,5.0,6.0,2.0,0.0,17.0,8.0,7.0,1.0,16.0,12.0,26.0,10.0,15.0,5.0,22.0,26.0,11.0,0.0,22.0,3.0,2.0,17.0,0.0,2.0,4.0,1.0,11.0,5.0,7.0,0.0,6.0,4.0,5.0,8.0,7.0,6.0,7.0,3.0,1.0,16.0,4.0,19.0,33.0,2.0,14.0,6.0,1.0,20.0,2.0,20.0,6.0,25.0,7.0,11.0,1.0,29.0,4.0,13.0,9.0,1.0,1.0,13.0,3.0,11.0,2.0,14.0,6.0,9.0,15.0,3.0,24.0,22.0,0.0,11.0,9.0,6.0,6.0,14.0,23.0,21.0,2.0,13.0,2.0,8.0,14.0,7.0,14.0,3.0,2.0,3.0,3.0,1.0,14.0,3.0,8.0,4.0,2.0,24.0,0.0,2.0,12.0,3.0,1.0,6.0,20.0,3.0,1.0,2.0,1.0,3.0,13.0,6.0,17.0,0.0,1.0,21.0,0.0,1.0,5.0,13.0,3.0,0.0,7.0,7.0,12.0,4.0,2.0,0.0,1.0,21.0,5.0,5.0,6.0,3.0,0.0,34.0,0.0,23.0,0.0,5.0,4.0,1.0,3.0,6.0,18.0,0.0,9.0,9.0,4.0,8.0,0.0,3.0,7.0,0.0,11.0,21.0,14.0,9.0,4.0,6.0,3.0,12.0,2.0,7.0,1.0,8.0,1.0,3.0,23.0,4.0,3.0,8.0,3.0,10.0,4.0,1.0,7.0,21.0,4.0,0.0,3.0,4.0,3.0,5.0,23.0,5.0,10.0,18.0,3.0,25.0,3.0,0.0,8.0,1.0,0.0,3.0,9.0,0.0,3.0,3.0,5.0,8.0,5.0,4.0,37.0,19.0,9.0,3.0,2.0,0.0,14.0,4.0,5.0,3.0,8.0,11.0,4.0,1.0,0.0,20.0,15.0,6.0,4.0,14.0,0.0,13.0,10.0,5.0,21.0,15.0,5.0,17.0,8.0,7.0,0.0,3.0,0.0,15.0,2.0,1.0,11.0,20.0,1.0,7.0,2.0,1.0,31.0,8.0,3.0,7.0,2.0,5.0,3.0,23.0,6.0,24.0,8.0,5.0,2.0,11.0,8.0,28.0,4.0,22.0,21.0,2.0,20.0,3.0,2.0,20.0,14.0,2.0,9.0,17.0,5.0,30.0,21.0,8.0,25.0,16.0,10.0,19.0,8.0,26.0,0.0,0.0,2.0,2.0,0.0,13.0,2.0,6.0,6.0,2.0,3.0,10.0,1.0,3.0,3.0,5.0,5.0,5.0,5.0,5.0,1.0,3.0,5.0,5.0,3.0,5.0,5.0,5.0,4.0,5.0,4.0,5.0,4.0,5.0,1.0,3.0,0.0,5.0,2.0,5.0,4.0,5.0,0.0,4.0,4.0,3.0,0.0,0.0,0.0,0.0,0.0,4.0,0.0,0.0,2.0,2.0,0.0,0.0,0.0,0.0,0.0,0.0,0.0,0.0,0.0,0.0,0.0,0.0,0.0,0.0,0.0,0.0,0.0,0.0,0.0,0.0,9.0,5.0,11.0,0.0,17.0,0.0,0.0,0.0,5.0,5.0,9.0,12.0,6.0,9.0,5.0,9.0,12.0,6.0,14.0,0.0,18.0,15.0,3.0,4.0,19.0,9.0,12.0,15.0,14.0,0.0,3.0,9.0,5.0,7.0,12.0,3.0,6.0,1.0,3.0,29.0,3.0,4.0,0.0,3.0,4.0,3.0,3.0,4.0,14.0,3.0,8.0,9.0,16.0,2.0,2.0,10.0,6.0,3.0,8.0,9.0,17.0,14.0,19.0,6.0,2.0,1.0,5.0,2.0,7.0,37.0,8.0,7.0,7.0,2.0,17.0,9.0,12.0,1.0,1.0,15.0,7.0,12.0,1.0,12.0,13.0,2.0,25.0,0.0,2.0,0.0,6.0,5.0,8.0,9.0,3.0,6.0,7.0,0.0,26.0,7.0,36.0,12.0,20.0,4.0,19.0,5.0,7.0,13.0,3.0,12.0,20.0,9.0,11.0,21.0,16.0,0.0,2.0,15.0,6.0,14.0,14.0,17.0,17.0,9.0,11.0,22.0,13.0,16.0,10.0,14.0,15.0,19.0,14.0,9.0,14.0,16.0,12.0,13.0,8.0,15.0,16.0,13.0,12.0,8.0,5.0,18.0,13.0,2.0,2.0,7.0,9.0,6.0,18.0,10.0,19.0,17.0,11.0,13.0,13.0,2.0,16.0,1.0,0.0,13.0,13.0,18.0,16.0,16.0,8.0,9.0,12.0,11.0,7.0,17.0,6.0,2.0,13.0,3.0,19.0,5.0,11.0,11.0,20.0,19.0,17.0,20.0,20.0,4.0,4.0,8.0,5.0,4.0,14.0,14.0,10.0,14.0,20.0,15.0,8.0,18.0,12.0,11.0,13.0,4.0,10.0,12.0,11.0,3.0,6.0,2.0,10.0,12.0,7.0,10.0,14.0,4.0,14.0,13.0,3.0,3.0,7.0,2.0,7.0,4.0,1.0,7.0,14.0,15.0,13.0,9.0,6.0,0.0,1.0,5.0,0.0,14.0,3.0,20.0,7.0,15.0,12.0,13.0,24.0,14.0,11.0,11.0,9.0,1.0,8.0,6.0,8.0,1.0,8.0,13.0,25.0,17.0,0.0,0.0,0.0,0.0,0.0,0.0,0.0,0.0,0.0,0.0,0.0,0.0,0.0,0.0,0.0,0.0,0.0,0.0,0.0,0.0,0.0,0.0,0.0,0.0,0.0,0.0,0.0,0.0,0.0,0.0,0.0,0.0,0.0,0.0,0.0,0.0,0.0,0.0,0.0,0.0,0.0,0.0,0.0,0.0,0.0,0.0,0.0,0.0,0.0,0.0,0.0,0.0,0.0,0.0,0.0,0.0,0.0,5.0,0.0,5.0,1.0,0.0,0.0,1.0,1.0,5.0,2.0,2.0,5.0,2.0,3.0,0.0,1.0,5.0,1.0,1.0,1.0,0.0,0.0,1.0,2.0,4.0,5.0,2.0,4.0,5.0,1.0,4.0,5.0,5.0,1.0,5.0,3.0,5.0,5.0,4.0,5.0,2.0,5.0,4.0,5.0,1.0,5.0,0.0,4.0,5.0,2.0,5.0,5.0,5.0,5.0,5.0,5.0,3.0,5.0,5.0,0.0,2.0,4.0,5.0,4.0,5.0,3.0,5.0,5.0,5.0,3.0,5.0,2.0,5.0,2.0,5.0,1.0,3.0,5.0,7.0,5.0,4.0,7.0,3.0,2.0,7.0,4.0,3.0,5.0,3.0,1.0,3.0,5.0,5.0,1.0,4.0,5.0,2.0,0.0,5.0,5.0,0.0,5.0,0.0,5.0,0.0,0.0,0.0,0.0,5.0,0.0,5.0,0.0,0.0,5.0,5.0,5.0,3.0,0.0,4.0,5.0,0.0,5.0,5.0,5.0,5.0,5.0,0.0,5.0,2.0,4.0,5.0,5.0,5.0,0.0,5.0,5.0,0.0,0.0,5.0,0.0,5.0,0.0,5.0,5.0,3.0,6.0,10.0,0.0,3.0,10.0,0.0,1.0,2.0,4.0,0.0,3.0,3.0,3.0,3.0,4.0,12.0,5.0,1.0,15.0,0.0,7.0,5.0,15.0,4.0,0.0,15.0,1.0,0.0,1.0,1.0,1.0,6.0,1.0,6.0,4.0,2.0,3.0,2.0,7.0,3.0,3.0,2.0,2.0,0.0,1.0,3.0,4.0,7.0,6.0,6.0,8.0,3.0,12.0,5.0,3.0,1.0,0.0,9.0,2.0,3.0,1.0,2.0,3.0,9.0,1.0,1.0,1.0,6.0,3.0,1.0,3.0,10.0,4.0,0.0,0.0,5.0,1.0,1.0,2.0,7.0,7.0,4.0,9.0,0.0,3.0,2.0,0.0,1.0,1.0,4.0,6.0,3.0,2.0,8.0,4.0,5.0,4.0,3.0,2.0,1.0,10.0,5.0,18.0,7.0,9.0,4.0,10.0,4.0,2.0,2.0,0.0,0.0,1.0,5.0,3.0,1.0,4.0,6.0,3.0,0.0,2.0,1.0,1.0,1.0,3.0,1.0,0.0,1.0,1.0,3.0,5.0,3.0,7.0,6.0,9.0,1.0,2.0,2.0,5.0,4.0,4.0,2.0,3.0,4.0,7.0,6.0,0.0,0.0,1.0,0.0,10.0,11.0,13.0,8.0,4.0,13.0,11.0,8.0,18.0,5.0,6.0,7.0,5.0,4.0,0.0,0.0,0.0,0.0,0.0,0.0,0.0,8.0,0.0,0.0,9.0,0.0,0.0,0.0,4.0,1.0,4.0,0.0,0.0,6.0,6.0,4.0,7.0,3.0,9.0,32.0,27.0,13.0,12.0,9.0,4.0,4.0,2.0,6.0,5.0,8.0,8.0,1.0,0.0,8.0,11.0,28.0,2.0,2.0,24.0,0.0,0.0,14.0,3.0,6.0,10.0,4.0,2.0,6.0,0.0,6.0,0.0,18.0,8.0,3.0,5.0,4.0,2.0,5.0,5.0,0.0,5.0,5.0,5.0,5.0,5.0,4.0,5.0,1.0,5.0,5.0,5.0,5.0,5.0,5.0,3.0,5.0,5.0,5.0,5.0,5.0,5.0,5.0,3.0,1.0,5.0,5.0,5.0,4.0,3.0,5.0,5.0,4.0,5.0,5.0,5.0,3.0,5.0,3.0,19.0,2.0,0.0,9.0,0.0,0.0,0.0,18.0,12.0,5.0,0.0,2.0,4.0,7.0,6.0,4.0,1.0,7.0,1.0,31.0,33.0,27.0,13.0,7.0,11.0,0.0,0.0,2.0,1.0,0.0,7.0,5.0,21.0,0.0,5.0,4.0,15.0,12.0,13.0,5.0,3.0,20.0,19.0,0.0,21.0,20.0,12.0,22.0,18.0,7.0,9.0,14.0,14.0,1.0,0.0,21.0,19.0,18.0,40.0,4.0,0.0,6.0,2.0,3.0,1.0,1.0,1.0,28.0,27.0,8.0,2.0,8.0,3.0,4.0,16.0,8.0,5.0,3.0,7.0,6.0,8.0,4.0,2.0,7.0,11.0,5.0,1.0,5.0,5.0,5.0,5.0,3.0,5.0,2.0,15.0,9.0,11.0,5.0,13.0,11.0,10.0,15.0,9.0,10.0,0.0,0.0,0.0,0.0,2.0,3.0,0.0,0.0,0.0,4.0,0.0,0.0,0.0,0.0,0.0,3.0,0.0,0.0,7.0,2.0,2.0,5.0,2.0,16.0,2.0,45.0,0.0,2.0,0.0,0.0,0.0,5.0,0.0,0.0,0.0,0.0,0.0,1.0,2.0,2.0,1.0,3.0,1.0,0.0,1.0,0.0,0.0,1.0,2.0,0.0,0.0,1.0,1.0,1.0,0.0,1.0,1.0,1.0,0.0,0.0,1.0,1.0,1.0,1.0,2.0,1.0,0.0,0.0,1.0,0.0,2.0,2.0,0.0,1.0,5.0,1.0,1.0,1.0,1.0,1.0,2.0,1.0,0.0,1.0,1.0,0.0,1.0,2.0,1.0,1.0,1.0,0.0,3.0,1.0,0.0,0.0,1.0,1.0,1.0,0.0,0.0,1.0,0.0,0.0,1.0,0.0,1.0,0.0,0.0,1.0,0.0,1.0,0.0,1.0,1.0,1.0,2.0,0.0,4.0,3.0,2.0,3.0,0.0,7.0,0.0,3.0,1.0,9.0,0.0,2.0,1.0,0.0,0.0,0.0,0.0,1.0,0.0,1.0,1.0,0.0,0.0,0.0,2.0,1.0,1.0,4.0,1.0,1.0,2.0,2.0,7.0,0.0,2.0,0.0,0.0,2.0,4.0,0.0,2.0,1.0,1.0,1.0,0.0,1.0,2.0,0.0,7.0,2.0,0.0,0.0,2.0,1.0,0.0,2.0,2.0,0.0,1.0,4.0,3.0,0.0,0.0,9.0,7.0,1.0,0.0,0.0,0.0,0.0,1.0,1.0,1.0,4.0,0.0,0.0,0.0,2.0,0.0,1.0,0.0,0.0,1.0,0.0,0.0,0.0,0.0,4.0,0.0,2.0,1.0,1.0,2.0,1.0,11.0,1.0,0.0,0.0,0.0,0.0,0.0,2.0,2.0,2.0,4.0,0.0,0.0,4.0,0.0,10.0,0.0,0.0,0.0,0.0,0.0,0.0,2.0,1.0,0.0,7.0,0.0,0.0,7.0,0.0,2.0,0.0,0.0,0.0,1.0,0.0,0.0,0.0,0.0,0.0,0.0,0.0,6.0,4.0,1.0,4.0,6.0,5.0,4.0,2.0,6.0,3.0,1.0,3.0,3.0,3.0,4.0,7.0,8.0,5.0,0.0,4.0,2.0,2.0,3.0,3.0,4.0,5.0,4.0,0.0,4.0,3.0,0.0,12.0,12.0,8.0,11.0,7.0,10.0,12.0,7.0,10.0,7.0,7.0,8.0,12.0,7.0,9.0,9.0,8.0,5.0,5.0,5.0,5.0,1.0,5.0,5.0,3.0,5.0,1.0,2.0,2.0,3.0,0.0,3.0,3.0,0.0,9.0,1.0,4.0,6.0,0.0,7.0,2.0,1.0,1.0,4.0,5.0,0.0,5.0,3.0,1.0,6.0,4.0,6.0,1.0,3.0,6.0,5.0,2.0,1.0,3.0,9.0,1.0,2.0,6.0,2.0,1.0,14.0,1.0,5.0,0.0,2.0,2.0,6.0,0.0,0.0,1.0,0.0,7.0,0.0,5.0,2.0,5.0,5.0,5.0,5.0,4.0,0.0,5.0,2.0,4.0,5.0,0.0,5.0,5.0,5.0,5.0,5.0,5.0,5.0,3.0,5.0,4.0,3.0,0.0,4.0,4.0,5.0,5.0,5.0,3.0,5.0,5.0,5.0,5.0,1.0,5.0,5.0,5.0,4.0,5.0,4.0,4.0,2.0,4.0,5.0,5.0,5.0,5.0,4.0,5.0,5.0,4.0,5.0,2.0,4.0,3.0,4.0,5.0,5.0,5.0,5.0,5.0,2.0,5.0,4.0,5.0,4.0,5.0,4.0,5.0,5.0,4.0,5.0,4.0,5.0,5.0,5.0,5.0,5.0,4.0,5.0,4.0,5.0,5.0,4.0,5.0,5.0,4.0,4.0,5.0,3.0,1.0,3.0,5.0,5.0,5.0,5.0,5.0,5.0,5.0,5.0,4.0,5.0,5.0,4.0,5.0,2.0,5.0,5.0,3.0,5.0,2.0,5.0,5.0,5.0,5.0,4.0,0.0,5.0,0.0,0.0,0.0,0.0,1.0,4.0,7.0,8.0,27.0,29.0,7.0,4.0,19.0,14.0,14.0,6.0,4.0,5.0,16.0,9.0,11.0,11.0,6.0,9.0,4.0,13.0,20.0,23.0,15.0,15.0,9.0,20.0,20.0,26.0,10.0,11.0,5.0,11.0,22.0,10.0,5.0,17.0,33.0,13.0,12.0,5.0,15.0,11.0,5.0,10.0,26.0,14.0,5.0,14.0,6.0,3.0,3.0,7.0,5.0,2.0,11.0,8.0,9.0,5.0,7.0,3.0,3.0,6.0,5.0,7.0,12.0,3.0,19.0,18.0,24.0,16.0,19.0,0.0,1.0,12.0,15.0,6.0,3.0,2.0,13.0,12.0,6.0,19.0,5.0,13.0,0.0,5.0,10.0,1.0,18.0,2.0,13.0,12.0,21.0,10.0,4.0,5.0,11.0,4.0,3.0,12.0,6.0,4.0,14.0,14.0,4.0,10.0,17.0,9.0,14.0,26.0,10.0,1.0,2.0,10.0,29.0,1.0,18.0,8.0,3.0,10.0,11.0,33.0,18.0,15.0,2.0,17.0,18.0,18.0,15.0,4.0,5.0,3.0,10.0,21.0,19.0,16.0,22.0,10.0,5.0,20.0,12.0,0.0,12.0,0.0,2.0,23.0,29.0,6.0,4.0,14.0,10.0,2.0,14.0,8.0,10.0,3.0,3.0,13.0,5.0,1.0,5.0,9.0,13.0,10.0,8.0,5.0,8.0,14.0,8.0,5.0,4.0,8.0,22.0,5.0,6.0,4.0,9.0,12.0,6.0,7.0,5.0,23.0,12.0,6.0,3.0,18.0,5.0,0.0,7.0,0.0,7.0,10.0,8.0,0.0,3.0,18.0,2.0,0.0,17.0,6.0,8.0,21.0,6.0,16.0,16.0,8.0,29.0,12.0,2.0,7.0,7.0,5.0,16.0,15.0,9.0,10.0,4.0,4.0,5.0,9.0,18.0,17.0,9.0,2.0,9.0,10.0,15.0,11.0,24.0,15.0,14.0,12.0,12.0,7.0,6.0,9.0,9.0,20.0,3.0,13.0,16.0,11.0,2.0,24.0,2.0,8.0,34.0,0.0,2.0,22.0,24.0,9.0,4.0,10.0,9.0,12.0,3.0,11.0,22.0,18.0,19.0,9.0,2.0,4.0,1.0,45.0,25.0,16.0,16.0,14.0,17.0,8.0,8.0,6.0,13.0,4.0,1.0,11.0,11.0,13.0,1.0,18.0,14.0,8.0,7.0,9.0,10.0,15.0,5.0,4.0,11.0,11.0,4.0,19.0,21.0,12.0,4.0,2.0,0.0,11.0,2.0,2.0,4.0,3.0,11.0,12.0,11.0,3.0,8.0,24.0,7.0,2.0,5.0,2.0,0.0,20.0,6.0,2.0,7.0,8.0,14.0,11.0,1.0,3.0,7.0,35.0,8.0,19.0,7.0,1.0,16.0,19.0,14.0,8.0,16.0,2.0,17.0,19.0,11.0,6.0,2.0,8.0,14.0,0.0,13.0,21.0,8.0,3.0,3.0,0.0,2.0,4.0,1.0,2.0,3.0,2.0,1.0,5.0,1.0,0.0,0.0,1.0,0.0,1.0,2.0,1.0,2.0,4.0,0.0,1.0,0.0,1.0,0.0,0.0,1.0,0.0,0.0,5.0,1.0,0.0,1.0,5.0,1.0,,3.0,5.0,5.0,0.0,0.0,0.0,1.0,0.0,1.0,0.0,4.0,2.0,0.0,2.0,0.0,1.0,1.0,0.0,0.0,0.0,1.0,0.0,0.0,1.0,0.0,3.0,0.0,1.0,1.0,5.0,3.0,0.0,2.0,0.0,4.0,1.0,5.0,1.0,0.0,0.0,1.0,0.0,2.0,0.0,1.0,1.0,0.0,2.0,1.0,5.0,0.0,0.0,0.0,0.0,0.0,0.0,5.0,1.0,0.0,0.0,0.0,1.0,2.0,4.0,1.0,0.0,3.0,1.0,3.0,2.0,1.0,0.0,1.0,2.0,0.0,5.0,0.0,3.0,2.0,0.0,1.0,4.0,3.0,1.0,3.0,3.0,1.0,4.0,0.0,3.0,5.0,3.0,9.0,1.0,1.0,0.0,5.0,4.0,2.0,6.4,1.0,0.0,0.0,2.0,8.0,1.0,2.0,2.0,5.0,5.0,3.0,7.0,2.0,4.0,14.0,0.0,5.0,1.0,6.0,0.0,0.0,2.0,0.0,3.0,2.0,4.0,10.0,2.0,7.0,8.0,5.0,5.0,0.0,2.0,3.0,3.0,2.0,5.0,0.0,7.0,7.0,11.0,2.0,6.333333333333333,3.0,19.0,12.0,2.0,0.0,8.0,4.0,1.0,2.0,2.0,6.0,5.0,4.0,2.0,3.0,3.0,5.0,5.0,2.0,1.0,1.0,10.0,1.0,0.0,4.0,5.0,4.0,1.0,0.0,1.0,2.0,6.0,1.0,2.0,1.0,6.0,4.0,0.0,3.0,0.0,2.0,4.0,2.0,2.0,8.0,3.0,5.0,2.0,3.0,3.0,2.0,5.0,16.0,2.0,1.0,5.0,4.0,0.0,0.0,3.0,1.0,12.0,7.0,8.0,9.0,4.0,0.0,1.0,4.0,5.0,9.0,4.0,1.0,2.0,3.0,2.0,3.5,4.0,0.0,6.0,4.0,2.0,5.0,7.0,0.0,2.0,6.0,3.0,4.0,1.0,1.0,7.0,3.0,8.0,2.0,8.0,4.0,10.0,0.0,4.0,8.0,0.0,3.0,10.0,12.0,0.0,0.0,1.0,3.0,3.0,7.0,3.0,1.0,1.0,2.0,5.0,3.0,6.0,1.0,1.0,2.0,0.0,9.0,2.0,7.0,5.0,4.0,5.0,2.0,1.0,4.0,5.0,3.0,4.0,1.0,4.0,9.0,1.0,11.0,4.0,5.0,14.0,0.0,8.0,17.0,4.0,11.0,6.0,4.0,21.0,15.0,1.0,11.0,3.0,1.0,15.0,1.0,4.0,12.0,14.0,11.0,9.0,1.0,5.0,0.0,2.0,10.0,3.0,12.0,14.0,0.0,7.0,9.0,3.0,4.0,4.0,14.0,11.0,11.0,15.0,18.0,11.0,11.0,3.0,7.0,14.0,4.0,9.0,2.0,11.0,8.0,2.0,14.0,5.0,3.0,3.0,7.0,11.0,4.0,10.0,19.0,25.0,18.0,3.0,7.0,27.0,6.0,6.0,4.0,14.0,25.0,26.0,18.0,7.0,4.0,0.0,10.0,8.0,15.0,16.0,4.0,3.0,0.0,20.0,13.0,0.0,4.0,15.0,11.0,6.0,7.0,4.0,1.0,10.0,9.0,3.0,10.0,0.0,7.0,13.0,18.0,3.0,7.0,17.0,0.0,15.0,10.0,3.0,12.0,0.0,25.0,15.0,3.0,0.0,13.0,4.0,4.0,16.0,15.0,17.0,2.0,14.0,18.0,12.0,17.0,20.0,14.0,19.0,14.0,20.0,16.0,9.0,12.0,5.0,2.0,10.0,10.0,5.0,9.0,3.0,16.0,2.0,1.0,10.0,11.0,5.0,13.0,7.0,9.0,0.0,17.0,12.0,19.0,17.0,5.0,6.0,5.0,2.0,19.0,10.0,7.0,2.0,0.0,8.0,11.0,5.0,2.0,1.0,7.0,7.0,10.0,15.0,13.0,14.0,8.0,13.0,16.0,2.0,5.0,5.0,9.0,15.0,14.0,11.0,16.0,4.0,3.0,18.0,8.0,11.0,11.0,9.0,6.0,12.0,8.0,8.0,4.0,3.0,2.0,14.0,14.0,3.0,3.0,14.0,14.0,0.0,8.0,2.0,7.0,14.0,13.0,9.0,13.0,14.0,14.0,10.0,6.0,11.0,8.0,12.0,14.0,5.0,14.0,9.0,18.0,2.0,5.0,7.0,3.0,1.0,0.0,0.0,13.0,8.0,1.0,4.0,14.0,1.0,14.0,12.0,5.0,11.0,3.0,8.0,13.0,7.0,11.0,9.0,12.0,7.0,7.0,9.0,18.0,1.0,5.0,11.0,0.0,8.0,6.0,12.0,6.0,12.0,14.0,12.0,15.0,3.0,6.0,19.0,12.0,7.0,10.0,7.0,10.0,11.0,24.0,10.0,5.0,13.0,6.0,8.0,13.0,8.0,12.0,7.0,8.0,5.0,16.0,11.0,12.0,13.0,12.0,8.0,9.0,4.0,9.0,0.0,0.0,0.0,0.0,0.0,0.0,16.0,7.0,0.0,4.0,1.0,4.0,16.0,25.0,5.0,1.0,3.0,0.0,1.0,7.0,15.0,16.0,10.0,11.0,4.0,3.0,1.0,16.0,8.0,6.0,6.0,10.0,11.0,1.0,2.0,10.0,5.0,0.0,3.0,2.0,7.0,11.0,4.0,12.0,3.0,5.0,1.0,8.0,9.0,4.0,0.0,2.0,5.0,16.0,3.0,3.0,1.0,2.0,6.0,1.0,2.0,9.0,1.0,3.0,15.0,4.0,10.0,9.0,0.0,1.0,6.0,9.0,0.0,10.0,6.0,3.0,19.0,5.0,3.0,11.0,8.0,14.0,7.0,5.0,3.0,4.0,4.0,2.0,4.0,3.0,3.0,0.0,6.0,9.0,1.0,3.0,1.0,4.0,5.0,7.0,45.0,20.0,14.0,14.0,12.0,5.0,0.0,15.0,7.0,5.0,7.0,0.0,11.0,17.0,5.0,27.0,10.0,13.0,13.0,5.0,6.0,3.0,8.0,6.0,12.0,9.0,3.0,0.0,9.0,7.0,1.0,2.0,10.0,2.0,8.0,4.0,11.0,38.0,9.0,16.0,3.0,17.0,1.0,3.0,25.0,0.0,0.0,9.0,5.0,1.0,10.0,36.0,7.0,9.0,3.0,4.0,10.0,6.0,3.0,8.0,14.0,5.0,5.0,3.0,18.0,6.0,9.0,7.0,2.0,8.0,2.0,11.0,3.0,4.0,8.0,2.0,0.0,2.0,19.0,3.0,5.0,7.0,8.0,6.0,8.0,5.0,25.0,9.0,7.0,4.0,14.0,14.0,8.0,2.0,0.0,5.0,3.0,5.0,10.0,3.0,19.0,8.0,4.0,7.0,15.0,10.0,1.0,5.0,2.0,2.0,3.0,2.0,14.0,2.0,3.0,5.0,10.0,6.0,4.0,6.0,7.0,5.0,1.0,3.0,3.0,0.0,16.0,3.0,7.0,3.0,2.0,3.0,2.0,16.0,4.0,1.0,20.0,10.0,4.0,10.0,14.0,1.0,3.5,16.0,6.0,3.0,24.0,1.0,1.0,5.0,2.0,0.0,10.0,1.0,6.0,9.0,7.0,2.0,1.0,5.0,0.0,5.0,16.0,12.0,8.0,13.0,0.0,6.0,11.0,13.0,1.0,11.0,5.0,3.0,8.0,38.0,0.0,14.0,3.0,15.0,6.0,9.0,6.0,2.0,0.0,0.0,16.0,4.0,13.0,8.0,2.0,14.0,17.0,5.0,2.0,1.0,10.0,10.0,33.0,1.0,6.0,3.0,3.0,2.0,3.0,8.0,1.0,11.0,10.0,5.0,6.0,7.0,0.0,1.0,4.0,12.0,0.0,5.0,5.0,7.0,11.0,2.0,0.0,3.0,4.0,4.0,1.0,4.0,5.0,4.0,7.0,1.0,0.0,10.0,9.0,5.0,4.0,7.0,12.0,4.0,3.0,3.0,1.0,11.0,9.0,2.0,18.0,16.0,5.0,10.0,14.0,25.0,0.0,8.0,7.0,6.0,6.0,1.0,0.0,1.0,8.0,9.0,4.0,6.0,2.0,0.0,6.0,7.0,9.0,5.0,5.0,7.0,6.0,3.0,3.0,3.0,3.0,5.0,1.0,17.0,3.0,11.0,16.0,11.0,29.0,3.0,4.0,4.0,6.0,6.0,5.0,9.0,1.0,7.0,6.0,0.0,1.0,3.0,11.0,23.0,22.0,5.0,0.0,10.0,1.0,9.0,3.0,3.0,23.0,16.0,6.0,0.0,17.0,7.0,1.0,2.0,10.0,6.0,2.0,7.0,1.0,0.0,2.0,9.0,8.0,14.0,9.0,4.0,26.0,12.0,0.0,14.0,18.0,2.0,19.0,0.0,7.0,10.0,6.0,11.0,5.0,16.0,7.0,10.0,6.0,23.0,13.0,12.0,17.0,7.0,0.0,16.0,13.0,2.0,14.0,9.0,5.0,18.0,25.0,21.0,30.0,6.0,27.0,5.0,10.0,16.0,6.0,4.0,8.0,10.0,1.0,2.0,5.0,1.0,12.0,6.0,6.0,9.0,1.0,13.0,12.0,8.0,5.0,3.0,3.0,14.0,4.0,3.0,23.0,5.0,8.0,4.0,4.0,6.0,24.0,17.0,6.0,5.0,11.0,6.0,7.0,10.0,17.0,2.0,0.0,5.0,19.0,15.0,23.0,6.0,0.0,2.0,2.0,9.0,0.0,8.0,0.0,5.0,5.0,8.0,5.0,1.0,10.0,15.0,10.0,16.0,4.0,3.0,13.0,12.0,16.0,4.0,6.0,4.0,7.0,2.0,10.0,9.0,2.0,4.0,1.0,6.0,4.0,0.0,8.0,2.0,3.0,8.0,14.0,49.0,5.0,8.0,6.0,8.625,17.0,5.0,5.0,4.0,10.0,3.0,4.0,14.0,8.0,2.0,2.0,7.0,1.0,9.0,18.0,13.0,3.0,9.0,8.0,2.0,7.0,12.0,2.0,2.0,1.0,5.0,6.0,3.0,5.0,4.0,12.0,2.0,3.0,3.0,6.0,11.0,8.0,3.0,9.0,7.0,7.0,3.0,9.0,4.0,15.0,8.0,3.0,2.0,1.0,0.0,1.0,6.0,3.0,1.0,2.0,8.0,9.0,4.0,4.0,7.0,5.0,6.0,4.0,4.0,8.0,14.0,3.0,7.0,6.0,0.0,13.0,8.0,4.0,0.0,11.0,4.0,0.0,3.0,0.0,0.0,4.0,4.0,12.0,1.0,9.0,20.0,12.0,5.0,9.0,2.0,4.0,0.0,7.0,5.0,6.0,6.0,2.0,6.0,1.0,5.0,6.0,10.0,11.0,2.0,3.0,24.0,0.0,6.0,3.0,7.0,10.0,7.0,7.0,2.0,6.0,4.0,3.0,9.0,3.0,13.0,13.0,8.0,14.0,10.0,8.0,5.0,5.0,25.0,4.0,6.0,9.0,8.0,22.0,2.0,2.0,2.0,4.0,1.0,7.0,7.0,6.0,4.0,7.0,5.0,21.0,2.0,10.0,3.0,7.0,17.0,7.0,6.0,2.0,0.0,36.0,13.0,0.0,9.0,8.0,7.0,0.0,4.0,7.0,2.0,2.0,10.0,7.0,23.0,3.0,5.0,6.0,10.0,14.0,0.0,15.0,7.0,3.0,3.0,12.0,7.0,3.0,4.0,10.0,9.0,3.0,5.0,3.0,11.0,13.0,20.0,10.0,3.0,15.0,8.0,8.0,19.0,54.0,10.0,5.0,5.0,3.0,10.0,10.0,3.0,3.0,2.0,15.0,7.0,6.0,7.0,9.0,3.0,10.0,2.0,3.0,5.0,1.0,2.0,19.0,6.0,2.0,9.0,2.0,9.0,18.0,26.0,2.0,6.0,6.0,12.0,8.0,7.0,4.0,12.0,22.0,8.0,6.0,3.0,0.0,25.0,2.0,7.0,4.0,7.0,2.0,5.0,4.0,0.0,2.0,12.0,6.0,7.0,5.0,15.0,20.0,11.0,3.0,7.0,6.0,5.0,16.0,19.0,2.0,3.0,1.0,2.0,11.0,3.0,1.0,18.0,7.0,4.0,11.0,6.0,8.0,3.0,5.0,8.0,1.0,11.0,7.0,13.0,16.0,3.0,4.0,5.0,10.0,3.0,2.0,10.0,2.0,6.0,3.0,9.0,16.0,9.0,7.0,4.0,8.0,0.0,9.0,3.0,6.0,6.0,26.0,1.0,5.0,22.0,6.0,6.0,7.0,4.0,2.0,3.0,3.0,4.0,13.0,0.0,6.0,1.0,7.0,22.0,0.0,3.0,4.0,24.0,23.0,3.0,29.0,18.0,11.0,5.0,4.0,6.0,14.0,3.0,0.0,5.0,6.0,4.0,2.0,17.0,4.0,17.0,7.0,16.0,1.0,5.0,0.0,8.0,12.0,6.0,10.0,12.0,7.0,3.0,13.0,9.0,2.0,8.0,1.0,2.0,11.0,14.0,10.0,3.0,0.0,0.0,11.0,11.0,2.0,3.0,4.0,3.0,10.0,20.0,7.0,6.0,14.0,2.0,14.0,16.0,7.0,1.0,8.0,1.0,7.0,10.0,13.0,3.0,7.0,5.0,7.0,5.0,8.0,4.0,5.0,7.0,11.0,15.0,9.0,5.0,18.0,10.0,5.0,24.0,1.0,7.0,5.0,0.0,5.0,4.0,10.0,11.0,2.0,9.0,4.0,10.0,10.0,5.0,9.0,9.0,7.0,23.0,9.0,3.0,8.0,1.0,4.0,0.0,5.0,9.5,11.0,10.0,1.0,2.0,4.0,30.0,24.0,20.0,10.0,3.0,5.0,0.0,4.0,0.0,11.0,30.0,14.0,10.0,8.0,7.0,0.0,5.0,13.0,1.0,5.0,13.0,1.0,0.0,18.0,1.0,19.0,5.0,9.0,7.5,27.0,7.0,7.0,7.0,26.0,50.0,4.0,6.0,3.0,7.0,1.0,4.0,6.0,10.0,15.0,20.0,5.0,24.0,17.0,8.0,3.0,2.0,4.0,21.0,16.0,17.0,5.0,12.0,22.0,6.0,1.0,6.0,2.0,4.0,4.0,1.0,12.0,1.0,5.0,0.0,18.0,14.0,9.0,1.0,18.0,4.0,0.0,26.0,2.0,,9.0,3.0,5.0,0.0,20.0,18.0,0.0,16.0,2.0,7.0,10.0,20.0,15.0,5.0,3.0,2.0,2.0,5.0,1.0,0.0,3.0,7.0,0.0,11.0,27.0,31.0,5.0,0.0,0.0,2.0,10.0,17.0,5.0,3.0,6.0,0.0,4.0,9.0,9.0,6.0,4.0,9.0,2.0,3.0,7.0,19.0,5.0,4.0,8.0,12.0,1.0,7.0,5.0,6.0,19.0,6.0,4.0,6.0,2.0,7.0,5.0,2.0,2.0,8.0,5.0,13.0,10.0,5.0,9.0,12.0,7.0,5.0,6.0,13.0,2.0,20.0,30.0,4.0,18.0,3.0,7.0,10.0,20.0,11.0,6.0,8.0,0.0,14.0,6.0,5.0,0.0,4.0,6.0,5.0,0.0,2.0,5.0,3.0,1.0,13.0,4.0,4.0,1.0,3.0,5.0,19.0,14.0,6.0,0.0,15.0,34.0,14.0,6.0,0.0,7.0,17.0,14.0,16.0,8.0,8.0,8.0,17.0,4.0,4.0,12.0,12.0,1.0,1.0,9.0,4.0,3.0,6.0,0.0,13.0,8.0,9.0,10.0,5.0,11.0,4.0,3.0,3.0,9.0,11.0,5.0,7.0,3.0,1.0,2.0,8.0,14.0,1.0,3.0,9.0,7.0,3.0,6.0,6.0,5.0,38.0,0.0,10.0,8.0,6.0,2.0,22.0,3.0,10.0,0.0,8.0,2.0,2.0,3.0,11.0,3.0,9.0,7.0,2.0,0.0,2.0,2.0,5.0,0.0,1.0,2.0,3.0,1.0,6.0,8.0,4.0,0.0,19.0,2.0,0.0,5.0,1.0,8.0,2.0,1.0,12.0,0.0,0.0,0.0,1.0,13.0,15.0,8.0,3.0,2.0,6.0,2.0,4.0,15.0,2.0,3.0,13.0,7.0,17.0,0.0,6.0,7.0,7.0,3.0,5.0,1.0,3.0,3.0,6.0,9.0,26.0,15.0,6.0,9.0,0.0,17.0,19.0,33.0,5.0,4.0,7.0,18.0,5.0,4.0,15.0,1.0,15.0,12.0,7.0,9.0,5.0,4.0,14.0,10.0,0.0,5.0,0.0,8.0,2.0,0.0,15.0,19.0,15.0,4.0,14.0,2.0,5.0,12.0,1.0,6.0,3.0,11.0,8.0,1.0,5.0,21.0,0.0,13.0,5.0,8.0,3.0,16.0,2.0,9.0,5.0,0.0,7.0,1.0,22.0,33.0,30.0,13.0,20.0,29.0,19.0,0.0,0.0,18.0,8.0,15.0,12.0,21.0,12.0,15.0,10.0,30.0,15.0,15.0,5.0,21.0,15.0,6.0,23.0,17.0,1.0,6.0,3.0,10.0,18.0,10.0,9.0,2.0,21.0,11.0,11.0,17.0,20.0,17.0,14.0,5.0,21.0,12.0,20.0,29.0,30.0,0.0,4.0,15.0,21.0,14.0,14.0,14.0,0.0,8.0,12.0,7.0,21.0,9.0,5.0,10.0,18.0,10.0,16.0,18.0,10.0,15.0,2.0,15.0,11.0,17.0,11.0,9.0,12.0,27.0,10.0,13.0,15.0,9.0,0.0,9.0,10.0,1.0,19.0,13.0,7.0,10.0,1.0,7.0,12.0,18.0,2.0,16.0,10.0,4.0,6.0,15.0,18.0,5.0,21.0,8.0,1.0,1.0,11.0,16.0,23.0,33.0,19.0,2.0,0.0,17.0,5.0,8.0,4.0,16.0,15.0,5.0,12.0,1.0,8.0,4.0,2.0,6.0,9.0,18.0,7.0,9.0,8.0,16.0,5.0,20.0,20.0,4.0,5.0,10.0,14.0,14.0,16.0,17.0,7.0,7.0,4.0,25.0,15.0,16.0,8.0,22.0,21.0,11.0,18.0,14.0,8.0,7.0,10.0,14.0,6.0,10.0,12.0,24.0,3.0,11.0,9.0,27.0,10.0,11.0,5.0,6.0,29.0,13.0,2.0,21.0,5.0,15.0,18.0,12.0,12.0,2.0,15.0,15.0,12.0,8.0,12.0,9.0,7.0,9.0,8.0,23.0,21.0,21.0,24.0,3.0,12.0,1.0,18.0,18.0,13.0,13.0,7.0,8.0,35.0,20.0,23.0,21.0,12.0,3.0,7.0,9.0,15.0,2.0,6.0,19.0,18.0,13.0,13.0,7.0,21.0,0.0,12.0,15.0,8.0,10.0,11.0,7.0,4.0,12.0,14.0,8.0,4.0,10.0,12.0,6.0,22.0,7.0,3.0,3.0,16.0,5.0,10.0,13.0,14.0,7.0,15.0,9.0,16.0,16.0,10.0,17.0,6.0,22.0,15.0,10.0,25.0,2.0,8.0,13.0,0.0,17.0,12.0,16.0,5.0,25.0,24.0,8.0,9.0,13.0,6.0,7.0,5.0,17.0,6.0,12.0,20.0,9.0,21.0,16.0,12.0,4.0,3.0,7.0,5.0,1.0,25.0,9.0,18.0,20.0,10.0,17.0,23.0,17.0,15.0,20.0,8.0,11.0,7.0,11.0,19.0,14.0,23.0,8.0,3.0,7.0,2.0,8.0,7.0,5.0,11.0,2.0,5.0,5.0,7.0,9.0,11.0,5.0,5.0,7.0,7.0,14.0,24.0,5.0,9.0,7.0,14.0,5.0,9.0,8.0,6.0,6.0,7.0,7.0,7.0,6.0,5.0,5.0,7.0,6.0,5.0,6.0,6.0,,16.0,2.0,0.0,0.0,3.0,0.0,4.0,3.0,0.0,0.0,5.0,5.0,0.0,2.0,6.0,0.0,20.0,8.0,1.0,9.0,1.0,11.0,10.0,4.0,1.0,0.0,2.0,2.0,1.0,5.0,7.0,1.0,3.0,0.0,3.0,6.0,10.0,5.0,12.0,7.0,11.0,4.0,5.0,5.0,4.0,16.0,3.0,4.0,5.0,9.0,3.0,0.0,8.0,25.0,3.0,8.0,9.0,11.0,8.0,0.0,1.0,3.0,4.0,6.0,6.0,3.0,10.0,4.0,4.0,4.0,4.0,0.0,6.0,15.0,1.0,7.0,4.0,11.0,8.0,3.0,7.0,10.0,3.0,14.0,5.0,8.0,8.0,0.0,4.0,1.0,0.0,0.0,0.0,0.0,0.0,0.0,3.0,0.0,0.0,0.0,0.0,0.0,2.0,0.0,0.0,0.0,7.0,0.0,7.0,0.0,0.0,2.0,0.0,1.0,12.0,28.0,11.0,0.0,9.0,2.0,7.0,6.0,10.0,6.0,0.0,,0.0,9.0,10.0,9.0,12.0,7.0,5.0,,3.0,11.0,5.0,2.0,6.0,9.0,8.0,17.0,6.0,14.0,7.0,12.0,13.0,2.0,4.0,4.0,7.0,19.0,2.0,9.0,8.0,3.0,8.0,5.0,9.0,2.0,7.0,10.0,25.0,4.0,5.0,2.0,5.0,7.0,3.0,6.0,7.0,8.0,15.0,10.0,6.0,3.0,1.0,4.0,5.0,7.0,8.0,20.0,4.0,3.0,2.0,13.0,9.0,11.0,12.0,9.0,6.0,6.0,13.0,14.0,8.0,4.0,8.0,10.0,8.0,12.0,0.0,14.0,8.0,1.0,14.0,13.0,0.0,13.0,6.0,17.0,20.0,10.0,14.0,9.0,5.0,17.0,7.0,10.0,3.0,1.0,,6.0,1.0,8.0,3.0,,1.0,7.0,7.0,6.0,16.0,2.0,20.0,5.0,10.0,17.0,13.0,3.0,8.0,10.0,8.0,11.0,0.0,1.0,5.0,14.0,1.0,2.0,23.0,5.0,4.0,12.0,17.0,25.0,1.0,0.0,18.0,12.0,20.0,5.0,18.0,1.0,1.0,1.0,0.0,10.0,5.0,10.0,12.0,9.0,13.0,2.0,6.0,16.0,10.0,13.0,7.0,11.0,3.0,10.0,15.0,6.0,5.0,4.0,12.0,2.0,3.0,7.0,8.0,2.0,6.0,4.0,4.0,0.0,0.0,9.0,4.0,4.0,8.0,3.0,3.0,6.0,6.0,5.0,4.0,0.0,5.0,7.0,4.0,0.0,0.0,3.0,4.0,8.0,1.0,5.0,7.0,2.0,2.0,4.0,3.0,8.0,8.0,1.0,2.0,10.0,7.0,7.0,11.0,3.0,0.0,0.0,5.0,7.0,1.0,6.0,9.0,10.0,11.0,19.0,15.0,1.0,24.0,3.0,9.0,6.0,17.0,7.0,9.0,0.0,5.0,19.0,2.0,5.0,1.0,3.0,0.0,5.0,0.0,0.0,9.0,5.0,0.0,0.0,4.0,3.0,15.0,4.0,8.0,6.0,6.0,3.0,2.0,0.0,0.0,3.0,6.0,0.0,2.0,3.0,7.0,0.0,1.0,3.0,2.0,2.0,5.0,12.0,5.0,4.0,4.0,0.0,8.0,10.0,12.0,9.0,2.0,6.0,9.0,0.0,7.0,7.0,4.0,2.0,17.0,4.0,8.0,1.0,5.0,3.0,5.0,12.0,10.0,10.0,7.0,7.0,1.0,8.0,10.0,3.0,6.0,16.0,15.0,4.0,11.0,10.0,13.0,9.0,9.0,11.0,8.0,15.0,3.0,1.0,8.0,8.0,9.0,7.0,0.0,8.0,6.0,6.0,10.0,3.0,10.0,13.0,4.0,13.0,7.0,7.0,2.0,9.0,9.0,12.0,6.0,11.0,5.0,13.0,14.0,12.0,11.0,26.0,3.0,6.0,12.0,4.0,8.0,1.0,9.0,6.0,0.0,7.0,15.0,5.0,11.0,16.0,5.0,8.0,4.0,2.0,0.0,4.0,11.0,2.0,2.0,0.0,6.0,6.0,5.0,3.0,9.0,11.0,9.0,7.0,0.0,4.0,10.0,0.0,1.0,1.0,3.0,4.0,0.0,5.0,20.0,8.0,8.0,1.0,8.0,3.0,1.0,18.0,0.0,2.0,0.0,3.0,1.0,15.0,22.0,10.0,4.0,5.0,12.0,0.0,1.0,0.0,0.0,0.0,0.0,2.0,5.0,8.0,3.0,11.0,2.0,6.0,0.0,3.0,6.0,9.0,8.0,4.0,12.0,0.0,6.0,0.0,0.0,10.0,2.0,2.0,4.0,2.0,6.0,2.0,2.0,1.0,4.0,3.0,0.0,4.0,2.0,0.0,1.0,1.0,9.0,3.0,0.0,0.0,3.0,0.0,15.0,1.0,0.0,24.0,3.0,8.0,1.0,11.0,5.0,5.0,4.0,20.0,19.0,0.0,6.0,13.0,0.0,9.0,2.0,5.0,7.0,4.0,0.0,0.0,0.0,0.0,18.0,17.0,4.0,12.0,6.0,1.0,8.0,37.0,4.0,14.0,13.0,16.0,20.0,11.0,24.0,12.0,8.0,5.0,24.0,14.0,10.0,26.0,4.0,13.0,21.0,15.0,14.0,14.0,6.0,10.0,2.0,3.0,17.0,2.0,5.0,1.0,1.0,50.0,1.0,4.0,0.0,17.0,8.0,10.0,1.0,2.0,0.0,1.0,5.0,12.0,1.0,14.0,17.0,4.0,0.0,1.0,1.0,1.0,0.0,0.0,3.0,13.0,6.0,3.0,0.0,16.0,5.0,3.0,8.0,11.0,1.0,1.0,0.0,1.0,13.0,3.0,7.0,10.0,5.0,4.0,0.0,1.0,1.0,0.0,0.0,13.0,0.0,14.0,6.0,6.0,8.0,3.0,0.0,4.0,5.0,16.0,1.0,0.0,8.0,11.0,14.0,38.0,3.0,9.0,12.0,7.0,10.0,10.0,7.0,11.0,9.0,14.0,8.0,0.0,7.0,16.0,3.0,4.0,9.0,6.0,2.0,2.0,2.0,1.0,0.0,11.0,6.0,10.0,15.0,2.0,9.0,19.0,19.0,9.0,3.0,10.0,8.0,10.0,9.0,1.0,0.0,13.0,7.0,12.0,6.0,0.0,0.0,0.0,4.0,11.0,17.0,5.0,4.0,7.0,5.0,3.0,6.0,6.0,4.0,12.0,6.0,1.0,3.0,5.0,11.0,3.0,9.0,3.0,3.0,1.0,2.0,2.0,9.0,9.0,10.0,19.0,3.0,2.0,14.0,0.0,0.0,13.0,7.0,11.0,14.0,7.0,6.0,5.0,25.0,8.0,6.0,8.0,10.0,9.0,10.0,1.0,1.0,1.0,5.0,2.0,5.0,0.0,3.0,16.0,4.0,3.0,1.0,5.0,0.0,0.0,9.0,12.0,2.0,0.0,2.0,1.0,1.0,0.0,0.0,4.0,0.0,7.0,0.0,3.0,1.0,6.0,1.0,2.0,3.0,0.0,1.0,5.0,8.0,9.0,18.0,11.0,1.0,16.0,1.0,0.0,6.0,1.0,10.0,3.0,7.0,4.0,0.0,6.0,1.0,11.0,4.0,6.0,0.0,0.0,0.0,21.0,17.0,6.0,8.0,11.0,11.0,2.0,4.0,6.0,8.0,4.0,14.0,8.0,7.0,4.0,4.0,10.0,10.0,2.0,5.0,6.0,7.0,9.0,6.0,8.0,1.0,7.0,11.0,1.0,1.0,7.0,3.0,0.0,11.0,4.0,8.0,7.0,1.0,3.0,8.0,8.0,1.0,7.0,3.0,0.0,5.0,2.0,1.0,2.0,4.0,3.0,4.0,5.0,3.0,5.0,4.0,9.0,6.0,5.0,4.0,9.0,5.0,4.0,13.0,11.0,4.0,4.0,4.0,6.0,4.0,13.0,10.0,3.0,7.0,12.0,14.0,8.0,8.0,0.0,9.0,5.0,5.0,12.0,4.0,4.0,5.0,4.0,0.0,17.0,20.0,9.0,0.0,3.0,8.0,20.0,1.0,13.0,6.0,10.0,7.0,1.0,9.0,5.0,20.0,23.0,24.0,18.0,16.0,16.0,1.0,4.0,8.0,12.0,2.0,0.0,6.0,11.0,0.0,0.0,2.0,3.0,8.0,11.0,4.0,18.0,9.0,4.0,5.0,9.0,14.0,3.0,13.0,7.0,5.0,20.0,6.0,13.0,16.0,10.0,11.0,4.0,11.0,4.0,8.0,13.0,11.0,4.0,11.0,14.0,23.0,2.0,6.0,12.0,1.0,0.0,7.0,12.0,6.0,7.0,11.0,13.0,9.0,12.0,11.0,1.0,10.0,12.0,21.0,29.0,8.0,13.0,15.0,4.0,4.0,7.0,1.0,15.0,20.0,12.0,10.0,2.0,25.0,14.0,24.0,21.0,10.0,0.0,10.0,9.0,3.0,5.0,16.0,13.0,8.0,7.0,11.0,3.0,1.0,15.0,14.0,12.0,11.0,3.0,4.0,12.0,0.0,11.0,15.0,5.0,1.0,2.0,13.0,23.0,6.0,15.0,5.0,10.0,8.0,7.0,5.0,12.0,3.0,9.0,4.0,11.0,7.0,2.0,11.0,15.0,9.0,14.0,11.0,7.0,12.0,10.0,18.0,7.0,11.0,1.0,11.0,1.0,17.0,6.0,19.0,9.0,10.0,3.0,8.0,12.0,16.0,15.0,6.0,4.0,5.0,5.0,6.0,2.0,8.0,10.0,12.0,7.0,8.0,2.0,8.0,2.0,6.0,7.0,2.0,5.0,8.0,5.0,5.0,18.0,8.0,14.0,15.0,5.0,14.0,8.0,3.0,2.0,1.0,2.0,6.0,6.0,11.0,1.0,6.0,15.0,11.0,0.0,1.0,0.0,1.0,0.0,6.0,4.0,13.0,13.0,6.0,3.0,8.0,5.0,7.0,7.0,0.0,13.0,16.0,0.0,6.0,0.0,8.0,3.0,2.0,3.0,2.0,0.0,16.0,2.0,7.0,13.0,14.0,11.0,0.0,14.0,6.0,8.0,0.0,10.0,10.0,8.0,8.0,7.0,5.0,5.0,6.0,10.0,4.0,4.0,6.0,16.0,4.0,8.0,7.0,4.0,7.0,8.0,9.0,5.0,9.0,11.0,2.0,4.0,2.0,9.0,0.0,9.0,0.0,3.0,13.0,14.0,6.0,9.0,5.0,2.0,11.0,8.0,5.0,10.0,7.0,6.0,15.0,4.0,1.0,3.0,0.0,2.0,0.0,0.0,0.0,1.0,0.0,3.0,2.0,0.0,0.0,1.0,2.0,5.0,0.0,0.0,0.0,2.0,0.0,0.0,5.0,0.0,1.0,1.0,0.0,3.0,0.0,1.0,0.0,3.0,0.0,5.0,4.0,0.0,1.0,0.0,0.0,0.0,0.0,5.0,2.0,0.0,1.0,1.0,0.0,0.0,5.0,1.0,1.0,0.0,2.0,1.0,0.0,0.0,4.0,0.0,2.0,0.0,4.0,1.0,5.0,1.0,2.0,2.0,3.0,0.0,0.0,1.0,0.0,4.0,0.0,2.0,0.0,2.0,0.0,1.0,0.0,2.0,3.0,4.0,,,,,,,,,,,,,,,,,,,,,,,,,,,,,,,,,,,,,,,,,,,,,,,,,,,,,,,,,,,,,,,,,,,,,,,,,,,,,,,,,,,,,,,,,,,,,,,,,,,,,,,,,,,,,,,,,,,,,,,,,,,,,,,,,,,,,,,,,,,,,,,,,,,,,,,,,,,,,,,,,,,,,,,,,,,,,,,,,,,,,,,,,,,,,,,,,,,,,,,,,,,,8.0,12.0,3.0,1.0,3.0,11.0,0.0,0.0,0.0,0.0,9.0,11.0,0.0,0.0,1.0,6.0,4.0,15.0,11.0,8.0,2.0,5.0,0.0,1.0,10.0,2.0,40.0,3.0,7.0,0.0,1.0,3.0,0.0,0.0,0.0,3.0,3.0,11.0,3.0,8.0,5.0,1.0,0.0,0.0,5.0,7.0,6.0,18.0,9.0,6.0,3.0,17.0,11.0,3.0,1.0,0.0,2.0,15.0,10.0,2.0,12.0,4.0,7.0,7.0,6.0,3.0,0.0,0.0,4.0,2.0,13.0,1.0,14.0,9.0,12.0,3.0,3.0,1.0,1.0,1.0,8.0,4.0,16.0,6.0,5.0,1.0,5.0,2.0,2.0,4.0,2.0,1.0,10.0,11.0,1.0,7.0,1.0,5.0,4.0,4.0,0.0,12.0,4.0,2.0,5.0,6.0,8.0,1.0,14.0,2.0,0.0,8.0,1.0,10.0,2.0,1.0,6.0,4.0,0.0,0.0,4.0,1.0,17.0,10.0,4.0,7.0,2.0,0.0,2.0,8.0,0.0,0.0,19.0,3.0,1.0,3.0,8.0,8.0,14.0,4.0,0.0,3.0,0.0,7.0,1.0,0.0,2.0,0.0,0.0,0.0,0.0,7.0,11.0,2.0,4.0,0.0,2.0,14.0,3.0,0.0,0.0,0.0,8.0,0.0,0.0,0.0,0.0,2.0,3.0,0.0,0.0,16.0,0.0,1.0,0.0,0.0,1.0,1.0,0.0,0.0,2.0,0.0,2.0,8.0,5.0,0.0,1.0,2.0,0.0,1.0,1.0,1.0,0.0,0.0,0.0,2.0,1.0,3.0,1.0,0.0,2.0,0.0,0.0,0.0,1.0,4.0,1.0,0.0,3.0,0.0,1.0,0.0,0.0,1.0,0.0,2.0,2.0,1.0,1.0,0.0,1.0,0.0,0.0,1.0,0.0,0.0,0.0,1.0,2.0,0.0,3.0,4.0,2.0,0.0,0.0,2.0,2.0,2.0,0.0,2.0,0.0,2.0,1.0,0.0,0.0,1.0,5.0,0.0,0.0,0.0,1.0,6.0,6.0,9.0,3.0,12.0,6.0,6.0,10.0,1.0,5.0,5.0,5.0,5.0,5.0,5.0,5.0,2.0,5.0,5.0,5.0,4.0,5.0,5.0,0.0,1.0,4.0,5.0,5.0,5.0,1.0,5.0,5.0,5.0,4.0,5.0,5.0,4.0,5.0,5.0,5.0,5.0,3.0,1.0,4.0,5.0,3.0,5.0,5.0,0.0,0.0,0.0,0.0,0.0,2.0,0.0,0.0,0.0,0.0,0.0,2.0,0.0,0.0,0.0,0.0,0.0,0.0,0.0,1.0,0.0,0.0,0.0,0.0,0.0,0.0,0.0,0.0,0.0,0.0,0.0,0.0,0.0,0.0,0.0,4.0,0.0,0.0,0.0,0.0,0.0,0.0,0.0,0.0,0.0,0.0,3.0,0.0,0.0,0.0,0.0,0.0,0.0,0.0,0.0,0.0,0.0,0.0,0.0,0.0,0.0,0.0,0.0,0.0,0.0,0.0,0.0,0.0,0.0,0.0,0.0,0.0,0.0,0.0,0.0,0.0,0.0,0.0,1.0,0.0,0.0,0.0,0.0,0.0,0.0,0.0,0.0,0.0,0.0,0.0,0.0,0.0,0.0,0.0,0.0,0.0,0.0,2.0,0.0,0.0,0.0,0.0,0.0,0.0,0.0,0.0,0.0,0.0,0.0,0.0,0.0,0.0,0.0,0.0,0.0,0.0,0.0,0.0,0.0,0.0,0.0,1.0,2.0,1.0,0.0,0.0,0.0,0.0,0.0,0.0,0.0,0.0,0.0,0.0,0.0,1.0,0.0,0.0,0.0,1.0,0.0,0.0,0.0,0.0,0.0,7.0,0.0,0.0,2.0,0.0,0.0,0.0,2.0,1.0,0.0,1.0,2.0,0.0,4.0,0.0,0.0,0.0,2.0,0.0,0.0,0.0,0.0,0.0,0.0,0.0,0.0,0.0,0.0,0.0,0.0,0.0,0.0,0.0,0.0,0.0,0.0,0.0,0.0,0.0,0.0,5.0,0.0,0.0,0.0,0.0,0.0,0.0,0.0,0.0,0.0,1.0,0.0,0.0,0.0,4.0,0.0,5.0,5.0,0.0,5.0,17.0,11.0,6.0,15.0,3.0,7.0,8.0,9.0,13.0,6.0,8.0,8.0,8.0,9.0,22.0,11.0,4.0,11.0,6.0,4.0,4.0,13.0,6.0,12.0,2.0,3.0,9.0,17.0,9.0,8.0,14.0,12.0,15.0,11.0,12.0,14.0,8.0,0.0,16.0,7.0,9.0,9.0,9.0,6.0,4.0,1.0,5.0,7.0,3.0,0.0,7.0,5.0,0.0,5.0,5.0,9.0,13.0,6.0,2.0,20.0,13.0,0.0,24.0,29.0,27.0,8.0,0.0,8.0,4.0,4.0,4.0,6.0,21.0,36.0,31.0,23.0,27.0,12.0,1.0,12.0,2.0,8.0,5.0,19.0,4.0,3.0,2.0,0.0,21.0,4.0,39.0,7.0,1.0,0.0,0.0,0.0,17.0,27.0,14.0,13.0,0.0,26.0,1.0,6.0,0.0,14.0,0.0,6.0,7.0,2.0,3.0,19.0,26.0,5.0,8.0,16.0,35.0,20.0,3.0,3.0,22.0,3.0,7.0,0.0,20.0,3.0,9.0,4.0,13.0,4.0,0.0,0.0,29.0,8.0,10.0,2.0,23.0,0.0,0.0,8.0,15.0,26.0,0.0,7.0,16.0,10.0,0.0,0.0,12.0,6.0,36.0,17.0,2.0,2.0,9.0,2.0,2.0,16.0,5.0,1.0,4.0,3.0,2.0,2.0,1.0,3.0,3.0,1.0,1.0,1.0,4.0,3.0,1.0,0.0,3.0,4.0,0.0,0.0,3.0,0.0,1.0,3.0,3.0,4.0,2.0,1.0,2.0,7.0,1.0,3.0,5.0,1.0,0.0,2.0,1.0,1.0,6.0,2.0,4.0,1.0,4.0,1.0,5.0,2.0,4.0,3.0,0.0,1.0,3.0,0.0,5.0,0.0,0.0,0.0,0.0,0.0,0.0,,,,,,,,,,,,5.0,,,,,,4.0,1.0,2.0,2.0,1.0,5.0,0.0,,,1.0,,,5.0,1.0,5.0,,2.0,0.0,,3.0,2.0,,3.0,0.0,1.0,2.0,2.0,,2.0,,,,5.0,5.0,3.0,,,0.0,4.0,4.0,0.0,1.0,1.0,,3.0,0.0,2.0,5.0,3.0,0.0,,5.0,3.0,0.0,0.0,3.0,5.0,,0.0,,2.0,2.0,,5.0,0.0,,1.0,1.0,2.0,,2.0,0.0,2.0,,0.0,1.0,1.0,,,,,2.0,2.0,,1.0,3.0,,1.0,5.0,1.5,,,5.0,2.5,5.0,5.0,,2.0,1.0,0.0,0.0,0.0,2.0,,4.0,,0.0,2.0,,,,,,1.0,,,,0.0,,2.0,4.0,5.0,2.0,4.0,,0.0,2.0,2.0,,5.0,0.0,1.0,2.0,0.0,2.0,1.0,1.0,0.0,,,5.0,3.0,0.0,0.0,4.0,0.0,,2.0,,,,,3.0,,,,0.0,0.0,,3.0,,0.0,,,,1.0,1.0,1.0,1.0,4.0,5.0,0.0,0.0,,4.0,0.0,0.0,1.0,,2.0,2.0,,3.0,1.0,,0.0,1.0,0.0,,,1.0,,5.0,0.0,1.0,,1.0,5.0,5.0,1.0,1.0,1.0,5.0,,,,,,,,,,,,,,,,,0.0,0.0,,2.0,2.0,,3.0,,4.0,,0.0,3.0,0.0,2.0,,0.0,,,1.0,2.0,5.0,1.0,2.0,0.0,1.0,1.0,,,,,,,0.0,1.0,5.0,5.0,0.0,,,,2.0,0.0,,3.0,2.0,0.0,,,,0.0,,5.0,3.0,0.0,1.0,0.0,5.0,,,1.0,,,3.0,3.0,3.0,,,1.0,0.0,5.0,5.0,4.0,0.0,5.0,4.0,,1.0,5.0,1.0,0.0,0.0,4.0,1.0,,5.0,1.0,,,,,,5.0,,,,3.0,2.0,0.0,0.0,1.0,5.0,4.0,,0.0,5.0,5.0,1.0,0.0,0.0,0.0,0.0,0.0,0.0,0.0,5.0,2.0,4.0,2.0,2.0,2.0,2.0,5.0,0.0,0.0,0.0,0.0,3.0,1.0,0.0,1.0,3.0,4.0,0.0,5.0,3.0,1.0,1.0,1.0,0.0,2.0,5.0,0.0,2.0,0.0,0.0,1.0,2.0,0.0,2.0,2.0,0.0,0.0,0.0,5.0,4.0,2.0,5.0,1.0,0.0,1.0,0.0,0.0,2.0,3.0,4.0,3.0,1.0,1.0,5.0,4.0,0.0,0.0,5.0,4.0,0.0,1.0,2.0,0.0,5.0,0.0,0.0,4.0,5.0,4.0,2.0,2.0,0.0,0.0,0.0,0.0,1.0,0.0,2.0,0.0,0.0,1.0,5.0,2.0,0.0,1.0,1.0,1.0,4.0,1.0,0.0,1.0,1.0,0.0,3.0,1.0,2.0,0.0,4.0,4.0,5.0,0.0,3.0,1.0,0.0,0.0,1.0,1.0,0.0,5.0,0.0,1.0,4.0,0.0,2.0,0.0,1.0,1.0,0.0,3.0,4.0,0.0,0.0,1.0,4.0,0.0,1.0,2.0,2.0,3.0,0.0,3.0,2.0,1.0,3.0,0.0,0.0,0.0,0.0,0.0,0.0,1.0,0.0,0.0,4.0,0.0,0.0,0.0,0.0,1.0,0.0,0.0,0.0,0.0,1.0,5.0,7.0,15.0,13.0,4.0,0.0,29.0,10.0,0.0,11.0,8.0,3.0,4.0,3.0,16.0,7.0,13.0,10.0,6.0,5.0,33.0,21.0,16.0,7.0,0.0,16.0,19.0,7.0,14.0,6.0,12.0,14.0,24.0,12.0,27.0,7.0,7.0,7.0,0.0,5.0,2.0,1.0,9.0,4.0,11.0,6.0,11.0,15.0,18.0,14.0,0.0,35.0,13.0,16.0,15.0,18.0,38.0,15.0,3.0,8.0,15.0,0.0,9.0,23.0,14.0,1.0,17.0,13.0,13.0,3.0,7.0,12.0,11.0,5.0,18.0,5.0,11.0,4.0,4.0,9.0,5.0,4.0,11.0,18.0,8.0,8.0,23.0,5.0,10.0,13.0,16.0,7.0,8.0,7.0,7.0,0.0,5.0,8.0,6.0,11.0,11.0,16.0,15.0,10.0,14.0,13.0,11.0,14.0,10.0,8.0,22.0,8.0,12.0,14.0,13.0,16.0,4.0,20.0,0.0,13.0,13.0,18.0,17.0,0.0,3.0,4.0,1.0,4.0,22.0,16.0,19.0,15.0,6.0,10.0,18.0,8.0,34.0,24.0,13.0,11.0,17.0,13.0,13.0,17.0,17.0,11.0,6.0,19.0,10.0,18.0,0.0,14.0,6.0,10.0,11.0,17.0,13.0,17.0,16.0,10.0,19.0,7.0,8.0,13.0,13.0,9.0,9.0,4.0,8.0,11.0,14.0,17.0,9.0,15.0,16.0,7.0,15.0,3.0,10.0,5.0,14.0,0.0,15.0,2.0,14.0,12.0,21.0,2.0,13.0,13.0,17.0,10.0,7.0,3.0,11.0,20.0,8.0,7.0,18.0,4.0,13.0,9.0,6.0,24.0,8.0,0.0,9.0,8.0,19.0,13.0,17.0,8.0,10.0,8.0,13.0,13.0,17.0,5.0,12.0,8.0,13.0,15.0,11.0,13.0,7.0,9.0,14.0,5.0,8.0,4.0,15.0,12.0,4.0,22.0,1.0,17.0,14.0,9.0,7.0,13.0,9.0,4.0,13.0,6.0,17.0,9.0,10.0,13.0,17.0,0.0,14.0,18.0,6.0,12.0,10.0,10.0,12.0,3.0,10.0,13.0,2.0,13.0,12.0,10.0,8.0,23.0,15.0,11.0,8.0,13.0,14.0,5.0,11.0,8.0,7.0,18.0,2.0,7.0,11.0,13.0,5.0,1.0,14.0,14.0,11.0,9.0,11.0,16.0,2.0,11.0,10.0,9.0,6.0,0.0,0.0,16.0,0.0,11.0,15.0,7.0,7.0,1.0,16.0,9.0,6.0,12.0,13.0,11.0,16.0,10.0,14.0,4.0,7.0,7.0,12.0,3.0,19.0,10.0,12.0,3.0,4.0,4.0,9.0,14.0,19.0,7.0,3.0,9.0,11.0,14.0,11.0,1.0,13.0,5.0,5.0,4.0,3.0,18.0,18.0,7.0,12.0,12.0,10.0,10.0,14.0,7.0,8.0,7.0,5.0,8.0,6.0,13.0,7.0,6.0,2.0,24.0,9.0,0.0,4.0,3.0,4.0,27.0,27.0,6.0,3.0,4.0,7.0,3.0,15.0,15.0,7.0,10.0,5.0,2.0,6.0,8.0,10.0,5.0,14.0,1.0,5.0,5.0,1.0,5.0,5.0,0.0,5.0,1.0,1.0,1.0,4.0,5.0,5.0,2.0,2.0,5.0,5.0,0.0,5.0,1.0,0.0,2.0,0.0,5.0,5.0,2.0,3.0,5.0,5.0,5.0,2.0,5.0,5.0,3.0,5.0,3.0,2.0,5.0,4.0,3.0,5.0,5.0,2.0,5.0,1.0,5.0,4.0,4.0,5.0,5.0,0.0,5.0,5.0,5.0,0.0,5.0,5.0,3.0,5.0,5.0,5.0,5.0,5.0,0.0,4.0,5.0,2.0,1.0,0.0,4.0,5.0,5.0,4.0,5.0,1.0,5.0,3.0,2.0,0.0,5.0,0.0,5.0,5.0,4.0,2.0,5.0,4.0,0.0,5.0,5.0,4.0,5.0,5.0,5.0,3.0,5.0,0.0,5.0,2.0,5.0,5.0,3.0,5.0,5.0,5.0,5.0,5.0,5.0,4.0,0.0,2.0,5.0,5.0,5.0,5.0,2.0,1.0,0.0,3.0,3.0,5.0,1.0,3.0,5.0,5.0,5.0,1.0,2.0,2.0,5.0,5.0,5.0,5.0,1.0,5.0,5.0,5.0,5.0,5.0,5.0,5.0,5.0,5.0,5.0,5.0,5.0,5.0,5.0,3.0,5.0,1.0,5.0,5.0,5.0,0.0,18.0,4.0,14.0,4.0,3.0,5.0
16,,,,,,,,,,,,,,,,,,,,,,,,,,,,,,,,,,,,,,,,,,,,,,,,,,,,,,,,,,,,,,,,,,,,,,,,,,,,,,,,,5.0,2.0,4.0,5.0,5.0,5.0,5.0,,,,,,,0.0,0.0,0.0,0.0,0.0,0.0,0.0,0.0,0.0,0.0,0.0,0.0,0.0,0.0,0.0,0.0,0.0,0.0,0.0,0.0,,,,,,,,,,,,,,,,,,,,,,,,,,,,,,,,,,,,,,,,,,,,,,,,,,,,,,,,,,,,,,,,,,,,,,,,,,,,,,,,,,,,,,,,,,,,,,,,,,,,,,,,,,,,,,,,,,,,,,,,,,,,,,,,,,,,,,,,,,,,,,,,,,,,,,,,,,,,,,,,,,,,,,,,,,,,,,,,,,,,,,,,,,,,,,,,,,,,,,9.0,13.0,8.0,4.0,6.0,5.0,2.0,9.0,10.0,4.0,11.0,2.0,4.0,13.0,6.0,6.0,10.0,8.0,12.0,5.0,9.0,11.0,12.0,3.0,10.0,6.0,8.0,0.0,6.0,16.0,5.0,11.0,5.0,9.0,20.0,4.0,11.0,6.0,7.0,12.0,11.0,15.0,11.0,12.0,4.0,18.0,2.0,11.0,6.0,17.0,4.0,7.0,2.0,13.0,3.0,0.0,6.0,4.0,12.0,8.0,7.0,11.0,7.0,9.0,,,,,,,,,,,,,,,,,,,,,,,,,,,,,,,,,,,,,,,,,,,,,,,,,,,,,,,,,,,,,,,,,,,,,,,,,,,,,,,,,,,,,,,,,,,,,,,,,,,,,,,,,,,,,,,,,,,,,,,,,,,,,,,,,,,,,,,,,,,,,,,,,,,,,,,5.0,5.0,5.0,4.0,5.0,,,,,,,,,,,,,,,,,,,,,,,,,,,,,,,,,,,,,,,,,,,,,,,,,,,,,,,,,,,,,,,,,,,,,,,,,,,,,,,,,,,,,,,,,,,,,,,,,,,,,,,,,,,,,,,,,,,,,4.0,0.0,0.0,15.0,0.0,0.0,0.0,0.0,0.0,1.0,0.0,2.0,4.0,0.0,3.0,0.0,2.0,3.0,0.0,0.0,2.0,2.0,5.0,0.0,2.0,5.0,2.0,0.0,2.0,2.0,5.0,1.0,2.0,1.0,2.0,5.0,1.0,3.0,2.0,3.0,2.0,4.0,5.0,0.0,5.0,1.0,0.0,5.0,0.0,3.0,0.0,0.0,5.0,5.0,2.0,2.0,1.0,0.0,0.0,1.0,2.0,5.0,0.0,5.0,5.0,5.0,5.0,4.0,2.0,2.0,3.0,5.0,,,,,,,,,,,,,,,,,,,,,,,,,,,,,,,,,,,,,,,,,,,,,,,,,,,,,,,,,,,,,,,,,,,,,,,,,,,,,,,,,,,,,,,,,,,,,,,,,,,,,,,,,,,,,,,,,,,,,,,,,,,,,,,,,,,,,,,,,,,,9.0,12.0,4.0,8.0,1.0,4.0,10.0,12.0,3.0,6.0,6.0,4.0,8.0,6.0,12.0,1.0,6.0,5.0,6.0,16.0,9.0,10.0,1.0,3.0,1.0,13.0,11.0,6.0,11.0,5.0,6.0,12.0,3.0,8.0,16.0,7.0,1.0,8.0,8.0,8.0,14.0,0.0,10.0,3.0,5.0,6.0,8.0,10.0,10.0,11.0,6.0,14.0,15.0,7.0,0.0,11.0,5.0,10.0,13.5,19.0,1.0,8.0,18.0,10.0,8.0,4.0,11.0,11.0,6.0,10.0,0.0,6.0,3.0,13.0,7.0,11.0,10.0,7.0,11.0,8.0,14.0,1.0,0.0,2.0,8.0,4.0,4.0,3.0,22.0,17.0,3.0,16.0,0.0,15.0,19.0,1.0,7.0,5.0,4.0,3.0,14.0,4.0,1.0,2.0,11.0,5.0,3.0,14.0,1.0,5.0,18.0,7.0,7.0,9.0,15.0,0.0,18.0,5.0,7.0,7.0,11.0,7.0,8.0,1.0,13.0,24.0,10.0,7.0,4.0,10.0,2.0,2.0,8.0,12.0,14.0,1.0,2.0,8.0,13.0,6.0,8.0,3.0,0.0,11.0,23.0,6.0,10.0,6.0,6.0,6.0,0.0,3.0,6.0,0.0,1.0,6.0,14.0,7.0,0.0,7.0,20.0,14.0,6.0,8.0,4.0,4.0,10.0,8.0,19.0,1.0,3.0,3.0,4.0,5.0,15.0,10.0,0.0,3.0,20.0,3.0,13.0,0.0,1.0,1.0,11.0,9.0,14.0,6.0,12.0,8.0,4.0,,,,,,,,,,,,,,,,,,,,,,,,,,,,,,,,,,,,,,,,,,,,,,,,,,,,,,,,,,,,,,,,,,,,,,,,,,,,,,,,,,,,,,,,,,,,,,,,,,,,,,,,,,,,,,,,,,,,,,,,,,,,,,,,,,,,,,,,,,,,,,,,,,,,,,,,,,,,,,,,,,,,,,,,,,,,,,,,,,,,,,,,,,,,,,,,,,,,,,,,,,,,,,,,,,,,,,,,,,,,,,,,,,,,,,,,,,,,,,,,,,,,,,,,,,,,,,,,,,,,,,,,,,,,,,,,,,,,,,,,,,,,,,,,,,,,,,,,,,,,,,,,,,,,,,,,,,,,,,,,,,,,,,,,,,,,,,,,,,,,,,,,,,,,,,,,,,,,,,,,,,,,,,,,,,,,,,,,,,,,,,,,,,,,,,,,,,,,,,,,,,,,,,,,,,,,,,,,,,,,,,,,,,,,,,,,,,,,,,,,,,,,,,,,,,,,,,,,,,,,,,,,,,,,,,,,,,,,,,,,,,,,,,,,,,,,,,,,,,,,,,,,,,,,,,,,,,,,,,,,,,,,,,,,,,,,,,,,,,,,,,,,,,,,,,,,,,,,,,,,,,,,,,,,,,,,,,,,,,,,,,,,,,,,,,,,,,,,,,,,,,,,,,,,,,,,,,,,,,,,,,,,,,,,,,,,,,,,,,,,,,,,,,,,,,,,,,,,,,,,,,,,,,,,,,,,,,,,,,,,,,,,,,,,,,,,,,,,,,,,,,,,,,,,,,,,,,,,,,,,,,,,,,,,,,,,,,,,,,,,,,,,,,,,,,,,,,,,,,,,,,,,,,,,,,,,,,,,,,,,,,,,,,,,,,,,,,,,,,,,,,,,,,,,,,,,,,,,,,,,,,,,,,,,,,,,,,,,,,,,,,,,,,,,,,,,,,,,,,,,,,,,,,,,,,,,,,,,,,,,,,,,,,,,,,,,,,,,,,,,,,,,,,,,,,,,,,,,,,,,,,,,,,,,,,,,,,,,,,,,,,,,,,,,,,,,,,,,,,,,,,,,,,,,,,,,,,,,,,,,,,,,,,,,,,,,,,,,,,,,,,,,,,,,,,,,,,,,,,,,,,,,,,,,,,,,,,,,,,,,,,,,,,,,,,,,,,,,,,,,,,,,,,,,,,,,,,,,,,,,,,,,,,,,,,,,,,,,,,,,,,,,,,,,,,,,,,,,,,,,,,,,,,,,,,,,,,,,,,,,,,,,,,,,,,,,,,,,,,,,,,,,,,,,,,,,,,,,,,,,,,,,,,,,,,,,,,,,,,,,,,,,,,,,,,,,,,,,,,,,,,,,,,,,,,,,,,,,,,,,,,,,,,,,,,,,,,,,,,,,,,,,,,,,,,,,,,,,,,,,,,,,,,,,,,,,,,,,,,,,,,,,,,,,,,,,,,,,,,,,,,,,,,,,,,,,,,,,,,,,,,,,,,,,,,,,,,,,,,,,,,,,,,,,,,,,,,,,,,,,,,,,,,,,,,,,,,,,,,,,,,,,,,,,,,,,,,,,,,,,,,,,,,,,,,,,,,,,,,,,,,,,,,,,,,,,,,,,,,,,,,,,,,,,,,,,,,,,,,,,,,,,,,,,,,,,,,,,,,,,,,,,,,,,,,,,,,,,,,,,,,,,,,,,,,,,,,,,,,,,,,,,,,,,,,,,,,,,,,,,,,,,,,,,,,,,,,,,,,,,,,,,,,,,,,,,,,,,,,,,,,,,,,,,,,,,,,,,,,,,,,,,,,,,,,,,,,,,,,,,,,,5.0,0.0,5.0,3.0,3.0,1.0,5.0,0.0,0.0,0.0,1.0,2.0,1.0,1.0,0.0,4.0,0.0,5.0,5.0,1.0,,,,,,,,,,,,,,,,,,,,,,,,,,,,,,,,,,,,,,,,,,,,,,,,,,,,,,,,,,,,,,,,,,,,,,,,,,,,,,,,,,,,,,,,,,,,,,,,,,,,,,,,,,,,,,,,,,,,,,,,,,,,,,,,,,,,,,,,,,,,,,,,,,,,,,,,,,,,,,,,,,,,,,,,,,,,,,,,,,,,,,,,,,,,,,,,,,,,,,,,,,,,,,,,,,,,,,,,,,,,,,,,,,,,,,,,,,,,,,,,,,,,,,,,,,,,,,,,,,,,,,,,,,,,,,,,,,,,,,,,,,,,,,,,,,,,,,,,,,,,,,,,,,,,,,,,,,,,,,,,,,,,,,,,,,,,,,,,,,,,,,,,,,,,,,,,,,,,,,,,,,,,,,,,,,,,,,,,,,,,,,,,,,,,,,,,,,,,,,,,,,,,,,,,,,,,,,,,,,,,,,,,,,,,,,,,,,,,,,,,,,,,,,,,,,,,,,,,,,,,,,,,,,,,,,,,,,,,,,,,,,,,,,,,,,,,,,,,,,,,,,,,,,,,,,,,,,,,,,,,,,,,,,,,,,,,,,,,,,,,,,,,,,,,,,,,,,,,,,,,,,,,,,,,,,,,,,,,,,,,,,,,,,,,,,,,,,,,,,,,,,,,,,,,,,,,,,,,,,,,,,,,,,,,,,,,,,,,,,,,,,,,,,,,,,,,,,,,,,,,,,,,,,,,,,,,,,,,,,,,,,,,,,,,,,,,,,,,,,,,,,,,,,,,,,,,,,,,,,,,,,,,,,,,,,,,,,,,,,,,,,,,,,,,,,,,,,,,,,,,,,,,,,,,,,,,,,,,,,,,,,,,,,,,,,,,,,,,,,,,,,,,,,,,,,,,,,,,,,,,,,,,,,,,,,,,,,,,,,,,,,,,,,,,,,,,,,,,,,,,,,,,,,,,,,,,,,,,,,,,,,,,,,,,,,,,,,,,,,,,,,,,,,,,,,,,,,,,,,,,,,,,,,,,,,,,,,,,,,,,,,,,,,,,,,,,,,,,,,,,,,,,,,,,,,,,,,,,,,,,,,,,,,,,,,,,,,,,,,,,,,,,,,,,,,,,,,,,,,,,,,,,,,,,,,,,,,,,,,,,,,,,,,,,,,,,,,,,,,,,,,,,,,,,,,,,,,,,,,,,,,,,,,,,,,,,,,,,,,,,,,,,,,,,,,,,,,,,,,,,,,,,,,,,,,,,,,,,,5.0,3.0,1.0,3.0,5.0,4.0,8.0,5.0,1.0,6.0,0.0,4.0,0.0,2.0,3.0,12.0,8.0,1.0,2.0,5.0,2.0,2.0,3.0,7.0,8.0,0.0,2.0,2.0,6.0,6.0,0.0,4.0,12.0,3.0,10.0,4.0,3.0,4.0,3.0,4.0,0.0,2.0,4.0,5.0,0.0,4.0,3.0,5.0,0.0,0.0,5.0,5.0,5.0,2.0,0.0,5.0,5.0,2.0,5.0,4.0,4.0,1.0,3.0,1.0,5.0,2.0,3.0,5.0,5.0,4.0,4.0,1.0,2.0,0.0,5.0,5.0,5.0,5.0,4.0,2.0,1.0,2.0,3.0,3.0,1.0,0.0,5.0,0.0,5.0,2.0,4.0,5.0,3.0,4.0,4.0,5.0,5.0,1.0,5.0,5.0,5.0,5.0,5.0,5.0,2.0,5.0,4.0,5.0,5.0,5.0,1.0,1.0,4.0,5.0,4.0,0.0,5.0,5.0,5.0,3.0,5.0,5.0,5.0,2.0,5.0,1.0,0.0,0.0,1.0,1.0,4.0,2.0,0.0,3.0,0.0,4.0,1.0,1.0,0.0,2.0,3.0,0.0,1.0,2.0,3.0,0.0,1.0,2.0,1.0,0.0,0.0,0.0,1.0,0.0,1.0,0.0,1.0,1.0,0.0,3.0,0.0,2.0,,,,,,,,,,,,,,,,,,,,,,,,,,,,,,,,,,,,,,,,,,,,,,,,,,,,,,,,,,,,,,,,,,,,,,,,,,,,,,,,,,,,,,,,,,,,,,,,,,,,,,,,,,,,,,,,,,,,,,,,,,,,,,,,,,,,,,,,,,,,,,,,,,,,,,,,,,,,,,,,,,,,,,,,,,,,,,,,,,,,,,,,,,,,,,,,,,,,,,,,,,,,,,,,,,,,,,,,,,,,,,,,,,,,,,,,,,,,,,,,,,,,,,,,,,,,,,,,,,,,,,,,,,,,,,,,,,,,,,,,,,,,,,,,,,,,,,,,,,,,,,,,,,,,,,,,,,,,,,,,,,,,,,,,,,,,,,,,,,,,,,,,,,,,,,,,,,,,,,,,,,,,,,,,,,,,,,,,,,,,,,,,,,,,,,,,,,,,,,,,,,,,,,,,,,,,,,,,,,,,,,,,,,,,,,,,,,,,,,,,,,,,,,,,,,,,,,,,,,,,,,,,,,,,,,,,,,,,,,,,,,,,,,,,,,,,,,,,,,,,,,,,,,,,,,,,,,,,,,,,,,,,,,,,,,,,,,,,,,,,,,,,,,,,,,,,,,,,,,,,,,,,,,,,,,,,,,,,,,,,,,,,,,,,,,,,,,,,,,,,,,,,,,,,,,,,,,,,,,,,,,,,,,,,,,,,,,,,,,,,,,,,,,,,,,,,,,,,,,,,,,,,,,,,,,,,,,,,,,,,,,,,,,,,,,,,,,,,,,,,,,,,,,,,,,,,,,,,,,,,,,,,,,,,,,,,,,,,,,,,,,,,,,,,,,,,,,,,,,,,,,,,,,,,,,,,,,,,,,,,,,,,,,,,,,,,,,,,,,,,,,,,,,,,,,,,,,,,,,,,,,,,,,,,,,,,,,,,,,,,,,,,,,,,,,,,,,,,,,,,,,,,,,,,,,,,,,,,,,,,,,,,,,,,,,,,,,,,,,,,,,,,,,,,,,,,,,,,,,,,,,,,,,,,,,,,,,,,,,,,,,,,,,,,,,,,,,,,,,,,,,,,,,,,,,,,,,,,,,,,,,,,,,,,,,,,,,,,,,,,,,,,,,,,,,,,,,,,,,,,,,,,,,,,,,,,,,,,,,,,,,,,,,,,,,,,,,,,,,,,,,,,,,,,,,,,,,,,,,,,,,,,,,,,,,,,,,,,,,,,,,,,,,,,,,,,,,,,,,,,,,,,,,,,,,,,,,,,,,,,,,,,,,,,,,,,,,,,,,,,,,,,,,,,,,,,,,,,,,,,,,,,,,,,,,,,,,,,,,,,,,,,,,,,,,,,,,,,,,,,,,,,,,,,,,,,,,,,,,,,,,,,,,,,,,,,,,,,,,,,,,,,,,,,,,,,,,,,,,,,,,,,,,,,,,,,,,,,,,,,,,,,,,,,,,,,,,,,,,,,,,,,,,,,,,,,,,,,,,,,,,,,,,,,,,,,,,,,,,,,,,,,,,,,,,,,,,,,,,,,,,,,,,,,,,,,,,,,,,,,,,,,,,,,,,,,,,,,,,,,,,,,,,,,,,,,,,,,,,,,,,,,,,,,,,,,,,,,,,,,,,,,,,,,,,,,,,,,,,,,,,,,,,,,,,,,,,,,,,,,,,,,,,,,,,,,,,,,,,,,,,,,,,,,,,,,,,,,,,,,,,,,,,,,,,,,,,,,,,,,,,,,,,,,,,,,,,,,,,,,,,,,,,,,,,,,,,,,,,,,,,,,,,,,,,,,,,,,,,,,,,,,,,,,,,,,,,,,,,,,,,,,,,,,,,,,,,,,,,,,,,,,,,,,,,,,,,,,,,,,,,,,,,,,,,,,,,,,,,,,,,,,,,,,,,,,,,,,,,,,,,,,,,,,,,,,,,,,,,,,,,,,,,,,,,,,,,,,,,,,,,,,,,,,,,,,,,,,,,,,,,,,,,,,,,,,,,,,,,,,,,,,,,,,,,,,,,,,,,,,,,,,,,,,,,,,,,,,,,,,,,,,,,,,,,,,,,,,,,,,,,,,,,,,,,,,,,,,,,,,,,,,,,,,,,,,,,,,,,,,,,,,,,,,,,,,,,,,,,,,,,,,,,,,,,,,,,,,,,,,,,,,,,,,,,,,,,,,,,,,,,,,,,,,,,,,,,,,,,,,,,,,,,,,,,,,,,,,,,,,,,,,,,,,,,,,,,,,,,,,,,,,,,,,,,,,,,,,,,,,,,,,,,,,,,,,,,,,,,,,,,,,,,,,,,,,,,,,,,,,,,,,,,,,,,,,,,,,,,,,,,,,,,,,,,,,,,,,,,,,,,,,,,,,,,,,,,,,,,,,,,,,,,,,,,,,,,,,,,,,,,,,,,,,,,,,,,,,,,,,,,,,,,,,,,,,,,,,,,,,,,,,,,,,,,,,,,,,,,,,,,,,,,,,,,,,,,,,,,,,,,,,,,,,,,,,,,,,,,,,,,,,,,,,,,,,,,,,,,,,,,,,,,,,,,,,,,,,,,,,,,,,,,,,,,,,,,,,,,,,,,,,,,,,,,,,,,,,,,,,,,,,,,,,,,,,,,,,,,,,,,,,,,,,,,,,,,,,,,,,,,,,,,,,,,,,,,,,,,,,,,,,,,,,,,,,,,,,,,,,,,,,,,,,,,,,,,,,,,,,,,,,,,,,,,,,,,,,,,,,,,,,,,,,,,,,,,,,,,,,,,,,,,,,,,,,,,,,,,,,,,,,,,,,,,,,,,,,,,,,,,,,,,,,,,,,,,,,,,,,,,,,,,,,,,,,,,,,,,,,,,,,,,,,,,,,,,,,,,,,,,,,,,,,,,,,,,,,,,,,,,,,,,,,,,,,,,,,,,,,,,,,,,,,,,,,,,,,,,,,,,,,,,,,,,,,,,,,,,,,,,,,,,,,,,,,,,,,,,,,,,,,,,,,,,,,,,,,,,,,,,,,,,,,,,,,,,,,,,,,,,,,,,,,,,,,,,,,,,,,,,,,,,,,,,,,,,,,,,,,,,,,,,,,,,,,,,,,,,,,,,,,,,,,,,,,,,,,,,,,,,,,,,,,,,,,,,,,,,,,,,,,,,,,,,,,,,,,,2.0,2.0,2.0,1.0,2.0,0.0,1.0,2.0,2.0,3.0,2.0,2.0,2.0,2.0,2.0,2.0,2.0,2.0,1.0,3.0,2.0,3.0,5.0,4.0,2.0,4.0,2.0,2.0,1.0,2.0,4.0,4.0,0.0,0.0,4.0,2.0,3.0,4.0,4.0,3.0,5.0,3.0,2.0,1.0,0.0,3.0,1.0,2.0,4.0,5.0,2.0,2.0,3.0,2.0,4.0,2.0,3.0,0.0,4.0,3.0,3.0,2.0,0.0,2.0,3.0,2.0,1.0,2.0,2.0,1.0,3.0,3.0,3.0,2.0,0.0,3.0,2.0,2.0,3.0,2.0,3.0,3.0,2.0,3.0,5.0,5.0,3.0,2.0,3.0,,,,,,,,,,,,,,,,,,,,,,,,,,,,,,,,,,,,,,,,,,,,,,,,,,,,,,,,,,,,,,,,,,,,,,,5.0,5.0,5.0,5.0,5.0,5.0,5.0,5.0,5.0,,,,,,,,,,,,,,,,,,,,,,,,,,,,,,,,,,,,,,,,,,,,,,,,,,,,,,,,,,,,,,,,,,,,,,,,,,,,,,,,,,,,,,,,,,,,,,,,,,,,,,,,,,,,,,,,,,,,,,,,,,,,,,,,,,,,,,,,,,,,,,,,,,,,,,,,,,,,,,,,,,,,,,,,,,,,,,,,,,,,,,,,,,,,,,,,,,,,,,,,,,,,,,,,,,,,,,,,,,,,,,,,,,,,,,,,,,,,,,,,,,,,,,,,,,,,,,,,,,,,,,,,,,,,,,,,,,,,,,,,,,,,,,,,,,,,,,,,,,,,,,,,,,,,,,,,,,,,,,,,,,,,,,,,,,,,,,,,,,,,,,,,,,,,,,,,,,,,,,,,,,,,,,,,,,,,,,,,,,,,,,,,,,,,,,,,,,,,,,,,,,,,,,,,,,,,,,,,,,,,,,,,,,,,,,,,,,,,,,,,,,,,,,,,,,,,,,,,,,,,,,,,,,,,,,,,,,,,,,,,,,,,,,,,,,,,,,,,,,,,,,,,,,,,,,,,,,,,,,,,,,,,,,,,,,,,,,,,,,,,,,,,,,,,,,,,,,,,,,,,,,,,,,,,,,,,,,,,,,,,,,,,,,,,,,,,,,,,,,,,,,,,,,,,,,,,,,,,,,,,,,,,,,,,,,,,,,,,,,,,,,,,,,,,,,,,,,,,,,,,,,,,,,,,,,,,,,,,,,,,,,,,,,,,,,,,,,,,,,,,,,,,,,,,,,,,,,,,,,,,,,,,,,,,,,,,,,,,,,,,,,,,,,,,,,,,,,,,,,,,,,,,,,,,,,,,,,,,,,,,,,,,,,,,,,,,,,,,,,,,,,,,,,,,,,,,,,,,,,,,,,,,,,,,,,,,,,,,,,,,,,,,,,,,,,,,,,,,,,,,,,,,,,,,,,,,,,,,,,,,,,,,,,,,,,,,,,,,,,,,,,,,,,,,,,,,,,,,,,,,,,,,,,,,,,,,,,,,,,,,,,,,,,,,,,,,,,,,,,,,,,,,,,,,,,,,,,,,,,,,,,,,,,,,,,,,,,,,,,,,,,,,,,,,,,,,,,,,,,,,,,,,,,,,,,,,,,,,,,,,,,,,,,,,,,,,,,,,,,,,,,,,,,,,,,,,,,,,,,,,,,,,,,,,,,,,,,,,,,,,,,,,,,,,,,,,,,,,,,,,,,,,,,,,,,,,,,,,,,,,,,,,,,,,,,,,,,,,,,,,,,,,,,,,,,,,,,,,,,,,,,,,,,,,,,,,,,,,,,,,,,,,,,,,,,,,,,,,,,,,,,,,,,,,,,,,,,,,,,,,,,,,,,,,,,,,,,,,,,,,,,,,,,,,,,,,,,,,,,,,,,,,,,,,,,,,,,,,,,,,,,,,,,,,,,,,,,,,,,,,,,,,,,,,,,,,,,,,,,,,,,,,,,,,,,,,,,,,,,,,,,,,,,,,,,,,,,,,,,,,,,,,,,,,,,,,,,,,,,,,,,,,,,,,,,,,,,,,,,,,,,,,,,,,,,,,,,,,,,,,,,,,,,,,,,,,,,,,,,,,,,,,,,,,,,,,,,,,,,,,,,,,,,,,,,,,,,,,,,,,,,,,,,,,,,,,,,,,,,,,,,,,,,,,,,,,,,,,,,,,,,,,,,,,,,,,,,,,,,,,,,,,,,,,,,,,,,,,,,,,,,,,,,,,,,,,,,,,,,,,,,,,,,,,,,,,,,,,,,,,,,,,,,,,,,,,,,,,,,,,,,,,,,,,,,,,,,,,,,,,,,,,,,,,,,,,,,,,,,,,,,,,,,,,,,,,,,,,,,,,,,,,,,,,,,,,,,,,,,,,,,,,,,,,,,,,,,,,,,,,,,,,,,,,,,,,,,,,,,,,,,,,,,,,,,,,,,,,,,,,,,,,,,,,,,,,,,,,,,,,,,,,,,,,,,,,,,,,0.0,0.0,0.0,0.0,0.0,0.0,0.0,,,,,,,,,,,,,,,,,,,,,,,,,,,,,,,,,,,,,,,,,,,,,,,,,,,,,,,,,,,,,,,,,,,,,,,,,,,,,,,,,,,,,,,,,,,,,,,,,,,,,,,,,,,,,,,,,,,,,,,,,,,,,,,,,,,,,,,,,,,,,,,,,,,,,,,,,,,,,,,,,,,,,,,,,,,,,,,,,,,,,,,,,,,,,,,,,,,,,,,,6.0,,,,,,,,,,,,,,,,,,,,,,,,,,,,,,,,,,,,,,,,,,,,,,,,,,,,,,,,,,,,,,,,,,,,,,,,,,,,,,,,,,,,,,,,,,,,,,,,,,,,,,,,,,,,,,,,,10.0,6.0,3.0,12.0,7.0,11.0,8.0,6.0,10.0,15.0,8.0,6.0,3.0,4.0,11.0,10.0,9.0,8.0,11.0,,,,,,,,,,,,,,,,,,,,,,,,,,,,,,,,,,,,,,,,,,,,,,,,,,,,,,,,,,,,,,,,,,,,,,,,,,,,,,,,,,,,,,,,,,,,,,,,,,,,,,,,,,,,,,,,,,,,,,,,,,,,,,,,,,,,,,4.0,3.0,5.0,6.0,6.0,3.0,4.0,5.0,5.0,1.0,3.0,5.0,8.0,8.0,5.0,6.0,5.0,1.0,6.0,7.0,6.0,4.0,,,,,,,,,,,,,,,,,,,,,,,,,,,,,,,,,,,,,,,,,,,,,,,,,,,,,,,,,,,,,,,,,,,,,,,,,,,,,,,,,,,,,,,,,,,,,,,,,,,,,,,,,,,,,,,,,,,,,,,,,,,,,,,,,,,,,,,,,,,,,,,,,,,,,,,,,,,,,,,,,,,,,,,,,,,,,,,,,,,,,,,,,,,,,,,,,,,,,,,,,,,,,,,,,,,,,,,,,,,,,,,,,,,,,,,,,,,,,,,,,,,,,,,,,,,,,,,,,,,,,,,,,,,,,,,,,,,,,,,,,,,,,,,,,,,,,,,,,,,,,,,,,,,,,,,,,,,,,,,,,,,,,,,,,,,,,,,,,,,,,,,,,,,,,,,,,,,,,,,,,,,,,,,,,,,,,,,,,,,,,,,,,,,,,,,,,,,,,,,,,,,,,,,,,,,,,,,,,,,,,,,,,,,,,,,,,,,,,,,,,,,,,,,,,,,,,,,,,,,,,,,,,,,,,,,,,,,,,,,,,,,,,,,,,,,,,,,,,,,,,,,,,,,,,,,,,,,,,,,,,,,,,,,,,,,,,,,,,,,,,,,,,,,,,,,,,,,,,,,,,,,,,,,,,,,,,,,,,,,,,,,,,,,,,,,,,,,,,,,,,,,,,,,,,,,,,,,,,,,,,,,,,,,,,,,,,,,,,,,,,,,,,,,,,,,,,,,,,,,,,,,,,,,,,,,,,,,,,,,,,,,,,,,,,,,,,,,,,,,,,,,,,,,,,,,,,,,,,,,,,,,,,,,,,,,,,,,,,,,,,,,,,,,,,,,,,,,,,,,,,,,,,,,,,,,,,,,,,,,,,,,,,,,,,,,,,,,,,,,,,,,,,,,,,,,,,,,,,,,,,,,,,,,,,,,,,,,,,,,,,,,,,,,,,,,,,,,,,,,,,,,,,,,,,,,,,,,,,,,,,,,,,,,,,,,,,,,,,,,,,,,,,,,,,,,,,,,,,,,,,,,,,,,,,,,,,,,,,,,,,,,,,,,,,,,,,,,,,,,,,,,,,,,,,,,,,,,,,,,,,,,,,,,,,,,,,,,,,,,,,,,,,,,,,,,,,,,,,,,,,,,,,,,,,,,,,,,,,,,,,,,,,,,,,,,,,,,,,,,,,,,,,,,,,,,,,,,,,,,,,,,,,,,,,,,,,,,,,,,,,,,,,,,,,,,,,,,,,,,,,,,,,,,,,,,,,,,,,,,,,,,,,,,,,,,,,,,,,,,,,,,,,,,,,,,,,,,,,,,,,,,,,,,,,,,,,,,,,,,,,,,,,,,,,,,,,,,,,,,,,,,,,,,,,,,,,,,,,,,,,,,,,,,,,,,,,,,,,,,,,,,,,,,,,,,,,,,,,,,,,,,,,,,,,,,,,,,,,,,,,,,,,,,,,,,,,,,,,,,,,,,,,,,,,,,,,,,,,,,,,,,,,,,,,,,,,,,,,,,,,,,,,,,,,,,,,,,,,,,,,,,,,,,,,,,,,,,,,,,,,,,,,,,,,,,,,,,,,,,,,,,,,,,,,,,,,,,,,,,,,,,,,,,,,,,,,,,,,,,,,,,,,,,,,,,,,,,,,,,,,,,,,,,,,,,,,,,,,,,,,,,,,,,,,,,,,,,,,,,,,,,,,,,,,,,,,,,,,,,,,,,,,,,,,,,,,,,,,,,,,,,,,,,,,,,,,,,,,,,,,,,,,,,,,,,,,,,,,,,,,,,,,,,,,,,,,,,,,,,,,,,,,,,,,,,,,,,,,,,,,,,,,,,,,,,,,,,,,,,,,,,,,,,,,,,,,,,,,,,,,,,,,,,,,,,,,,,,,,,,,,,,,,,,,,,,,,,,,,,,,,,,,,,,,,,,,,,,,,,,,,,,,,,,,,,,,,,,,,,,,,,,,,,,,,,,,,,,,,,,,,,,,,,,,,,,,,,,,,,,,,,,,,,,,,,,,,,,,,,,,,,,,,,,,,,,,,,,,,,,,,,,,,,,,,,,,,,,,,,,,,,,,,,,,,,,,,,,,,,,,,,,,,,,,,,,,,,,,,,,,,,,,,,,,,,,,,,,,,,,,,,,,,,,,,,,,,,,,,,,,,,,,,,,,,,,,,,,,,,,,,,,,,,,,,,,,,,,,,,,,,5.0,5.0,5.0,1.0,2.0,0.0,5.0,0.0,5.0,5.0,5.0,2.0,2.0,5.0,0.0,5.0,0.0,1.0,4.0,5.0,5.0,5.0,3.0,5.0,5.0,0.0,5.0,1.0,3.0,0.0,1.0,0.0,5.0,0.0,5.0,5.0,3.0,2.0,5.0,0.0,0.0,5.0,0.0,0.0,1.0,2.0,5.0,0.0,5.0,,,,,,,,,,,,,,,,,,,,,,,,,,,,,,,,,,,,,,,,,,,,,,,,,,,,,,,,,,,,,,,,,,,,,,,,,,,,,,,,,,,,,,,,,,,,,,,,,,,,,,,,,,,,,,,,,,,,,,,,,,,,,,,,,,,,,,,,,,,,,,,,,,,,,,,,,,,,,,,,,,,,,,,,,,,,,,,5.0,5.0,3.0,3.0,3.0,5.0,5.0,5.0,2.0,4.0,5.0,4.0,,,,,,,,,,,,,,,,,,,,,,,,,,,,,,,,,,,,,,,,,,,,,,,,,,,,,,,,,,,,,,,,,,,,,,,,,,,,,,,,,,,,,,,,,,11.0,2.0,3.0,10.0,10.0,18.0,1.0,0.0,5.0,7.0,5.0,12.0,3.0,17.0,8.0,,,,,,,,,,,,,,,,,,,,,,,,,,,,,0.0,0.0,5.0,5.0,4.0,4.0,5.0,0.0,0.0,4.0,5.0,4.0,5.0,3.0,5.0,4.0,4.0,5.0,4.0,4.0,4.0,2.0,0.0,3.0,5.0,2.0,4.0,4.0,1.0,4.0,5.0,0.0,0.0,,,,,,,,,,,,,,,,,,,,,,,,,,,,,,,,,,,,,,,,,,,,,,,,,,,,,,,,,,,,,,,,,,,,,,,,,,,,,,,,,,,,,,,,,,,,,,,,,,,,,,,,,,,,,,,,,,,,,,,,,,,,,,,,,,,,,,,,,,,,,,,,,,,,,11.0,5.0,4.0,4.0,6.0,4.0,1.0,4.0,2.0,10.0,1.0,0.0,0.0,0.0,3.0,2.0,0.0,5.0,6.0,0.0,7.0,3.0,0.0,2.0,1.0,4.0,3.0,2.0,3.0,7.0,1.0,10.0,4.0,4.0,5.0,0.0,5.0,0.0,3.0,4.0,1.0,2.0,5.0,3.0,2.0,4.0,2.0,1.0,4.0,4.0,3.0,2.0,3.0,0.0,6.0,2.0,2.0,0.0,3.0,7.0,5.0,3.0,5.0,1.0,3.0,3.0,4.0,3.0,1.0,0.0,5.0,11.0,1.0,4.0,4.0,1.0,3.0,0.0,6.0,1.0,5.0,4.0,8.0,0.0,1.0,0.0,1.0,1.0,2.0,1.0,0.0,1.0,2.0,2.0,2.0,1.0,8.0,1.0,2.0,4.0,4.0,0.0,3.0,4.0,2.0,4.0,1.0,2.0,0.0,8.0,1.0,,,,,,,,,,,,,,,,,,,,,,,,,,,,,,,,,,,,,,,,,,,,,,,,,,,,,,,,,,,,,,,,,,,,,,,,,,,,,,,,,,,,,,,,,,,,,,,,,,,,,,,,,,,,,,,,,,,,,,,,,,,,,,,,,,,,,,,,,,,,,,,,,,,,,,,,,,,,,,,,,,,,,,,,,,,,,,,,,,,,,,,,,,,,,,,,,,,,,,,,,,,,,,,,,,,,,,,,,,,,,,,,,,,,,,,,,,,,,,,,,,,,,,,,,,,,,,,,,,,,,,,,,,,,,,,,,,,,,,,,,,,,,,,,,,,,,,,,,,,,,,,,,,,,,,,,,,,,,,,,,,,,,,,,,,,,,,,,,,,,,,,,,,,,,,,,,0.0,3.0,4.0,3.0,0.0,0.0,4.0,0.0,0.0,0.0,1.0,1.0,3.0,1.0,1.0,1.0,0.0,3.0,3.0,0.0,2.0,0.0,0.0,1.0,51.0,0.0,13.0,6.0,2.0,3.0,2.0,0.0,2.0,0.0,1.0,2.0,1.0,0.0,1.0,2.0,0.0,3.0,0.0,3.0,0.0,1.0,0.0,17.0,4.0,0.0,1.0,1.0,1.0,0.0,0.0,3.0,2.0,2.0,1.0,2.0,0.0,0.0,3.0,0.0,2.0,0.0,5.0,,,,,1.0,0.0,0.0,1.0,5.0,5.0,5.0,5.0,5.0,5.0,,,,,,,,,,,,,,,,,,,,,11.0,17.0,8.0,4.0,35.0,6.0,14.0,2.0,12.0,10.0,14.0,14.0,4.0,4.0,4.0,11.0,0.0,11.0,0.0,9.0,19.0,7.0,9.0,12.0,6.0,9.0,5.0,1.0,3.0,6.0,2.0,0.0,4.0,8.0,12.0,15.0,2.0,6.0,5.0,10.0,15.0,2.0,21.0,0.0,4.0,5.0,5.0,5.0,4.0,5.0,5.0,5.0,0.0,0.0,1.0,5.0,5.0,5.0,5.0,5.0,5.0,5.0,5.0,4.0,5.0,3.0,1.0,5.0,5.0,3.0,5.0,5.0,4.0,5.0,5.0,0.0,2.0,2.0,5.0,1.0,1.0,3.0,0.0,1.0,3.0,0.0,5.0,0.0,3.0,0.0,0.0,5.0,4.0,1.0,0.0,5.0,2.0,1.0,1.0,5.0,5.0,5.0,5.0,1.0,5.0,5.0,1.0,5.0,0.0,2.0,0.0,0.0,5.0,5.0,4.0,3.0,5.0,5.0,1.0,0.0,5.0,5.0,5.0,0.0,1.0,3.0,5.0,5.0,1.0,3.0,1.0,0.0,5.0,1.0,4.0,5.0,1.0,0.0,5.0,3.0,4.0,4.0,5.0,3.0,5.0,0.0,5.0,0.0,5.0,2.0,5.0,5.0,1.0,0.0,5.0,3.0,5.0,5.0,2.0,5.0,2.0,9.0,15.0,10.0,7.0,16.0,9.0,9.0,5.0,11.0,6.0,15.0,18.0,15.0,17.0,9.0,2.0,5.0,5.0,1.0,4.0,3.0,4.0,5.0,1.0,2.0,0.0,3.0,5.0,3.0,4.0,5.0,1.0,5.0,5.0,5.0,5.0,3.0,5.0,5.0,1.0,5.0,0.0,0.0,5.0,5.0,5.0,2.0,0.0,5.0,3.0,5.0,2.0,5.0,5.0,5.0,1.0,5.0,5.0,5.0,5.0,2.0,5.0,1.0,5.0,0.0,2.0,0.0,0.0,0.0,5.0,5.0,4.0,5.0,4.0,5.0,2.0,3.0,5.0,0.0,5.0,5.0,1.0,1.0,0.0,5.0,2.0,3.0,5.0,5.0,5.0,5.0,5.0,5.0,5.0,5.0,5.0,5.0,5.0,5.0,1.0,3.0,5.0,5.0,5.0,1.0,5.0,4.0,5.0,2.0,5.0,2.0,5.0,1.0,5.0,5.0,5.0,5.0,1.0,5.0,1.0,0.0,0.0,5.0,2.0,5.0,5.0,,,,,,,,,,,,,,,,,,,,,,,,,,,,,,,,,,,,,,,,,,,,,,,,,,,,,,,,,,,,,,,,,,,,,,,,,,,,,,,,,,,,,,,,,,,,,,,,,,,,,,,,,,,,,,,,,,,,,,,,,,,,,,,,,,,,,,,,,,,,,,,,,,,,,,,,,,,,,,,,,,,,,,,,,,,,,,,,,,,,,,,,,,,,,,,,,,,,,,,,,,,,,,,,,,,,,,,,,,,,,,,,,,,,,,,,,,,,,,,,,,,,,,,,,,,,,,,,,,,,,,,,,,,,,,,,,,,,,,,,,,,,,,,,,,,,,,,,,,,,,,,,,,,,,,,,,,,,,,,,,,,,,,,,,,,,,,,,,,,,,,,,,,,,,,,,,,,,,,,,,,,,,,,,,,,,,,,,,,,,,,,,,,,,,,,,,,,,,,,,,,,,,,,,,,,,,,,,,,,,,,,,,,,,,,,,,,,,,,,,,,,,,,,,,,,,,,,,,,,,,,,,,,,,,,,,,,,,,,,,,,,,,,,,,,,,,,,,,,,,13.0,9.0,10.0,18.0,11.0,11.0,9.0,13.0,9.0,12.0,12.0,11.0,12.0,13.0,0.0,0.0,10.0,6.0,15.0,13.0,10.0,14.0,6.0,8.0,12.0,20.0,15.0,10.0,23.0,0.0,5.0,6.0,7.0,8.0,0.0,8.0,11.0,25.0,0.0,12.0,13.0,9.0,11.0,4.0,9.0,17.0,10.0,19.0,12.0,10.0,9.0,19.0,6.0,25.0,13.0,19.0,21.0,12.0,5.0,10.0,8.0,10.0,6.0,14.0,12.0,8.0,15.0,16.0,15.0,10.0,18.0,12.0,12.0,8.0,16.0,14.0,22.0,18.0,14.0,12.0,20.0,18.0,25.0,9.0,15.0,9.0,23.0,15.0,17.0,16.0,10.0,18.0,13.0,12.0,13.0,12.0,2.0,12.0,15.0,16.0,15.0,21.0,12.0,9.0,16.0,11.0,11.0,9.0,11.0,9.0,10.0,14.0,15.0,14.0,9.0,13.0,13.0,10.0,13.0,18.0,14.0,9.0,11.0,12.0,0.0,23.0,8.0,8.0,15.0,11.0,12.0,9.0,14.0,8.0,11.0,11.0,10.0,17.0,11.0,15.0,9.0,10.0,5.0,8.0,,,,,,,,,,,,,,,,,,,,,,,,,,,,,,,,,,,,,,,,,,,,,,,,,,,,,,,,,,,,,,,,,,,,,,,,,,,,,,,,,,,,,,,,,,,,,,,,,,,,,,,,,,,,,,,,,,,,,,,,,,,,,,,,,,,,,,,,,,,,,,,,,,,,,,,,,,,,,,,,,,,,,,,,,,,,,,,,,,,,,,,,,,,,,,,,,,,,,,,,,,,,,,,,,,,,,,,,,,,,,,,,,,,,,,,,,,,,,,,,,,,,,,,,,,,,,,,,,,,,,,,,,,,,,,,,,,,,,,,,,,,,,,,,,,,,,,,,,,,,,,,,,,,,,,,,,,,,,,,,,,,,,,,,,,,,,,,,,,,,,,,,,,,,,,,,,,,,,,,,,,,,,,,,,,,,,,,,,,,,,,,,,,,,,,,,,,,,,,,,,,,,,,,,,,,,,,,,,,,,,,,,,,,,,,,,,,,,,,,,,,,,,,,,,,,,,,,,,,,,,,,,,,,,,,,,,,,,,,,,,,,,,,,,,,,,,,,,,,,,,,,,,,,,,,,,,,,,,,,,,,,,,,,,,,,,,,,,,,,,,,,,,,,,,,,,,,,,,,,,,,,,,,,,,,,,,,,,,,,,,,,,,,,,,,,,,,,,,,,,,,,,,,,,,,,,,,,,,,,,,,,,,,,,,,,,,,,,,,,,,,,,,,1.0,0.0,,0.0,4.0,0.0,0.0,0.0,0.0,0.0,0.0,0.0,0.0,0.0,0.0,0.0,0.0,0.0,0.0,0.0,0.0,0.0,0.0,0.0,0.0,0.0,0.0,0.0,0.0,0.0,0.0,0.0,0.0,0.0,0.0,0.0,0.0,0.0,0.0,0.0,0.0,1.0,,0.0,0.0,2.0,0.0,0.0,5.0,5.0,3.0,5.0,5.0,,0.0,5.0,,3.0,5.0,2.0,,2.0,1.0,4.0,2.0,1.0,0.0,7.0,6.0,,,,,,3.0,3.0,5.0,5.0,2.0,2.0,5.0,0.0,2.0,3.0,0.0,0.0,3.0,1.0,0.0,5.0,5.0,4.0,2.0,5.0,4.0,1.0,4.0,0.0,1.0,1.0,3.0,0.0,4.0,1.0,1.0,3.0,5.0,5.0,5.0,1.0,5.0,3.0,23.0,5.0,1.0,5.0,4.0,5.0,5.0,4.0,3.0,5.0,,2.0,0.0,1.0,5.0,5.0,3.0,0.0,5.0,2.0,,,2.0,3.0,5.0,3.0,5.0,5.0,5.0,5.0,3.0,5.0,4.0,3.0,5.0,4.666666666666667,4.0,5.0,1.0,5.0,2.0,4.0,,,0.0,1.0,5.0,5.0,,1.0,1.0,3.0,3.0,5.0,2.0,3.0,5.0,4.0,1.0,5.0,5.0,1.0,5.0,4.0,5.0,5.0,5.0,5.0,5.0,2.0,0.0,5.0,5.0,3.0,,3.0,5.0,3.0,1.0,4.0,12.0,4.0,3.0,8.0,5.0,0.0,1.0,2.0,1.0,0.0,,,4.0,3.0,1.0,1.0,0.0,2.0,5.0,2.0,,2.0,4.0,0.0,2.0,0.0,2.0,0.0,7.0,2.0,0.0,1.0,5.0,5.0,4.0,4.0,4.0,4.0,3.0,23.0,,,,0.0,,10.0,3.0,5.0,0.0,,0.0,5.0,6.0,1.0,1.0,4.0,3.0,,,4.0,5.0,4.0,0.0,1.0,2.0,3.0,4.0,1.0,5.0,1.0,0.0,3.0,0.0,4.0,0.0,1.0,0.0,0.0,1.0,1.0,0.0,0.0,0.0,0.0,1.0,0.0,1.0,0.0,0.0,,,0.0,10.0,3.0,0.0,0.0,5.0,0.0,1.0,5.0,5.0,18.0,24.0,5.0,7.0,3.0,4.0,4.0,2.0,2.0,1.0,,3.0,0.0,1.0,1.0,0.0,0.0,0.0,2.0,0.0,3.0,5.0,0.0,5.0,5.0,3.0,4.0,5.0,4.0,5.0,9.0,14.0,3.0,4.0,1.0,0.0,5.0,0.0,5.0,5.0,4.0,,1.0,1.0,4.0,5.0,2.0,2.5,2.0,5.0,0.0,2.0,1.0,5.0,1.0,16.0,2.0,0.0,,3.0,,2.0,5.0,1.0,1.0,2.0,,3.0,1.0,1.0,2.0,,2.0,,,5.0,,1.0,10.0,,,,,0.0,3.0,5.0,2.0,5.0,5.0,3.0,4.0,2.0,,,4.0,5.0,0.0,6.0,2.0,5.0,5.0,0.0,2.0,3.0,0.0,6.0,2.0,1.0,4.0,,5.0,1.0,5.0,2.0,6.0,5.0,2.0,,5.0,3.0,4.0,4.0,4.0,5.0,5.0,,2.0,0.0,,1.0,0.0,0.0,3.0,2.0,1.0,0.0,0.0,1.0,,1.0,5.0,3.0,1.0,5.0,1.0,0.0,3.0,5.0,16.0,,,2.0,5.0,2.0,3.0,5.0,0.0,4.0,3.0,3.0,0.0,2.0,5.0,2.0,3.0,5.0,11.0,13.0,5.0,3.0,6.0,5.0,1.0,6.0,6.0,8.0,6.0,33.0,5.0,5.0,,3.0,3.0,0.0,0.0,5.0,5.0,9.0,3.0,5.0,0.0,0.0,0.0,0.0,0.0,,0.0,5.0,4.0,4.0,0.0,5.0,5.0,5.0,5.0,3.0,,1.0,4.0,,1.0,5.0,4.0,8.0,,,5.0,,5.0,,,0.0,0.0,5.0,4.0,,2.0,2.75,5.0,,4.0,0.0,,,1.0,,5.0,,,,,,,2.0,1.0,2.0,5.0,5.0,0.0,1.0,5.0,3.0,5.0,4.0,5.0,,,,1.0,5.0,1.0,3.0,5.0,1.0,4.0,4.0,,,5.0,5.0,1.0,0.0,5.0,4.0,3.0,2.0,5.0,0.0,5.0,1.0,3.0,4.0,5.0,3.0,,5.0,3.0,5.0,4.0,2.0,2.0,5.0,1.0,5.0,0.0,1.0,,0.0,0.0,5.0,9.0,5.0,5.0,5.0,0.0,5.0,5.0,5.0,5.0,5.0,5.0,5.0,5.0,5.0,3.0,5.0,3.0,5.0,5.0,0.0,,5.0,,2.0,,2.0,0.0,1.0,5.0,5.0,1.0,,5.0,5.0,4.0,,4.0,,,1.0,1.0,4.0,2.0,0.0,2.0,3.0,0.0,2.0,0.0,2.0,,0.0,5.0,5.0,3.0,5.0,5.0,0.0,6.0,7.0,0.0,2.0,5.0,0.0,2.0,3.0,0.0,5.0,2.0,5.0,3.0,3.0,5.0,1.0,0.0,5.0,4.0,5.0,,0.0,0.0,0.0,2.0,2.0,0.0,5.0,2.0,5.0,5.0,1.0,3.0,2.0,1.0,5.0,5.0,5.0,4.0,5.0,2.0,3.0,5.0,2.0,3.0,2.0,2.0,1.0,3.0,5.0,5.0,2.0,0.0,0.0,,,,,,1.0,1.0,1.0,5.0,,,2.0,5.0,4.0,2.0,1.0,0.0,5.0,4.0,4.0,2.0,5.0,5.0,0.0,0.0,2.0,,1.0,5.0,0.0,,,4.0,2.0,1.0,1.0,,,5.0,5.0,4.0,2.0,3.0,4.0,5.0,4.0,3.0,5.0,4.0,2.0,2.0,3.0,2.0,3.0,8.0,,,,3.0,0.0,3.0,,0.0,0.0,2.0,5.0,0.0,1.0,3.0,,2.0,5.0,1.0,5.0,3.0,5.0,,1.0,5.0,3.0,5.0,,,0.0,2.0,5.0,5.0,2.0,0.0,5.0,,,,,,6.0,2.0,4.0,0.0,1.0,,5.0,,,4.0,5.0,5.0,2.0,0.0,5.0,4.0,1.0,0.0,5.0,3.0,5.0,4.0,1.0,,,0.0,2.0,4.0,3.0,2.0,5.0,5.0,0.0,5.0,5.0,0.0,3.0,1.0,0.0,2.0,0.0,0.0,0.0,1.0,1.0,5.0,5.0,0.0,,4.0,0.0,5.0,,4.0,5.0,5.0,2.0,,4.0,,5.0,5.0,,,5.0,5.0,0.0,,,2.0,2.0,,6.0,5.0,1.0,1.0,0.0,2.0,0.0,,,5.0,,,,,,,,,,,2.0,,2.0,5.0,,4.0,,2.0,2.0,1.0,,3.0,2.0,0.0,,0.0,5.0,2.0,4.0,2.0,4.0,5.0,,1.0,3.0,0.0,,1.0,0.0,,,0.0,0.0,1.0,,0.0,1.0,0.0,,0.0,5.0,,,,,,,,,,,4.0,2.0,5.0,5.0,4.0,0.0,5.0,0.0,5.0,5.0,1.0,0.0,1.0,1.0,5.0,6.0,3.0,5.0,5.0,1.0,3.0,0.0,2.0,2.0,2.0,8.0,5.0,1.0,4.0,3.0,2.0,2.0,3.0,0.0,0.0,2.0,5.0,2.0,3.0,3.0,,5.0,3.0,3.0,0.0,,,,,,3.0,3.0,1.0,0.0,0.0,1.0,4.0,3.0,0.0,3.0,4.0,,,,4.0,1.0,,0.0,2.0,2.0,5.0,0.0,0.0,5.0,5.0,8.0,2.0,4.0,0.0,5.0,7.0,5.0,5.0,5.0,1.0,0.0,5.0,5.0,4.0,3.0,1.0,0.0,5.0,3.0,5.0,5.0,5.0,3.0,5.0,5.0,2.0,4.0,2.0,3.0,5.0,0.0,5.0,0.0,5.0,1.0,,,0.0,6.0,3.5,2.0,3.0,5.0,3.0,0.0,4.0,1.0,5.0,,4.0,2.0,,0.0,0.0,1.0,0.0,4.0,3.0,5.0,5.0,1.0,2.0,0.0,5.0,0.0,0.0,,4.0,2.0,0.0,1.0,2.0,5.0,0.0,3.0,2.0,4.0,3.0,5.0,4.0,0.0,2.0,,0.0,0.0,4.0,,1.0,0.0,5.0,1.0,5.0,0.0,4.0,5.0,1.0,5.0,0.0,2.0,2.0,5.0,0.0,4.0,1.0,0.0,0.0,5.0,2.0,1.0,5.0,1.0,2.0,2.0,5.0,1.0,5.0,5.0,5.0,2.0,9.0,12.0,,,,,,5.0,0.0,0.0,2.0,5.0,5.0,5.0,,3.0,0.0,,5.0,5.0,3.0,5.0,0.0,1.0,5.0,5.0,,3.0,2.0,0.0,5.0,0.0,11.0,6.0,3.0,5.0,3.0,2.0,3.0,3.0,5.0,3.0,3.0,0.0,2.0,2.0,3.0,3.0,1.0,4.0,2.0,0.0,4.0,,4.0,2.0,5.0,1.0,2.0,,,0.0,0.0,,5.0,2.0,2.0,1.0,4.0,,,,4.0,1.0,5.0,,15.0,4.0,,4.0,5.0,,8.0,4.0,5.0,0.0,6.0,3.0,,,0.0,5.0,4.0,6.0,5.0,6.0,1.0,1.0,,2.0,2.0,4.0,5.0,0.0,3.0,0.0,4.0,5.0,,1.0,4.0,4.0,4.0,3.0,5.0,,4.0,5.0,0.0,4.0,6.0,12.0,1.0,0.0,7.0,15.0,6.0,4.0,4.0,0.0,4.0,2.0,2.0,0.0,0.0,2.0,,,,,,,,,,,,,,,,,,,,,,,,,,,,5.0,2.0,0.0,1.0,0.0,0.0,0.0,5.0,,,5.0,2.0,0.0,5.0,2.0,2.0,5.0,2.0,2.0,3.0,4.0,4.0,5.0,5.0,2.0,4.0,7.0,5.0,3.0,3.0,2.0,3.0,0.0,5.0,0.0,3.0,5.0,5.0,5.0,1.0,0.0,5.0,0.0,4.0,5.0,2.0,0.0,1.0,2.0,10.0,,5.0,5.0,5.0,5.0,5.0,5.0,5.0,4.0,3.0,4.0,5.0,5.0,1.0,3.0,1.0,0.0,1.0,4.0,4.0,0.0,1.0,3.0,0.0,6.0,1.0,,2.0,0.0,0.0,3.0,,3.0,4.0,3.0,3.0,1.0,5.0,,1.0,3.0,4.0,4.0,5.0,2.0,5.0,3.0,3.0,4.0,5.0,0.0,5.0,3.0,3.0,,5.0,1.0,5.0,1.0,1.0,0.0,5.0,2.0,5.0,4.0,5.0,1.0,3.0,2.0,4.0,0.0,5.0,5.0,5.0,5.0,4.0,5.0,5.0,0.0,5.0,2.0,0.0,1.0,5.0,5.0,4.0,1.0,0.0,3.0,1.0,3.0,,,,,,,,,5.0,2.0,,0.0,4.0,3.0,0.0,5.0,3.0,5.0,5.0,,0.0,5.0,4.0,1.0,9.0,4.0,4.0,7.0,3.0,0.0,8.0,7.0,0.0,1.0,0.0,,2.0,5.0,1.0,1.0,1.0,0.0,2.0,2.0,,1.0,2.0,,2.0,0.0,5.0,2.0,,3.0,4.0,1.0,4.0,1.0,,,,,,2.0,0.0,5.0,5.0,,4.0,4.0,4.0,4.0,12.0,,1.0,,4.0,5.0,5.0,3.0,2.0,2.0,,5.0,1.0,3.0,3.0,6.0,0.0,0.0,,,,,1.0,1.0,2.0,1.0,0.0,0.0,0.0,0.0,0.0,4.0,3.0,5.0,1.0,1.0,2.0,0.0,5.0,3.0,3.0,5.0,5.0,5.0,3.0,2.0,2.0,5.0,1.0,5.0,5.0,5.0,2.0,5.0,0.0,3.0,1.0,1.0,5.0,2.0,5.0,2.0,5.0,4.0,2.0,4.0,1.0,,2.0,5.0,0.0,2.0,0.0,0.0,,2.0,0.0,1.0,0.0,0.0,2.0,0.0,1.0,1.0,0.0,2.0,0.0,0.0,3.0,5.0,4.0,2.0,3.0,0.0,5.0,5.0,4.0,5.0,2.0,5.0,5.0,4.0,3.0,5.0,4.0,4.0,5.0,5.0,1.0,5.0,4.0,5.0,2.0,2.0,5.0,5.0,4.0,2.0,3.0,4.0,4.0,4.0,3.0,,,,,,,,,,,,,,,,,,,4.0,5.0,5.0,4.0,3.0,5.0,4.0,5.0,5.0,5.0,4.0,5.0,5.0,4.0,,,,,,,,,,,,,,,,,,,,,,,,,,,,,,,,,,,,,,,,,,,,,,,,,,,,,,,,,,,,,,,,,,,,,,,,,,,,,,,,,,,,,,,,,,,,,,,,,,,,,,,,,,,,,,,,,,,,,,,,,,,,,,,,,,,,,,,,,,,,,,,,,,,,,,,,,,,,,,,,,,,,,,,,,,,,,,,,,,,,,,,,,,,,,,,,,,,,,,,,,,,,,,,,,,,,,,,,,,,,,,,,,,,,,,,,,,,,,,,,,,,,,,,,,,,,,,,,,,,,,,,,,,,,,,,,,,,,,,,,,,,,,,,,,,,4.0,4.0,4.0,1.0,0.0,4.0,2.0,4.0,0.0,1.0,2.0,1.0,0.0,5.0,5.0,1.0,5.0,4.0,5.0,2.0,5.0,7.0,7.0,9.0,3.0,2.0,4.0,12.0,14.0,7.0,6.0,4.0,4.0,3.0,6.0,0.0,4.0,4.0,15.0,5.0,7.0,4.0,6.0,8.0,17.0,3.0,7.0,5.0,6.0,10.0,7.0,9.0,17.0,5.0,7.0,10.0,4.0,11.0,6.0,3.0,3.0,5.0,7.0,8.0,4.0,3.0,7.0,3.0,10.0,27.0,9.0,5.0,13.0,4.0,2.0,4.0,5.0,4.0,4.0,11.0,3.0,6.0,5.0,4.0,3.0,3.0,3.0,3.0,6.0,11.0,7.0,18.0,12.0,12.0,14.0,4.0,5.0,6.0,11.0,7.0,11.0,10.0,5.0,6.0,4.0,10.0,6.0,12.0,5.0,4.0,3.0,3.0,9.0,3.0,6.0,13.0,5.0,0.0,3.0,9.0,14.0,14.0,5.0,8.0,13.0,12.0,3.0,7.0,14.0,7.0,7.0,6.0,5.0,1.0,3.0,5.0,10.0,1.0,7.0,3.0,13.0,10.0,7.0,6.0,3.0,6.0,5.0,9.0,2.0,7.0,10.0,3.0,7.0,4.0,7.0,10.0,13.0,9.0,2.0,,,,,,,,,,,,,,,,,7.0,16.0,11.0,11.0,,,,,,,,,,0.0,0.0,0.0,0.0,0.0,0.0,0.0,0.0,0.0,4.0,9.0,3.0,,,5.0,5.0,5.0,5.0,4.0,5.0,,,,,,,,,5.0,5.0,5.0,4.0,5.0,2.0,4.0,5.0,4.0,5.0,5.0,5.0,1.0,0.0,18.0,20.0,0.0,0.0,6.0,10.0,22.0,5.0,12.0,12.0,15.0,8.0,4.0,1.0,6.0,7.0,4.0,5.0,4.0,13.0,3.0,4.0,7.0,1.0,22.0,8.0,,5.0,11.0,5.0,5.0,5.0,4.0,5.0,0.0,5.0,5.0,5.0,5.0,5.0,5.0,5.0,5.0,5.0,5.0,5.0,4.0,5.0,5.0,5.0,5.0,5.0,5.0,3.0,,,,,,,,,,,,,,,,,,,,,,,,,,,,,,,,,,,,,,,,,,,,,,,,,,,,,,,,,,,,,,,,,,,,,,,,,,,,,,,,,,,,,,,,,,,,,,,,,,,,,,,,,,,,,,,,,,,,,,,,,,,,,,,,,,,,,,,,,,,,,,,,,,,,,,,,,,,,,,,,,,,,,,,,,,,,,,,,,,,5.0,4.0,5.0,5.0,5.0,5.0,5.0,5.0,3.0,4.0,5.0,4.0,5.0,0.0,1.5,1.0,5.0,5.0,4.0,4.0,5.0,5.0,5.0,5.0,5.0,5.0,5.0,6.0,16.0,9.5,2.0,9.0,4.0,0.0,8.5,6.0,8.0,9.0,6.0,1.0,11.0,6.0,7.0,7.0,11.0,7.0,10.0,7.0,6.0,8.0,5.0,6.0,3.0,3.0,12.0,9.0,7.0,6.0,8.0,5.0,6.0,2.0,3.0,9.0,6.5,1.0,6.0,5.0,6.0,9.0,7.0,4.0,7.0,5.0,2.0,4.0,9.0,10.0,9.0,8.0,7.0,10.0,11.0,8.0,7.0,10.0,7.0,7.0,6.0,4.0,5.0,4.0,7.0,6.0,7.0,10.0,6.0,6.0,6.0,7.0,8.0,8.0,10.0,8.0,9.0,6.0,9.0,8.0,7.0,8.0,10.0,6.0,3.0,7.0,7.0,8.0,10.0,5.0,0.0,7.0,8.0,10.0,7.0,10.0,6.0,8.0,5.0,8.0,9.0,8.0,7.0,8.0,9.0,10.0,9.0,8.0,10.0,10.0,9.0,10.0,8.0,9.0,11.0,7.0,7.0,8.0,7.0,3.0,5.0,5.0,2.0,1.0,6.0,4.0,4.0,2.0,9.0,6.0,1.0,4.0,4.0,2.0,3.0,2.0,6.0,8.0,2.0,8.0,4.0,2.0,4.0,4.0,3.0,7.0,6.0,4.0,0.0,4.0,6.0,1.0,2.0,3.0,,,,,,,,,,,,,,,,,,,,,,,,,,,,,,,,,,,,,,,,,,,,,,,,,,,,,,,,,,,,,,,,,,,,,,,,,,0.0,1.0,2.0,2.0,6.0,2.0,1.0,0.0,7.0,4.0,14.0,3.0,0.0,0.0,2.0,1.0,1.0,1.0,0.0,0.0,2.0,4.0,1.0,4.0,2.0,2.0,1.0,3.0,2.0,0.0,0.0,0.0,0.0,0.0,1.0,4.0,1.0,0.0,1.0,2.0,5.0,0.0,,,,,,,,,,,,,,,,,,,,,,,,,,,,,,,,,,,,,,,,,,,,,,,,,,,,,,,,,,,,,,,,,,,,,,,,,,,,,,,,,,,,,,,,,,,,,,,,,,,,,,,,,,,,,,,,,,,,,,,,,,,,,,,,,,,,,,,,,,,,,,,,,,,,,,,,,,,,,,,,,,,,,,,,,,,,,,,,,,,,,,,,,,,,,,,,,,,,,,,,,,,,,,,,,,,,,,,,,,,,,,,,,,,,,,,,,,,,,,,,,,,,,,,,,,,,,,,,,,,,,,,,,,,,,,,,,,,,,,,,,,,,,,,,,,,,,,,,,,,,,,,,,,,,,,,,,,,,,,,,,,,,,,,,,,,,,,,,,,,,,,,,,,,,,,,,,,,,,,,,,,,,,,,,,,,,,,,,,,,,,,,,,,,,,,,,,,,,,,,,,,,,,,,,,,,,,,,,,,,,,,,,,,,,,,,,,,,,,,,,,,,,,,,,,,,,,,,,,,,,,,,,,,,,,,,,,,,,,,,,,,,,,,,,,,,,,,,,,,,,,,,,,,,,,,,,,,,,,,,,,,,,,,,,,,,,,,,,,,,,,,,,,,,,,,,,,,,,,,,,,,,,,,,,,,,,,,,,,,,,,,,,,,,,,,,,,,,,,,,,,,,,,,,,,,,,,,,,,,,,,,,,,,,,,,,,,,,,,,,,,,,,,,,,,,,,,,,,,,,,,,,,,,,,,,,,,,,,,,,,,,,,,,,,,,,,,,,,,,,,,,,,,,,,,,,,,,,,,,,,,,,,,,,,,,,,,,,,,,,,,,,,,,,,,,,,,,,,,,,,,,,,,,,,,,,,,,3.0,8.0,8.0,4.0,1.0,8.0,0.0,3.0,3.0,5.0,4.0,5.0,5.0,5.0,1.0,3.0,5.0,5.0,3.0,5.0,4.0,5.0,4.0,5.0,3.0,5.0,4.0,5.0,1.0,3.0,0.0,5.0,2.0,5.0,4.0,5.0,0.0,4.0,4.0,3.0,,,,,,,,,,,,,,,,,,,,,,,,,,,,,,,,,,,,,,,,,,,,,,,,,,,,,,,,,,,,,,,,,,,,,,,,,,,,,,,,,,,,,,,,,,,,,,,,,,,,,,,,,,,,,,,,,,,,,,,,,,,,,,,,,,,,,,,,,,,,,,,,,,,,,,,,,,,,,,,,,,,,,,,,,,,,,,,,,,,,,,,,,,,,,,,,,,,,,,,,,,,,,,,,,,,,,,,,,,,,,,,,,,,,,,,,,,,,,,,,,,,,,,,,,,,,,,,,,,,,,,,,,,,,,,,,,,,,,,,,,,,,,,,,,,,,,,,,,,,,,,,,,,,,,,,,,,,,,,,,,,,,,,,,,,,,,,,,,,,,,,,,,,,1.0,,,,,5.0,,,,,,,,5.0,,,,,,,,,,2.0,4.0,5.0,1.0,5.0,5.0,5.0,0.0,5.0,2.0,5.0,5.0,4.0,5.0,2.0,5.0,5.0,5.0,0.0,5.0,0.0,4.0,5.0,2.0,5.0,5.0,5.0,4.0,4.0,5.0,2.0,5.0,5.0,5.0,4.0,5.0,5.0,4.0,5.0,3.0,5.0,5.0,5.0,1.0,5.0,4.0,5.0,3.0,5.0,2.0,5.0,5.0,7.0,5.0,4.0,7.0,3.0,2.0,7.0,4.0,3.0,5.0,3.0,1.0,3.0,5.0,5.0,1.0,4.0,5.0,2.0,0.0,5.0,5.0,0.0,5.0,0.0,5.0,0.0,0.0,0.0,0.0,5.0,0.0,5.0,0.0,0.0,5.0,5.0,5.0,3.0,0.0,4.0,5.0,0.0,5.0,5.0,5.0,5.0,5.0,0.0,5.0,2.0,4.0,5.0,5.0,5.0,0.0,5.0,5.0,0.0,0.0,5.0,0.0,5.0,0.0,5.0,5.0,3.0,,,,,,,,,,,,,,,,,,,,,,,,,,,,,,,,,,,,,,,,,,,,,,,,,,,,,,,,,,,,,,,,,,,,,,,,,,,,,,,,,,,,,,,,,,,,,,,,,,,,,,,,,,,,,,,,,,,,,,,,,,,,,,,,,,,,,,,,,,,,,,,,,,,,,,,11.0,8.0,9.0,11.0,3.0,10.0,7.0,5.0,13.0,,,,,,,,,,,,,,,,,,,,,,,,,6.0,3.0,5.0,7.0,10.0,1.0,9.0,23.0,5.0,12.0,13.0,0.0,0.0,0.0,1.0,2.0,13.0,1.0,1.0,1.0,2.0,3.0,6.0,0.0,2.0,20.0,1.0,1.0,7.0,2.0,6.0,10.0,1.0,3.0,0.0,0.0,5.0,0.0,23.0,4.0,3.0,5.0,4.0,1.0,5.0,5.0,0.0,5.0,5.0,4.0,5.0,5.0,3.0,5.0,0.0,5.0,5.0,5.0,5.0,5.0,5.0,2.0,5.0,5.0,5.0,5.0,5.0,5.0,5.0,3.0,0.0,4.0,5.0,5.0,5.0,3.0,5.0,5.0,4.0,5.0,5.0,5.0,4.0,5.0,,,,,,,,,,,,,,,,,,,,,,,,,,,,,,,,,,,,,,,,,,,,,,,,,,,,,,,,,,,,,,,,,,,,,,,,2.0,11.0,0.0,5.0,16.0,4.0,5.0,2.0,5.0,5.0,7.0,1.0,1.0,6.0,7.0,5.0,1.0,5.0,5.0,5.0,5.0,2.0,5.0,2.0,14.0,9.0,11.0,5.0,13.0,11.0,10.0,15.0,9.0,10.0,,,,,,,,,,,,,,,,,,,,,,,,,,,,,,,,,,,,,,,,,,,,,,,,,,,,,,,,,,,,,,,,,,,,,,,,,,,,,,,,,,,,,,,,,,,,,,,,,,,,,,,,,,,,,,,,,,,,,,,,,,,,,,,,,,,,,,,,,,,,,,,,,,,,,,,,,,,,,,,,,,,,,,,,,,,,,,,,,,,,,,,,,,,,,,,,,,,,,,,,,,,,,,,,,,,,,,,,,,,,,,,,,,,,,,,,,,,,,,,,,,,,,,,,,,,,,,,,,,,,,,,,,,,,,,,,,,,,,,,,,,,,,,,,,,,,,,,,,,,,,,,5.0,5.0,5.0,1.0,2.0,5.0,5.0,2.0,5.0,,,,,,,,,,,,,,,,,,,,,,,,,,,,,,,,,,,,,,,,,,,,,,,,,,,,,5.0,2.0,5.0,5.0,5.0,5.0,4.0,0.0,5.0,3.0,4.0,5.0,0.0,5.0,5.0,5.0,5.0,5.0,5.0,5.0,3.0,5.0,4.0,3.0,0.0,4.0,4.0,5.0,5.0,5.0,3.0,5.0,5.0,5.0,5.0,1.0,5.0,5.0,5.0,4.0,5.0,4.0,4.0,2.0,4.0,5.0,5.0,5.0,5.0,4.0,5.0,5.0,4.0,5.0,2.0,4.0,3.0,2.0,5.0,5.0,5.0,5.0,5.0,2.0,5.0,4.0,5.0,4.0,5.0,4.0,5.0,5.0,4.0,5.0,4.0,5.0,5.0,5.0,5.0,5.0,4.0,5.0,4.0,5.0,5.0,4.0,5.0,5.0,4.0,4.0,5.0,3.0,1.0,3.0,5.0,5.0,5.0,5.0,5.0,5.0,5.0,5.0,4.0,5.0,5.0,4.0,5.0,2.0,5.0,5.0,3.0,5.0,4.0,5.0,5.0,5.0,5.0,4.0,0.0,5.0,,,,,3.0,4.0,7.0,8.0,28.0,34.0,7.0,0.0,21.0,14.0,14.0,9.0,7.0,6.0,26.0,14.0,11.0,2.0,5.0,9.0,1.0,11.0,22.0,22.0,14.0,15.0,10.0,19.0,26.0,27.0,8.0,14.0,2.0,5.0,20.0,28.0,14.0,19.0,32.0,12.0,6.0,9.0,23.0,14.0,3.0,13.0,23.0,16.0,17.0,19.0,8.0,2.0,3.0,10.0,6.0,4.0,6.0,9.0,5.0,1.0,3.0,4.0,11.0,2.0,0.0,4.0,1.0,3.0,16.0,22.0,22.0,15.0,19.0,2.0,9.0,4.0,17.0,1.0,3.0,8.0,16.0,18.0,5.0,28.0,5.0,13.0,1.0,4.0,7.0,3.0,26.0,2.0,15.0,13.0,24.0,15.0,5.0,0.0,3.0,3.0,1.0,12.0,9.0,16.0,20.0,21.0,2.0,13.0,15.0,8.0,20.0,4.0,4.0,2.0,2.0,2.0,10.0,1.0,15.0,8.0,4.0,11.0,2.0,31.0,13.0,10.0,5.0,10.0,12.0,18.0,14.0,2.0,5.0,4.0,12.0,21.0,17.0,6.0,24.0,13.0,3.0,2.0,5.0,10.0,16.0,0.0,1.0,23.0,27.0,9.0,6.0,14.0,2.0,2.0,12.0,14.0,4.0,10.0,3.0,1.0,12.0,9.0,3.0,7.0,13.0,3.0,8.0,2.0,6.0,17.0,8.0,4.0,0.0,16.0,20.0,6.0,8.0,2.0,0.0,25.0,4.0,0.0,8.0,4.0,16.0,1.0,2.0,9.0,1.0,3.0,11.0,0.0,7.0,2.0,11.0,0.0,10.0,13.0,3.0,2.0,22.0,7.0,11.0,24.0,4.0,16.0,22.0,4.0,20.0,7.0,0.0,13.0,1.0,11.0,17.0,13.0,2.0,18.0,6.0,6.0,7.0,8.0,19.0,13.0,12.0,3.0,8.0,23.0,23.0,7.0,24.0,14.0,13.0,18.0,11.0,2.0,2.0,9.0,7.0,30.0,8.0,17.0,14.0,11.0,1.0,24.0,1.0,3.0,46.0,4.0,0.0,19.0,21.0,8.0,5.0,12.0,4.0,15.0,5.0,13.0,20.0,24.0,17.0,11.0,3.0,6.0,3.0,44.0,37.0,26.0,31.0,17.0,23.0,7.0,9.0,12.0,14.0,4.0,6.0,12.0,15.0,16.0,0.0,12.0,20.0,4.0,6.0,9.0,10.0,14.0,5.0,5.0,11.0,11.0,2.0,1.0,35.0,11.0,8.0,6.0,3.0,12.0,7.0,6.0,2.0,0.0,13.0,11.0,11.0,9.0,3.0,10.0,9.0,4.0,13.0,4.0,0.0,5.0,11.0,3.0,5.0,0.0,2.0,2.0,0.0,7.0,3.0,10.0,8.0,20.0,17.0,0.0,5.0,15.0,24.0,5.0,20.0,7.0,21.0,27.0,13.0,13.0,9.0,6.0,11.0,1.0,13.0,26.0,8.0,2.0,0.0,0.0,4.0,4.0,,,,,,,,,,,,,,,,,,,,,,,,,,,,,,,,,,,,,,,,,,,,,,,,,,,,,,,,,,,,,,,,,,,,,,,,,,,,,,,,,,,,,,,,,,,,,,,,,,,,,,,,,,,,,,,,,,,1.0,1.0,3.0,3.0,1.0,4.0,1.0,3.0,5.0,6.0,9.0,1.0,1.0,0.0,5.0,4.0,2.0,7.0,1.0,0.0,0.0,2.0,8.0,1.0,2.0,2.0,5.0,8.0,3.0,6.0,2.0,4.0,14.0,0.0,5.0,1.0,6.0,0.0,0.0,1.0,0.0,3.0,3.0,4.0,9.0,2.0,7.0,8.0,6.0,5.0,0.0,2.0,3.0,3.0,2.0,6.0,0.0,7.0,7.0,11.0,2.0,6.333333333333333,3.0,16.0,10.0,2.0,0.0,4.0,3.0,1.0,2.0,2.0,5.0,5.0,4.0,2.0,1.0,3.0,7.0,5.0,5.0,2.0,1.0,10.0,1.0,0.0,4.0,6.0,2.0,2.0,0.0,1.0,2.0,6.0,3.0,2.0,0.0,7.0,4.0,0.0,4.0,0.0,1.0,4.0,2.0,2.0,8.0,4.0,4.0,3.0,3.0,3.0,3.0,5.0,13.0,1.0,2.0,1.0,2.0,0.0,0.0,2.0,3.0,12.0,7.0,8.0,9.0,4.0,0.0,1.0,3.0,5.0,9.0,4.0,2.0,2.0,4.0,2.0,3.0,4.0,1.0,6.0,4.0,2.0,5.0,7.0,0.0,2.0,6.0,3.0,4.0,1.0,1.0,7.0,0.0,10.0,2.0,7.0,4.0,11.0,0.0,4.0,10.0,0.0,3.0,9.0,11.0,0.0,0.0,1.0,3.0,3.0,7.0,2.0,0.0,0.0,0.0,1.0,1.0,6.0,1.0,1.0,2.0,0.0,8.0,2.0,6.0,5.0,4.0,4.0,3.0,1.0,4.0,5.0,3.0,,,,,,,,,,,,,,,,,,,,,,,,,,,,,,,,,,,,,,,,,,,,,,,,,,,,,,,,,,,,,,,,,,,,,,,,,,,,,,,,,,,,,,,,,,,,,,,,,,,,,,,,,,,,,,,,,,,,,,,,,,,,,,,,,,,,,,,,,,,,,,,,,,,,,,,,,,,,,,,,,,,,,,,,,,,,,,,,,,,,,,,,,,,,,,,,,,,,,,,,,,,,,,,,,,,,,,,,,,,,,,,,,,,,,,,,,,,,,,,,,,,,,,,,,,,,,,,,,,,,,,,,,,,,,,,,,,,,,,,,,,,,,,,,,,,,,,,,,,,,,,,,,,,,,,,,,,,,,,,,,,,,,,,,,,,,,,,,,,,,,,,,,,,,,,,,,,,,,,,,,,,,,,,,,,,,,,,,,,,,,,,,,,,,,,,,,,,,,,,,,,,,,,,,,,,,,,,,,,,,,,,,,,,,,,,,,,,,,,,,,,,,,,,,,,,,,,,,,,,,,,,,,,,,,,,,,,,,,,,,,,,,,,,,,,,,,,,,,,,,,,,,,,,,,,,,,,,,,,,,,,,,,,,,,,,,,,,,,,,,,,,,,,,,,,,,,,,,,,,,,,,,,,,,,,,,,,,,,,,,,,,,,,,,,,,,,,,,,,,,,,,,,,,,,,,,,,,,,,,,,,,,,,,,,,,,,,,,,,,,,,,,,,,,,,,,,,,,,,,,,,,,,,,,,,,,,,,,,,,,,,,,,,,,,,,,,,,,,,,,,,,,,,,,,,,,,,,,,,,,,,,,,,,,,,,,,,,,,,,,,,,,,,,,,,,,,,,,,,,,,,,,,,,,,,,,,,,,,,,,,,,,,,,,,,,,,,,,,,,,,,,,,,,,,,,,,,,,,,,,,,,,,,,,,,,,,,,,,,,,,,,,,,,,,,,,,,,,,,,,,,,,,,,,,,,,,,,,,,,,,,,,,,,,,,,,,,,,,,,,,,,,,,,,,,,,,,,,,,,,,,,,,,,,,,,,,,,,,,,,,,,,,,,,,,,,,,,,,,,,,,,,,,,,,,,,,,,,,,,,,,,,,,,,,,,,,,,,,,,,,,,,,,,,,,,,,,,,,,,,,,,,,,,,,,,,,,,,,,,,,,,,,,,,,,,,,,,,,,,,,,,,,,,,,,,,,,,,,,,,,,,,,,,,,,,,,,,,,,,,,,,,,,,,,,,,,,,,,,,,,,,,,,,,,,,,,,,,,,,,,,,,,,,,,,,,,,,,,,,,,,,,,,,,,,,,,,,,,,,,,,,,,,,,,,,,,,,,,,,,,,,,,,,,,,,,,,,,,,,,,,,,,,,,,,,,,,,,,,,,,,,,,,,,,,,,,,,,,,,,,,,,,,,,,,,,,,,,,,,,,,,,,,,,,,,,,,,,,,,,,,,,,,,,,,,,,,,,,,,,,,,,,,,,,,,,,,,,,,,,,,,,,,,,,,,,,,,,,,,,,,,,,,,,,,,,,,,,,,,,,,,,,,,,,,,,,,,,,,,,,,,,,,,,,,,,,,,,,,,,,,,,,,,,,,,,,,,,,,,,,,,,,,,,,,,,,,,,,,,,,,,,,,,,,,,,,,,,,,,,,,,,,,,,,,,,,,,,,,,,,,,,,,,,,,,,,,,,,,,,,,,,,,,,,,,,,,,,,,,,,,,,,,,,,,,,,,,,,,,,,,,,,,,,,,,,,,,,,,,,,,,,,,,,,,,,,,,,,,,,,,,,,,,,,,,,,,,,,,,,,,,,,,,,,,,,,,,,,,,,,,,,,,,,,,,,,,,,,,,,,,,,,,,,,,,,,,,,,,,,,,,,,,,,,,,,,,,,,,,,,,,,,,,,,,,,,,,,,,,,,,,,,,,,,,,,,,,,,,,,,,,,,,,,,,,,,,,,,,,,,,,,,,,,,,,,,,,,,,,,,,,,,,,,,,,,,,,,,,,,,,,,,,,,,,,,,,,,,,,,,,,,,,,,,,,,,,,,,,,,,,,,,,,,,,,,,,,,,,,,,,,,,,,,,,,,,,,,,,,,,,,,,,,,,,,,,,,,,,,,,,,,,,,,,,,,,,,,,,,,,,,,,,,,,,,,,,,,,,,,,,,,,,,,,,,,,,,,,,,,,,,,,,,,,,,,,,,,,,,,,,,,,,,,,,,,,,,,,,,,,,,,,,,,,,,,,,,,,,,,,,,,,,,,,,,,,,,,,,,,,,,,,,,,,,,,,,,,,,,,,,,,,,,,,,,,,,,,,,,,,,,,,,,,,,,,,,,,,,,,,,,,,,,,,,,,,,,,,,,,,,,,,,,,,,,,,,,,,,,,,,,,,,,,,,,,,,,,,,,,,,,,,,,,,,,,,,,,,,,,,,,,,,,,,,,,,,,,,,,,,,,,,,,,,,,,,,,,,,,,,,,,,,,,,,,,,,,,,,,,,,,,,,,,,,,,,,,,,,,,,,,,,,,,,,,,,,,,,,,,,,,,,,,,,,,,,,,,,,,,,,,,,,,,,,,,,,,,,,,,,,,,,,,,,,,,,,,,,,,,,,,,,,,,,,,,,,,,,,,,,,,,,,,,,,,,,,,,,,,,,,,,,,,,,,,,,,,,,,,,,,,,,,,,,,,,,,,,,,,,,,,,,,,,,,,,,,,,,,,,,,,,,,,,,,,,,,,,,,,,,,,,,,,,,,,,,,,,,,,,,,,,,,,,,,,,,,,,,,,,,,,,,,,,,,,,,,,,,,,,,,,,,,,,,,,,,,,,,,,,,,,,,,,,,,,,,,,,,,,,,,,,,,,,,,,,,,,,,,,,,,,,,,,,,,,,,,,,,,,,,,,,,,,,,,,,,,,,,,,,,,,,,,,,,,,,,,,,,,,,,,,,,,,,,,,,,,,,,,,,,,,,,,,,,,,,,,,,,,,,,,,,,,,,,,,,,,,,,,,,,,,,,,,,,,,,,,,,,,,,,,,,,,,,,,,,,,,,,,,,,,,,,,,,,,,,,,,,,,,,,,,,,,,,,,,,,,,,,,,,,,,,,,,,,,,,,,,,,,,,,,,,,,,,,,,,,,,,,,,,,,,,,,,,,,,,,,,,,,,,,,,,,,,,,,,,,,,,,,,,,,,,,,,,,,,,,,,,,,,,,,,,,,,,,,,,,,,,,,,,,,,,,,,,,,,,,,,,,,,,,,,,,,,,,,,,,,,,,,,,,,,,,,,,,,,,,,,,,,,,,,,,,,,,,,,,,,,,,,,,,,,,,,,,,,,,,,,,,,,,,,,,,,,,,,,,,,,,,,,,,,,,,,,,,,,,,,,,,,,,,,,,,,,,,,,,,,,,,,,,,,,,,,,,,,,,,,,,,,,,,,,,,,,,,,,,,,,,,,,,,,,,,,,,,,,,,,,,,,,,,,,,,,,,,,,,,,,,,,,,,,,,,,,,,,,,,,,,,,,,,,,,,,,,,,,,,,,,,,,,,,,,,,,,,,,,,,,,,,,,,,,,,,,,,,,,,,,,,,,,,,,,1.0,3.0,0.0,2.0,0.0,0.0,0.0,1.0,0.0,2.0,2.0,0.0,1.0,1.0,0.0,5.0,0.0,0.0,0.0,0.0,0.0,0.0,5.0,0.0,1.0,1.0,0.0,2.0,0.0,1.0,1.0,3.0,0.0,5.0,4.0,0.0,0.0,0.0,0.0,2.0,0.0,5.0,2.0,0.0,1.0,0.0,0.0,0.0,5.0,1.0,0.0,0.0,3.0,0.0,0.0,0.0,3.0,0.0,2.0,1.0,4.0,1.0,5.0,0.0,2.0,1.0,3.0,0.0,0.0,1.0,0.0,4.0,0.0,0.0,0.0,1.0,0.0,1.0,0.0,2.0,3.0,3.0,18.0,5.0,6.0,9.0,3.0,5.0,3.0,4.0,17.0,3.0,1.0,9.0,5.0,6.0,0.0,2.0,16.0,7.0,4.0,3.0,2.0,0.0,0.0,1.0,6.0,6.0,0.0,4.0,6.0,4.0,7.0,12.0,0.0,7.0,5.0,2.0,1.0,1.0,9.0,6.0,4.0,7.0,13.0,11.0,3.0,8.0,3.0,8.0,1.0,8.0,8.0,11.0,1.0,3.0,15.0,4.0,1.0,25.0,0.0,8.0,6.0,3.0,0.0,16.0,8.0,12.0,2.0,11.0,3.0,3.0,6.0,5.0,11.0,1.0,2.0,14.0,6.0,5.0,5.0,9.0,30.0,5.0,3.0,5.0,5.0,3.0,8.0,9.0,5.0,3.0,10.0,1.0,5.0,11.0,14.0,2.0,5.0,18.0,10.0,3.0,17.0,13.0,12.0,5.0,3.0,3.0,15.0,22.0,17.0,4.0,4.0,2.0,1.0,1.0,2.0,2.0,6.0,3.0,0.0,0.0,6.0,17.0,2.0,3.0,3.0,1.0,0.0,5.0,4.0,9.0,7.0,0.0,4.0,1.0,0.0,8.0,2.0,0.0,2.0,0.0,1.0,1.0,3.0,7.0,2.0,16.0,0.0,4.0,1.0,17.0,0.0,3.0,2.0,2.0,4.0,3.0,3.0,0.0,6.0,27.0,4.0,13.0,8.0,22.0,7.0,0.0,19.0,7.0,0.0,6.0,11.0,16.0,2.0,14.0,4.0,3.0,5.0,6.0,3.0,1.0,3.0,0.0,3.0,6.0,3.0,1.0,3.0,2.0,0.0,2.0,3.0,0.0,5.0,0.0,1.0,11.0,3.0,10.0,0.0,3.0,3.0,3.0,4.0,,,,,,,,,,,,,,,,,,,,,,,,,,,,,,,,,,,,,,,,,,,,,,,,,,,,,,,,,,,,,,,,,,,,,,,,,,,,,,,,,,,,,,,,,,,,,,,,,,,,,,,,,,,,,,,,,,,,,,,,,,,,,,,,,,,,,,,,,,,,,,,,,,,,,,,,,,,,,,,,,,,,,,,,,,,,,,,,,,,,,,,,,,,,,,,,,,,,,,,,,,,,,,,,,,,,,,,,,,,,,,,,,,,,,,,,,,,,,,,,,,,,,,,,,,,,6.0,6.0,9.0,3.0,12.0,7.0,5.0,10.0,0.0,5.0,5.0,5.0,4.0,5.0,5.0,5.0,4.0,5.0,5.0,5.0,5.0,2.0,5.0,2.0,2.0,5.0,5.0,5.0,5.0,3.0,5.0,2.0,5.0,2.0,4.0,5.0,4.0,5.0,5.0,5.0,5.0,4.0,5.0,0.0,5.0,1.0,5.0,3.0,,,,,,,,,,,,,,,,,,,,,,,,,,,,,,,,,,,,,,,,,,,,,,,,,,,,,,,,,,,,,,,,,,,,,,,,,,,,,,,,,,,,,,,,,,,,,,,,,,,,,,,,,,,,,,,,,,,,,,,,,,,,,,,,,,,,,,,,,,,,,,,,,,,,,,,,,,,,,,,,,,,,,,,,,,,,,,,,,,,,,,,,,,,,,,,,,,,,,,,,4.0,0.0,5.0,5.0,0.0,5.0,,,,,,,,,,,,,,,,,,,,,,,,,,,,,,,,,,,,,,,,,,,,,,,,,,,,,,,,,,,,,,,,,,,,,,,,,,,,,,,,,,,,,,,,,,,,,,,,,,,,,,,,,,,,,,,,,,,,,,,,,,,,,,,,,,,,,,,,,,,,,,,,,,,,,,,,,,,,,,,,,,,,,,,,,,,,,,,,,,,,,,,,,,,,,,,,,,,,,,,,,,,4.0,2.0,4.0,3.0,0.0,1.0,3.0,0.0,5.0,,,,,,,,,,,,,,,,,,5.0,2.0,0.0,3.0,5.0,,,,,,,,,,4.0,1.0,5.0,,5.0,1.0,,5.0,,,,,,,,,,,,,,0.0,2.0,,,5.0,3.0,,1.0,,,,,,,,,,,,,,,,,,,,,,0.0,,,,,,,3.0,,,,,,,,1.0,,1.0,,1.0,4.0,,1.0,1.0,,2.0,,,,1.0,,,5.0,1.0,,2.0,,,0.0,,,,,0.0,2.0,0.0,,0.0,,,,,,,1.0,,,,,,,,,,,,0.0,,,,1.0,,,,,,,,,,0.0,,,,,,,,1.0,,,,,,,,2.0,,,,4.0,,2.0,,,4.0,2.0,,,,1.0,4.0,,,,,,,,,0.0,1.0,,1.0,,1.0,2.0,,1.0,,0.0,,,5.0,,,,,,,,,,,,1.0,,,,,,,,,,,,,,,,,,1.0,3.0,,,,,5.0,2.0,0.0,,,,,,,,,,,,,,,,3.0,,0.0,3.0,0.0,2.0,,,,,,2.0,0.0,,,,1.0,,,,5.0,2.0,5.0,,,,,,,,,,0.0,,,,,,,,,,,,,,,,,,,,,,,,,3.0,,,,5.0,5.0,,2.0,,4.0,,1.0,,,,,,5.0,,3.0,0.0,,,,,0.0,,,,,,,,,,,,,,,,,,,,,,,,,,,,,,,,,,,,,,,,,,,,,,,,,,,,,,,,,,,,,,,,,,,,,,,,,,,,,,,,,,,,,,,,,,,,,,,,,,,,,,,,,,,,,,,,,,,,,,,,,,,,,,,,,,,,,,,,,,,,,,,,,,,,,,,,,,,,,,,,,,,,,,,,,,,,,,,,,,,,,,,,,,,,,,,,,,,,,,,,,,,,,,,,,,,,,,,,,,,,,,,,,,,,,,,,,,,,,,,,,,,,,,,,,,,,,,,,,,,,,,,,,,,,,,,,,,,,,,,,,,,,,,,,,,,,,,,,,,,,,,,,,,,,,,,,,,,,,,,,,,,,,,,,,,,,,,,,,,,,,,,,,,,,,,,,,,,,,,,,,,,,,,,,,,,,,,,,,,,,,,,,,,,,,,,,,,,,,,,,,,,,,,,,,,,,,,,,,,,,,,,,,,,,,,,,,,,,,,,,,,,,,,,,,,,,,,,,,,,,,,,,,,,,,,,,,,,,,,,,,,,,,,,,,,,,,,,,,,,,,,,,,,,,,,,,,,,,,,,,,,,,,,,,,,,,,,,,,,,,0.0,5.0,5.0,1.0,5.0,5.0,0.0,5.0,0.0,3.0,1.0,4.0,5.0,5.0,5.0,3.0,5.0,4.0,0.0,5.0,5.0,0.0,3.0,1.0,3.0,2.0,2.0,0.0,5.0,5.0,3.0,1.0,5.0,5.0,4.0,5.0,5.0,2.0,5.0,5.0,5.0,2.0,5.0,4.0,5.0,1.0,5.0,1.0,2.0,3.0,0.0,3.0,1.0,0.0,2.0,2.0,5.0,5.0,5.0,5.0,5.0,5.0,5.0,5.0,0.0,5.0,5.0,0.0,2.0,3.0,3.0,4.0,5.0,2.0,5.0,1.0,5.0,2.0,2.0,5.0,4.0,2.0,5.0,5.0,4.0,1.0,3.0,5.0,2.0,5.0,5.0,1.0,5.0,5.0,1.0,1.0,5.0,2.0,5.0,5.0,3.0,5.0,2.0,2.0,5.0,5.0,5.0,5.0,5.0,3.0,3.0,3.0,5.0,5.0,5.0,5.0,4.0,1.0,0.0,4.0,2.0,5.0,3.0,3.0,5.0,5.0,5.0,2.0,4.0,4.0,5.0,5.0,5.0,5.0,1.0,5.0,5.0,5.0,5.0,5.0,5.0,5.0,5.0,5.0,5.0,5.0,3.0,3.0,5.0,3.0,5.0,5.0,5.0,5.0,5.0,2.0,25.0,2.0,13.0,4.0,2.0,2.0
17,,,,,,,,,,,,,,,,,,,,,,,,,,,,,,,,,,,,,,,,,,,,,,,,,,,,,,,,,,,,,,,,,,,,,,,,,,,,,,,,,,,,,,,,,,,,,,,,,,,,,,,,,,,,,,,,,,,,,,,,,,,,,,,,,,,,,,,,,,,,,,,,,,,,,,,,,,,,,,,,,,,,,,,,,,,,,,,,,,,,,,,,,,,,,,,,,,,,,,,,,,,,,,,,,,,,,,,,,,,,,,,,,,,,,,,,,,,,,,,,,,,,,,,,,,,,,,,,,,,,,,,,,,,,,,,,,,,,,,,,,,,,,,,,,,,,,,,,,,,,,,,,,,,,,,,,,,,,,,,,,,,,,,,,,,,,,,,,,,,,,,,,,,,,,,,,,,,,,,,,,,,,,,,,,,,,,,,,,,,,,,,,,,,,,,,,,,,,,,,,,,,,,,,,,,,,,,,,,,,,,,,,,,,,,,,,,,,,,,,,,,,,,,,,,,,,,,,,,,,,,,,,,,,,,,,,,,,,,,,,,,,,,,,,,,,,,,,,,,,,,,,,,,,,,,,,,,,,,,,,,,,,,,,,,,,,,,,,,,,,,,,,,,,,,,,,,,,,,,,,,,,,,,,,,,,,,,,,,,,,,,,,,,,,,,,,,,,,,,,,,,,,,,,,,,,,,,,,,,,,,,,,,,,,,,,,,,,,,,,,,,,,,,,,,,,,,,,,,,,,,,,,,,,,,,,,,,,,,,,,,,,,,,,,,,,,,,,,,,,,,,,,,,,,,,,,,,,,,,,,,,,,,,,,,,,,,,,,,,,,,,,,,,,,,,,,,,,,,,,,,,,,,,,,,,,,,,,,,,,,,,,,,,,,,,,,,,,,,,,,,,,,,,,,,,,,,,,,,,,,,,,,,,,,,,,,,,,,,,,,,,,,,,,,,,,,,,,,,,,,,,,,,,,,,,,,,,,,,,,,,,,,,,,,,,,,,,,,,,,,,,,,,,,,,,,,,,,,,,,,,,,,,,,,,,,,,,,,,,,,,,,,,,,,,,,,,,,,,,,,,,,,,,,,,,,,,,,,,,,,,,,,,,,,,,,,,,,,,,,,,,,,,,,,,,,,,,,,,,,,,,,,,,,,,,,,,,,,,,,,,,,,,,,,,,,,,,,,,,,,,,,,,,,,,,,,,,,,,,,,,,,,,,,,,,,,,,,,,,,,,,,,,,,,,,,,,,,,,,,,,,,,,,,,,,,,,,,,,,,,,,,,,,,,,,,,,,,,,,,,,,,,,,,,,,,,,,,,,,,,,,,,,,,,,,,,,,,,,,,,,,,,,,,,,,,,,,,,,,,,,,,,,,,,,,,,,,,,,,,,,,,,,,,,,,,,,,,,,,,,,,,,,,,,,,,,,,,,,,,,,,,,,,,,,,,,,,,,,,,,,,,,,,,,,,,,,,,,,,,,,,,,,,,,,,,,,,,,,,,,,,,,,,,,,,,,,,,,,,,,,,,,,,,,,,,,,,,,,,,,,,,,,,,,,,,,,,,,,,,,,,,,,,,,,,,,,,,,,,,,,,,,,,,,,,,,,,,,,,,,,,,,,,,,,,,,,,,,,,,,,,,,,,,,,,,,,,,,,,,,,,,,,,,,,,,,,,,,,,,,,,,,,,,,,,,,,,,,,,,,,,,,,,,,,,,,,,,,,,,,,,,,,,,,,,,,,,,,,,,,,,,,,,,,,,,,,,,,,,,,,,,,,,,,,,,,,,,,,,,,,,,,,,,,,,,,,,,,,,,,,,,,,,,,,,,,,,,,,,,,,,,,,,,,,,,,,,,,,,,,,,,,,,,,,,,,,,,,,,,,,,,,,,,,,,,,,,,,,,,,,,,,,,,,,,,,,,,,,,,,,,,,,,,,,,,,,,,,,,,,,,,,,,,,,,,,,,,,,,,,,,,,,,,,,,,,,,,,,,,,,,,,,,,,,,,,,,,,,,,,,,,,,,,,,,,,,,,,,,,,,,,,,,,,,,,,,,,,,,,,,,,,,,,,,,,,,,,,,,,,,,,,,,,,,,,,,,,,,,,,,,,,,,,,,,,,,,,,,,,,,,,,,,,,,,,,,,,,,,,,,,,,,,,,,,,,,,,,,,,,,,,,,,,,,,,,,,,,,,,,,,,,,,,,,,,,,,,,,,,,,,,,,,,,,,,,,,,,,,,,,,,,,,,,,,,,,,,,,,,,,,,,,,,,,,,,,,,,,,,,,,,,,,,,,,,,,,,,,,,,,,,,,,,,,,,,,,,,,,,,,,,,,,,,,,,,,,,,,,,,,,,,,,,,,,,,,,,,,,,,,,,,,,,,,,,,,,,,,,,,,,,,,,,,,,,,,,,,,,,,,,,,,,,,,,,,,,,,,,,,,,,,,,,,,,,,,,,,,,,,,,,,,,,,,,,,,,,,,,,,,,,,,,,,,,,,,,,,,,,,,,,,,,,,,,,,,,,,,,,,,,,,,,,,,,,,,,,,,,,,,,,,,,,,,,,,,,,,,,,,,,,,,,,,,,,,,,,,,,,,,,,,,,,,,,,,,,,,,,,,,,,,,,,,,,,,,,,,,,,,,,,,,,,,,,,,,,,,,,,,,,,,,,,,,,,,,,,,,,,,,,,,,,,,,,,,,,,,,,,,,,,,,,,,,,,,,,,,,,,,,,,,,,,,,,,,,,,,,,,,,,,,,,,,,,,,,,,,,,,,,,,,,,,,,,,,,,,,,,,,,,,,,,,,,,,,,,,,,,,,,,,,,,,,,,,,,,,,,,,,,,,,,,,,,,,,,,,,,,,,,,,,,,,,,,,,,,,,,,,,,,,,,,,,,,,,,,,,,,,,,,,,,,,,,,,,,,,,,,,,,,,,,,,,,,,,,,,,,,,,,,,,,,,,,,,,,,,,,,,,,,,,,,,,,,,,,,,,,,,,,,,,,,,,,,,,,,,,,,,,,,,,,,,,,,,,,,,,,,,,,,,,,,,,,,,,,,,,,,,,,,,,,,,,,,,,,,,,,,,,,,,,,,,,,,,,,,,,,,,,,,,,,,,,,,,,,,,,,,,,,,,,,,,,,,,,,,,,,,,,,,,,,,,,,,,,,,,,,,,,,,,,,,,,,,,,,,,,,,,,,,,,,,,,,,,,,,,,,,,,,,,,,,,,,,,,,,,,,,,,,,,,,,,,,,,,,,,,,,,,,,,,,,,,,,,,,,,,,,,,,,,,,,,,,,,,,,,,,,,,,,,,,,,,,,,,,,,,,,,,,,,,,,,,,,,,,,,,,,,,,,,,,,,,,,,,,,,,,,,,,,,,,,,,,,,,,,,,,,,,,,,,,,,,,,,,,,,,,,,,,,,,,,,,,,,,,,,,,,,,,,,,,,,,,,,,,,,,,,,,,,,,,,,,,,,,,,,,,,,,,,,,,,,,,,,,,,,,,,,,,,,,,,,,,,,,,,,,,,,,,,,,,,,,,,,,,,,,,,,,,,,,,,,,,,,,,,,,,,,,,,,,,,,,,,,,,,,,,,,,,,,,,,,,,,,,,,,,,,,,,,,,,,,,,,,,,,,,,,,,,,,,,,,,,,,,,,,,,,,,,,,,,,,,,,,,,,,,,,,,,,,,,,,,,,,,,,,,,,,,,,,,,,,,,,,,,,,,,,,,,,,,,,,,,,,,,,,,,,,,,,,,,,,,,,,,,,,,,,,,,,,,,,,,,,,,,,,,,,,,,,,,,,,,,,,,,,,,,,,,,,,,,,,,,,,,,,,,,,,,,,,,,,,,,,,,,,,,,,,,,,,,,,,,,,,,,,,,,,,,,,,,,,,,,,,,,,,,,,,,,,,,,,,,,,,,,,,,,,,,,,,,,,,,,,,,,,,,,,,,,,,,,,,,,,,,,,,,,,,,,,,,,,,,,,,,,,,,,,,,,,,,,,,,,,,,,,,,,,,,,,,,,,,,,,,,,,,,,,,,,,,,,,,,,,,,,,,,,,,,,,,,,,,,,,,,,,,,,,,,,,,,,,,,,,,,,,,,,,,,,,,,,,,,,,,,,,,,,,,,,,,,,,,,,,,,,,,,,,,,,,,,,,,,,,,,,,,,,,,,,,,,,,,,,,,,,,,,,,,,,,,,,,,,,,,,,,,,,,,,,,,,,,,,,,,,,,,,,,,,,,,,,,,,,,,,,,,,,,,,,,,,,,,,,,,,,,,,,,,,,,,,,,,,,,,,,,,,,,,,,,,,,,,,,,,,,,,,,,,,,,,,,,,,,,,,,,,,,,,,,,,,,,,,,,,,,,,,,,,,,,,,,,,,,,,,,,,,,,,,,,,,,,,,,,,,,,,,,,,,,,,,,,,,,,,,,,,,,,,,,,,,,,,,,,,,,,,,,,,,,,,,,,,,,,,,,,,,,,,,,,,,,,,,,,,,,,,,,,,,,,,,,,,,,,,,,,,,,,,,,,,,,,,,,,,,,,,,,,,,,,,,,,,,,,,,,,,,,,,,,,,,,,,,,,,,,,,,,,,,,,,,,,,,,,,,,,,,,,,,,,,,,,,,,,,,,,,,,,,,,,,,,,,,,,,,,,,,,,,,,,,,,,,,,,,,,,,,,,,,,,,,,,,,,,,,,,,,,,,,,,,,,,,,,,,,,,,,,,,,,,,,,,,,,,,,,,,,,,,,,,,,,,,,,,,,,,,,,,,,,,,,,,,,,,,,,,,,,,,,,,,,,,,,,,,,,,,,,,,,,,,,,,,,,,,,,,,,,,,,,,,,,,,,,,,,,,,,,,,,,,,,,,,,,,,,,,,,,,,,,,,,,,,,,,,,,,,,,,,,,,,,,,,,,,,,,,,,,,,,,,,,,,,,,,,,,,,,,,,,,,,,,,,,,,,,,,,,,,,,,,,,,,,,,,,,,,,,,,,,,,,,,,,,,,,,,,,,,,,,,,,,,,,,,,,,,,,,,,,,,,,,,,,,,,,,,,,,,,,,,,,,,,,,,,,,,,,,,,,,,,,,,,,,,,,,,,,,,,,,,,,,,,,,,,,,,,,,,,,,,,,,,,,,,,,,,,,,,,,,,,,,,,,,,,,,,,,,,,,,,,,,,,,,,,,,,,,,,,,,,,,,,,,,,,,,,,,,,,,,,,,,,,,,,,,,,,,,,,,,,,,,,,,,,,,,,,,,,,,,,,,,,,,,,,,,,,,,,,,,,,,,,,,,,,,,,,,,,,,,,,,,,,,,,,,,,,,,,,,,,,,,,,,,,,,,,,,,,,,,,,,,,,,,,,,,,,,,,,,,,,,,,,,,,,,,,,,,,,,,,,,,,,,,,,,,,,,,,,,,,,,,,,,,,,,,,,,,,,,,,,,,,,,,,,,,,,,,,,,,,,,,,,,,,,,,,,,,,,,,,,,,,,,,,,,,,,,,,,,,,,,,,,,,,,,,,,,,,,,,,,,,,,,,,,,,,,,,,,,,,,,,,,,,,,,,,,,,,,,,,,,,,,,,,,,,,,,,,,,,,,,,,,,,,,,,,,,,,,,,,,,,,,,,,,,,,,,,,,,,,,,,,,,,,,,,,,,,,,,,,,,,,,,,,,,,,,,,,,,,,,,,,,,,,,,,,,,,,,,,,,,,,,,,,,,,,,,,,,,,,,,,,,,,,,,,,,,,,,,,,,,,,,,,,,,,,,,,,,,,,,,,,,,,,,,,,,,,,,,,,,,,,,,,,,,,,,,,,,,,,,,,,,,,,,,,,,,,,,,,,,,,,,,,,,,,,,,,,,,,,,,,,,,,,,,,,,,,,,,,,,,,,,,,,,,,,,,,,,,,,,,,,,,,,,,,,,,,,,,,,,,,,,,,,,,,,,,,,,,,,,,,,,,,,,,,,,,,,,,,,,,,,,,,,,,,,,,,,,,,,,,,,,,,,,,,,,,,,,,,,,,,,,,,,,,,,,,,,,,,,,,,,,,,,,,,,,,,,,,,,,,,,,,,,,,,,,,,,,,,,,,,,,,,,,,,,,,,,,,,,,,,,,,,,,,,,,,,,,,,,,,,,,,,,,,,,,,,,,,,,,,,,,,,,,,,,,,,,,,,,,,,,,,,,,,,,,,,,,,,,,,,,,,,,,,,,,,,,,,,,,,,,,,,,,,,,,,,,,,,,,,,,,,,,,,,,,,,,,,,,,,,,,,,,,,,,,,,,,,,,,,,,,,,,,,,,,,,,,,,,,,,,,,,,,,,,,,,,,,,,,,,,,,,,,,,,,,,,,,,,,,,,,,,,,,,,,,,,,,,,,,,,,,,,,,,,,,,,,,,,,,,,,,,,,,,,,,,,,,,,,,,,,,,,,,,,,,,,,,,,,,,,,,,,,,,,,,,,,,,,,,,,,,,,,,,,,,,,,,,,,,,,,,,,,,,,,,,,,,,,,,,,,,,,,,,,,,,,,,,,,,,,,,,,,,,,,,,,,,,,,,,,,,,,,,,,,,,,,,,,,,,,,,,,,,,,,,,,,,,,,,,,,,,,,,,,,,,,,,,,,,,,,,,,,,,,,,,,,,,,,,,,,,,,,,,,,,,,,,,,,,,,,,,,,,,,,,,,,,,,,,,,,,,,,,,,,,,,,,,,,,,,,,,,,,,,,,,,,,,,,,,,,,,,,,,,,,,,,,,,,,,,,,,,,,,,,,,,,,,,,,,,,,,,,,,,,,,,,,,,,,,,,,,,,,,,,,,,,,,,,,,,,,,,,,,,,,,,,,,,,,,,,,,,,,,,,,,,,,,,,,,,,,,,,,,,,,,,,,,,,,,,,,,,,,,,,,,,,,,,,,,,,,,,,,,,,,,,,,,,,,,,,,,,,,,,,,,,,,,,,,,,,,,,,,,,,,,,,,,,,,,,,,,,,,,,,,,,,,,,,,,,,,,,,,,,,,,,,,,,,,,,,,,,,,,,,,,,,,,,,,,,,,,,,,,,,,,,,,,,,,,,,,,,,,,,,,,,,,,,,,,,,,,,,,,,,,,,,,,,,,,,,,,,,,,,,,,,,,,,,,,,,,,,,,,,,,,,,,,,,,,,,,,,,,,,,,,,,,,,,,,,,,,,,,,,,,,,,,,,,,,,,,,,,,,,,,,,,,,,,,,,,,,,,,,,,,,,,,,,,,,,,,,,,,,,,,,,,,,,,,,,,,,,,,,,,,,,,,,,,,,,,,,,,,,,,,,,,,,,,,,,,,,,,,,,,,,,,,,,,,,,,,,,,,,,,,,,,,,,,,,,,,,,,,,,,,,,,,,,,,,,,,,,,,,,,,,,,,,,,,,,,,,,,,,,,,,,,,,,,,,,,,,,,,,,,,,,,,,,,,,,,,,,,,,,,,,,,,,,,,,,,,,,,,,,,,,,,,,,,,,,,,,,,,,,,,,,,,,,,,,,,,,,,,,,,,,,,,,,,,,,,,,,,,,,,,,,,,,,,,,,,,,,,,,,,,,,,,,,,,,,,,,,,,,,,,,,,,,,,,,,,,,,,,,,,,,,,,,,,,,,,,,,,,,,,,,,,,,,,,,,,,,,,,,,,,,,,,,,,,,,,,,,,,,,,,,,,,,,,,,,,,,,,,,,,,,,,,,,,,,,,,,,,,,,,,,,,,,,,,,,,,,,,,,,,,,,,,,,,,,,,,,,,,,,,,,,,,,,,,,,,,,,,,,,,,,,,,,,,,,,,,,,,,,,,,,,,,,,,,,,,,,,,,,,,,,,,,,,,,,,,,,,,,,,,,,,,,,,,,,,,,,,,,,,,,,,,,,,,,,,,,,,,,,,,,,,,,,,,,,,,,,,,,,,,,,,,,,,,,,,,,,,,,,,,,,,,,,,,,,,,,,,,,,,,,,,,,,,,,,,,,,,,,,,,,,,,,,,,,,,,,,,,,,,,,,,,,,,,,,,,,,,,,,,,,,,,,,,,,,,,,,,,,,,,,,,,,,,,,,,,,,,,,,,,,,,,,,,,,,,,,,,,,,,,,,,,,,,,,,,,,,,,,,,,,,,,,,,,,,,,,,,,,,,,,,,,,,,,,,,,,,,,,,,,,,,,,,,,,,,,,,,,,,,,,,,,,,,,,,,,,,,,,,,,,,,,,,,,,,,,,,,,,,,,,,,,,,,,,,,,,,,,,,,,,,,,,,,,,,,,,,,,,,,,,,,,,,,,,,,,,,,,,,,,,,,,,,,,,,,,,,,,,,,,,,,,,,,,,,,,,,,,,,,,,,,,,,,,,,,,,,,,,,,,,,,,,,,,,,,,,,,,,,,,,,,,,,,,,,,,,,,,,,,,,,,,,,,,,,,,,,,,,,,,,,,,,,,,,,,,,,,,,,,,,,,,,,,,,,,,,,,,,,,,,,,,,,,,,,,,,,,,,,,,,,,,,,,,,,,,,,,,,,,,,,,,,,,,,,,,,,,,,,,,,,,,,,,,,,,,,,,,,,,,,,,,,,,,,,,,,,,,,,,,,,,,,,,,,,,,,,,,,,,,,,,,,,,,,,,,,,,,,,,,,,,,,,,,,,,,,,,,,,,,,,,,,,,,,,,,,,,,,,,,,,,,,,,,,,,,,,,,,,,,,,,,,,,,,,,,,,,,,,,,,,,,,,,,,,,,,,,,,,,,,,,,,,,,,,,,,,,,,,,,,,,,,,,,,,,,,,,,,,,,,,,,,,,,,,,,,,,,,,,,,,,,,,,,,,,,,,,,,,,,,,,,,,,,,,,,,,,,,,,,,,,,,,,,,,,,,,,,,,,,,,,,,,,,,,,,,,,,,,,,,,,,,,,,,,,,,,,,,,,,,,,,,,,,,,,,,,,,,,,,,,,,,,,,,,,,,,,,,,,,,,,,,,,,,,,,,,,,,,,,,,,,,,,,,,,,,,,,,,,,,,,,,,,,,,,,,,,,,,,,,,,,,,,,,,,,,,,,,,,,,,,,,,,,,,,,,,,,,,,,,,,,,,,,,,,,,,,,,,,,,,,,,,,,,,,,,,,,,,,,,,,,,,,,,,,,,,,,,,,,,,,,,,,,,,,,,,,,,,,,,,,,,,,,,,,,,,,,,,,,,,,,,,,,,,,,,,,,,,,,,,,,,,,,,,,,,,,,,,,,,,,,,,,,,,,,,,,,,,,,,,,,,,,,,,,,,,,,,,,,,,,,,,,,,,,,,,,,,,,,,,,,,,,,,,,,,,,,,,,,,,,,,,,,,,,,,,,,,,,,,,,,,,,,,,,,,,,,,,,,,,,,,,,,,,,,,,,,,,,,,,,,,,,,,,,,,,,,,,,,,,,,,,,,,,,,,,,,,,,,,,,,,,,,,,,,,,,,,,,,,,,,,,,,,,,,,,,,,,,,,,,,,,,,,,,,,,,,,,,,,,,,,,,,,,,,,,,,,,,,,,,,,,,,,,,,,,,,,,,,,,,,,,,,,,,,,,,,,,,,,,,,,,,,,,,,,,,,,,,,,,,,,,,,,,,,,,,,,,,,,,,,,,,,,,,,,,,,,,,,,,,,,,,,,,,,,,,,,,,,,,,,,,,,,,,,,,,,,,,,,,,,,,,,,,,,,,,,,,,,,,,,,,,,,,,,,,,,,,,,,,,,,,,,,,,,,,,,,,,,,,,,,,,,,,,,,,,,,,,,,,,,,,,,,,,,,,,,,,,,,,,,,,,,,,,,,,,,,,,,,,,,,,,,,,,,,,,,,,,,,,,,,,,,,,,,,,,,,,,,,,,,,,,,,,,,,,,,,,,,,,,,,,,,,,,,,,,,,,,,,,,,,,,,,,,,,,,,,,,,,,,,,,,,,,,,,,,,,,,,,,,,,,,,,,,,,,,,,,,,,,,,,,,,,,,,,,,,,,,,,,,,,,,,,,,,,,,,,,,,,,,,,,,,,,,,,,,,,,,,,,,,,,,,,,,,,,,,,,,,,,,,,,,,,,,,,,,,,,,,,,,,,,,,,,,,,,,,,,,,,,,,,,,,,,,,,,,,,,,,,,,,,,,,,,,,,,,,,,,,,,,,,,,,,,,,,,,,,,,,,,,,,,,,,,,,,,,,,,,,,,,,,,,,,,,,,,,,,,,,,,,,,,,,,,,,,,,,,,,,,,,,,,,,,,,,,,,,,,,,,,,,,,,,,,,,,,,,,,,,,,,,,,,,,,,,,,,,,,,,,,,,,,,,,,,,,,,,,,,,,,,,,,,,,,,,,,,,,,,,,,,,,,,,,,,,,,,,,,,,,,,,,,,,,,,,,,,,,,,,,,,,,,,,,,,,,,,,,,,,,,,,,,,,,,,,,,,,,,,,,,,,,,,,,,,,,,,,,,,,,,,,,,,,,,,,,,,,,,,,,,,,,,,,,,,,,,,,,,,,,,,,,,,,,,,,,,,,,,,,,,,,,,,,,,,,,,,,,,,,,,,,,,,,,,,,,,,,,,,,,,,,,,,,,,,,,,,,,,,,,,,,,,,,,,,,,,,,,,,,,,,,,,,,,,,,,,,,,,,,,,,,,,,,,,,,,,,,,,,,,,,,,,,,,,,,,,,,,,,,,,,,,,,,,,,,,,,,,,,,,,,,,,,,,,,,,,,,,,,,,,,,,,,,,,,,,,,,,,,,,,,,,,,,,,,,,,,,,,,,,,,,,,,,,,,,,,,,,,,,,,,,,,,,,,,,,,,,,,,,,,,,,,,,,,,,,,,,,,,,,,,,,,,,,,,,,,,,,,,,,,,,,,,,,,,,,,,,,,,,,,,,,,,,,,,,,,,,,,,,,,,,,,,,,,,,,,,,,,,,,,,,,,,,,,,,,,,,,,,,,,,,,,,,,,,,,,,,,,,,,,,,,,,,,,,,,,,,,,,,,,,,,,,,,,,,,,,,,,,,,,,,,,,,,,,,,,,,,,,,,,,,,,,,,,,,,,,,,,,,,,,,,,,,,,,,,,,,,,,,,,,,,,,,,,,,,,,,,,,,,,,,,,,,,,,,,,,,,,,,,,,,,,,,,,,,,,,,,,,,,,,,,,,,,,,,,,,,,,,,,,,,,,,,,,,,,,,,,,,,,,,,,,,,,,,,,,,,,,,,,,,,,,,,,,,,,,,,,,,,,,,,,,,,,,,,,,,,,,,,,,,,,,,,,,,,,,,,,,,,,,,,,,,,,,,,,,,,,,,,,,,,,,,,,,,,,,,,,,,,,,,,,,,,,,,,,,,,,,,,,,,,,,,,,,,,,,,,,,,,,,,,,,,,,,,,,,,,,,,,,,,,,,,,,,,,,,,,,,,,,,,,,,,,,,,,,,,,,,,,,,,,,,,,,,,,,,,,,,,,,,,,,,,,,,,,,,,,,,,,,,,,,,,,,,,,,,,,,,,,,,,,,,,,,,,,,,,,,,,,,,,,,,,,,,,,,,,,,,,,,,,,,,,,,,,,,,,,,,,,,,,,,,,,,,,,,,,,,,,,,,,,,,,,,,,,,,,,,,,,,,,,,,,,,,,,,,,,,,,,,,,,,,,,,,,,,,,,,,,,,,,,,,,,,,,,,,,,,,,,,,,,,,,,,,,,,,,,,,,,,,,,,,,,,,,,,,,,,,,,,,,,,,,,,,,,,,,,,,,,,,,,,,,,,,,,,,,,,,,,,,,,,,,,,,,,,,,,,,,,,,,,,,,,,,,,,,,,,,,,,,,,,,,,,,,,,,,,,,,,,,,,,,,,,,,,,,,,,,,,,,,,,,,,,,,,,,,,,,,,,,,,,,,,,,,,,,,,,,,,,,,,,,,,,,,,,,,,,,,,,,,,,,,,,,,,,,,,,,,,,,,,,,,,,,,,,,,,,,,,,,,,,,,,,,,,,,,,,,,,,,,,,,,,,,,,,,,,,,,,,,,,,,,,,,,,,,,,,,,,,,,,,,,,,,,,,,,,,,,,,,,,,,,,,,,,,,,,,,,,,,,,,,,,,,,,,,,,,,,,,,,,,,,,,,,,,,,,,,,,,,,,,,,,,,,,,,,,,,,,,,,,,,,,,,,,,,,,,,,,,,,,,,,,,,,,,,,,,,,,,,,,,,,,,,,,,,,,,,,,,,,,,,,,,,,,,,,,,,,,,,,,,,,,,,,,,,,,,,,,,,,,,,,,,,,,,,,,,,,,,,,,,,,,,,,,,,,,,,,,,,,,,,,,,,,,,,,,,,,,,,,,,,,,,,,,,,,,,,,,,,,,,,,,,,,,,,,,,,,,,,,,,,,,,,,,,,,,,,,,,,,,,,,,,,,,,,,,,,,,,,,,,,,,,,,,,,,,,,,,,,,,,,,,,,,,,,,,,,,,,,,,,,,,,,,,,,,,,,,,,,,,,,,,,,,,,,,,,,,,,,,,,,,,,,,,,,,,,,,,,,,,,,,,,,,,,,,,,,,,,,,,,,,,,,,,,,,,,,,,,,,,,,,,,,,,,,,,,,,,,,,,,,,,,,,,,,,,,,,,,,,,,,,,,,,,,,,,,,,,,,,,,,,,,,,,,,,,,,,,,,,,,,,,,,,,,,,,,,,,,,,,,,,,,,,,,,,,,,,,,,,,,,,,,,,,,,,,,,,,,,,,,,,,,,,,,,,,,,,,,,,,,,,,,,,,,,,,,,,,,,,,,,,,,,,,,,,,,,,,,,,,,,,,,,,,,,,,,,,,,,,,,,,,,,,,,,,,,,,,,,,,,,,,,,,,,,,,,,,,,,,,,,,,,,,,,,,,,,,,,,,,,,,,,,,,,,,,,,,,,,,,,,,,,,,,,,,,,,,,,,,,,,,,,,,,,,,,,,,,,,,,,,,,,,,,,,,,,,,,,,,,,,,,,,,,,,,,,,,,,,,,,,,,,,,,,,,,,,,,,,,,,,,,,,,,,,,,,,,,,,,,,,,,,,,,,,,,,,,,,,,,,,,,,,,,,,,,,,,,,,,,,,,,,,,,,,,,,,,,,,,,,,,,,,,,,,,,,,,,,,,,,,,,,,,,,,,,,,,,,,,,,,,,,,,,,,,,,,,,,,,,,,,,,,,,,,,,,,,,,,,,,,,,,,,,,,,,,,,,,,,,,,,,,,,,,,,,,,,,,,,,,,,,,,,,,,,,,,,,,,,,,,,,,,,,,,,,,,,,,,,,,,,,,,,,,,,,,,,,,,,,,,,,,,,,,,,,,,,,,,,,,,,,,,,,,,,,,,,,,,,,,,,,,,,,,,,,,,,,,,,,,,,,,,,,,,,,,,,,,,,,,,,,,,,,,,,,,,,,,,,,,,,,,,,,,,,,,,,,,,,,,,,,,,,,,,,,,,,,,,,,,,,,,,,,,,,,,,,,,,,,,,,,,,,,,,,,,,,,,,,,,,,,,,,,,,,,,,,,,,,,,,,,,,,,,,,,,,,,,,,,,,,,,,,,,,,,,,,,,,,,,,,,,,,,,,,,,,,,,,,,,,,,,,,,,,,,,,,,,,,,,,,,,,,,,,,,,,,,,,,,,,,,,,,,,,,,,,,,,,,,,,,,,,,,,,,,,,,,,,,,,,,,,,,,,,,,,,,,,,,,,,,,,,,,,,,,,,,,,,,,,,,,,,,,,,,,,,,,,,,,,,,,,,,,,,,,,,,,,,,,,,,,,,,,,,,,,,,,,,,,,,,,,,,,,,,,,,,,,,,,,,,,,,,,,,,,,,,,,,,,,,,,,,,,,,,,,,,,,,,,,,,,,,,,,,,,,,,,,,,,,,,,,,,,,,,,,,,,,,,,,,,,,,,,,,,,,,,,,,,,,,,,,,,,,,,,,,,,,,,,,,,,,,,,,,,,,,,,,,,,,,,,,,,,,,,,,,,,,,,,,,,,,,,,,,,,,,,,,,,,,,,,,,,,,,,,,,,,,,,,,,,,,,,,,,,,,,,,,,,,,,,,,,,,,,,,,,,,,,,,,,,,,,,,,,,,,,,,,,,,,,,,,,,,,,,,,,,,,,,,,,,,,,,,,,,,,,,,,,,,,,,,,,,,,,,,,,,,,,,,,,,,,,,,,,,,,,,,,,,,,,,,,,,,,,,,,,,,,,,,,,,,,,,,,,,,,,,,,,,,,,,,,,,,,,,,,,,,,,,,,,,,,,,,,,,,,,,,,,,,,,,,,,,,,,,,,,,,,,,,,,,,,,,,,,,,,,,,,,,,,,,,,,,,,,,,,,,,,,,,,,,,,,,,,,,,,,,,,,,,,,,,,,,,,,,,,,,,,,,,,,,,,,,,,,,,,,,,,,,,,,,,,,,,,,,,,,,,,,,,,,,,,,,,,,,,,,,,,,,,,,,,,,,,,,,,,,,,,,,,,,,,,,,,,,,,,,,,,,,,,,,,,,,,,,,,,,,,,,,,,,,,,,,,,,,,,,,,,,,,,,,,,,,,,,,,,,,,,,,,,,,,,,,,,,,,,,,,,,,,,,,,,,,,,,,,,,,,,,,,,,,,,,,,,,,,,,,,,,,,,,,,,,,,,,,,,,,,,,,,,,,,,,,,,,,,,,,,,,,,,,,,,,,,,,,,,,,,,,,,,,,,,,,,,,,,,,,,,,,,,,,,,,,,,,,,,,,,,,,,,,,,,,,,,,,,,,,,,,,,,,,,,,,,,,,,,,,,,,,,,,,,,,,,,,,,,,,,,,,,,,,,,,,,,,,,,,,,,,,,,,,,,,,,,,,,,,,,,,,,,,,,,,,,,,,,,,,,,,,,,,,,,,,,,,,,,,,,,,,,,,,,,,,,,,,,,,,,,,,,,,,,,,,,,,,,,,,,,,,,,,,,,,,,,,,,,,,,,,,,,,,,,,,,,,,,,,,,,,,,,,,,,,,,,,,,,,,,,,,,,,,,,,,,,,,,,,,,,,,,,,,,,,,,,,,,,,,,,,,,,,,,,,,,,,,,,,,,,,,,,,,,,,,,,,,,,,,,,,,,,,,,,,,,,,,,,,,,,,,,,,,,,,,,,,,,,,,,,,,,,,,,,,,,,,,,,,,,,,,,,,,,,,,,,,,,,,,,,,,,,,,,,,,,,,,,,,,,,,,,,,,,,,,,,,,,,,,,,,,,,,,,,,,,,,,,,,,,,,,,,,,,,,,,,,,,,,,,,,,,,,,,,,,,,,,,,,,,,,,,,,,,,,,,,,,,,,,,,,,,,,,,,,,,,,,,,,,,,,,,,,,,,,,,,,,,,,,,,,,,,,,,,,,,,,,,,,,,,,,,,,,,,,,,,,,,,,,,,,,,,,,,,,,,,,,,,,,,,,,,,,,,,,,,,,,,,,,,,,,,,,,,,,,,,,,,,,,,,,,,,,,,,,,,,,,,,,,,,,,,,,,,,,,,,,,,,,,,,,,,,,,,,,,,,,,,,,,,,,,,,,,,,,,,,,,,,,,,,,,,,,,,,,,,,,,,,,,,,,,,,,,,,,,,,,,,,,,,,,,,,,,,,,,,,,,,,,,,,,,,,,,,,,,,,,,,,,,,,,,,,,,,,,,,,,,,,,,,,,,,,,,,,,,,,,,,,,,,,,,,,,,,,,,,,,,,,,,,,,,,,,,,,,,,,,,,,,,,,,,,,,,,,,,,,,,,,,,,,,,,,,,,,,,,,,,,,,,,,,,,,,,,,,,,,,,,,,,,,,,,,,,,,,,,,,,,,,,,,,,,,,,,,,,,,,,,,,,,,,,,,,,,,,,,,,,,,,,,,,,,,,,,,,,,,,,,,,,,,,,,,,,,,,,,,,,,,,,,,,,,,,,,,,,,,,,,,,,,,,,,,,,,,,,,,,,,,,,,,,,,,,,,,,,,,,,,,,,,,,,,,,,,,,,,,,,,,,,,,,,,,,,,,,,,,,,,,,,,,,,,,,,,,,,,,,,,,,,,,,,,,,,,,,,,,,,,,,,,,,,,,,,,,,,,,,,,,,,,,,,,,,,,,,,,,,,,,,,,,,,,,,,,,,,,,,,,,,,,,,,,,,,,,,,,,,,,,,,,,,,,,,,,,,,,,,,,,,,,,,,,,,,,,,,,,,,,,,,,,,,,,,,,,,,,,,,,,,,,,,,,,,,,,,,,,,,,,,,,,,,,,,,,,,,,,,,,,,,,,,,,,,,,,,,,,,,,,,,,,,,,,,,,,,,,,,,,,,,,,,,,,,,,,,,,,,,,,,,,,,,,,,,,,,,,,,,,,,,,,,,,,,,,,,,,,,,,,,,,,,,,,,,,,,,,,,,,,,,,,,,,,,,,,,,,,,,,,,,,,,,,,,,,,,,,,,,,,,,,,,,,,,,,,,,,,,,,,,,,,,,,,,,,,,,,,,,,,,,,,,,,,,,,,,,,,,,,,,,,,,,,,,,,,,,,,,,,,,,,,,,,,,,,,,,,,,,,,,,,,,,,,,,,,,,,,,,,,,,,,,,,,,,,,,,,,,,,,,,,,,,,,,,,,,,,,,,,,,,,,,,,,,,,,,,,,,,,,,,,,,,,,,,,,,,,,,,,,,,,,,,,,,,,,,,,,,,,,,,,,,,,,,,,,,,,,,,,,,,,,,,,,,,,,,,,,,,,,,,,,,,,,,,,,,,,,,,,,,,,,,,,,,,,,,,,,,,,,,,,,,,,,,,,,,,,,,,,,,,,,,,,,,,,,,,,,,,,,,,,,,,,,,,,,,,,,,,,,,,,,,,,,,,,,,,,,,,,,,,,,,,,,,,,,,,,,,,,,,,,,,,,,,,,,,,,,,,,,,,,,,,,,,,,,,,,,,,,,,,,,,,,,,,,,,,,,,,,,,,,,,,,,,,,,,,,,,,,,,,,,,,,,,,,,,,,,,,,,,,,,,,,,,,,,,,,,,,,,,,,,,,,,,,,,,,,,,,,,,,,,,,,,,,,,,,,,,,,,,,,,,,,,,,,,,,,,,,,,,,,,,,,,,,,,,,,,,,,,,,,,,,,,,,,,,,,,,,,,,,,,,,,,,,,,,,,,,,,,,,,,,,,,,,,,,,,,,,,,,,,,,,,,,,,,,,,,,,,,,,,,,,,,,,,,,,,,,,,,,,,,,,,,,,,,,,,,,,,,,,,,,,,,,,,,,,,,,,,,,,,,,,,,,,,,,,,,,,,,,,,,,,,,,,,,,,,,,,,,,,,,,,,,,,,,,,,,,,,,,,,,,,,,,,,,,,,,,,,,,,,,,,,,,,,,,,,,,,,,,,,,,,,,,,,,,,,,,,,,,,,,,,,,,,,,,,,,,,,,,,,,,,,,,,,,,,,,,,,,,,,,,,,,,,,,,,,,,,,,,,,,,,,,,,,,,,,,,,,,,,,,,,,,,,,,,,,,,,,,,,,,,,,,,,,,,,,,,,,,,,,,,,,,,,,,,,,,,,,,,,,,,,,,,,,,,,,,,,,,,,,,,,,,,,,,,,,,,,,,,,,,,,,,,,,,,,,,,,,,,,,,,,,,,,,,,,,,,,,,,,,,,,,,,,,,,,,,,,,,,,,,,,,,,,,,,,,,,,,,,,,,,,,,,,,,,,,,,,,,,,,,,,,,,,,,,,,,,,,,,,,,,,,,,,,,,,,,,,,,,,,,,,,,,,,,,,,,,,,,,,,,,,,,,,,,,,,,,,,,,,,,,,,,,,,,,,,,,,,,,,,,,,,,,,,,,,,,,,,,,,,,,,,,,,,,,,,,,,,,,,,,,,,,,,,,,,,,,,,,,,,,,,,,,,,,,,,,,,,,,,,,,,,,,,,,,,,,,,,,,,,,,,,,,,,,,,,,,,,,,,,,,,,,,,,,,,,,,,,,,,,,,,,,,,,,,,,,,,,,,,,,,,,,,,,,,,,,,,,,,,,,,,,,,,,,,,,,,,,4.0,6.0,,,,,,,,,,,,,,,,,,,,,,,,,,,,,,,,,,,,,,,,,,,,,,,,,,,,,,,,,,,,,,,,,,,,,,,,,,,,,,,,,,,,,,,,,,,,,,,,,,,,,,,,,,,,,,,,,,,,,,,,,,,,,,,,,,,,,,,,,,,,,,,,,,,,,,,,,,,,,,,,,,,,,,,,,,,,,,,,,,,,,,,,,,,,,,,,,,,,,,,,,,,,,,,,,,,,,,,,,,,,,,,,,,,,,,,,,,,,,,,,,,,,,,,,,,,,,,,,,,,,,,,,,,,,,,,,,,,,,,,,,,,,,,,,,,,,,,,,,,,,,,,,,,,,,,,,,,,,,,,,,,,,,,,,,,,,,,,,,,,,,,,,,,,,,,,,,,,,,,,,,,,,,,,,,,,,,,,,,,,,,,,,,,,,,,,,,,,,,,,,,,,,,,,,,,,,,,,,,,,,,,,,,,,,,,,,,,,,,,,,,,,,,,,,,,,,,,,,,,,,,,,,,,,,,,,,,,,,,,,,,,,,,,,,,,,,,,,,,,,,,,,,,,,,,,,,,,,,,,,,,,,,,,,,,,,,,,,,,,,,,,,,,,,,,,,,,,,,,,,,,,,,,,,,,,,,,,,,,,,,,,,,,,,,,,,,,,,,,,,,,,,,,,,,,,,,,,,,,,,,,,,,,,,,,,,,,,,,,,,,,,,,,,,,,,,,,,,,,,,,,,,,,,,,,,,,,,,,,,,,,,,,,,,,,,,,,,,,,,,,,,,,,,,,,,,,,,,,,,,,,,,,,,,,,,,,,,,,,,,,,,,,,,,,,,,,,,,,,,,,,,,,,,,,,,,,,,,,,,,,,,,,,,,,,,,,,,,,,,,,,,,,,,,,,,,,,,,,,,,,,,,,,,,,,,,,,,,,,,,,,,,,,,,,,,,,,,,,,,,,,,,,,,,,,,,,,,,,,,,,,,,,,,,,,,,,,,,,,,,,,,,,,,,,,,,,,,,,,,,,,,,,,,,,,,,,,,,,,,,,,,,,,,,,,,,,,,,,,,,,,,,,,,,,,,,,,,,,,,,,,,,,,,,,,,,,,,,,,,,,,,,,,,,,,,,,,,,,,,,,,,,,,,,,,,,,,,,,,,,,,,,,,,,,,,,,,,,,,,,,,,,,,,,,,,,,,,,,,,,,,,,,,,,,,,,,,,,,,,,,,,,,,,,,,,,,,,,,,,,,,,,,,,,,,,,,,,,,,,,,,,,,,,,,,,,,,,,,,,,,,,,,,,,,,,,,,,,,,,,,,,,,,,,,,,,,,,,,,,,,,,,,,,,,,,,,,,,,,,,,,,,,,,,,,,,,,,,,,,,,,,,,,,,,,,,,,,,,,,,,,,,,,,,,,,,,,,,,,,,,,,,,,,,,,,,,,,,,,,,,,,,,,,,,,,,,,,,,,,,,,,,,,,,,,,,,,,,,,,,,,,,,,,,,,,,,,,,,,,,,,,,,,,,,,,,,,,,,,,,,,,,,,,,,,,,,,,,,,,,,,,,,,,,,,,,,,,,,,,,,,,,,,,,,,,,,,,,,,,,,,,,,,,,,,,,,,,,,,,,,,,,,,,,,,,,,,,,,,,,,,,,,,,,,,,,,,,,,,,,,,,,,,,,,,,,,,,,,,,,,,,,,,,,,,,,,,,,,,,,,,,,,,,,,,,,,,,,,,,,,,,,,,,,,,,,,,,,,,,,,,,,,,,,,,,,,,,,,,,,,,,,,,,,,,,,,,,,,,,,,,,,,,,,,,,,,,,,,,,,,,,,,,,,,,,,,,,,,,,,,,,,,,,,,,,,,,,,,,,,,,,,,,,,,,,,,,,,,,,,,,,,,,,,,,,,,,,,,,,,,,,,,,,,,,,,,,,,,,,,,,,,,,,,,,,,,,,,,,,,,,,,,,,,,,,,,,,,,,,,,,,,,,,,,,,,,,,,,,,,,,,,,,,,,,,,,,,,,,,,,,,,,,,,,,,,,,,,,,,,,,,,,,,,,,,,,,,,,,,,,,,,,,,,,,,,,,,,,,,,,,,,,,,,,,,,,,,,,,,,,,,,,,,,,,,,,,,,,,,,,,,,,,,,,,,,,,,,,,,,,,,,,,,,,,,,,,,,,,,,,,,,,,,,,,,,,,,,,,,,,,,,,,,,,,,,,,,,,,,,,,,,,,,,,,,,,,,,,,,,,,,,,,,,,,,,,,,,,,,,,,,,,,,,,,,,,,,,,,,,,,,,,,,,,,,,,,,,,,,,,,,,,,,,,,,,,,,,,,,,,,,,,,,,,,,,,,,,,,,,,,,,,,,,,,,,,,,,,,,,,,,,,,,,,,,,,,,,,,,,,,,,,,,,,,,,,,,,,,,,,,,,,,,,,,,,,,,,,,,,,,,,,,,,,,,,,,,,,,,,,,,,,,,,,,,,,,,,,,,,,,,,,,,,,,,,,,,,,,,,,,,,,,,,,,,,,,,,,,,,,,,,,,,,,,,,,,,,,,,,,,,,,,,,,,,,,,,,,,,,,,,,,,,,,,,,,,,,,,,,,,,,,,,,,,,,,,,,,,,,,,,,,,,,,,,,,,,,,,,,,,,,,,,,,,,,,,,,,,,,,,,,,,,,,,,,,,,,,,,,,,,,,,,,,,,,,,,,,,,,,,,,,,,,,,,,,,,,,,,,,,,,,,,,,,,,,,,,,,,,,,,,,,,,,,,,,,,,,,,,,,,,,,,,,,,,,,,,,,,,,,,,,,,,,,,,,,,,,,,,,,,,,,,,,,,,,,,,,,,,,,,,,,,,,,,,,,,,,,,,,,,,,,,,,,,,,,,,,,,,,,,,,,,,,,,,,,,,,,,,,,,,,,,,,,,,,,,,,,,,,,,,,,,,,,,,,,,,,,,,,,,,,,,,,,,,,,,,,,,,,,,,,,,,,,,,,,,,,,,,,,,,,,,,,,,,,,,,,,,,,,,,,,,,,,,,,,,,,,,,,,,,,,,,,,,,,,,,,,,,,,,,,,,,,,,,,,,,,,,,,,,,,,,,,,,,,,,,,,,,,,,,,,,,,,,,,,,,,,,,,,,,,,,,,,,,,,,,,,,,,,,,,,,,,,,,,,,,,,,,,,,,,,,,,,,,,,,,,,,,,,,,,,,,,,,,,,,,,,,,,,,,,,,,,,,,,,,,,,,,,,,,,,,,,,,,,,,,,,,,,,,,,,,,,,,,,,,,,,,,,,,,,,,,,,,,,,,,,,,,,,,,,,,,,,,,,,,,,,,,,,,,,,,,,,,,,,,,,,,,,,,,,,,,,,,,,,,,,,,,,,,,,,,,,,,,,,,,,,,,,,,,,,,,,,,,,,,,,,,,,,,,,,,,,,,,,,,,,,,,,,,,,,,,,,,,,,,,,,,,,,,,,,,,,,,,,,,,,,,,,,,,,,,,,,,,,,,,,,,,,,,,,,,,,,,,,,,,,,,,,,,,,,,,,,,,,,,,,,,,,,,,,,,,,,,,,,,,,,,,,,,,,,,,,,,,,,,,,,,,,,,,,,,,,,,,,,,,,,,,,,,,,,,,,,,,,,,,,,,,,,,,,,,,,,,,,,,,,,,,,,,,,,,,,,,,,,,,,,,,,,,,,,,,,,,,,,,,,,,,,,,,,,,,,,,,,,,,,,,,,,,,,,,,,,,,,,,,,,,,,,,,,,,,,,,,,,,,,,,,,,,,,,,,,,,,,,,,,,,,,,,,,,,,,,,,,,,,,,,,,,,,,,,,,,,,,,,,,,,,,,,,,,,,,,,,,,,,,,,,,,,,,,,,,,,,,,,,,,,,,,,,,,,,,,,,,,,,,,,,,,,,,,,,,,,,,,,,,,,,,,,,,,,,,,,,,,,,,,,,,,,,,,,,,,,,,,,,,,,,,,,,,,,,,,,,,,,,,,,,,,,,,,,,,,,,,,,,,,,,,,,,,,,,,,,,,,,,,,,,,,,,,,,,,,,,,,,,,,,,,,,,,,,,,,,,,,,,,,,,,,,,,,,,,,,,,,,,,,,,,,,,,,,,,,,,,,,,,,,,,,,,,,,,,,,,,,,,,,,,,,,,,,,,,,,,,,,,,,,,,,,,,,,,,,,,,,,,,,,,,,,,,,,,,,,,,,,,,,,,,,,,,,,,,,,,,,,,,,,,,,,,,,,,,,,,,,,,,,,,,,,,,,,,,,,,,,,,,,,,,,,,,,,,,,,,,,,,,,,,,,,,,,,,,,,,,,,,,,,,,,,,,,,,,,,,,,,,,,,,,,,,,,,,,,,,,,,,,,,,,,,,,,,,,,,,,,,,,,,,,,,,,,,,,,,,,,,,,,,,,,,,,,,,,,,,,,,,,,,,,,,,,,,,,,,,,,,,,,,,,,,,,,,,,,,,,,,,,,,,,,,,,,,,,,,,,,,,,,,,,,,,,,,,,,,,,,,,,,,,,,,,,,,,,,,,,,,,,,,,,,,,,,,,,,,,,,,,,,,,,,,,,,,,,,,,,,,,,,,,,,,,,,,,,,,,,,,,,,,,,,,,,,,,,,,,,,,,,,,,,,,,,,,,,,,,,,,,,,,,,,,,,,,,,,,,,,,,,,,,,,,,,,,,,,,,,,,,,,,,,,,,,,,,,,,,,,,,,,,,,,,,,,,,,,,,,,,,,,,,,,,,,,,,,,,,,,,,,,,,,,,,,,,,,,,,,,,,,,,,,,,,,,,,,,,,,,,,,,,,,,,,,,,,,,,,,,,,,,,,,,,,,,,,,,,,,,,,,,,,,,,,,,,,,,,,,,,,,,,,,,,,,,,,,,,,,,,,,,,,,,,,,,,,,,,,,,,,,,,,,,,,,,,,,,,,,,,,,,,,,,,,,,,,,,,,,,,,,,,,,,,,,,,,,,,,,,,,,,,,,,,,,,,,,,,,,,,,,,,,,,,,,,,,,,,,,,,,,,,,,,,,,,,,,,,,,,,,,,,,,,,,,,,,,,,,,,,,,,,,,,,,,,,,,,,,,,,,,,,,,,,,,,,,,,,,,,,,,,,,,,,,,,,,,,,,,,,,,,,,,,,,,,,,,,,,,,,,,,,,,,,,,,,,,,,,,,,,,,,,,,,,,,,,,,,,,,,,,,,,,,,,,,,,,,,,,,,,,,,,,,,,,,,,,,,,,,,,,,,,,,,,,,,,,,,,,,,,,,,,,,,,,,,,,,,,,,,,,,,,,,,,,,,,,,,,,,,,,,,,,,,,,,,,,,,,,,,,,,,,,,,,,,,,,,,,,,,,,,,,,,,,,,,,,,,,,,,,,,,,,,,,,,,,,,,,,,,,,,,,,,,,,,,,,,,,,,,,,,,,,,,,,,,,,,,,,,,,,,,,,,,,,,,,,,,,,,,,,,,,,,,,,,,,,,,,,,,,,,,,,,,,,,,,,,,,,,,,,,,,,,,,,,,,,,,,,,,,,,,,,,,,,,,,,,,,,,,,,,,,,,,,,,,,,,,,,,,,,,,,,,,,,,,,,,,,,,,,,,,,,,,,,,,,,,,,,,,,,,,,,,,,,,,,,,,,,,,,,,,,,,,,,,,,,,,,,,,,,,,,,,,,,,,,,,,,,,,,,,,,,,,,,,,,,,,,,,,,,,,,,,,,,,,,,,,,,,,,,,,,,,,,,,,,,,,,,,,,,,,,,,,,,,,,,,,,,,,,,,,,,,,,,,,,,,,,,,,,,,,,,,,,,,,,,,,,,,,,,,,,,,,,,,,,,,,,,,,,,,,,,,,,,,,,,,,,,,,,,,,,,,,,,,,,,,,,,,,,,,,,,,,,,,,,,,,,,,,,,,,,,,,,,,,,,,,,,,,,,,,,,,,,,,,,,,,,,,,,,,,,,,,,,,,,,,,,,,,,,,,,,,,,,,,,,,,,,,,,,,,,,,,,,,,,,,,,,,,,,,,,,,,,,,,,,,,,,,,,,,,,,,,,,,,,,,,,,,,,,,,,,,,,,,,,,,,,,,,,,,,,,,,,,,,,,,,,,,,,,,,,,,,,,,,,,,,,,,,,,,,,,,,,,,,,,,,,,,,,,,,,,,,,,,,,,,,,,,,,,,,,,,,,,,,,,,,,,,,,,,,,,,,,,,,,,,,,,,,,,,,,,,,,,,,,,,,,,,,,,,,,,,,,,,,,,,,,,,,,,,,,,,,,,,,,,,,,,,,,,,,,,,,,,,,,,,,,,,,,,,,,,,,,,,,,,,,,,,,,,,,,,,,,,,,,,,,,,,,,,,,,,,,,,,,,,,,,,,,,,,,,,,,,,,,,,,,,,,,,,,,,,,,,,,,,,,,,,,,,,,,,,,,,,,,,,,,,,,,,,,,,,,,,,,,,,,,,,,,,,,,,,,,,,,,,,,,,,,,,,,,,,,,,,,,,,,,,,,,,,,,,,,,,,,,,,,,,,,,,,,,,,,,,,,,,,,,,,,,,,,,,,,,,,,,,,,,,,,,,,,,,,,,,,,,,,,,,,,,,,,,,,,,,,,,,,,,,,,,,,,,,,,,,,,,,,,,,,,,,,,,,,,,,,,,,,,,,,,,,,,,,,,,,,,,,,,,,,,,,,,,,,,,,,,,,,,,,,,,,,,,,,,,,,,,,,,,,,,,,,,,,,,,,,,,,,,,,,,,,,,,,,,,,,,,,,,,,,,,,,,,,,,,,,,,,,,,,,,,,,,,,,,,,,,,,,,,,,,,,,,,,,,,,,,,,,,,,,,,,,,,,,,,,,,,,,,,,,,,,,,,,,,,,,,,,,,,,,,,,,,,,,,,,,,,,,,,,,,,,,,,,,,,,,,,,,,,,,,,,,,,,,,,,,,,,,,,,,,,,,,,,,,,,,,,,,,,,,,,,,,,,,,,,,,,,,,,,,,,,,,,,,,,,,,,,,,,,,,,,,,,,,,,,,,,,,,,,,,,,,,,,,,,,,,,,,,,,,,,,,,,,,,,,,,,,,,,,,,,,,,,,,,,,,,,,,,,,,,,,,,,,,,,,,,,,,,,,,,,,,,,,,,,,,,,,,,,,,,,,,,,,,,,,,,,,,,,,,,,,,,,,,,,,,,,,,,,,,,,,,,,,,,,,,,,,,,,,,,,,,,,,,,,,,,,,,,,,,,,,,,,,,,,,,,,,,,,,,,,,,,,,,,,,,,,,,,,,,,,,,,,,,,,,,,,,,,,,,,,,,,,,,,,,,,,,,,,,,,,,,,,,,,,,,,,,,,,,,,,,,,,,,,,,,,,,,,,,,,,,,,,,,,,,,,,,,,,,,,,,,,,,,,,,,,,,,,,,,,,,,,,,,,,,,,,,,,,,,,,,,,,,,,,,,,,,,,,,,,,,,,,,,,,,,,,,,,,,,,,,,,,,,,,,,,,,,,,,,,,,,,,,,,,,,,,,,,,,,,,,,,,,,,,,,,,,,,,,,,,,,,,,,,,,,,,,,,,,,,,,,,,,,,,,,,,,,,,,,,,,,,,,,,,,,,,,,,,,,,,,,,,,,,,,,,,,,,,,,,,,,,,,,,,,,,,,,,,,,,,,,,,,,,,,,,,,,,,,,,,,,,,,,,,,,,,,,,,,,,,,,,,,,,,,,,,,,,,,,,,,,,,,,,,,,,,,,,,,,,,,,,,,,,,,,,,,,,,,,,,,,,,,,,,,,,,,,,,,,,,,,,,,,,,,,,,,,,,,,,,,,,,,,,,,,,,,,,,,,,,,,,,,,,,,,,,,,,,,,,,,,,,,,,,,,,,,,,,,,,,,,,,,,,,,,,,,,,,,,,,,,,,,,,,,,,,,,,,,,,,,,,,,,,,,,,,,,,,,,,,,,,,,,,,,,,,,,,,,,,,,,,,,,,,,,,,,,,,,,,,,,,,,,,,,,,,,,,,,,,,,,,,,,,,,,,,,,,,,,,,,,,,,,,,,,,,,,,,,,,,,,,,,,,,,,,,,,,,,,,,,,,,,,,,,,,,,,,,,,,,,,,,,,,,,,,,,,,,,,,,,,,,,,,,,,,,,,,,,,,,,,,,,,,,,,,,,,,,,,,,,,,,,,,,,,,,,,,,,,,,,,,,,,,,,,,,,,,,,,,,,,,,,,,,,,,,,,,,,,,,,,,,,,,,,,,,,,,,,,,,,,,,,,,,,,,,,,,,,,,,,,,,,,,,,,,,,,,,,,,,,,,,,,,,,,,,,,,,,,,,,,,,,,,,,,,,,,,,,,,,,,,,,,,,,,,,,,,,,,,,,,,,,,,,,,,,,,,,,,,,,,,,,,,,,,,,,,,,,,,,,,,,,,,,,,,,,,,,,,,,,,,,,,,,,,,,,,,,,,,,,,,,,,,,,,,,,,,,,,,,,,,,,,,,,,,,,,,,,,,,,,,,,,,,,,,,,,,,,,,,,,,,,,,,,,,,,,,,,,,,,,,,,,,,,,,,,,,,,,,,,,,,,,,,,,,,,,,,,,,,,,,,,,,,,,,,,,,,,,,,,,,,,,,,,,,,,,,,,,,,,,,,,,,,,,,,,,,,,,,,,,,,,,,,,,,,,,,,,,,,,,,,,,,,,,,,,,,,,,,,,,,,,,,,,,,,,,,,,,,,,,,,,,,,,,,,,,,,,,,,,,,,,,,,,,,,,,,,,,,,,,,,,,,,,,,,,,,,,,,,,,,,,,,,,,,,,,,,,,,,,,,,,,,,,,,,,,,,,,,,,,,,,,,,,,,,,,,,,,,,,,,,,,,,,,,,,,,,,,,,,,,,,,,,,,,,,,,,,,,,,,,,,,,,,,,,,,,,,,,,,,,,,,,,,,,,,,,,,,,,,,,,,,,,,,,,,,,,,,,,,,,,,,,,,,,,,,,,,,,,,,,,,,,,,,,,,,,,,,,,,,,,,,,,,,,,,,,,,,,,,,,,,,,,,,,,,,,,,,,,,,,,,,,,,,,,,,,,,,,,,,,,,,,,,,,,,,,,,,,,,,,,,,,,,,,,,,,,,,,,,,,,,,,,,,,,,,,,,,,,,,,,,,,,,,,,,,,,,,,,,,,,,,,,,,,,,,,,,,,,,,,,,,,,,,,,,,,,,,,,,,,,,,,,,,,,,,,,,,,,,,,,,,,,,,,,,,,,,,,,,,,,,,,,,,,,,,,,,,,,,,,,,,,,,,,,,,,,,,,,,,,,,,,,,,,,,,,,,,,,,,,,,,,,,,,,,,,,,,,,,,,,,,,,,,,,,,,,,,,,,,,,,,,,,,,,,,,,,,,,,,,,,,,,,,,,,,,,,,,,,,,,,,,,,,,,,,,,,,,,,,,,,,,,,,,,,,,,,,,,,,,,,,,,,,,,,,,,,,,,,,,,,,,,,,,,,,,,,
